Txn date,Effective,Description,Truncated card number,Amount,Charges,Balance
2025/03/01,2025/03/01,36360,,500,,50000
2025/03/01,2025/02/22,SF FuneralFDC0000000795L250222,,31.63,,1340306.08
2025/03/01,2025/02/24,SF FuneralFDC000000069C5250224,,31.63,,1340337.71
2025/03/01,2025/02/24,SF FuneralFDC000000084S1250224,,31.63,,1340369.34
2025/03/01,2025/02/24,SF FuneralF810327       250224,,31.63,,1340400.97
2025/03/01,2025/02/24,SF FuneralF1079340      250224,,31.63,,1340432.6
2025/03/01,2025/02/24,SF FuneralF1111395      250224,,31.63,,1340464.23
2025/03/01,2025/02/24,SF FuneralFDC0000000NPG9250224,,31.63,,1340495.86
2025/03/01,2025/02/25,SF FuneralF805200       250225,,31.63,,1340527.49
2025/03/01,2025/02/25,SF FuneralF816436       250225,,31.63,,1340559.12
2025/03/01,2025/02/25,SF FuneralFDC0000000CWFK250225,,31.63,,1340590.75
2025/03/01,2025/02/25,SF FuneralF1020683      250225,,31.63,,1340622.38
2025/03/01,2025/02/25,SF FuneralF1033680      250225,,31.63,,1340654.01
2025/03/01,2025/02/25,SF FuneralF1115225      250225,,31.63,,1340685.64
2025/03/01,2025/02/25,SF FuneralFDC0000000NRVB250225,,31.63,,1340717.27
2025/03/01,2025/02/25,SF FuneralF1123030      250225,,31.63,,1340748.9
2025/03/01,2025/02/25,SF FuneralF1127417      250225,,31.63,,1340780.53
2025/03/01,2025/02/25,SF FuneralF1130616      250225,,31.63,,1340812.16
2025/03/01,2025/02/25,SF FuneralF743038       250225,,31.63,,1340843.79
2025/03/01,2025/02/25,SF FuneralF1132382      250225,,31.63,,1340875.42
2025/03/01,2025/02/26,SF FuneralFDC00000007DMT250226,,31.63,,1340907.05
2025/03/01,2025/02/22,SF FuneralFDC000000082KN250222,,126.5,,1341033.55
2025/03/01,2025/02/22,SF FuneralF819883       250222,,126.5,,1341160.05
2025/03/01,2025/02/22,SF FuneralF820021       250222,,126.5,,1341286.55
2025/03/01,2025/02/22,SF FuneralF828632       250222,,126.5,,1341413.05
2025/03/01,2025/02/22,SF FuneralF1061976      250222,,126.5,,1341539.55
2025/03/01,2025/02/22,SF FuneralF1108110      250222,,126.5,,1341666.05
2025/03/01,2025/02/22,SF FuneralF1129250      250222,,126.5,,1341792.55
2025/03/01,2025/02/24,SF FuneralF1020934      250224,,126.5,,1341919.05
2025/03/01,2025/02/24,SF FuneralFDC0000000MLB3250224,,126.5,,1342045.55
2025/03/01,2025/02/25,SF FuneralF816365       250225,,126.5,,1342172.05
2025/03/01,2025/02/25,SF FuneralF817194       250225,,126.5,,1342298.55
2025/03/01,2025/02/25,SF FuneralF992084       250225,,126.5,,1342425.05
2025/03/01,2025/02/25,SF FuneralF1080351      250225,,63.25,,1342488.3
2025/03/01,2025/02/25,SF FuneralF1120296      250225,,126.5,,1342614.8
2025/03/01,2025/02/25,SF FuneralF1127919      250225,,63.25,,1342678.05
2025/03/01,2025/02/26,SF FuneralFDC000000077ZJ250226,,126.5,,1342804.55
2025/03/01,2025/02/26,SF FuneralF1118417      250226,,126.5,,1342931.05
2025/03/01,2025/02/26,SF FuneralF1122781      250226,,126.5,,1343057.55
2025/03/01,2025/02/27,SF FuneralFDC000000056T2250227,,220,,1343277.55
2025/03/01,2025/02/27,SF FuneralF812127       250227,,126.5,,1343404.05
2025/03/01,2025/02/27,SF FuneralF813449       250227,,126.5,,1343530.55
2025/03/01,2025/02/27,SF FuneralF827874       250227,,126.5,,1343657.05
2025/03/01,2025/02/27,SF FuneralF1066139      250227,,126.5,,1343783.55
2025/03/01,2025/02/27,SF FuneralF1078585      250227,,126.5,,1343910.05
2025/03/01,2025/02/27,SF FuneralF1115103      250227,,126.5,,1344036.55
2025/03/01,2025/02/27,SF FuneralFDC0000000NHCZ250227,,126.5,,1344163.05
2025/03/01,2025/02/27,SF FuneralFDC0000000NHD0250227,,126.5,,1344289.55
2025/03/01,2025/02/27,SF FuneralF1073377      250227,,126.5,,1344416.05
2025/03/01,2025/02/27,SF FuneralF1120892      250227,,126.5,,1344542.55
2025/03/01,2025/02/28,SF FuneralF809383       250228,,126.5,,1344669.05
2025/03/01,2025/02/28,SF FuneralF834685       250228,,126.5,,1344795.55
2025/03/01,2025/02/28,SF FuneralF834733       250228,,126.5,,1344922.05
2025/03/01,2025/02/28,SF FuneralF844337       250228,,126.5,,1345048.55
2025/03/01,2025/02/28,SF FuneralF980892       250228,,126.5,,1345175.05
2025/03/01,2025/02/28,SF FuneralF987170       250228,,126.5,,1345301.55
2025/03/01,2025/02/28,SF FuneralF1021067      250228,,126.5,,1345428.05
2025/03/01,2025/02/28,SF FuneralF1021087      250228,,126.5,,1345554.55
2025/03/01,2025/02/28,SF FuneralF1021798      250228,,126.5,,1345681.05
2025/03/01,2025/02/28,SF FuneralFDC0000000L90R250228,,126.5,,1345807.55
2025/03/01,2025/02/28,SF FuneralF1110128      250228,,126.5,,1345934.05
2025/03/01,2025/02/28,SF FuneralFDC0000000N5N9250228,,126.5,,1346060.55
2025/03/01,2025/02/28,SF FuneralF784966       250228,,126.5,,1346187.05
2025/03/01,2025/02/24,SF FuneralFDC00000007DSV250224,,31.63,,1346218.68
2025/03/01,2025/02/25,SF FuneralFDC000000078FZ250225,,31.63,,1346250.31
2025/03/01,2025/02/25,SF FuneralF798676       250225,,31.63,,1346281.94
2025/03/01,2025/02/25,SF FuneralF820929       250225,,31.63,,1346313.57
2025/03/01,2025/02/25,SF FuneralF991415       250225,,31.63,,1346345.2
2025/03/01,2025/02/25,SF FuneralF1020608      250225,,31.63,,1346376.83
2025/03/01,2025/02/25,SF FuneralF1050698      250225,,31.63,,1346408.46
2025/03/01,2025/02/25,SF FuneralF1061865      250225,,31.63,,1346440.09
2025/03/01,2025/02/25,SF FuneralF1062646      250225,,31.63,,1346471.72
2025/03/01,2025/02/25,SF FuneralF1074598      250225,,31.63,,1346503.35
2025/03/01,2025/02/25,SF FuneralF1103795      250225,,31.63,,1346534.98
2025/03/01,2025/02/25,SF FuneralF1116010      250225,,31.63,,1346566.61
2025/03/01,2025/02/25,SF FuneralF1127719      250225,,31.63,,1346598.24
2025/03/01,2025/02/26,SF FuneralF842872       250226,,31.63,,1346629.87
2025/03/01,2025/02/24,SF FuneralF991385       250224,,31.63,,1346661.5
2025/03/01,2025/02/24,SF FuneralF1066299      250224,,31.63,,1346693.13
2025/03/01,2025/02/24,SF FuneralF1072928      250224,,31.63,,1346724.76
2025/03/01,2025/02/25,SF FuneralFDC000000073P4250225,,31.63,,1346756.39
2025/03/01,2025/02/25,SF FuneralFDC00000008G43250225,,31.63,,1346788.02
2025/03/01,2025/02/25,SF FuneralF813552       250225,,31.63,,1346819.65
2025/03/01,2025/02/25,SF FuneralF1017666      250225,,31.63,,1346851.28
2025/03/01,2025/02/25,SF FuneralF1060838      250225,,31.63,,1346882.91
2025/03/01,2025/02/25,SF FuneralFDC0000000LVMD250225,,31.63,,1346914.54
2025/03/01,2025/02/25,SF FuneralF1084842      250225,,31.63,,1346946.17
2025/03/01,2025/02/25,SF FuneralF1102942      250225,,31.63,,1346977.8
2025/03/01,2025/02/25,SF FuneralF1118338      250225,,31.63,,1347009.43
2025/03/01,2025/02/25,SF FuneralF1129417      250225,,31.63,,1347041.06
2025/03/01,2025/02/21,SF FuneralF988690       250222,,126.5,,1347167.56
2025/03/01,2025/02/22,SF FuneralFDC000000062PC250222,,126.5,,1347294.06
2025/03/01,2025/02/22,SF FuneralFDC00000007LTQ250222,,126.5,,1347420.56
2025/03/01,2025/02/22,SF FuneralFDC00000007LYP250222,,126.5,,1347547.06
2025/03/01,2025/02/22,SF FuneralF811741       250222,,126.5,,1347673.56
2025/03/01,2025/02/22,SF FuneralF818242       250222,,126.5,,1347800.06
2025/03/01,2025/02/22,SF FuneralF840792       250222,,126.5,,1347926.56
2025/03/01,2025/02/22,SF FuneralF991753       250222,,126.5,,1348053.06
2025/03/01,2025/02/22,SF FuneralFDC0000000NYNQ250223,,126.5,,1348179.56
2025/03/01,2025/02/22,SF FuneralF1124544      250222,,126.5,,1348306.06
2025/03/01,2025/02/22,SF FuneralF1125102      250223,,126.5,,1348432.56
2025/03/01,2025/02/22,SF FuneralF1125104      250223,,126.5,,1348559.06
2025/03/01,2025/02/24,SF FuneralF827769       250224,,126.5,,1348685.56
2025/03/01,2025/02/25,SF FuneralFDC000000064RZ250225,,63.25,,1348748.81
2025/03/01,2025/02/25,SF FuneralF805847       250225,,126.5,,1348875.31
2025/03/01,2025/02/25,SF FuneralF811637       250225,,126.5,,1349001.81
2025/03/01,2025/02/25,SF FuneralF813480       250225,,63.25,,1349065.06
2025/03/01,2025/02/25,SF FuneralF823118       250225,,63.25,,1349128.31
2025/03/01,2025/02/25,SF FuneralF990512       250225,,126.5,,1349254.81
2025/03/01,2025/02/25,SF FuneralF1052117      250225,,63.25,,1349318.06
2025/03/01,2025/02/25,SF FuneralF1083711      250225,,63.25,,1349381.31
2025/03/01,2025/02/25,SF FuneralFDC0000000Q3YY250225,,126.5,,1349507.81
2025/03/01,2025/02/25,SF FuneralF1131085      250225,,126.5,,1349634.31
2025/03/01,2025/02/26,SF FuneralFDC00000007P1V250226,,126.5,,1349760.81
2025/03/01,2025/02/28,SF FuneralFDC0000000706X250228,,126.5,,1349887.31
2025/03/01,2025/02/28,SF FuneralFDC0000000751F250228,,386.5,,1350273.81
2025/03/01,2025/02/28,SF FuneralFDC00000007DR9250228,,126.5,,1350400.31
2025/03/01,2025/02/28,SF FuneralF800145       250228,,126.5,,1350526.81
2025/03/01,2025/02/28,SF FuneralFDC00000009DDC250228,,126.5,,1350653.31
2025/03/01,2025/02/28,SF FuneralF817312       250228,,126.5,,1350779.81
2025/03/01,2025/02/28,SF FuneralF821298       250228,,126.5,,1350906.31
2025/03/01,2025/02/28,SF FuneralF843552       250228,,126.5,,1351032.81
2025/03/01,2025/02/28,SF FuneralF1054492      250228,,126.5,,1351159.31
2025/03/01,2025/02/28,SF FuneralF1061665      250228,,126.5,,1351285.81
2025/03/01,2025/02/28,SF FuneralF1109576      250228,,126.5,,1351412.31
2025/03/01,2025/02/28,SF FuneralF1113101      250228,,126.5,,1351538.81
2025/03/01,2025/02/28,SF FuneralF1114330      250228,,126.5,,1351665.31
2025/03/01,2025/02/28,SF FuneralF1116125      250228,,126.5,,1351791.81
2025/03/01,2025/02/28,SF FuneralF1125504      250228,,126.5,,1351918.31
2025/03/01,2025/02/28,SF FuneralF1126044      250228,,126.5,,1352044.81
2025/03/01,2025/02/28,SF FuneralFDC0000000PPGM250228,,126.5,,1352171.31
2025/03/01,2025/02/19,SF FuneralFDC000000068V7250219,,126.5,,1352297.81
2025/03/01,2025/02/22,SF FuneralF830027       250222,,126.5,,1352424.31
2025/03/01,2025/02/24,SF FuneralFDC000000063H3250224,,126.5,,1352550.81
2025/03/01,2025/02/24,SF FuneralFDC00000007L4Z250224,,126.5,,1352677.31
2025/03/01,2025/02/24,SF FuneralF831939       250224,,126.5,,1352803.81
2025/03/01,2025/02/24,SF FuneralF1079049      250224,,126.5,,1352930.31
2025/03/01,2025/02/24,SF FuneralFDC0000000MSRY250224,,126.5,,1353056.81
2025/03/01,2025/02/24,SF FuneralF1113638      250224,,126.5,,1353183.31
2025/03/01,2025/02/24,SF FuneralF1113979      250224,,63.25,,1353246.56
2025/03/01,2025/02/25,SF FuneralF817558       250225,,126.5,,1353373.06
2025/03/01,2025/02/25,SF FuneralFDC0000000HTT8250225,,126.5,,1353499.56
2025/03/01,2025/02/25,SF FuneralFDC0000000LCST250225,,126.5,,1353626.06
2025/03/01,2025/02/25,SF FuneralF1075251      250225,,126.5,,1353752.56
2025/03/01,2025/02/25,SF FuneralF1078528      250225,,63.25,,1353815.81
2025/03/01,2025/02/25,SF FuneralF1084293      250225,,126.5,,1353942.31
2025/03/01,2025/02/25,SF FuneralF1108894      250225,,126.5,,1354068.81
2025/03/01,2025/02/25,SF FuneralF1109644      250225,,126.5,,1354195.31
2025/03/01,2025/02/25,SF FuneralF1130959      250225,,126.5,,1354321.81
2025/03/01,2025/02/25,SF FuneralF1131792      250225,,126.5,,1354448.31
2025/03/01,2025/02/26,SF FuneralF1120553      250226,,126.5,,1354574.81
2025/03/01,2025/02/27,SF FuneralF805122       250227,,126.5,,1354701.31
2025/03/01,2025/02/27,SF FuneralF806015       250227,,126.5,,1354827.81
2025/03/01,2025/02/27,SF FuneralFDC0000000H0V3250227,,126.5,,1354954.31
2025/03/01,2025/02/27,SF FuneralFDC0000000PG88250227,,126.5,,1355080.81
2025/03/01,2025/02/28,SF FuneralFDC00000005W9N250228,,220,,1355300.81
2025/03/01,2025/02/28,SF FuneralFDC000000067KY250228,,126.5,,1355427.31
2025/03/01,2025/02/28,SF FuneralFDC00000006RNF250228,,126.5,,1355553.81
2025/03/01,2025/02/28,SF FuneralFDC000000077HC250228,,126.5,,1355680.31
2025/03/01,2025/02/28,SF FuneralFDC00000008JKX250228,,126.5,,1355806.81
2025/03/01,2025/02/28,SF FuneralF816288       250228,,126.5,,1355933.31
2025/03/01,2025/02/28,SF FuneralFDC00000009VGG250228,,126.5,,1356059.81
2025/03/01,2025/02/28,SF FuneralF818788       250228,,126.5,,1356186.31
2025/03/01,2025/02/28,SF FuneralF981610       250301,,126.5,,1356312.81
2025/03/01,2025/02/28,SF FuneralF1068340      250228,,126.5,,1356439.31
2025/03/01,2025/02/28,SF FuneralFDC0000000M8TT250228,,126.5,,1356565.81
2025/03/01,2025/02/28,SF FuneralF1117026      250228,,126.5,,1356692.31
2025/03/01,2025/02/28,SF FuneralF1118068      250228,,126.5,,1356818.81
2025/03/01,2025/02/28,SF FuneralF1126166      250228,,126.5,,1356945.31
2025/03/01,2025/02/28,SF FuneralF1126299      250228,,126.5,,1357071.81
2025/03/01,2025/02/28,SF FuneralF1127428      250228,,126.5,,1357198.31
2025/03/01,2025/02/28,SF FuneralF1128041      250228,,126.5,,1357324.81
2025/03/01,2025/02/22,SF FuneralF802870       250222,,126.5,,1357451.31
2025/03/01,2025/02/22,SF FuneralF1116780      250222,,63.25,,1357514.56
2025/03/01,2025/02/22,SF FuneralFDC0000000NYP1250223,,126.5,,1357641.06
2025/03/01,2025/02/24,SF FuneralFDC00000002WKR250224,,220,,1357861.06
2025/03/01,2025/02/24,SF FuneralF832212       250223,,126.5,,1357987.56
2025/03/01,2025/02/24,SF FuneralF987009       250224,,126.5,,1358114.06
2025/03/01,2025/02/25,SF FuneralFDC00000006BTY250225,,126.5,,1358240.56
2025/03/01,2025/02/25,SF FuneralFDC000000085JC250225,,126.5,,1358367.06
2025/03/01,2025/02/25,SF FuneralF832100       250225,,126.5,,1358493.56
2025/03/01,2025/02/25,SF FuneralFDC0000000CWJT250225,,63.25,,1358556.81
2025/03/01,2025/02/25,SF FuneralF987322       250225,,126.5,,1358683.31
2025/03/01,2025/02/25,SF FuneralF991711       250225,,126.5,,1358809.81
2025/03/01,2025/02/25,SF FuneralF1059381      250225,,126.5,,1358936.31
2025/03/01,2025/02/25,SF FuneralF1074940      250225,,126.5,,1359062.81
2025/03/01,2025/02/25,SF FuneralF1114524      250225,,126.5,,1359189.31
2025/03/01,2025/02/25,SF FuneralF1125006      250225,,126.5,,1359315.81
2025/03/01,2025/02/25,SF FuneralF1125399      250225,,126.5,,1359442.31
2025/03/01,2025/02/25,SF FuneralFDC0000000Q3YX250225,,126.5,,1359568.81
2025/03/01,2025/02/25,SF FuneralF1131279      250225,,126.5,,1359695.31
2025/03/01,2025/02/26,SF FuneralF831599       250226,,126.5,,1359821.81
2025/03/01,2025/02/26,SF FuneralF992366       250226,,126.5,,1359948.31
2025/03/01,2025/02/26,SF FuneralF1020969      250226,,126.5,,1360074.81
2025/03/01,2025/02/26,SF FuneralFDC0000000LSVT250226,,126.5,,1360201.31
2025/03/01,2025/02/26,SF FuneralF1110375      250226,,126.5,,1360327.81
2025/03/01,2025/02/26,SF FuneralF1124148      250226,,126.5,,1360454.31
2025/03/01,2025/02/27,SF FuneralFDC00000006CPQ250227,,126.5,,1360580.81
2025/03/01,2025/02/27,SF FuneralFDC00000007VKY250227,,126.5,,1360707.31
2025/03/01,2025/02/27,SF FuneralFDC0000000857L250227,,126.5,,1360833.81
2025/03/01,2025/02/27,SF FuneralFDC000000097KT250227,,126.5,,1360960.31
2025/03/01,2025/02/27,SF FuneralF820134       250227,,126.5,,1361086.81
2025/03/01,2025/02/27,SF FuneralF841104       250227,,126.5,,1361213.31
2025/03/01,2025/02/27,SF FuneralF993417       250227,,126.5,,1361339.81
2025/03/01,2025/02/27,SF FuneralF1021463      250227,,126.5,,1361466.31
2025/03/01,2025/02/27,SF FuneralF1060530      250227,,126.5,,1361592.81
2025/03/01,2025/02/27,SF FuneralFDC0000000LLZK250227,,191.5,,1361784.31
2025/03/01,2025/02/27,SF FuneralFDC0000000M8BS250227,,126.5,,1361910.81
2025/03/01,2025/02/27,SF FuneralF1112129      250227,,126.5,,1362037.31
2025/03/01,2025/02/27,SF FuneralF1112480      250227,,126.5,,1362163.81
2025/03/01,2025/02/27,SF FuneralF1120879      250227,,126.5,,1362290.31
2025/03/01,2025/02/27,SF FuneralFDC0000000PN8M250227,,126.5,,1362416.81
2025/03/01,2025/02/27,SF FuneralFDC0000000PNPD250227,,126.5,,1362543.31
2025/03/01,2025/02/28,SF FuneralFDC00000005WSD250228,,220,,1362763.31
2025/03/01,2025/02/28,SF FuneralFDC00000007C9Y250228,,126.5,,1362889.81
2025/03/01,2025/02/28,SF FuneralF808597       250228,,126.5,,1363016.31
2025/03/01,2025/02/28,SF FuneralF809052       250228,,126.5,,1363142.81
2025/03/01,2025/02/28,SF FuneralF901226       250301,,126.5,,1363269.31
2025/03/01,2025/02/28,SF FuneralF788809       250228,,256.5,,1363525.81
2025/03/01,2025/02/28,SF FuneralFDC0000000JWS9250228,,126.5,,1363652.31
2025/03/01,2025/02/28,SF FuneralFDC0000000NJMS250228,,126.5,,1363778.81
2025/03/01,2025/02/28,SF FuneralF1118274      250228,,126.5,,1363905.31
2025/03/01,2025/02/28,SF FuneralF1126950      250228,,126.5,,1364031.81
2025/03/01,2025/02/28,SF FuneralF1128846      250228,,126.5,,1364158.31
2025/03/01,2025/02/28,SF FuneralF1129508      250228,,126.5,,1364284.81
2025/03/01,2025/02/28,SF FuneralF1130232      250228,,126.5,,1364411.31
2025/03/01,2025/02/24,SF FuneralFDC00000002SMZ250224,,220,,1364631.31
2025/03/01,2025/02/24,SF FuneralFDC000000034JS250224,,110,,1364741.31
2025/03/01,2025/02/24,SF FuneralF1126157      250224,,126.5,,1364867.81
2025/03/01,2025/02/28,SF FuneralF828051       250228,,126.5,,1364994.31
2025/03/01,2025/02/21,SF FuneralFDC00000003LK0250221,,220,,1365214.31
2025/03/01,2025/02/21,SF FuneralF981215       250222,,126.5,,1365340.81
2025/03/01,2025/02/21,SF FuneralF990262       250223,,126.5,,1365467.31
2025/03/01,2025/02/22,SF FuneralFDC00000005YN6250222,,126.5,,1365593.81
2025/03/01,2025/02/22,SF FuneralF827838       250222,,126.5,,1365720.31
2025/03/01,2025/02/24,SF FuneralF802288       250224,,126.5,,1365846.81
2025/03/01,2025/02/24,SF FuneralF802315       250224,,126.5,,1365973.31
2025/03/01,2025/02/25,SF FuneralFDC00000006CX8250225,,126.5,,1366099.81
2025/03/01,2025/02/25,SF FuneralFDC00000007FJ6250225,,126.5,,1366226.31
2025/03/01,2025/02/25,SF FuneralF834242       250225,,126.5,,1366352.81
2025/03/01,2025/02/25,SF FuneralF1120149      250225,,63.25,,1366416.06
2025/03/01,2025/02/25,SF FuneralF1120220      250225,,63.25,,1366479.31
2025/03/01,2025/02/25,SF FuneralFDC0000000NYPL250225,,126.5,,1366605.81
2025/03/01,2025/02/25,SF FuneralFDC0000000PRPN250225,,126.5,,1366732.31
2025/03/01,2025/02/25,SF FuneralF1131019      250225,,63.25,,1366795.56
2025/03/01,2025/02/25,SF FuneralF1131149      250225,,126.5,,1366922.06
2025/03/01,2025/02/25,SF FuneralFDC0000000Q4L6250225,,126.5,,1367048.56
2025/03/01,2025/02/25,SF FuneralFDC0000000Q54Q250225,,126.5,,1367175.06
2025/03/01,2025/02/28,SF FuneralFDC000000065DD250228,,126.5,,1367301.56
2025/03/01,2025/02/28,SF FuneralFDC000000067LH250228,,126.5,,1367428.06
2025/03/01,2025/02/28,SF FuneralFDC0000000684P250228,,126.5,,1367554.56
2025/03/01,2025/02/28,SF FuneralFDC0000000685F250228,,126.5,,1367681.06
2025/03/01,2025/02/28,SF FuneralFDC00000006XXD250228,,126.5,,1367807.56
2025/03/01,2025/02/28,SF FuneralFDC00000009H0N250228,,126.5,,1367934.06
2025/03/01,2025/02/28,SF FuneralF813490       250228,,126.5,,1368060.56
2025/03/01,2025/02/28,SF FuneralF822006       250228,,126.5,,1368187.06
2025/03/01,2025/02/28,SF FuneralF987319       250301,,126.5,,1368313.56
2025/03/01,2025/02/28,SF FuneralF990279       250301,,126.5,,1368440.06
2025/03/01,2025/02/28,SF FuneralF1061532      250228,,126.5,,1368566.56
2025/03/01,2025/02/28,SF FuneralF1066439      250228,,126.5,,1368693.06
2025/03/01,2025/02/28,SF FuneralF1110172      250228,,126.5,,1368819.56
2025/03/01,2025/02/28,SF FuneralFDC0000000MR2X250228,,126.5,,1368946.06
2025/03/01,2025/02/28,SF FuneralF1117395      250228,,126.5,,1369072.56
2025/03/01,2025/02/28,SF FuneralF1126203      250228,,126.5,,1369199.06
2025/03/01,2025/02/28,SF FuneralF1126903      250228,,126.5,,1369325.56
2025/03/01,2025/02/28,SF FuneralF1127950      250228,,126.5,,1369452.06
2025/03/01,2025/02/21,SF FuneralF1126087      250221,,126.5,,1369578.56
2025/03/01,2025/02/22,SF FuneralF812711       250222,,126.5,,1369705.06
2025/03/01,2025/02/24,SF FuneralF900264       250222,,126.5,,1369831.56
2025/03/01,2025/02/24,SF FuneralF987690       250224,,126.5,,1369958.06
2025/03/01,2025/02/25,SF FuneralFDC00000006XY7250225,,126.5,,1370084.56
2025/03/01,2025/02/25,SF FuneralFDC00000007Q2R250225,,126.5,,1370211.06
2025/03/01,2025/02/25,SF FuneralFDC00000007Q5P250225,,126.5,,1370337.56
2025/03/01,2025/02/25,SF FuneralF793801       250225,,126.5,,1370464.06
2025/03/01,2025/02/25,SF FuneralFDC00000009CP1250225,,95.75,,1370559.81
2025/03/01,2025/02/25,SF FuneralF1021955      250225,,63.25,,1370623.06
2025/03/01,2025/02/25,SF FuneralF1072850      250225,,63.25,,1370686.31
2025/03/01,2025/02/25,SF FuneralF1124768      250225,,63.25,,1370749.56
2025/03/01,2025/02/26,SF FuneralF820185       250226,,256.5,,1371006.06
2025/03/01,2025/02/26,SF FuneralF900809       250226,,126.5,,1371132.56
2025/03/01,2025/02/26,SF FuneralF986933       250226,,126.5,,1371259.06
2025/03/01,2025/02/27,SF FuneralFDC000000057FK250227,,126.5,,1371385.56
2025/03/01,2025/02/27,SF FuneralFDC00000005MQV250227,,126.5,,1371512.06
2025/03/01,2025/02/27,SF FuneralFDC00000005W51250227,,126.5,,1371638.56
2025/03/01,2025/02/27,SF FuneralFDC00000006G52250227,,126.5,,1371765.06
2025/03/01,2025/02/27,SF FuneralFDC00000006GJ5250227,,126.5,,1371891.56
2025/03/01,2025/02/27,SF FuneralFDC0000000BQQ3250227,,126.5,,1372018.06
2025/03/01,2025/02/27,SF FuneralF828920       250227,,126.5,,1372144.56
2025/03/01,2025/02/27,SF FuneralF841285       250227,,126.5,,1372271.06
2025/03/01,2025/02/27,SF FuneralF981601       250227,,126.5,,1372397.56
2025/03/01,2025/02/27,SF FuneralF1075123      250227,,126.5,,1372524.06
2025/03/01,2025/02/27,SF FuneralF1075141      250227,,126.5,,1372650.56
2025/03/01,2025/02/27,SF FuneralF1084614      250227,,126.5,,1372777.06
2025/03/01,2025/02/27,SF FuneralF1102874      250227,,126.5,,1372903.56
2025/03/01,2025/02/27,SF FuneralF1117203      250227,,126.5,,1373030.06
2025/03/01,2025/02/27,SF FuneralF1120157      250227,,126.5,,1373156.56
2025/03/01,2025/02/27,SF FuneralF1120679      250227,,126.5,,1373283.06
2025/03/01,2025/02/27,SF FuneralFDC0000000NZ2T250227,,126.5,,1373409.56
2025/03/01,2025/02/28,SF FuneralFDC00000008YFT250228,,126.5,,1373536.06
2025/03/01,2025/02/28,SF FuneralFDC0000000H1QJ250301,,126.5,,1373662.56
2025/03/01,2025/02/28,SF FuneralF988322       250301,,126.5,,1373789.06
2025/03/01,2025/02/28,SF FuneralF1124559      250228,,126.5,,1373915.56
2025/03/01,2025/02/25,SF FuneralF1073379      250225,,31.63,,1373947.19
2025/03/01,2025/02/25,SF FuneralF1073746      250225,,31.63,,1373978.82
2025/03/01,2025/02/25,SF FuneralF1123497      250225,,31.63,,1374010.45
2025/03/01,2025/02/28,SF FuneralFDC00000005HJM250228,,31.63,,1374042.08
2025/03/01,2025/02/28,SF FuneralF981788       250228,,31.63,,1374073.71
2025/03/01,2025/02/26,SF FuneralF802223       250226,,126.5,,1374200.21
2025/03/01,2025/02/26,SF FuneralF808656       250226,,126.5,,1374326.71
2025/03/01,2025/02/26,SF FuneralFDC0000000BBS5250226,,126.5,,1374453.21
2025/03/01,2025/02/26,SF FuneralF827826       250226,,126.5,,1374579.71
2025/03/01,2025/02/26,SF FuneralF992508       250226,,126.5,,1374706.21
2025/03/01,2025/02/26,SF FuneralF992740       250226,,126.5,,1374832.71
2025/03/01,2025/02/26,SF FuneralF993452       250226,,126.5,,1374959.21
2025/03/01,2025/02/26,SF FuneralFDC0000000JFXT250226,,126.5,,1375085.71
2025/03/01,2025/02/26,SF FuneralF992956       250226,,126.5,,1375212.21
2025/03/01,2025/02/26,SF FuneralF1120798      250226,,126.5,,1375338.71
2025/03/01,2025/02/26,SF FuneralF1121772      250226,,126.5,,1375465.21
2025/03/01,2025/02/26,SF FuneralFDC0000000P0Y6250226,,126.5,,1375591.71
2025/03/01,2025/02/27,SF FuneralFDC00000005DDL250227,,126.5,,1375718.21
2025/03/01,2025/02/27,SF FuneralFDC00000005FV6250227,,126.5,,1375844.71
2025/03/01,2025/02/27,SF FuneralFDC00000005GBC250227,,126.5,,1375971.21
2025/03/01,2025/02/27,SF FuneralFDC00000005RZK250227,,220,,1376191.21
2025/03/01,2025/02/27,SF FuneralFDC0000000630V250227,,126.5,,1376317.71
2025/03/01,2025/02/27,SF FuneralFDC000000066QG250227,,126.5,,1376444.21
2025/03/01,2025/02/27,SF FuneralFDC00000006C5K250227,,126.5,,1376570.71
2025/03/01,2025/02/27,SF FuneralFDC00000006X1M250227,,126.5,,1376697.21
2025/03/01,2025/02/27,SF FuneralFDC00000006XP2250227,,126.5,,1376823.71
2025/03/01,2025/02/27,SF FuneralFDC000000071VJ250227,,126.5,,1376950.21
2025/03/01,2025/02/27,SF FuneralFDC00000007TMJ250227,,126.5,,1377076.71
2025/03/01,2025/02/27,SF FuneralF803709       250227,,126.5,,1377203.21
2025/03/01,2025/02/27,SF FuneralF804237       250227,,126.5,,1377329.71
2025/03/01,2025/02/27,SF FuneralF812288       250227,,126.5,,1377456.21
2025/03/01,2025/02/27,SF FuneralF812891       250227,,126.5,,1377582.71
2025/03/01,2025/02/27,SF FuneralF816607       250227,,126.5,,1377709.21
2025/03/01,2025/02/27,SF FuneralF817924       250227,,126.5,,1377835.71
2025/03/01,2025/02/27,SF FuneralF819594       250227,,126.5,,1377962.21
2025/03/01,2025/02/27,SF FuneralFDC0000000B6KL250227,,126.5,,1378088.71
2025/03/01,2025/02/27,SF FuneralF828754       250227,,126.5,,1378215.21
2025/03/01,2025/02/27,SF FuneralF828913       250227,,126.5,,1378341.71
2025/03/01,2025/02/27,SF FuneralF833006       250227,,126.5,,1378468.21
2025/03/01,2025/02/27,SF FuneralF841155       250227,,126.5,,1378594.71
2025/03/01,2025/02/27,SF FuneralFDC0000000DZGG250227,,126.5,,1378721.21
2025/03/01,2025/02/27,SF FuneralFDC0000000HX70250227,,126.5,,1378847.71
2025/03/01,2025/02/27,SF FuneralF989328       250227,,126.5,,1378974.21
2025/03/01,2025/02/27,SF FuneralF1020935      250227,,126.5,,1379100.71
2025/03/01,2025/02/27,SF FuneralF1058802      250227,,126.5,,1379227.21
2025/03/01,2025/02/27,SF FuneralF1060811      250227,,126.5,,1379353.71
2025/03/01,2025/02/27,SF FuneralF1061054      250227,,126.5,,1379480.21
2025/03/01,2025/02/27,SF FuneralFDC0000000KS96250227,,126.5,,1379606.71
2025/03/01,2025/02/27,SF FuneralF1068199      250227,,126.5,,1379733.21
2025/03/01,2025/02/27,SF FuneralF1072699      250227,,126.5,,1379859.71
2025/03/01,2025/02/27,SF FuneralF1074938      250227,,126.5,,1379986.21
2025/03/01,2025/02/27,SF FuneralF1079080      250227,,126.5,,1380112.71
2025/03/01,2025/02/27,SF FuneralF1103732      250227,,126.5,,1380239.21
2025/03/01,2025/02/27,SF FuneralF1104231      250227,,126.5,,1380365.71
2025/03/01,2025/02/27,SF FuneralF1109072      250227,,126.5,,1380492.21
2025/03/01,2025/02/27,SF FuneralF1112009      250227,,126.5,,1380618.71
2025/03/01,2025/02/27,SF FuneralF1112241      250227,,126.5,,1380745.21
2025/03/01,2025/02/27,SF FuneralF1112356      250227,,126.5,,1380871.71
2025/03/01,2025/02/27,SF FuneralF1112484      250227,,126.5,,1380998.21
2025/03/01,2025/02/27,SF FuneralF1113212      250227,,126.5,,1381124.71
2025/03/01,2025/02/27,SF FuneralF1113281      250227,,126.5,,1381251.21
2025/03/01,2025/02/27,SF FuneralF1114226      250227,,126.5,,1381377.71
2025/03/01,2025/02/27,SF FuneralF1114695      250227,,126.5,,1381504.21
2025/03/01,2025/02/27,SF FuneralF1117034      250227,,126.5,,1381630.71
2025/03/01,2025/02/27,SF FuneralFDC0000000NJSC250227,,126.5,,1381757.21
2025/03/01,2025/02/27,SF FuneralFDC0000000NK23250227,,126.5,,1381883.71
2025/03/01,2025/02/27,SF FuneralF1118056      250227,,126.5,,1382010.21
2025/03/01,2025/02/27,SF FuneralF1121976      250227,,126.5,,1382136.71
2025/03/01,2025/02/27,SF FuneralF1122344      250227,,126.5,,1382263.21
2025/03/01,2025/02/27,SF FuneralFDC0000000P3YP250227,,126.5,,1382389.71
2025/03/01,2025/02/27,SF FuneralFDC0000000P3YR250227,,126.5,,1382516.21
2025/03/01,2025/02/27,SF FuneralF1123535      250227,,126.5,,1382642.71
2025/03/01,2025/02/27,SF FuneralF1123550      250227,,126.5,,1382769.21
2025/03/01,2025/02/27,SF FuneralF1126030      250227,,126.5,,1382895.71
2025/03/01,2025/02/27,SF FuneralF1127545      250227,,126.5,,1383022.21
2025/03/01,2025/02/27,SF FuneralF1128066      250227,,126.5,,1383148.71
2025/03/01,2025/02/24,SF FuneralFDC00000008JY9250224,,63.25,,1383211.96
2025/03/01,2025/02/24,SF FuneralFDC00000008JYB250224,,63.25,,1383275.21
2025/03/01,2025/02/24,SF FuneralF1074831      250224,,126.5,,1383401.71
2025/03/01,2025/02/24,SF FuneralF1075195      250224,,126.5,,1383528.21
2025/03/01,2025/02/24,SF FuneralFDC0000000M35Z250224,,126.5,,1383654.71
2025/03/01,2025/02/24,SF FuneralFDC0000000N4K7250224,,126.5,,1383781.21
2025/03/01,2025/02/24,SF FuneralF1114025      250224,,126.5,,1383907.71
2025/03/01,2025/02/24,SF FuneralF1129157      250224,,126.5,,1384034.21
2025/03/01,2025/02/25,SF FuneralFDC000000061PC250225,,126.5,,1384160.71
2025/03/01,2025/02/25,SF FuneralFDC000000064LG250225,,126.5,,1384287.21
2025/03/01,2025/02/25,SF FuneralFDC00000006NCH250225,,63.25,,1384350.46
2025/03/01,2025/02/25,SF FuneralFDC00000006ZY7250225,,126.5,,1384476.96
2025/03/01,2025/02/25,SF FuneralFDC00000007N2L250225,,126.5,,1384603.46
2025/03/01,2025/02/25,SF FuneralFDC00000007NTY250225,,126.5,,1384729.96
2025/03/01,2025/02/25,SF FuneralF793712       250225,,126.5,,1384856.46
2025/03/01,2025/02/25,SF FuneralF793946       250225,,126.5,,1384982.96
2025/03/01,2025/02/25,SF FuneralF840821       250225,,63.25,,1385046.21
2025/03/01,2025/02/25,SF FuneralF993377       250225,,63.25,,1385109.46
2025/03/01,2025/02/25,SF FuneralF1085191      250225,,63.25,,1385172.71
2025/03/01,2025/02/25,SF FuneralF1103541      250225,,126.5,,1385299.21
2025/03/01,2025/02/25,SF FuneralF1113788      250225,,126.5,,1385425.71
2025/03/01,2025/02/25,SF FuneralF1118010      250225,,63.25,,1385488.96
2025/03/01,2025/02/25,SF FuneralF1123420      250225,,126.5,,1385615.46
2025/03/01,2025/02/25,SF FuneralF1127561      250225,,63.25,,1385678.71
2025/03/01,2025/02/25,SF FuneralF1128117      250225,,126.5,,1385805.21
2025/03/01,2025/02/25,SF FuneralFDC0000000Q3YJ250225,,126.5,,1385931.71
2025/03/01,2025/02/25,SF FuneralFDC0000000Q3YQ250225,,126.5,,1386058.21
2025/03/01,2025/02/25,SF FuneralF1131116      250225,,126.5,,1386184.71
2025/03/01,2025/02/25,SF FuneralF1131157      250225,,126.5,,1386311.21
2025/03/01,2025/02/25,SF FuneralF1131267      250225,,126.5,,1386437.71
2025/03/01,2025/02/25,SF FuneralF1131605      250225,,126.5,,1386564.21
2025/03/01,2025/02/25,SF FuneralFDC0000000Q5R7250225,,126.5,,1386690.71
2025/03/01,2025/02/25,SF FuneralF1131740      250225,,126.5,,1386817.21
2025/03/01,2025/02/19,SF FuneralF808716       250219,,126.5,,1386943.71
2025/03/01,2025/02/22,SF FuneralFDC00000005H36250222,,126.5,,1387070.21
2025/03/01,2025/02/22,SF FuneralFDC0000000600Z250222,,126.5,,1387196.71
2025/03/01,2025/02/22,SF FuneralFDC0000000624H250222,,126.5,,1387323.21
2025/03/01,2025/02/22,SF FuneralFDC0000000752S250222,,63.25,,1387386.46
2025/03/01,2025/02/22,SF FuneralFDC00000007N1T250222,,126.5,,1387512.96
2025/03/01,2025/02/22,SF FuneralFDC000000085RF250222,,126.5,,1387639.46
2025/03/01,2025/02/22,SF FuneralF801361       250222,,126.5,,1387765.96
2025/03/01,2025/02/22,SF FuneralF1073820      250222,,126.5,,1387892.46
2025/03/01,2025/02/22,SF FuneralF1108702      250222,,126.5,,1388018.96
2025/03/01,2025/02/22,SF FuneralF1114458      250223,,126.5,,1388145.46
2025/03/01,2025/02/22,SF FuneralF1128043      250222,,126.5,,1388271.96
2025/03/01,2025/02/28,SF FuneralFDC00000005MZR250228,,126.5,,1388398.46
2025/03/01,2025/02/28,SF FuneralFDC00000005WRL250228,,220,,1388618.46
2025/03/01,2025/02/28,SF FuneralFDC000000060NQ250228,,126.5,,1388744.96
2025/03/01,2025/02/28,SF FuneralFDC00000006B3J250228,,126.5,,1388871.46
2025/03/01,2025/02/28,SF FuneralFDC00000006BC6250228,,126.5,,1388997.96
2025/03/01,2025/02/28,SF FuneralFDC00000006D77250228,,126.5,,1389124.46
2025/03/01,2025/02/28,SF FuneralFDC00000006DCG250228,,126.5,,1389250.96
2025/03/01,2025/02/28,SF FuneralFDC00000006HJW250228,,126.5,,1389377.46
2025/03/01,2025/02/28,SF FuneralFDC00000006JS2250228,,126.5,,1389503.96
2025/03/01,2025/02/28,SF FuneralFDC00000007191250228,,126.5,,1389630.46
2025/03/01,2025/02/28,SF FuneralFDC00000007389250228,,126.5,,1389756.96
2025/03/01,2025/02/28,SF FuneralFDC00000007BPW250228,,126.5,,1389883.46
2025/03/01,2025/02/28,SF FuneralFDC00000007DTN250228,,126.5,,1390009.96
2025/03/01,2025/02/28,SF FuneralFDC00000007DTV250228,,126.5,,1390136.46
2025/03/01,2025/02/28,SF FuneralF797076       250228,,126.5,,1390262.96
2025/03/01,2025/02/28,SF FuneralFDC00000008346250228,,126.5,,1390389.46
2025/03/01,2025/02/28,SF FuneralFDC00000008741250228,,126.5,,1390515.96
2025/03/01,2025/02/28,SF FuneralFDC00000008FKG250228,,126.5,,1390642.46
2025/03/01,2025/02/28,SF FuneralF808328       250228,,126.5,,1390768.96
2025/03/01,2025/02/28,SF FuneralF809675       250228,,126.5,,1390895.46
2025/03/01,2025/02/28,SF FuneralF809727       250228,,126.5,,1391021.96
2025/03/01,2025/02/28,SF FuneralF810997       250228,,126.5,,1391148.46
2025/03/01,2025/02/28,SF FuneralF816457       250228,,126.5,,1391274.96
2025/03/01,2025/02/28,SF FuneralF817257       250228,,126.5,,1391401.46
2025/03/01,2025/02/28,SF FuneralF820624       250228,,126.5,,1391527.96
2025/03/01,2025/02/28,SF FuneralF823120       250228,,126.5,,1391654.46
2025/03/01,2025/02/28,SF FuneralF831115       250228,,126.5,,1391780.96
2025/03/01,2025/02/28,SF FuneralFDC0000000CBLF250228,,126.5,,1391907.46
2025/03/01,2025/02/28,SF FuneralFDC0000000CF61250228,,126.5,,1392033.96
2025/03/01,2025/02/28,SF FuneralF832435       250228,,126.5,,1392160.46
2025/03/01,2025/02/28,SF FuneralF833046       250228,,126.5,,1392286.96
2025/03/01,2025/02/28,SF FuneralF833367       250228,,126.5,,1392413.46
2025/03/01,2025/02/28,SF FuneralF841276       250228,,126.5,,1392539.96
2025/03/01,2025/02/28,SF FuneralF842141       250228,,126.5,,1392666.46
2025/03/01,2025/02/28,SF FuneralFDC0000000GTPK250228,,126.5,,1392792.96
2025/03/01,2025/02/28,SF FuneralF980437       250301,,126.5,,1392919.46
2025/03/01,2025/02/28,SF FuneralFDC0000000HG1M250301,,126.5,,1393045.96
2025/03/01,2025/02/28,SF FuneralF987462       250228,,126.5,,1393172.46
2025/03/01,2025/02/28,SF FuneralF988041       250228,,126.5,,1393298.96
2025/03/01,2025/02/28,SF FuneralF988965       250228,,126.5,,1393425.46
2025/03/01,2025/02/28,SF FuneralF990088       250228,,126.5,,1393551.96
2025/03/01,2025/02/28,SF FuneralF1020571      250228,,126.5,,1393678.46
2025/03/01,2025/02/28,SF FuneralF1020953      250228,,126.5,,1393804.96
2025/03/01,2025/02/28,SF FuneralF1021846      250228,,126.5,,1393931.46
2025/03/01,2025/02/28,SF FuneralF1021896      250228,,126.5,,1394057.96
2025/03/01,2025/02/28,SF FuneralF1022136      250228,,126.5,,1394184.46
2025/03/01,2025/02/28,SF FuneralF1055273      250228,,126.5,,1394310.96
2025/03/01,2025/02/28,SF FuneralF1061041      250228,,126.5,,1394437.46
2025/03/01,2025/02/28,SF FuneralF1065992      250228,,126.5,,1394563.96
2025/03/01,2025/02/28,SF FuneralF1066296      250228,,126.5,,1394690.46
2025/03/01,2025/02/28,SF FuneralFDC0000000KW31250228,,126.5,,1394816.96
2025/03/01,2025/02/28,SF FuneralF1066623      250228,,126.5,,1394943.46
2025/03/01,2025/02/28,SF FuneralFDC0000000KYQT250228,,126.5,,1395069.96
2025/03/01,2025/02/28,SF FuneralFDC0000000KZ1N250228,,126.5,,1395196.46
2025/03/01,2025/02/28,SF FuneralF1075292      250228,,126.5,,1395322.96
2025/03/01,2025/02/28,SF FuneralF1085240      250228,,126.5,,1395449.46
2025/03/01,2025/02/28,SF FuneralF1103614      250228,,126.5,,1395575.96
2025/03/01,2025/02/28,SF FuneralF1108717      250228,,126.5,,1395702.46
2025/03/01,2025/02/28,SF FuneralF1108767      250228,,126.5,,1395828.96
2025/03/01,2025/02/28,SF FuneralFDC0000000MK3Z250228,,126.5,,1395955.46
2025/03/01,2025/02/28,SF FuneralF1109752      250228,,126.5,,1396081.96
2025/03/01,2025/02/28,SF FuneralF1109858      250228,,126.5,,1396208.46
2025/03/01,2025/02/28,SF FuneralF1109921      250228,,126.5,,1396334.96
2025/03/01,2025/02/28,SF FuneralF1110198      250228,,126.5,,1396461.46
2025/03/01,2025/02/28,SF FuneralF1113192      250228,,126.5,,1396587.96
2025/03/01,2025/02/28,SF FuneralF1114930      250228,,126.5,,1396714.46
2025/03/01,2025/02/28,SF FuneralFDC0000000NJ1N250228,,126.5,,1396840.96
2025/03/01,2025/02/28,SF FuneralF1117211      250228,,126.5,,1396967.46
2025/03/01,2025/02/28,SF FuneralF1117933      250228,,126.5,,1397093.96
2025/03/01,2025/02/28,SF FuneralF1118173      250228,,126.5,,1397220.46
2025/03/01,2025/02/28,SF FuneralF1118372      250228,,126.5,,1397346.96
2025/03/01,2025/02/28,SF FuneralFDC0000000NPT2250228,,126.5,,1397473.46
2025/03/01,2025/02/28,SF FuneralF1118769      250228,,126.5,,1397599.96
2025/03/01,2025/02/28,SF FuneralF1120843      250228,,126.5,,1397726.46
2025/03/01,2025/02/28,SF FuneralF1118345      250228,,126.5,,1397852.96
2025/03/01,2025/02/28,SF FuneralFDC0000000PBN3250228,,126.5,,1397979.46
2025/03/01,2025/02/28,SF FuneralF1125109      250228,,126.5,,1398105.96
2025/03/01,2025/02/28,SF FuneralF1125710      250228,,126.5,,1398232.46
2025/03/01,2025/02/28,SF FuneralF1125718      250228,,126.5,,1398358.96
2025/03/01,2025/02/28,SF FuneralF1125869      250228,,126.5,,1398485.46
2025/03/01,2025/02/28,SF FuneralF1126254      250228,,126.5,,1398611.96
2025/03/01,2025/02/28,SF FuneralF1127320      250228,,126.5,,1398738.46
2025/03/01,2025/02/28,SF FuneralFDC0000000PPFH250228,,126.5,,1398864.96
2025/03/01,2025/02/28,SF FuneralF1127982      250228,,126.5,,1398991.46
2025/03/01,2025/02/28,SF FuneralF1128208      250228,,126.5,,1399117.96
2025/03/01,2025/02/28,SF FuneralF1128675      250228,,126.5,,1399244.46
2025/03/01,2025/02/28,SF FuneralF1128724      250228,,126.5,,1399370.96
2025/03/01,2025/02/28,SF FuneralF1128926      250228,,126.5,,1399497.46
2025/03/01,2025/02/28,SF FuneralFDC0000000PWXG250228,,126.5,,1399623.96
2025/03/01,2025/02/28,SF FuneralFDC0000000PXYD250228,,126.5,,1399750.46
2025/03/01,2025/02/28,SF FuneralF1129276      250228,,126.5,,1399876.96
2025/03/01,2025/02/28,SF FuneralFDC0000000PYJQ250228,,126.5,,1400003.46
2025/03/01,2025/02/28,SF FuneralF1129371      250228,,126.5,,1400129.96
2025/03/01,2025/02/28,SF FuneralFDC0000000Q57K250228,,126.5,,1400256.46
2025/03/01,2025/03/01,SF FuneralF992192       250301,,126.5,,1400382.96
2025/03/01,2025/03/01,SF FuneralF1059866      250301,,126.5,,1400509.46
2025/03/01,2025/03/01,SF FuneralF1109139      250301,,126.5,,1400635.96
2025/03/01,2025/03/01,SF FuneralFDC00000002MBX250301,,220,,1400855.96
2025/03/01,2025/03/01,SF FuneralFDC00000002TWN250301,,220,,1401075.96
2025/03/01,2025/03/01,SF FuneralFDC00000002XNC250301,,220,,1401295.96
2025/03/01,2025/03/01,SF FuneralFDC00000002Y47250301,,220,,1401515.96
2025/03/01,2025/03/01,SF FuneralFDC00000002YP4250301,,220,,1401735.96
2025/03/01,2025/03/01,SF FuneralFDC00000002ZLK250301,,220,,1401955.96
2025/03/01,2025/03/01,SF FuneralFDC0000000330V250301,,220,,1402175.96
2025/03/01,2025/03/01,SF FuneralFDC000000033PC250301,,220,,1402395.96
2025/03/01,2025/03/01,SF FuneralFDC00000003V07250301,,220,,1402615.96
2025/03/01,2025/03/01,SF FuneralFDC00000003V18250301,,220,,1402835.96
2025/03/01,2025/03/01,SF FuneralFDC00000005PS4250301,,126.5,,1402962.46
2025/03/01,2025/03/01,SF FuneralFDC00000005VZW250301,,126.5,,1403088.96
2025/03/01,2025/03/01,SF FuneralFDC000000067XS250301,,126.5,,1403215.46
2025/03/01,2025/03/01,SF FuneralFDC000000068M8250301,,126.5,,1403341.96
2025/03/01,2025/03/01,SF FuneralFDC00000006C64250301,,126.5,,1403468.46
2025/03/01,2025/03/01,SF FuneralFDC00000006GPJ250301,,126.5,,1403594.96
2025/03/01,2025/03/01,SF FuneralFDC00000006H56250301,,126.5,,1403721.46
2025/03/01,2025/03/01,SF FuneralFDC00000006MW6250301,,220,,1403941.46
2025/03/01,2025/03/01,SF FuneralFDC000000072MQ250301,,126.5,,1404067.96
2025/03/01,2025/03/01,SF FuneralFDC0000000737J250301,,126.5,,1404194.46
2025/03/01,2025/03/01,SF FuneralFDC000000073GL250301,,126.5,,1404320.96
2025/03/01,2025/03/01,SF FuneralFDC000000075DL250301,,126.5,,1404447.46
2025/03/01,2025/03/01,SF FuneralFDC000000075DM250301,,126.5,,1404573.96
2025/03/01,2025/03/01,SF FuneralFDC000000075DS250301,,126.5,,1404700.46
2025/03/01,2025/03/01,SF FuneralFDC00000007BSH250301,,126.5,,1404826.96
2025/03/01,2025/03/01,SF FuneralFDC00000007MXK250301,,126.5,,1404953.46
2025/03/01,2025/03/01,SF FuneralFDC00000007P2M250301,,126.5,,1405079.96
2025/03/01,2025/03/01,SF FuneralFDC00000007RYD250301,,126.5,,1405206.46
2025/03/01,2025/03/01,SF FuneralFDC00000007T6M250301,,126.5,,1405332.96
2025/03/01,2025/03/01,SF FuneralF820545       250301,,126.5,,1405459.46
2025/03/01,2025/03/01,SF FuneralF820893       250301,,126.5,,1405585.96
2025/03/01,2025/03/01,SF FuneralF821868       250301,,126.5,,1405712.46
2025/03/01,2025/03/01,SF FuneralFDC0000000CWZF250301,,191.5,,1405903.96
2025/03/01,2025/03/01,SF FuneralFDC0000000CYMQ250301,,126.5,,1406030.46
2025/03/01,2025/02/25,SF FuneralFDC00000005PCD250225,,31.63,,1406062.09
2025/03/01,2025/02/25,SF FuneralFDC00000007CQV250225,,31.63,,1406093.72
2025/03/01,2025/02/25,SF FuneralF811757       250225,,126.5,,1406220.22
2025/03/01,2025/02/25,SF FuneralF1078663      250225,,126.5,,1406346.72
2025/03/01,2025/02/25,SF FuneralF1110796      250225,,31.63,,1406378.35
2025/03/01,2025/02/25,SF FuneralF1118348      250225,,31.63,,1406409.98
2025/03/01,2025/02/25,SF FuneralF1120915      250225,,126.5,,1406536.48
2025/03/01,2025/02/25,SF FuneralF1128342      250225,,126.5,,1406662.98
2025/03/01,2025/02/25,SF FuneralF1130344      250225,,31.63,,1406694.61
2025/03/01,2025/02/25,SF FuneralF1130833      250225,,126.5,,1406821.11
2025/03/01,2025/02/25,SF FuneralF1130991      250225,,31.63,,1406852.74
2025/03/01,2025/02/26,SF FuneralF993213       250226,,126.5,,1406979.24
2025/03/01,2025/02/26,SF FuneralF1108259      250226,,126.5,,1407105.74
2025/03/01,2025/02/27,SF FuneralFDC00000003N5L250227,,220,,1407325.74
2025/03/01,2025/02/27,SF FuneralFDC0000000693K250227,,126.5,,1407452.24
2025/03/01,2025/02/27,SF FuneralFDC00000008SNL250227,,126.5,,1407578.74
2025/03/01,2025/02/27,SF FuneralF1111282      250227,,126.5,,1407705.24
2025/03/01,2025/02/27,SF FuneralF1114389      250227,,126.5,,1407831.74
2025/03/01,2025/02/27,SF FuneralF1115163      250227,,126.5,,1407958.24
2025/03/01,2025/02/27,SF FuneralF1123602      250227,,126.5,,1408084.74
2025/03/01,2025/02/22,SF FuneralF812938       250222,,126.5,,1408211.24
2025/03/01,2025/02/22,SF FuneralF1129087      250222,,126.5,,1408337.74
2025/03/01,2025/02/25,SF FuneralFDC00000005KQR250225,,126.5,,1408464.24
2025/03/01,2025/02/25,SF FuneralFDC00000006B9G250225,,31.63,,1408495.87
2025/03/01,2025/02/25,SF FuneralF801331       250225,,31.63,,1408527.5
2025/03/01,2025/02/25,SF FuneralF832776       250225,,63.25,,1408590.75
2025/03/01,2025/02/25,SF FuneralF1022184      250225,,31.63,,1408622.38
2025/03/01,2025/02/25,SF FuneralF1060278      250225,,126.5,,1408748.88
2025/03/01,2025/02/25,SF FuneralF1108531      250225,,126.5,,1408875.38
2025/03/01,2025/02/25,SF FuneralF1110349      250225,,31.63,,1408907.01
2025/03/01,2025/02/25,SF FuneralF1113997      250225,,126.5,,1409033.51
2025/03/01,2025/02/25,SF FuneralF1122862      250225,,31.63,,1409065.14
2025/03/01,2025/02/25,SF FuneralF1132455      250225,,126.5,,1409191.64
2025/03/01,2025/02/24,SF FuneralF797740       250223,,126.5,,1409318.14
2025/03/01,2025/02/24,SF FuneralF834709       250224,,63.25,,1409381.39
2025/03/01,2025/02/24,SF FuneralF1103763      250224,,126.5,,1409507.89
2025/03/01,2025/02/24,SF FuneralF1118919      250224,,126.5,,1409634.39
2025/03/01,2025/02/22,SF FuneralFDC00000008TGS250222,,126.5,,1409760.89
2025/03/01,2025/02/22,SF FuneralF820988       250222,,126.5,,1409887.39
2025/03/01,2025/02/22,SF FuneralF822600       250222,,126.5,,1410013.89
2025/03/01,2025/02/22,SF FuneralF823590       250222,,126.5,,1410140.39
2025/03/01,2025/02/22,SF FuneralF1060392      250222,,126.5,,1410266.89
2025/03/01,2025/02/22,SF FuneralF1127768      250222,,126.5,,1410393.39
2025/03/01,2025/02/26,SF FuneralF802401       250226,,63.25,,1410456.64
2025/03/01,2025/02/26,SF FuneralFDC0000000BW7W250226,,126.5,,1410583.14
2025/03/01,2025/02/26,SF FuneralF990271       250226,,63.25,,1410646.39
2025/03/01,2025/02/26,SF FuneralF992365       250226,,126.5,,1410772.89
2025/03/01,2025/02/26,SF FuneralFDC0000000J8SN250226,,126.5,,1410899.39
2025/03/01,2025/02/26,SF FuneralFDC0000000J8SR250226,,126.5,,1411025.89
2025/03/01,2025/02/26,SF FuneralF1020960      250226,,63.25,,1411089.14
2025/03/01,2025/02/24,SF FuneralFDC00000007DCR250224,,126.5,,1411215.64
2025/03/01,2025/02/24,SF FuneralF1084644      250224,,126.5,,1411342.14
2025/03/01,2025/02/24,SF FuneralF1123063      250224,,126.5,,1411468.64
2025/03/01,2025/02/24,SF FuneralF1125174      250224,,126.5,,1411595.14
2025/03/01,2025/02/28,SF FuneralFDC00000005N1F250228,,126.5,,1411721.64
2025/03/01,2025/02/28,SF FuneralFDC00000006CMJ250228,,126.5,,1411848.14
2025/03/01,2025/02/28,SF FuneralFDC00000006TLL250228,,126.5,,1411974.64
2025/03/01,2025/02/28,SF FuneralFDC00000007QJV250228,,126.5,,1412101.14
2025/03/01,2025/02/28,SF FuneralFDC00000007QK0250228,,126.5,,1412227.64
2025/03/01,2025/02/28,SF FuneralF800236       250228,,126.5,,1412354.14
2025/03/01,2025/02/28,SF FuneralFDC0000000B3SM250228,,126.5,,1412480.64
2025/03/01,2025/02/28,SF FuneralF820246       250228,,126.5,,1412607.14
2025/03/01,2025/02/28,SF FuneralF833637       250228,,126.5,,1412733.64
2025/03/01,2025/02/28,SF FuneralF989579       250228,,126.5,,1412860.14
2025/03/01,2025/02/28,SF FuneralFDC0000000JSPN250228,,126.5,,1412986.64
2025/03/01,2025/02/28,SF FuneralF1022131      250228,,126.5,,1413113.14
2025/03/01,2025/02/28,SF FuneralF1022140      250228,,126.5,,1413239.64
2025/03/01,2025/02/28,SF FuneralFDC0000000M3LH250228,,126.5,,1413366.14
2025/03/01,2025/02/28,SF FuneralF1108759      250228,,126.5,,1413492.64
2025/03/01,2025/02/28,SF FuneralF1110236      250228,,126.5,,1413619.14
2025/03/01,2025/02/28,SF FuneralF1116064      250228,,126.5,,1413745.64
2025/03/01,2025/02/28,SF FuneralF1118215      250228,,126.5,,1413872.14
2025/03/01,2025/02/27,SF FuneralFDC0000000782L250227,,126.5,,1413998.64
2025/03/01,2025/02/27,SF FuneralF803343       250227,,126.5,,1414125.14
2025/03/01,2025/02/27,SF FuneralF803481       250227,,126.5,,1414251.64
2025/03/01,2025/02/27,SF FuneralF805145       250227,,126.5,,1414378.14
2025/03/01,2025/02/27,SF FuneralF819920       250227,,126.5,,1414504.64
2025/03/01,2025/02/27,SF FuneralF829084       250227,,126.5,,1414631.14
2025/03/01,2025/02/27,SF FuneralF831014       250227,,126.5,,1414757.64
2025/03/01,2025/02/27,SF FuneralF832556       250227,,126.5,,1414884.14
2025/03/01,2025/02/27,SF FuneralFDC0000000GFQL250227,,191.5,,1415075.64
2025/03/01,2025/02/27,SF FuneralFDC0000000K7C4250227,,126.5,,1415202.14
2025/03/01,2025/02/27,SF FuneralF1055044      250227,,126.5,,1415328.64
2025/03/01,2025/02/27,SF FuneralFDC0000000K9DR250227,,126.5,,1415455.14
2025/03/01,2025/02/27,SF FuneralF1075084      250227,,126.5,,1415581.64
2025/03/01,2025/02/27,SF FuneralF1084928      250227,,126.5,,1415708.14
2025/03/01,2025/02/27,SF FuneralF1085139      250227,,126.5,,1415834.64
2025/03/01,2025/02/27,SF FuneralF1108947      250227,,126.5,,1415961.14
2025/03/01,2025/02/27,SF FuneralF1113303      250227,,126.5,,1416087.64
2025/03/01,2025/02/27,SF FuneralF1114285      250227,,126.5,,1416214.14
2025/03/01,2025/02/27,SF FuneralF1118964      250227,,126.5,,1416340.64
2025/03/01,2025/02/27,SF FuneralF1122826      250227,,126.5,,1416467.14
2025/03/01,2025/02/27,SF FuneralF1123270      250227,,126.5,,1416593.64
2025/03/01,2025/02/27,SF FuneralF1125067      250227,,126.5,,1416720.14
2025/03/01,2025/02/27,SF FuneralF1127469      250227,,126.5,,1416846.64
2025/03/01,2025/02/21,SF FuneralFDC00000006NNW250221,,126.5,,1416973.14
2025/03/01,2025/02/28,SF FuneralFDC00000005P6V250228,,126.5,,1417099.64
2025/03/01,2025/02/28,SF FuneralFDC000000068Q2250228,,126.5,,1417226.14
2025/03/01,2025/02/28,SF FuneralFDC000000068VR250228,,126.5,,1417352.64
2025/03/01,2025/02/28,SF FuneralFDC000000086G5250228,,126.5,,1417479.14
2025/03/01,2025/02/28,SF FuneralFDC0000000J35K250228,,126.5,,1417605.64
2025/03/01,2025/02/28,SF FuneralFDC0000000J35M250228,,126.5,,1417732.14
2025/03/01,2025/02/25,SF FuneralFDC00000005P6R250225,,63.25,,1417795.39
2025/03/01,2025/02/25,SF FuneralF1075090      250225,,126.5,,1417921.89
2025/03/01,2025/02/25,SF FuneralF1120411      250225,,63.25,,1417985.14
2025/03/01,2025/02/25,SF FuneralF1132201      250225,,126.5,,1418111.64
2025/03/01,2025/02/28,SF FuneralFDC00000006645250228,,220,,1418331.64
2025/03/01,2025/02/28,SF FuneralFDC000000068K4250228,,126.5,,1418458.14
2025/03/01,2025/02/28,SF FuneralFDC000000068MY250228,,126.5,,1418584.64
2025/03/01,2025/02/28,SF FuneralFDC00000006BWQ250228,,126.5,,1418711.14
2025/03/01,2025/02/28,SF FuneralFDC00000006FW4250228,,126.5,,1418837.64
2025/03/01,2025/02/28,SF FuneralFDC00000007DS9250228,,126.5,,1418964.14
2025/03/01,2025/02/28,SF FuneralF798583       250228,,31.63,,1418995.77
2025/03/01,2025/02/28,SF FuneralF809501       250228,,126.5,,1419122.27
2025/03/01,2025/02/28,SF FuneralF816167       250228,,126.5,,1419248.77
2025/03/01,2025/02/28,SF FuneralF820063       250228,,126.5,,1419375.27
2025/03/01,2025/02/28,SF FuneralF820851       250228,,126.5,,1419501.77
2025/03/01,2025/02/28,SF FuneralF830867       250228,,126.5,,1419628.27
2025/03/01,2025/02/28,SF FuneralF842925       250228,,126.5,,1419754.77
2025/03/01,2025/02/28,SF FuneralF1066048      250228,,126.5,,1419881.27
2025/03/01,2025/02/28,SF FuneralF1114235      250228,,126.5,,1420007.77
2025/03/01,2025/02/28,SF FuneralF1115169      250228,,126.5,,1420134.27
2025/03/01,2025/02/28,SF FuneralF1117698      250228,,126.5,,1420260.77
2025/03/01,2025/02/28,SF FuneralF1122804      250228,,126.5,,1420387.27
2025/03/01,2025/02/28,SF FuneralF1125699      250228,,126.5,,1420513.77
2025/03/01,2025/02/28,SF FuneralF1128859      250228,,126.5,,1420640.27
2025/03/01,2025/02/27,SF FuneralF1075224      250227,,126.5,,1420766.77
2025/03/01,2025/02/27,SF FuneralF1108326      250227,,126.5,,1420893.27
2025/03/01,2025/02/26,SF FuneralF1120168      250226,,126.5,,1421019.77
2025/03/01,2025/02/22,SF FuneralFDC00000006DKW250222,,126.5,,1421146.27
2025/03/01,2025/02/24,SF FuneralF1120799      250224,,126.5,,1421272.77
2025/03/01,2025/02/25,SF FuneralFDC000000067XN250225,,126.5,,1421399.27
2025/03/01,2025/02/27,SF FuneralFDC00000006DJR250227,,126.5,,1421525.77
2025/03/01,2025/02/28,SF FuneralF1021699      250228,,126.5,,1421652.27
2025/03/01,2025/02/28,SF FuneralF1066397      250228,,126.5,,1421778.77
2025/03/01,2025/03/01,SF FuneralF804113       250301,,126.5,,1421905.27
2025/03/01,2025/02/20,SF FuneralFDC00000006T3G250220,,126.5,,1422031.77
2025/03/01,2025/02/20,SF FuneralFDC00000006T3R250220,,126.5,,1422158.27
2025/03/01,2025/02/22,SF FuneralF807999       250222,,126.5,,1422284.77
2025/03/01,2025/02/22,SF FuneralF818889       250222,,126.5,,1422411.27
2025/03/01,2025/02/22,SF FuneralF823307       250222,,126.5,,1422537.77
2025/03/01,2025/02/22,SF FuneralF992319       250222,,126.5,,1422664.27
2025/03/01,2025/02/22,SF FuneralF1059298      250222,,126.5,,1422790.77
2025/03/01,2025/02/22,SF FuneralF1073696      250222,,126.5,,1422917.27
2025/03/01,2025/02/22,SF FuneralFDC0000000NHM7250222,,126.5,,1423043.77
2025/03/01,2025/02/22,SF FuneralF1120822      250223,,126.5,,1423170.27
2025/03/01,2025/02/22,SF FuneralF1125088      250222,,126.5,,1423296.77
2025/03/01,2025/02/25,SF FuneralFDC000000079QY250225,,31.63,,1423328.4
2025/03/01,2025/02/25,SF FuneralFDC00000007LMS250225,,126.5,,1423454.9
2025/03/01,2025/02/25,SF FuneralF794128       250225,,126.5,,1423581.4
2025/03/01,2025/02/25,SF FuneralF1068221      250225,,31.63,,1423613.03
2025/03/01,2025/02/25,SF FuneralF1103565      250225,,63.25,,1423676.28
2025/03/01,2025/02/25,SF FuneralF981451       250225,,31.63,,1423707.91
2025/03/01,2025/02/25,SF FuneralF1125711      250225,,126.5,,1423834.41
2025/03/01,2025/02/25,SF FuneralF1130923      250225,,126.5,,1423960.91
2025/03/01,2025/02/25,SF FuneralFDC0000000Q3NS250225,,126.5,,1424087.41
2025/03/01,2025/02/26,SF FuneralFDC00000005V57250226,,126.5,,1424213.91
2025/03/01,2025/02/26,SF FuneralFDC00000007PV3250226,,126.5,,1424340.41
2025/03/01,2025/02/26,SF FuneralF799091       250226,,126.5,,1424466.91
2025/03/01,2025/02/26,SF FuneralF992781       250226,,126.5,,1424593.41
2025/03/01,2025/02/26,SF FuneralF993286       250226,,126.5,,1424719.91
2025/03/01,2025/02/26,SF FuneralF993324       250226,,126.5,,1424846.41
2025/03/01,2025/02/26,SF FuneralF993540       250226,,126.5,,1424972.91
2025/03/01,2025/02/26,SF FuneralF1129063      250226,,126.5,,1425099.41
2025/03/01,2025/02/27,SF FuneralFDC000000084KT250227,,126.5,,1425225.91
2025/03/01,2025/02/27,SF FuneralF802771       250227,,126.5,,1425352.41
2025/03/01,2025/02/27,SF FuneralF843084       250227,,126.5,,1425478.91
2025/03/01,2025/02/27,SF FuneralFDC0000000N7RF250227,,126.5,,1425605.41
2025/03/01,2025/02/27,SF FuneralF1118512      250227,,126.5,,1425731.91
2025/03/01,2025/02/28,SF FuneralFDC000000069BF250228,,126.5,,1425858.41
2025/03/01,2025/02/28,SF FuneralFDC000000077Y7250228,,126.5,,1425984.91
2025/03/01,2025/02/28,SF FuneralF804166       250228,,126.5,,1426111.41
2025/03/01,2025/02/28,SF FuneralFDC0000000B9Q1250228,,126.5,,1426237.91
2025/03/01,2025/02/28,SF FuneralF843410       250228,,31.63,,1426269.54
2025/03/01,2025/02/28,SF FuneralF987216       250228,,126.5,,1426396.04
2025/03/01,2025/02/28,SF FuneralF987464       250228,,126.5,,1426522.54
2025/03/01,2025/02/28,SF FuneralF1020807      250228,,126.5,,1426649.04
2025/03/01,2025/02/28,SF FuneralF1066622      250228,,126.5,,1426775.54
2025/03/01,2025/02/28,SF FuneralF1073047      250228,,126.5,,1426902.04
2025/03/01,2025/02/28,SF FuneralF1085236      250228,,126.5,,1427028.54
2025/03/01,2025/02/28,SF FuneralF1109839      250228,,126.5,,1427155.04
2025/03/01,2025/02/28,SF FuneralF1111579      250228,,126.5,,1427281.54
2025/03/01,2025/02/28,SF FuneralF1115012      250228,,126.5,,1427408.04
2025/03/01,2025/02/28,SF FuneralF1125895      250228,,126.5,,1427534.54
2025/03/01,2025/02/28,SF FuneralF1127488      250228,,126.5,,1427661.04
2025/03/01,2025/02/28,SF FuneralF1127518      250228,,126.5,,1427787.54
2025/03/01,2025/02/28,SF FuneralF1129342      250228,,126.5,,1427914.04
2025/03/01,2025/03/01,SF FuneralFDC00000002T8D250301,,220,,1428134.04
2025/03/01,2025/03/01,SF FuneralFDC00000005CFV250301,,126.5,,1428260.54
2025/03/01,2025/03/01,SF FuneralFDC00000006B1W250301,,126.5,,1428387.04
2025/03/01,2025/03/01,SF FuneralFDC00000006FCK250301,,126.5,,1428513.54
2025/03/01,2025/03/01,SF FuneralFDC00000006G0V250301,,126.5,,1428640.04
2025/03/01,2025/03/01,SF FuneralFDC00000006DQ3250301,,126.5,,1428766.54
2025/03/01,2025/03/01,SF FuneralFDC00000006KS3250301,,126.5,,1428893.04
2025/03/01,2025/03/01,SF FuneralFDC00000006X0Y250301,,126.5,,1429019.54
2025/03/01,2025/03/01,SF FuneralFDC000000074G0250301,,126.5,,1429146.04
2025/03/01,2025/03/01,SF FuneralFDC000000077QZ250301,,126.5,,1429272.54
2025/03/01,2025/03/01,SF FuneralFDC000000078RV250301,,126.5,,1429399.04
2025/03/01,2025/03/01,SF FuneralFDC00000007960250301,,126.5,,1429525.54
2025/03/01,2025/03/01,SF FuneralFDC000000085DR250301,,126.5,,1429652.04
2025/03/01,2025/03/01,SF FuneralF800181       250301,,126.5,,1429778.54
2025/03/01,2025/03/01,SF FuneralF803074       250301,,126.5,,1429905.04
2025/03/01,2025/03/01,SF FuneralF808473       250301,,126.5,,1430031.54
2025/03/01,2025/03/01,SF FuneralF813075       250301,,126.5,,1430158.04
2025/03/01,2025/03/01,SF FuneralF817183       250301,,126.5,,1430284.54
2025/03/01,2025/03/01,SF FuneralF818109       250301,,126.5,,1430411.04
2025/03/01,2025/03/01,SF FuneralF819673       250301,,126.5,,1430537.54
2025/03/01,2025/03/01,SF FuneralF821265       250301,,126.5,,1430664.04
2025/03/01,2025/03/01,SF FuneralF828739       250301,,126.5,,1430790.54
2025/03/01,2025/03/01,SF FuneralF832037       250301,,126.5,,1430917.04
2025/03/01,2025/03/01,SF FuneralF832375       250301,,126.5,,1431043.54
2025/03/01,2025/03/01,SF FuneralF838900       250301,,126.5,,1431170.04
2025/03/01,2025/03/01,SF FuneralF993155       250301,,126.5,,1431296.54
2025/03/01,2025/03/01,SF FuneralF993296       250301,,126.5,,1431423.04
2025/03/01,2025/03/01,SF FuneralF993437       250301,,126.5,,1431549.54
2025/03/01,2025/03/01,SF FuneralF1020601      250301,,31.63,,1431581.17
2025/03/01,2025/03/01,SF FuneralF1021968      250301,,126.5,,1431707.67
2025/03/01,2025/03/01,SF FuneralF781742       250301,,126.5,,1431834.17
2025/03/01,2025/03/01,SF FuneralF1066555      250301,,126.5,,1431960.67
2025/03/01,2025/03/01,SF FuneralF1066765      250301,,126.5,,1432087.17
2025/03/01,2025/03/01,SF FuneralF1074755      250301,,126.5,,1432213.67
2025/03/01,2025/03/01,SF FuneralF1078875      250301,,126.5,,1432340.17
2025/03/01,2025/03/01,SF FuneralF1084730      250301,,126.5,,1432466.67
2025/03/01,2025/03/01,SF FuneralF1108137      250301,,126.5,,1432593.17
2025/03/01,2025/03/01,SF FuneralF1109100      250301,,126.5,,1432719.67
2025/03/01,2025/03/01,SF FuneralF1111762      250301,,126.5,,1432846.17
2025/03/01,2025/03/01,SF FuneralF1113870      250301,,126.5,,1432972.67
2025/03/01,2025/03/01,SF FuneralF1116889      250301,,126.5,,1433099.17
2025/03/01,2025/03/01,SF FuneralF1120521      250301,,126.5,,1433225.67
2025/03/01,2025/03/01,SF FuneralF1122033      250301,,126.5,,1433352.17
2025/03/01,2025/03/01,SF FuneralF1122726      250301,,126.5,,1433478.67
2025/03/01,2025/03/01,SF FuneralF1123983      250301,,126.5,,1433605.17
2025/03/01,2025/03/01,SF FuneralF1125662      250301,,31.63,,1433636.8
2025/03/01,2025/03/01,SF FuneralF1125800      250301,,126.5,,1433763.3
2025/03/01,2025/03/01,SF FuneralF1129377      250301,,126.5,,1433889.8
2025/03/01,2025/02/28,SF FuneralFDC0000000HZCK250228,,126.5,,1434016.3
2025/03/01,2025/02/28,SF FuneralF1117720      250228,,126.5,,1434142.8
2025/03/01,2025/02/28,SF FuneralF1127880      250228,,126.5,,1434269.3
2025/03/01,2025/02/28,SF FuneralFDC0000000PSXJ250228,,126.5,,1434395.8
2025/03/01,2025/02/27,SF FuneralF992258       250227,,126.5,,1434522.3
2025/03/01,2025/03/01,SF FuneralFDC00000006F1M250301,,126.5,,1434648.8
2025/03/01,2025/03/01,SF FuneralF809141       250301,,126.5,,1434775.3
2025/03/01,2025/03/01,SF FuneralF820376       250301,,126.5,,1434901.8
2025/03/01,2025/03/01,SF FuneralF821409       250301,,126.5,,1435028.3
2025/03/01,2025/03/01,SF FuneralF993375       250301,,126.5,,1435154.8
2025/03/01,2025/03/01,SF FuneralF1084017      250302,,126.5,,1435281.3
2025/03/01,2025/03/01,SF FuneralF1113733      250301,,126.5,,1435407.8
2025/03/01,2025/03/01,SF FuneralFDC0000000N963250301,,126.5,,1435534.3
2025/03/01,2025/03/01,SF FuneralF1122048      250301,,126.5,,1435660.8
2025/03/01,2025/03/01,SF FuneralF1129253      250301,,126.5,,1435787.3
2025/03/01,2025/03/01,SF FuneralF1129331      250301,,126.5,,1435913.8
2025/03/01,2025/03/01,SF FuneralF823985       250301,,126.5,,1436040.3
2025/03/01,2025/03/01,SF FuneralFDC0000000JY4C250301,,126.5,,1436166.8
2025/03/01,2025/03/01,SF FuneralF1125106      250301,,126.5,,1436293.3
2025/03/01,2025/03/01,SF FuneralFDC00000005T43250301,,126.5,,1436419.8
2025/03/01,2025/03/01,SF FuneralFDC00000008T61250301,,126.5,,1436546.3
2025/03/01,2025/03/01,SF FuneralF815907       250301,,126.5,,1436672.8
2025/03/01,2025/03/01,SF FuneralF818218       250301,,126.5,,1436799.3
2025/03/01,2025/03/01,SF FuneralF1055252      250301,,126.5,,1436925.8
2025/03/01,2025/03/01,SF FuneralFDC0000000L3XW250301,,126.5,,1437052.3
2025/03/01,2025/03/01,SF FuneralF1125249      250302,,126.5,,1437178.8
2025/03/01,2025/03/01,SF FuneralFDC00000002W5P250301,,220,,1437398.8
2025/03/01,2025/03/01,SF FuneralFDC000000033SY250301,,220,,1437618.8
2025/03/01,2025/03/01,SF FuneralFDC00000006FK6250301,,126.5,,1437745.3
2025/03/01,2025/03/01,SF FuneralFDC00000006NKC250301,,126.5,,1437871.8
2025/03/01,2025/03/01,SF FuneralFDC0000000700Z250301,,126.5,,1437998.3
2025/03/01,2025/03/01,SF FuneralFDC00000007JLL250301,,126.5,,1438124.8
2025/03/01,2025/03/01,SF FuneralFDC000000085XD250301,,126.5,,1438251.3
2025/03/01,2025/03/01,SF FuneralF802589       250301,,126.5,,1438377.8
2025/03/01,2025/03/01,SF FuneralF809380       250301,,126.5,,1438504.3
2025/03/01,2025/03/01,SF FuneralF810014       250301,,126.5,,1438630.8
2025/03/01,2025/03/01,SF FuneralF813467       250301,,126.5,,1438757.3
2025/03/01,2025/03/01,SF FuneralF814461       250301,,126.5,,1438883.8
2025/03/01,2025/03/01,SF FuneralFDC00000009MJN250301,,126.5,,1439010.3
2025/03/01,2025/03/01,SF FuneralF814867       250301,,126.5,,1439136.8
2025/03/01,2025/03/01,SF FuneralFDC00000009XP3250301,,126.5,,1439263.3
2025/03/01,2025/03/01,SF FuneralF833421       250301,,126.5,,1439389.8
2025/03/01,2025/03/01,SF FuneralF992581       250302,,126.5,,1439516.3
2025/03/01,2025/03/01,SF FuneralF993432       250301,,126.5,,1439642.8
2025/03/01,2025/03/01,SF FuneralF1061011      250301,,126.5,,1439769.3
2025/03/01,2025/03/01,SF FuneralF1073358      250301,,126.5,,1439895.8
2025/03/01,2025/03/01,SF FuneralFDC0000000LXMD250301,,191.5,,1440087.3
2025/03/01,2025/03/01,SF FuneralF1110082      250302,,63.25,,1440150.55
2025/03/01,2025/03/01,SF FuneralF1110214      250301,,126.5,,1440277.05
2025/03/01,2025/03/01,SF FuneralF794829       250301,,126.5,,1440403.55
2025/03/01,2025/03/01,SF FuneralF1120868      250301,,126.5,,1440530.05
2025/03/01,2025/03/01,SF FuneralF1122274      250301,,126.5,,1440656.55
2025/03/01,2025/03/01,SF FuneralF1122955      250301,,126.5,,1440783.05
2025/03/01,2025/03/01,SF FuneralF1124134      250302,,126.5,,1440909.55
2025/03/01,2025/03/01,SF FuneralFDC0000000PQSL250301,,126.5,,1441036.05
2025/03/01,2025/03/01,SF FuneralF1128866      250301,,126.5,,1441162.55
2025/03/01,2025/03/01,SF FuneralF1085192      250301,,126.5,,1441289.05
2025/03/01,2025/03/01,SF FuneralF1132001      250301,,126.5,,1441415.55
2025/03/01,2025/03/01,SF FuneralFDC000000058FQ250301,,126.5,,1441542.05
2025/03/01,2025/03/01,SF FuneralFDC00000005HP7250301,,126.5,,1441668.55
2025/03/01,2025/03/01,SF FuneralFDC00000005QD7250301,,126.5,,1441795.05
2025/03/01,2025/03/01,SF FuneralFDC00000006QRS250301,,220,,1442015.05
2025/03/01,2025/03/01,SF FuneralFDC00000006ZPV250301,,126.5,,1442141.55
2025/03/01,2025/03/01,SF FuneralFDC000000073TL250301,,126.5,,1442268.05
2025/03/01,2025/03/01,SF FuneralFDC00000007RVY250301,,220,,1442488.05
2025/03/01,2025/03/01,SF FuneralFDC00000007RXP250301,,126.5,,1442614.55
2025/03/01,2025/03/01,SF FuneralF810101       250301,,126.5,,1442741.05
2025/03/01,2025/03/01,SF FuneralFDC0000000B1SQ250301,,126.5,,1442867.55
2025/03/01,2025/03/01,SF FuneralF828828       250301,,126.5,,1442994.05
2025/03/01,2025/03/01,SF FuneralF993790       250301,,126.5,,1443120.55
2025/03/01,2025/03/01,SF FuneralF1021774      250301,,126.5,,1443247.05
2025/03/01,2025/03/01,SF FuneralF1074980      250301,,126.5,,1443373.55
2025/03/01,2025/03/01,SF FuneralF1075151      250301,,126.5,,1443500.05
2025/03/01,2025/03/01,SF FuneralF1075207      250301,,126.5,,1443626.55
2025/03/01,2025/03/01,SF FuneralF1078935      250302,,126.5,,1443753.05
2025/03/01,2025/03/01,SF FuneralF1079150      250301,,126.5,,1443879.55
2025/03/01,2025/03/01,SF FuneralF1079688      250301,,126.5,,1444006.05
2025/03/01,2025/03/01,SF FuneralF1121975      250301,,126.5,,1444132.55
2025/03/01,2025/03/01,SF FuneralF1122656      250301,,126.5,,1444259.05
2025/03/01,2025/03/01,SF FuneralF823058       250301,,126.5,,1444385.55
2025/03/01,2025/03/01,SF FuneralF1084522      250301,,126.5,,1444512.05
2025/03/01,2025/02/27,SF FuneralFDC00000006J5R250227,,126.5,,1444638.55
2025/03/01,2025/02/27,SF FuneralF1112521      250227,,126.5,,1444765.05
2025/03/01,2025/02/27,SF FuneralF1118347      250227,,126.5,,1444891.55
2025/03/01,2025/02/27,SF FuneralF1123147      250227,,126.5,,1445018.05
2025/03/01,2025/03/01,SF FuneralFDC00000005GS4250301,,126.5,,1445144.55
2025/03/01,2025/03/01,SF FuneralFDC00000005XP7250301,,126.5,,1445271.05
2025/03/01,2025/03/01,SF FuneralFDC000000063W2250301,,126.5,,1445397.55
2025/03/01,2025/03/01,SF FuneralFDC000000069HZ250301,,126.5,,1445524.05
2025/03/01,2025/03/01,SF FuneralFDC00000006J77250301,,126.5,,1445650.55
2025/03/01,2025/03/01,SF FuneralFDC00000006JFL250301,,126.5,,1445777.05
2025/03/01,2025/03/01,SF FuneralFDC00000006R1Y250301,,126.5,,1445903.55
2025/03/01,2025/03/01,SF FuneralFDC000000075FQ250301,,126.5,,1446030.05
2025/03/01,2025/03/01,SF FuneralF802708       250301,,126.5,,1446156.55
2025/03/01,2025/03/01,SF FuneralF803923       250301,,126.5,,1446283.05
2025/03/01,2025/03/01,SF FuneralF805671       250301,,126.5,,1446409.55
2025/03/01,2025/03/01,SF FuneralF808698       250301,,126.5,,1446536.05
2025/03/01,2025/03/01,SF FuneralF817464       250301,,126.5,,1446662.55
2025/03/01,2025/03/01,SF FuneralF817612       250301,,126.5,,1446789.05
2025/03/01,2025/03/01,SF FuneralF820849       250301,,126.5,,1446915.55
2025/03/01,2025/03/01,SF FuneralF828572       250301,,126.5,,1447042.05
2025/03/01,2025/03/01,SF FuneralF829821       250301,,126.5,,1447168.55
2025/03/01,2025/03/01,SF FuneralF838797       250301,,126.5,,1447295.05
2025/03/01,2025/03/01,SF FuneralF842366       250301,,126.5,,1447421.55
2025/03/01,2025/03/01,SF FuneralF992731       250301,,126.5,,1447548.05
2025/03/01,2025/03/01,SF FuneralF992817       250301,,126.5,,1447674.55
2025/03/01,2025/03/01,SF FuneralF993091       250301,,126.5,,1447801.05
2025/03/01,2025/03/01,SF FuneralF1066574      250301,,126.5,,1447927.55
2025/03/01,2025/03/01,SF FuneralF1066780      250301,,126.5,,1448054.05
2025/03/01,2025/03/01,SF FuneralF1068019      250301,,126.5,,1448180.55
2025/03/01,2025/03/01,SF FuneralF1080353      250301,,126.5,,1448307.05
2025/03/01,2025/03/01,SF FuneralF1110704      250301,,126.5,,1448433.55
2025/03/01,2025/03/01,SF FuneralF1113215      250301,,126.5,,1448560.05
2025/03/01,2025/03/01,SF FuneralF1125795      250301,,126.5,,1448686.55
2025/03/01,2025/03/01,SF FuneralF1128686      250301,,126.5,,1448813.05
2025/03/01,2025/03/01,SF FuneralF1131513      250302,,126.5,,1448939.55
2025/03/01,2025/03/01,SF FuneralF1130421      250301,,31.63,,1448971.18
2025/03/01,2025/02/22,SF FuneralFDC00000005FWH250222,,126.5,,1449097.68
2025/03/01,2025/02/22,SF FuneralFDC0000000616V250222,,126.5,,1449224.18
2025/03/01,2025/02/22,SF FuneralFDC00000007MGW250222,,126.5,,1449350.68
2025/03/01,2025/02/22,SF FuneralFDC00000007NC0250222,,126.5,,1449477.18
2025/03/01,2025/02/22,SF FuneralF805482       250222,,126.5,,1449603.68
2025/03/01,2025/02/22,SF FuneralFDC00000009515250222,,126.5,,1449730.18
2025/03/01,2025/02/22,SF FuneralF989590       250223,,126.5,,1449856.68
2025/03/01,2025/02/22,SF FuneralF1116790      250222,,126.5,,1449983.18
2025/03/01,2025/02/24,SF FuneralFDC00000007GYF250224,,126.5,,1450109.68
2025/03/01,2025/02/24,SF FuneralF1083805      250224,,126.5,,1450236.18
2025/03/01,2025/02/25,SF FuneralFDC00000007GXN250225,,126.5,,1450362.68
2025/03/01,2025/02/25,SF FuneralFDC00000007J2V250225,,126.5,,1450489.18
2025/03/01,2025/02/25,SF FuneralFDC00000007LL1250225,,126.5,,1450615.68
2025/03/01,2025/02/25,SF FuneralFDC00000007RGW250225,,126.5,,1450742.18
2025/03/01,2025/02/25,SF FuneralF808104       250225,,126.5,,1450868.68
2025/03/01,2025/02/25,SF FuneralF822239       250225,,31.63,,1450900.31
2025/03/01,2025/02/25,SF FuneralF1074970      250225,,126.5,,1451026.81
2025/03/01,2025/02/25,SF FuneralF1114564      250225,,126.5,,1451153.31
2025/03/01,2025/02/25,SF FuneralF1120751      250225,,126.5,,1451279.81
2025/03/01,2025/02/25,SF FuneralF1124597      250225,,126.5,,1451406.31
2025/03/01,2025/02/25,SF FuneralF1132482      250225,,126.5,,1451532.81
2025/03/01,2025/02/25,SF FuneralF1132532      250225,,63.25,,1451596.06
2025/03/01,2025/02/26,SF FuneralF819801       250226,,126.5,,1451722.56
2025/03/01,2025/02/26,SF FuneralF828709       250226,,126.5,,1451849.06
2025/03/01,2025/02/26,SF FuneralFDC0000000H8PW250226,,126.5,,1451975.56
2025/03/01,2025/02/26,SF FuneralF1059437      250226,,126.5,,1452102.06
2025/03/01,2025/02/26,SF FuneralF1132392      250226,,63.25,,1452165.31
2025/03/01,2025/02/28,SF FuneralFDC00000005DP1250228,,126.5,,1452291.81
2025/03/01,2025/02/28,SF FuneralF808326       250228,,126.5,,1452418.31
2025/03/01,2025/02/28,SF FuneralF817800       250228,,126.5,,1452544.81
2025/03/01,2025/02/28,SF FuneralF981544       250228,,126.5,,1452671.31
2025/03/01,2025/02/28,SF FuneralF1073123      250228,,126.5,,1452797.81
2025/03/01,2025/02/28,SF FuneralF1083838      250228,,126.5,,1452924.31
2025/03/01,2025/02/28,SF FuneralF1084874      250228,,126.5,,1453050.81
2025/03/01,2025/02/28,SF FuneralF1118501      250228,,126.5,,1453177.31
2025/03/01,2025/02/28,SF FuneralF1123085      250228,,126.5,,1453303.81
2025/03/01,2025/02/28,SF FuneralF1129019      250228,,126.5,,1453430.31
2025/03/01,2025/02/24,SF FuneralF833038       250224,,126.5,,1453556.81
2025/03/01,2025/02/25,SF FuneralFDC00000007LQZ250225,,126.5,,1453683.31
2025/03/01,2025/03/01,SF FuneralFDC0000000795L250301,,31.63,,1453714.94
2025/03/01,2025/03/01,SF FuneralF814211       250301,,31.63,,1453746.57
2025/03/01,2025/03/01,SF FuneralF832932       250301,,31.63,,1453778.2
2025/03/01,2025/03/01,SF FuneralF1054743      250302,,31.63,,1453809.83
2025/03/01,2025/02/22,SF FuneralFDC00000005LRG250222,,220,,1454029.83
2025/03/01,2025/02/22,SF FuneralFDC00000007H38250222,,126.5,,1454156.33
2025/03/01,2025/02/22,SF FuneralFDC000000085FV250222,,126.5,,1454282.83
2025/03/01,2025/02/22,SF FuneralFDC0000000B5JN250222,,126.5,,1454409.33
2025/03/01,2025/02/22,SF FuneralF1055202      250222,,126.5,,1454535.83
2025/03/01,2025/02/24,SF FuneralF821361       250223,,126.5,,1454662.33
2025/03/01,2025/02/24,SF FuneralFDC0000000N7WM250224,,126.5,,1454788.83
2025/03/01,2025/02/25,SF FuneralFDC0000000605Z250225,,126.5,,1454915.33
2025/03/01,2025/02/26,SF FuneralF829778       250226,,126.5,,1455041.83
2025/03/01,2025/02/26,SF FuneralFDC0000000PQNK250226,,63.25,,1455105.08
2025/03/01,2025/02/26,SF FuneralF1131883      250226,,63.25,,1455168.33
2025/03/01,2025/02/27,SF FuneralFDC00000006MWK250227,,126.5,,1455294.83
2025/03/01,2025/02/27,SF FuneralFDC000000073MG250227,,126.5,,1455421.33
2025/03/01,2025/02/27,SF FuneralFDC00000007PWQ250227,,126.5,,1455547.83
2025/03/01,2025/02/27,SF FuneralF803722       250227,,126.5,,1455674.33
2025/03/01,2025/02/27,SF FuneralF842458       250227,,126.5,,1455800.83
2025/03/01,2025/02/27,SF FuneralFDC0000000J8YF250227,,126.5,,1455927.33
2025/03/01,2025/02/27,SF FuneralFDC0000000KBBD250227,,126.5,,1456053.83
2025/03/01,2025/02/27,SF FuneralF1061007      250227,,126.5,,1456180.33
2025/03/01,2025/02/27,SF FuneralF1079294      250227,,126.5,,1456306.83
2025/03/01,2025/02/27,SF FuneralF1120870      250227,,126.5,,1456433.33
2025/03/01,2025/02/27,SF FuneralF1122057      250227,,126.5,,1456559.83
2025/03/01,2025/02/28,SF FuneralFDC00000003VK7250228,,220,,1456779.83
2025/03/01,2025/02/28,SF FuneralFDC0000000684S250228,,126.5,,1456906.33
2025/03/01,2025/02/28,SF FuneralFDC00000006W2N250228,,126.5,,1457032.83
2025/03/01,2025/02/28,SF FuneralFDC000000077WS250228,,126.5,,1457159.33
2025/03/01,2025/02/28,SF FuneralFDC000000086S0250228,,126.5,,1457285.83
2025/03/01,2025/02/28,SF FuneralF800647       250228,,126.5,,1457412.33
2025/03/01,2025/02/28,SF FuneralFDC00000008XXY250228,,126.5,,1457538.83
2025/03/01,2025/02/28,SF FuneralF818767       250228,,126.5,,1457665.33
2025/03/01,2025/02/28,SF FuneralF823031       250228,,126.5,,1457791.83
2025/03/01,2025/02/28,SF FuneralF988374       250301,,126.5,,1457918.33
2025/03/01,2025/02/28,SF FuneralFDC0000000JMVM250228,,63.25,,1457981.58
2025/03/01,2025/02/28,SF FuneralF1021283      250228,,126.5,,1458108.08
2025/03/01,2025/02/28,SF FuneralF1052297      250228,,126.5,,1458234.58
2025/03/01,2025/02/28,SF FuneralF1068205      250228,,126.5,,1458361.08
2025/03/01,2025/02/28,SF FuneralF1078666      250228,,126.5,,1458487.58
2025/03/01,2025/02/28,SF FuneralFDC0000000LVNH250228,,126.5,,1458614.08
2025/03/01,2025/02/28,SF FuneralFDC0000000N3SL250228,,126.5,,1458740.58
2025/03/01,2025/02/28,SF FuneralF1114281      250228,,126.5,,1458867.08
2025/03/01,2025/02/28,SF FuneralF1117011      250228,,126.5,,1458993.58
2025/03/01,2025/02/28,SF FuneralFDC0000000NY14250228,,126.5,,1459120.08
2025/03/01,2025/02/28,SF FuneralF1122687      250228,,126.5,,1459246.58
2025/03/01,2025/02/28,SF FuneralF1126243      250228,,126.5,,1459373.08
2025/03/01,2025/02/28,SF FuneralFDC0000000PN8C250228,,126.5,,1459499.58
2025/03/01,2025/02/28,SF FuneralF1128053      250228,,126.5,,1459626.08
2025/03/01,2025/02/21,SF FuneralF987589       250223,,126.5,,1459752.58
2025/03/01,2025/02/21,SF FuneralF1065652      250221,,126.5,,1459879.08
2025/03/01,2025/02/25,SF FuneralFDC00000008M9V250225,,126.5,,1460005.58
2025/03/01,2025/02/25,SF FuneralF1078282      250225,,126.5,,1460132.08
2025/03/01,2025/02/25,SF FuneralFDC0000000Q3GK250225,,126.5,,1460258.58
2025/03/01,2025/02/25,SF FuneralF834882       250225,,31.63,,1460290.21
2025/03/01,2025/02/25,SF FuneralF1104234      250225,,31.63,,1460321.84
2025/03/01,2025/03/01,SF FuneralFDC0000000KH3D250302,,31.63,,1460353.47
2025/03/01,2025/03/01,SF FuneralF1084539      250302,,31.63,,1460385.1
2025/03/01,2025/03/01,SF FuneralF1132315      250301,,126.5,,1460511.6
2025/03/01,2025/03/01,SF FuneralF1132402      250302,,126.5,,1460638.1
2025/03/01,2025/03/01,SF FuneralFDC000000068WC250301,,126.5,,1460764.6
2025/03/01,2025/03/01,SF FuneralFDC00000006QZ1250301,,126.5,,1460891.1
2025/03/01,2025/03/01,SF FuneralFDC00000007HGZ250301,,126.5,,1461017.6
2025/03/01,2025/03/01,SF FuneralF793818       250301,,126.5,,1461144.1
2025/03/01,2025/03/01,SF FuneralFDC00000007YF9250301,,126.5,,1461270.6
2025/03/01,2025/03/01,SF FuneralFDC000000086CF250301,,126.5,,1461397.1
2025/03/01,2025/03/01,SF FuneralFDC000000089X7250301,,126.5,,1461523.6
2025/03/01,2025/03/01,SF FuneralF808012       250301,,126.5,,1461650.1
2025/03/01,2025/03/01,SF FuneralF809808       250301,,126.5,,1461776.6
2025/03/01,2025/03/01,SF FuneralF813080       250301,,126.5,,1461903.1
2025/03/01,2025/03/01,SF FuneralF820759       250301,,126.5,,1462029.6
2025/03/01,2025/03/01,SF FuneralFDC0000000BB6L250301,,126.5,,1462156.1
2025/03/01,2025/03/01,SF FuneralF821472       250301,,126.5,,1462282.6
2025/03/01,2025/03/01,SF FuneralF821531       250301,,126.5,,1462409.1
2025/03/01,2025/03/01,SF FuneralF832421       250301,,126.5,,1462535.6
2025/03/01,2025/03/01,SF FuneralFDC0000000CS69250301,,126.5,,1462662.1
2025/03/01,2025/03/01,SF FuneralF992967       250301,,126.5,,1462788.6
2025/03/01,2025/03/01,SF FuneralF1022196      250301,,126.5,,1462915.1
2025/03/01,2025/03/01,SF FuneralF1066547      250301,,126.5,,1463041.6
2025/03/01,2025/03/01,SF FuneralF1067965      250301,,126.5,,1463168.1
2025/03/01,2025/03/01,SF FuneralF1068120      250301,,126.5,,1463294.6
2025/03/01,2025/03/01,SF FuneralF1075160      250301,,126.5,,1463421.1
2025/03/01,2025/03/01,SF FuneralF1079702      250301,,126.5,,1463547.6
2025/03/01,2025/03/01,SF FuneralF1080506      250301,,126.5,,1463674.1
2025/03/01,2025/03/01,SF FuneralFDC0000000LQML250301,,126.5,,1463800.6
2025/03/01,2025/03/01,SF FuneralF1083681      250301,,126.5,,1463927.1
2025/03/01,2025/03/01,SF FuneralF1116071      250301,,126.5,,1464053.6
2025/03/01,2025/03/01,SF FuneralF1117375      250301,,126.5,,1464180.1
2025/03/01,2025/03/01,SF FuneralFDC0000000NL11250301,,126.5,,1464306.6
2025/03/01,2025/03/01,SF FuneralF1122911      250301,,126.5,,1464433.1
2025/03/01,2025/03/01,SF FuneralF1124774      250301,,126.5,,1464559.6
2025/03/01,2025/03/01,SF FuneralF1125887      250302,,126.5,,1464686.1
2025/03/01,2025/03/01,SF FuneralF1129950      250301,,126.5,,1464812.6
2025/03/01,2025/03/01,SF FuneralFDC00000007TNR250301,,126.5,,1464939.1
2025/03/01,2025/03/01,SF FuneralF820655       250301,,126.5,,1465065.6
2025/03/01,2025/03/01,SF FuneralF993965       250301,,126.5,,1465192.1
2025/03/01,2025/03/01,SF FuneralF1033828      250301,,126.5,,1465318.6
2025/03/01,2025/03/01,SF FuneralF1055272      250301,,126.5,,1465445.1
2025/03/01,2025/03/01,SF FuneralF842131       250301,,126.5,,1465571.6
2025/03/01,2025/03/01,SF FuneralF1079495      250301,,126.5,,1465698.1
2025/03/01,2025/03/01,SF FuneralF1079557      250301,,126.5,,1465824.6
2025/03/01,2025/03/01,SF FuneralF1122859      250301,,126.5,,1465951.1
2025/03/01,2025/03/01,SF FuneralF1126842      250301,,126.5,,1466077.6
2025/03/01,2025/03/01,SF FuneralF1131130      250301,,126.5,,1466204.1
2025/03/01,2025/03/01,SF FuneralFDC00000005BW8250301,,126.5,,1466330.6
2025/03/01,2025/03/01,SF FuneralFDC00000005RKH250301,,126.5,,1466457.1
2025/03/01,2025/03/01,SF FuneralFDC000000062SY250301,,126.5,,1466583.6
2025/03/01,2025/03/01,SF FuneralFDC00000006D8R250301,,126.5,,1466710.1
2025/03/01,2025/03/01,SF FuneralFDC00000006G2H250301,,126.5,,1466836.6
2025/03/01,2025/03/01,SF FuneralFDC00000006G58250301,,126.5,,1466963.1
2025/03/01,2025/03/01,SF FuneralFDC00000006H07250301,,126.5,,1467089.6
2025/03/01,2025/03/01,SF FuneralFDC000000073P9250301,,126.5,,1467216.1
2025/03/01,2025/03/01,SF FuneralFDC000000078DP250301,,126.5,,1467342.6
2025/03/01,2025/03/01,SF FuneralFDC00000007BN1250301,,126.5,,1467469.1
2025/03/01,2025/03/01,SF FuneralFDC00000007CCT250301,,126.5,,1467595.6
2025/03/01,2025/03/01,SF FuneralFDC00000007DMS250301,,126.5,,1467722.1
2025/03/01,2025/03/01,SF FuneralFDC00000007TJJ250301,,126.5,,1467848.6
2025/03/01,2025/03/01,SF FuneralFDC000000083NM250301,,126.5,,1467975.1
2025/03/01,2025/03/01,SF FuneralFDC000000083NN250301,,126.5,,1468101.6
2025/03/01,2025/03/01,SF FuneralFDC000000084N4250301,,126.5,,1468228.1
2025/03/01,2025/03/01,SF FuneralF798655       250301,,126.5,,1468354.6
2025/03/01,2025/03/01,SF FuneralFDC0000000867Q250301,,126.5,,1468481.1
2025/03/01,2025/03/01,SF FuneralFDC0000000868R250301,,126.5,,1468607.6
2025/03/01,2025/03/01,SF FuneralF805530       250301,,126.5,,1468734.1
2025/03/01,2025/03/01,SF FuneralF808534       250301,,126.5,,1468860.6
2025/03/01,2025/03/01,SF FuneralF808964       250301,,126.5,,1468987.1
2025/03/01,2025/03/01,SF FuneralF812332       250301,,126.5,,1469113.6
2025/03/01,2025/03/01,SF FuneralF812888       250301,,126.5,,1469240.1
2025/03/01,2025/03/01,SF FuneralF813470       250301,,126.5,,1469366.6
2025/03/01,2025/03/01,SF FuneralF815401       250301,,126.5,,1469493.1
2025/03/01,2025/03/01,SF FuneralF816420       250301,,126.5,,1469619.6
2025/03/01,2025/03/01,SF FuneralF816963       250301,,126.5,,1469746.1
2025/03/01,2025/03/01,SF FuneralF821061       250301,,126.5,,1469872.6
2025/03/01,2025/03/01,SF FuneralF821676       250301,,126.5,,1469999.1
2025/03/01,2025/03/01,SF FuneralF832468       250301,,126.5,,1470125.6
2025/03/01,2025/03/01,SF FuneralF833642       250301,,126.5,,1470252.1
2025/03/01,2025/03/01,SF FuneralF834292       250301,,126.5,,1470378.6
2025/03/01,2025/03/01,SF FuneralF834395       250301,,126.5,,1470505.1
2025/03/01,2025/03/01,SF FuneralF834499       250301,,126.5,,1470631.6
2025/03/01,2025/03/01,SF FuneralF838838       250301,,126.5,,1470758.1
2025/03/01,2025/03/01,SF FuneralF992443       250301,,126.5,,1470884.6
2025/03/01,2025/03/01,SF FuneralF993427       250301,,126.5,,1471011.1
2025/03/01,2025/03/01,SF FuneralFDC0000000JDTD250301,,126.5,,1471137.6
2025/03/01,2025/03/01,SF FuneralF1017169      250301,,126.5,,1471264.1
2025/03/01,2025/03/01,SF FuneralF1020540      250301,,126.5,,1471390.6
2025/03/01,2025/03/01,SF FuneralF1020587      250301,,126.5,,1471517.1
2025/03/01,2025/03/01,SF FuneralF1021246      250301,,126.5,,1471643.6
2025/03/01,2025/03/01,SF FuneralF1059382      250301,,126.5,,1471770.1
2025/03/01,2025/03/01,SF FuneralF1061071      250302,,63.25,,1471833.35
2025/03/01,2025/03/01,SF FuneralF1066298      250301,,126.5,,1471959.85
2025/03/01,2025/03/01,SF FuneralF1066581      250301,,126.5,,1472086.35
2025/03/01,2025/03/01,SF FuneralF1073610      250301,,126.5,,1472212.85
2025/03/01,2025/03/01,SF FuneralF1073641      250301,,126.5,,1472339.35
2025/03/01,2025/03/01,SF FuneralF1078909      250301,,126.5,,1472465.85
2025/03/01,2025/03/01,SF FuneralF1060357      250302,,126.5,,1472592.35
2025/03/01,2025/03/01,SF FuneralF1108813      250301,,126.5,,1472718.85
2025/03/01,2025/03/01,SF FuneralFDC0000000MJM7250302,,126.5,,1472845.35
2025/03/01,2025/03/01,SF FuneralF1109063      250301,,126.5,,1472971.85
2025/03/01,2025/03/01,SF FuneralF1110268      250301,,126.5,,1473098.35
2025/03/01,2025/03/01,SF FuneralF1110696      250301,,126.5,,1473224.85
2025/03/01,2025/03/01,SF FuneralF1114906      250301,,126.5,,1473351.35
2025/03/01,2025/03/01,SF FuneralF1118506      250301,,126.5,,1473477.85
2025/03/01,2025/03/01,SF FuneralF1119718      250301,,126.5,,1473604.35
2025/03/01,2025/03/01,SF FuneralF1122590      250301,,126.5,,1473730.85
2025/03/01,2025/03/01,SF FuneralF1123026      250301,,126.5,,1473857.35
2025/03/01,2025/03/01,SF FuneralFDC0000000PLXB250301,,126.5,,1473983.85
2025/03/01,2025/03/01,SF FuneralF1127307      250301,,126.5,,1474110.35
2025/03/01,2025/03/01,SF FuneralFDC0000000PVYW250301,,126.5,,1474236.85
2025/03/01,2025/03/01,SF FuneralF1131093      250301,,63.25,,1474300.1
2025/03/01,2025/03/01,SF FuneralF1131208      250301,,126.5,,1474426.6
2025/03/01,2025/03/01,SF FuneralF1131211      250301,,126.5,,1474553.1
2025/03/01,2025/03/01,SF FuneralFDC00000003KBW250301,,220,,1474773.1
2025/03/01,2025/03/01,SF FuneralFDC00000005MF9250301,,126.5,,1474899.6
2025/03/01,2025/03/01,SF FuneralFDC000000066PM250301,,126.5,,1475026.1
2025/03/01,2025/03/01,SF FuneralFDC00000006F2S250301,,126.5,,1475152.6
2025/03/01,2025/03/01,SF FuneralFDC00000006F48250301,,126.5,,1475279.1
2025/03/01,2025/03/01,SF FuneralFDC00000006FD0250301,,126.5,,1475405.6
2025/03/01,2025/03/01,SF FuneralFDC00000006FJ6250301,,126.5,,1475532.1
2025/03/01,2025/03/01,SF FuneralFDC00000006G08250301,,126.5,,1475658.6
2025/03/01,2025/03/01,SF FuneralFDC00000006KZN250301,,126.5,,1475785.1
2025/03/01,2025/03/01,SF FuneralFDC00000006LTK250301,,63.25,,1475848.35
2025/03/01,2025/03/01,SF FuneralFDC00000006THF250301,,126.5,,1475974.85
2025/03/01,2025/03/01,SF FuneralFDC00000007C1B250301,,220,,1476194.85
2025/03/01,2025/03/01,SF FuneralFDC00000007C4G250301,,126.5,,1476321.35
2025/03/01,2025/03/01,SF FuneralF812589       250301,,126.5,,1476447.85
2025/03/01,2025/03/01,SF FuneralF812689       250301,,126.5,,1476574.35
2025/03/01,2025/03/01,SF FuneralF812709       250301,,126.5,,1476700.85
2025/03/01,2025/03/01,SF FuneralF815855       250301,,126.5,,1476827.35
2025/03/01,2025/03/01,SF FuneralF818728       250301,,126.5,,1476953.85
2025/03/01,2025/03/01,SF FuneralF830945       250301,,126.5,,1477080.35
2025/03/01,2025/03/01,SF FuneralF832006       250301,,126.5,,1477206.85
2025/03/01,2025/03/01,SF FuneralF832764       250301,,126.5,,1477333.35
2025/03/01,2025/03/01,SF FuneralF833246       250301,,126.5,,1477459.85
2025/03/01,2025/03/01,SF FuneralF833327       250301,,126.5,,1477586.35
2025/03/01,2025/03/01,SF FuneralFDC0000000CSZK250301,,126.5,,1477712.85
2025/03/01,2025/03/01,SF FuneralF842714       250301,,126.5,,1477839.35
2025/03/01,2025/03/01,SF FuneralF993161       250301,,126.5,,1477965.85
2025/03/01,2025/03/01,SF FuneralFDC0000000JF13250301,,126.5,,1478092.35
2025/03/01,2025/03/01,SF FuneralF1020657      250301,,126.5,,1478218.85
2025/03/01,2025/03/01,SF FuneralF1078918      250301,,126.5,,1478345.35
2025/03/01,2025/03/01,SF FuneralF1079042      250301,,126.5,,1478471.85
2025/03/01,2025/03/01,SF FuneralF1079059      250301,,126.5,,1478598.35
2025/03/01,2025/03/01,SF FuneralF901506       250301,,126.5,,1478724.85
2025/03/01,2025/03/01,SF FuneralF1080522      250301,,126.5,,1478851.35
2025/03/01,2025/03/01,SF FuneralF1085142      250301,,126.5,,1478977.85
2025/03/01,2025/03/01,SF FuneralF1085334      250301,,126.5,,1479104.35
2025/03/01,2025/03/01,SF FuneralF1085330      250301,,126.5,,1479230.85
2025/03/01,2025/03/01,SF FuneralF1104079      250301,,126.5,,1479357.35
2025/03/01,2025/03/01,SF FuneralF1108031      250301,,126.5,,1479483.85
2025/03/01,2025/03/01,SF FuneralF1109132      250301,,126.5,,1479610.35
2025/03/01,2025/03/01,SF FuneralF1109679      250301,,126.5,,1479736.85
2025/03/01,2025/03/01,SF FuneralFDC0000000N372250301,,126.5,,1479863.35
2025/03/01,2025/03/01,SF FuneralFDC0000000N38D250301,,126.5,,1479989.85
2025/03/01,2025/03/01,SF FuneralF1117235      250301,,126.5,,1480116.35
2025/03/01,2025/03/01,SF FuneralF1118038      250301,,126.5,,1480242.85
2025/03/01,2025/03/01,SF FuneralF1118656      250301,,126.5,,1480369.35
2025/03/01,2025/03/01,SF FuneralFDC0000000NPWH250301,,126.5,,1480495.85
2025/03/01,2025/03/01,SF FuneralFDC0000000NQ2D250301,,126.5,,1480622.35
2025/03/01,2025/03/01,SF FuneralF1119797      250301,,126.5,,1480748.85
2025/03/01,2025/03/01,SF FuneralFDC0000000P01F250301,,126.5,,1480875.35
2025/03/01,2025/03/01,SF FuneralF1124783      250301,,126.5,,1481001.85
2025/03/01,2025/03/01,SF FuneralF1125692      250301,,126.5,,1481128.35
2025/03/01,2025/03/01,SF FuneralFDC0000000PVP5250301,,126.5,,1481254.85
2025/03/01,2025/03/01,SF FuneralF1131897      250301,,126.5,,1481381.35
2025/03/01,2025/03/01,SF FuneralF1132504      250301,,126.5,,1481507.85
2025/03/01,2025/03/01,SF FuneralFDC00000005YZC250301,,126.5,,1481634.35
2025/03/01,2025/03/01,SF FuneralFDC00000006BFH250301,,126.5,,1481760.85
2025/03/01,2025/03/01,SF FuneralFDC00000006H36250301,,126.5,,1481887.35
2025/03/01,2025/03/01,SF FuneralFDC00000006R98250301,,126.5,,1482013.85
2025/03/01,2025/03/01,SF FuneralFDC000000075BV250301,,126.5,,1482140.35
2025/03/01,2025/03/01,SF FuneralFDC000000075JH250301,,126.5,,1482266.85
2025/03/01,2025/03/01,SF FuneralFDC0000000771K250301,,126.5,,1482393.35
2025/03/01,2025/03/01,SF FuneralFDC000000077VD250301,,126.5,,1482519.85
2025/03/01,2025/03/01,SF FuneralFDC0000000787Z250301,,126.5,,1482646.35
2025/03/01,2025/03/01,SF FuneralFDC0000000788C250301,,126.5,,1482772.85
2025/03/01,2025/03/01,SF FuneralFDC00000007F6N250301,,126.5,,1482899.35
2025/03/01,2025/03/01,SF FuneralFDC00000007V4M250301,,126.5,,1483025.85
2025/03/01,2025/03/01,SF FuneralF795220       250301,,126.5,,1483152.35
2025/03/01,2025/03/01,SF FuneralF795594       250301,,126.5,,1483278.85
2025/03/01,2025/03/01,SF FuneralF802798       250301,,126.5,,1483405.35
2025/03/01,2025/03/01,SF FuneralF822293       250301,,126.5,,1483531.85
2025/03/01,2025/03/01,SF FuneralF823096       250301,,126.5,,1483658.35
2025/03/01,2025/03/01,SF FuneralF823232       250301,,126.5,,1483784.85
2025/03/01,2025/03/01,SF FuneralF828142       250301,,126.5,,1483911.35
2025/03/01,2025/03/01,SF FuneralF1060091      250301,,126.5,,1484037.85
2025/03/01,2025/03/01,SF FuneralF1060201      250301,,126.5,,1484164.35
2025/03/01,2025/03/01,SF FuneralF1060755      250301,,126.5,,1484290.85
2025/03/01,2025/03/01,SF FuneralF1061553      250301,,126.5,,1484417.35
2025/03/01,2025/03/01,SF FuneralF1084605      250301,,126.5,,1484543.85
2025/03/01,2025/03/01,SF FuneralF1118028      250301,,126.5,,1484670.35
2025/03/01,2025/03/01,SF FuneralF1118262      250301,,126.5,,1484796.85
2025/03/01,2025/03/01,SF FuneralF1118561      250301,,126.5,,1484923.35
2025/03/01,2025/03/01,SF FuneralF1121967      250301,,126.5,,1485049.85
2025/03/01,2025/03/01,SF FuneralFDC0000000P09M250301,,126.5,,1485176.35
2025/03/01,2025/03/01,SF FuneralF1122004      250301,,126.5,,1485302.85
2025/03/01,2025/03/01,SF FuneralF1127629      250301,,126.5,,1485429.35
2025/03/01,2025/03/01,SF FuneralF1127851      250301,,126.5,,1485555.85
2025/03/01,2025/03/01,SF FuneralF1127864      250301,,126.5,,1485682.35
2025/03/01,2025/03/01,SF FuneralFDC0000000PVBN250301,,126.5,,1485808.85
2025/03/01,2025/03/01,SF FuneralF1128173      250301,,126.5,,1485935.35
2025/03/01,2025/03/01,SF FuneralF1130368      250301,,126.5,,1486061.85
2025/03/01,2025/03/01,SF FuneralF1131882      250301,,126.5,,1486188.35
2025/03/01,2025/03/01,SF FuneralFDC0000000349F250301,,220,,1486408.35
2025/03/01,2025/03/01,SF FuneralFDC000000069WV250301,,126.5,,1486534.85
2025/03/01,2025/03/01,SF FuneralFDC00000006BJR250301,,126.5,,1486661.35
2025/03/01,2025/03/01,SF FuneralFDC00000006HGP250301,,126.5,,1486787.85
2025/03/01,2025/03/01,SF FuneralFDC00000006HPW250301,,126.5,,1486914.35
2025/03/01,2025/03/01,SF FuneralFDC00000006KQZ250301,,220,,1487134.35
2025/03/01,2025/03/01,SF FuneralFDC0000000745C250301,,126.5,,1487260.85
2025/03/01,2025/03/01,SF FuneralFDC0000000745J250301,,126.5,,1487387.35
2025/03/01,2025/03/01,SF FuneralFDC00000007RQG250301,,126.5,,1487513.85
2025/03/01,2025/03/01,SF FuneralFDC00000007W2J250301,,126.5,,1487640.35
2025/03/01,2025/03/01,SF FuneralF795726       250301,,126.5,,1487766.85
2025/03/01,2025/03/01,SF FuneralFDC00000007YVX250301,,126.5,,1487893.35
2025/03/01,2025/03/01,SF FuneralFDC000000084J1250301,,126.5,,1488019.85
2025/03/01,2025/03/01,SF FuneralF798376       250301,,126.5,,1488146.35
2025/03/01,2025/03/01,SF FuneralFDC000000084TC250301,,126.5,,1488272.85
2025/03/01,2025/03/01,SF FuneralF799649       250301,,126.5,,1488399.35
2025/03/01,2025/03/01,SF FuneralF800022       250301,,126.5,,1488525.85
2025/03/01,2025/03/01,SF FuneralF800410       250301,,126.5,,1488652.35
2025/03/01,2025/03/01,SF FuneralFDC00000008GXD250301,,126.5,,1488778.85
2025/03/01,2025/03/01,SF FuneralF803205       250301,,126.5,,1488905.35
2025/03/01,2025/03/01,SF FuneralFDC00000008MYH250301,,126.5,,1489031.85
2025/03/01,2025/03/01,SF FuneralF804181       250301,,126.5,,1489158.35
2025/03/01,2025/03/01,SF FuneralF820568       250301,,126.5,,1489284.85
2025/03/01,2025/03/01,SF FuneralF829794       250301,,126.5,,1489411.35
2025/03/01,2025/03/01,SF FuneralF829799       250301,,126.5,,1489537.85
2025/03/01,2025/03/01,SF FuneralF830203       250301,,126.5,,1489664.35
2025/03/01,2025/03/01,SF FuneralF842254       250301,,126.5,,1489790.85
2025/03/01,2025/03/01,SF FuneralF1052090      250302,,126.5,,1489917.35
2025/03/01,2025/03/01,SF FuneralF1065804      250301,,126.5,,1490043.85
2025/03/01,2025/03/01,SF FuneralF1114423      250301,,63.25,,1490107.1
2025/03/01,2025/02/28,Rev SF FuneralFDC0000000PK90250228,,-126.5,,1489980.6
2025/03/01,2025/01/24,Rev SF FuneralF1080259      250127,,-126.5,,1489854.1
2025/03/01,2025/02/25,Rev SF FuneralF1111658      250225,,-63.25,,1489790.85
2025/03/01,2025/01/24,Rev SF FuneralF1113303      250127,,-126.5,,1489664.35
2025/03/01,2025/02/25,SF FuneralF1129262      250225,,126.5,,1489790.85
2025/03/01,2025/02/27,SF FuneralFDC000000085LB250227,,126.5,,1489917.35
2025/03/01,2025/02/27,SF FuneralF802338       250227,,126.5,,1490043.85
2025/03/01,2025/02/28,SF FuneralFDC0000000DZLN250228,,126.5,,1490170.35
2025/03/01,2025/02/28,SF FuneralFDC0000000NL44250228,,126.5,,1490296.85
2025/03/01,2025/03/01,SF FuneralF1073223      250301,,126.5,,1490423.35
2025/03/01,2025/03/01,Fee-Teller Transactions,,-19.83,,1490403.52
2025/03/01,2025/03/01,Dep-Cash-5512155847089,,383,19.83,1490786.52
2025/03/01,2025/02/28,Rev SF FuneralFDC00000006BWQ250228,,-126.5,,1490660.02
2025/03/01,2025/02/27,Rev SF FuneralFDC0000000NJPF250227,,-126.5,,1490533.52
2025/03/01,2025/01/28,Rev SF FuneralFDC0000000JM3K250128,,-126.5,,1490407.02
2025/03/01,2025/02/28,Rev SF FuneralFDC0000000JM3K250228,,-126.5,,1490280.52
2025/03/01,2025/01/24,Rev SF FuneralFDC00000006ZRR250128,,-126.5,,1490154.02
2025/03/01,2025/01/24,Rev SF FuneralF1117241      250128,,-126.5,,1490027.52
2025/03/01,2025/02/28,Rev SF FuneralFDC0000000JW31250228,,-126.5,,1489901.02
2025/03/01,2025/02/28,Rev SF FuneralFDC00000008PQ1250228,,-126.5,,1489774.52
2025/03/01,2025/02/28,Rev SF FuneralFDC00000007DTN250228,,-126.5,,1489648.02
2025/03/01,2025/02/28,Rev SF FuneralFDC00000007DTV250228,,-126.5,,1489521.52
2025/03/01,2025/02/28,Rev SF FuneralFDC0000000N3SL250228,,-126.5,,1489395.02
2025/03/01,2025/02/28,Rev SF FuneralFDC000000075FY250228,,-126.5,,1489268.52
2025/03/01,2025/02/28,Rev SF FuneralFDC00000009DDC250228,,-126.5,,1489142.02
2025/03/01,2025/02/28,Rev SF FuneralFDC0000000NJS8250228,,-126.5,,1489015.52
2025/03/01,2025/02/28,Rev SF FuneralFDC00000005W9N250228,,-220,,1488795.52
2025/03/01,2025/02/28,Rev SF FuneralFDC00000006BTS250228,,-126.5,,1488669.02
2025/03/01,2025/02/28,Rev SF FuneralFDC00000005WSD250228,,-220,,1488449.02
2025/03/01,2025/02/28,Rev SF FuneralFDC000000067KY250228,,-126.5,,1488322.52
2025/03/01,2025/02/28,Rev SF FuneralFDC000000067LH250228,,-126.5,,1488196.02
2025/03/01,2025/02/28,Rev SF FuneralFDC00000006JS2250228,,-126.5,,1488069.52
2025/03/01,2025/02/28,Rev SF FuneralFDC0000000GTPK250228,,-126.5,,1487943.02
2025/03/01,2025/02/28,Rev SF FuneralFDC0000000CF61250228,,-126.5,,1487816.52
2025/03/01,2025/03/01,Rev SF FuneralFDC0000000PLXB250301,,-126.5,,1487690.02
2025/03/01,2025/03/01,Rev SF FuneralFDC0000000867Q250301,,-126.5,,1487563.52
2025/03/01,2025/03/01,Rev SF FuneralFDC0000000JF13250301,,-126.5,,1487437.02
2025/03/01,2025/02/27,Rev SF FuneralFDC0000000NK23250227,,-126.5,,1487310.52
2025/03/01,2025/02/27,Rev SF FuneralFDC000000073MG250227,,-126.5,,1487184.02
2025/03/01,2025/02/27,Rev SF FuneralFDC000000066QG250227,,-126.5,,1487057.52
2025/03/01,2025/02/27,Rev SF FuneralFDC0000000H3SM250227,,-126.5,,1486931.02
2025/03/01,2025/02/27,Rev SF FuneralFDC0000000NKHH250227,,-126.5,,1486804.52
2025/03/01,2025/02/27,Rev SF FuneralFDC00000006GJ5250227,,-126.5,,1486678.02
2025/03/01,2025/02/01,Rev SF FuneralFDC0000000PLXB250201,,-126.5,,1486551.52
2025/03/01,2025/02/20,Rev SF FuneralFDC00000007CVM250220,,-126.5,,1486425.02
2025/03/01,2025/02/21,Rev SF FuneralFDC00000003LK0250221,,-220,,1486205.02
2025/03/01,2025/02/22,Rev SF FuneralFDC00000007813250222,,-126.5,,1486078.52
2025/03/01,2025/02/22,Rev SF FuneralFDC0000000678S250222,,-126.5,,1485952.02
2025/03/01,2025/02/24,Rev SF FuneralFDC0000000640K250224,,-126.5,,1485825.52
2025/03/01,2025/02/22,Rev SF FuneralFDC0000000678T250222,,-126.5,,1485699.02
2025/03/01,2025/02/22,Rev SF FuneralFDC0000000NB6T250222,,-126.5,,1485572.52
2025/03/01,2025/02/24,Rev SF FuneralFDC0000000MK0D250224,,-126.5,,1485446.02
2025/03/01,2025/02/22,Rev SF FuneralFDC0000000LH7P250222,,-126.5,,1485319.52
2025/03/01,2025/02/22,Rev SF FuneralFDC0000000P47W250223,,-126.5,,1485193.02
2025/03/01,2025/02/24,Rev SF FuneralFDC0000000N4K7250224,,-126.5,,1485066.52
2025/03/01,2025/02/25,Rev SF FuneralFDC0000000PSD7250225,,-126.5,,1484940.02
2025/03/01,2025/02/25,Rev SF FuneralFDC0000000Q3YJ250225,,-126.5,,1484813.52
2025/03/01,2025/02/25,Rev SF FuneralFDC00000007Q5P250225,,-126.5,,1484687.02
2025/03/01,2025/02/25,Rev SF FuneralFDC0000000NPJ3250225,,-126.5,,1484560.52
2025/03/01,2025/02/25,Rev SF FuneralFDC00000009CP1250225,,-95.75,,1484464.77
2025/03/01,2025/02/25,Rev SF FuneralFDC00000007FJ6250225,,-126.5,,1484338.27
2025/03/01,2025/02/25,Rev SF FuneralFDC0000000FQV0250225,,-63.25,,1484275.02
2025/03/01,2025/02/25,Rev SF FuneralFDC0000000Q5R7250225,,-126.5,,1484148.52
2025/03/01,2025/02/26,Rev SF FuneralFDC0000000LSVT250226,,-126.5,,1484022.02
2025/03/01,2025/02/26,Rev SF FuneralFDC00000009TNH250226,,-126.5,,1483895.52
2025/03/01,2025/02/22,SF FuneralFDC00000007H25250222,,126.5,,1484022.02
2025/03/01,2025/02/24,SF FuneralF833060       250224,,126.5,,1484148.52
2025/03/01,2025/02/24,SF FuneralF1128062      250224,,31.63,,1484180.15
2025/03/01,2025/02/25,SF FuneralFDC00000007GVV250225,,63.25,,1484243.4
2025/03/01,2025/02/28,SF FuneralF831829       250228,,126.5,,1484369.9
2025/03/01,2025/02/28,SF FuneralF832874       250228,,126.5,,1484496.4
2025/03/01,2025/02/28,SF FuneralF1050845      250228,,126.5,,1484622.9
2025/03/01,2025/03/01,SF FuneralFDC00000007R6W250301,,126.5,,1484749.4
2025/03/01,2025/03/01,SF FuneralF793750       250301,,220,,1484969.4
2025/03/01,2025/02/25,SF FuneralF833890       250225,,31.63,,1485001.03
2025/03/01,2025/02/26,SF FuneralF844044       250226,,31.63,,1485032.66
2025/03/01,2025/02/28,SF FuneralFDC0000000HXHK250228,,47.88,,1485080.54
2025/03/01,2025/02/25,SF FuneralF833072       250225,,31.63,,1485112.17
2025/03/01,2025/02/28,SF FuneralFDC00000008NYM250228,,31.63,,1485143.8
2025/03/01,2025/02/28,SF FuneralF988469       250301,,126.5,,1485270.3
2025/03/01,2025/02/28,SF FuneralF1110444      250228,,31.63,,1485301.93
2025/03/01,2025/02/22,SF FuneralFDC000000089HJ250222,,126.5,,1485428.43
2025/03/01,2025/02/25,SF FuneralFDC000000073JW250225,,126.5,,1485554.93
2025/03/01,2025/02/28,SF FuneralFDC00000006DNK250228,,126.5,,1485681.43
2025/03/01,2025/02/28,SF FuneralF804061       250228,,126.5,,1485807.93
2025/03/01,2025/02/28,SF FuneralF810075       250228,,126.5,,1485934.43
2025/03/01,2025/02/28,SF FuneralF821915       250228,,126.5,,1486060.93
2025/03/01,2025/03/01,SF FuneralFDC00000006FH1250301,,126.5,,1486187.43
2025/03/01,2025/03/01,SF FuneralFDC000000076KT250301,,126.5,,1486313.93
2025/03/01,2025/03/01,SF FuneralFDC00000007J7X250301,,126.5,,1486440.43
2025/03/01,2025/03/01,SF FuneralF812641       250301,,126.5,,1486566.93
2025/03/01,2025/03/01,SF FuneralF1079291      250301,,126.5,,1486693.43
2025/03/01,2025/03/01,SF FuneralFDC0000000LWV0250301,,126.5,,1486819.93
2025/03/01,2025/03/01,SF FuneralF1128036      250301,,126.5,,1486946.43
2025/03/01,2025/02/21,SF FuneralF987948       250222,,126.5,,1487072.93
2025/03/01,2025/02/22,SF FuneralFDC00000006XBM250222,,126.5,,1487199.43
2025/03/01,2025/02/22,SF FuneralF815051       250222,,126.5,,1487325.93
2025/03/01,2025/02/24,SF FuneralFDC00000006JQ8250223,,126.5,,1487452.43
2025/03/01,2025/02/24,SF FuneralFDC000000090G7250223,,126.5,,1487578.93
2025/03/01,2025/02/24,SF FuneralFDC0000000Q5N7250224,,126.5,,1487705.43
2025/03/01,2025/02/24,SF FuneralFDC0000000Q5N9250224,,126.5,,1487831.93
2025/03/01,2025/02/25,SF FuneralFDC00000007NZ9250225,,126.5,,1487958.43
2025/03/01,2025/02/25,SF FuneralFDC00000007VNT250225,,126.5,,1488084.93
2025/03/01,2025/02/25,SF FuneralF1115894      250225,,126.5,,1488211.43
2025/03/01,2025/02/25,SF FuneralF1131732      250225,,126.5,,1488337.93
2025/03/01,2025/02/26,SF FuneralF828047       250226,,126.5,,1488464.43
2025/03/01,2025/02/27,SF FuneralF782598       250227,,126.5,,1488590.93
2025/03/01,2025/02/27,SF FuneralF828100       250227,,126.5,,1488717.43
2025/03/01,2025/02/27,SF FuneralF1083829      250227,,126.5,,1488843.93
2025/03/01,2025/02/28,SF FuneralFDC00000005NPY250228,,126.5,,1488970.43
2025/03/01,2025/02/28,SF FuneralFDC000000067MS250228,,126.5,,1489096.93
2025/03/01,2025/02/28,SF FuneralFDC00000006LT6250228,,126.5,,1489223.43
2025/03/01,2025/02/28,SF FuneralF809003       250228,,126.5,,1489349.93
2025/03/01,2025/02/28,SF FuneralFDC00000009XG8250228,,126.5,,1489476.43
2025/03/01,2025/02/28,SF FuneralF820916       250228,,126.5,,1489602.93
2025/03/01,2025/02/28,SF FuneralF821696       250228,,126.5,,1489729.43
2025/03/01,2025/02/28,SF FuneralF834023       250228,,126.5,,1489855.93
2025/03/01,2025/02/28,SF FuneralF834140       250228,,126.5,,1489982.43
2025/03/01,2025/02/28,SF FuneralF989602       250301,,126.5,,1490108.93
2025/03/01,2025/02/28,SF FuneralF993362       250228,,126.5,,1490235.43
2025/03/01,2025/02/28,SF FuneralF784825       250228,,126.5,,1490361.93
2025/03/01,2025/02/28,SF FuneralF1083803      250228,,126.5,,1490488.43
2025/03/01,2025/02/28,SF FuneralF1117662      250228,,126.5,,1490614.93
2025/03/01,2025/02/28,SF FuneralF1129355      250228,,126.5,,1490741.43
2025/03/01,2025/03/01,SF FuneralFDC00000005H11250301,,126.5,,1490867.93
2025/03/01,2025/03/01,SF FuneralFDC00000005K5Y250301,,126.5,,1490994.43
2025/03/01,2025/03/01,SF FuneralFDC000000067GS250301,,126.5,,1491120.93
2025/03/01,2025/03/01,SF FuneralFDC00000007ZCB250301,,126.5,,1491247.43
2025/03/01,2025/03/01,SF FuneralF809426       250301,,126.5,,1491373.93
2025/03/01,2025/03/01,SF FuneralFDC000000094YH250301,,126.5,,1491500.43
2025/03/01,2025/03/01,SF FuneralF812188       250301,,126.5,,1491626.93
2025/03/01,2025/03/01,SF FuneralF812514       250301,,126.5,,1491753.43
2025/03/01,2025/03/01,SF FuneralF802812       250301,,126.5,,1491879.93
2025/03/01,2025/03/01,SF FuneralF828127       250301,,126.5,,1492006.43
2025/03/01,2025/03/01,SF FuneralF840900       250301,,126.5,,1492132.93
2025/03/01,2025/03/01,SF FuneralF842028       250301,,126.5,,1492259.43
2025/03/01,2025/03/01,SF FuneralF1054563      250301,,126.5,,1492385.93
2025/03/01,2025/03/01,SF FuneralF1068160      250302,,126.5,,1492512.43
2025/03/01,2025/03/01,SF FuneralFDC0000000L5VH250301,,126.5,,1492638.93
2025/03/01,2025/03/01,SF FuneralF1079654      250301,,126.5,,1492765.43
2025/03/01,2025/03/01,SF FuneralF1084022      250301,,126.5,,1492891.93
2025/03/01,2025/03/01,SF FuneralF1084343      250301,,126.5,,1493018.43
2025/03/01,2025/03/01,SF FuneralF1084555      250301,,126.5,,1493144.93
2025/03/01,2025/03/01,SF FuneralF1115008      250301,,126.5,,1493271.43
2025/03/01,2025/03/01,SF FuneralFDC0000000PYBQ250301,,126.5,,1493397.93
2025/03/01,2025/03/01,SF FuneralF1129418      250301,,126.5,,1493524.43
2025/03/01,2025/02/24,SF FuneralF847284       250222,,126.5,,1493650.93
2025/03/01,2025/02/25,SF FuneralF809985       250225,,126.5,,1493777.43
2025/03/01,2025/02/26,SF FuneralF992886       250226,,126.5,,1493903.93
2025/03/01,2025/02/26,SF FuneralF993059       250226,,126.5,,1494030.43
2025/03/01,2025/02/27,SF FuneralFDC000000032R9250227,,220,,1494250.43
2025/03/01,2025/02/27,SF FuneralFDC00000005D4R250227,,126.5,,1494376.93
2025/03/01,2025/02/27,SF FuneralFDC00000006BBY250227,,126.5,,1494503.43
2025/03/01,2025/02/27,SF FuneralFDC00000006BCQ250227,,126.5,,1494629.93
2025/03/01,2025/02/27,SF FuneralFDC00000007QY7250227,,126.5,,1494756.43
2025/03/01,2025/02/27,SF FuneralF802133       250227,,126.5,,1494882.93
2025/03/01,2025/02/27,SF FuneralF808391       250227,,126.5,,1495009.43
2025/03/01,2025/02/27,SF FuneralF812246       250227,,126.5,,1495135.93
2025/03/01,2025/02/27,SF FuneralF812976       250227,,126.5,,1495262.43
2025/03/01,2025/02/27,SF FuneralFDC0000000KZCY250227,,126.5,,1495388.93
2025/03/01,2025/02/27,SF FuneralFDC0000000L0CK250227,,126.5,,1495515.43
2025/03/01,2025/02/27,SF FuneralF1078478      250227,,126.5,,1495641.93
2025/03/01,2025/02/27,SF FuneralF1115151      250227,,126.5,,1495768.43
2025/03/01,2025/02/27,SF FuneralF1117621      250227,,126.5,,1495894.93
2025/03/01,2025/02/27,SF FuneralFDC0000000NZGJ250227,,126.5,,1496021.43
2025/03/01,2025/02/27,SF FuneralFDC0000000PBPL250227,,126.5,,1496147.93
2025/03/01,2025/02/28,SF FuneralFDC000000039M8250228,,220,,1496367.93
2025/03/01,2025/02/28,SF FuneralFDC00000006HDR250228,,126.5,,1496494.43
2025/03/01,2025/02/28,SF FuneralFDC00000006HKH250228,,126.5,,1496620.93
2025/03/01,2025/02/28,SF FuneralFDC00000006Z5Y250228,,126.5,,1496747.43
2025/03/01,2025/02/28,SF FuneralFDC00000007VBG250228,,126.5,,1496873.93
2025/03/01,2025/02/28,SF FuneralF805791       250228,,126.5,,1497000.43
2025/03/01,2025/02/28,SF FuneralF813821       250228,,126.5,,1497126.93
2025/03/01,2025/02/28,SF FuneralF828840       250228,,126.5,,1497253.43
2025/03/01,2025/02/28,SF FuneralFDC0000000GFB9250228,,126.5,,1497379.93
2025/03/01,2025/02/28,SF FuneralF1068288      250228,,126.5,,1497506.43
2025/03/01,2025/02/28,SF FuneralF1110320      250228,,126.5,,1497632.93
2025/03/01,2025/02/28,SF FuneralF1116800      250228,,126.5,,1497759.43
2025/03/01,2025/02/28,SF FuneralF1119054      250228,,126.5,,1497885.93
2025/03/01,2025/02/28,SF FuneralF1127104      250228,,126.5,,1498012.43
2025/03/01,2025/02/28,SF FuneralFDC0000000Q5M5250228,,126.5,,1498138.93
2025/03/01,2025/03/01,SF FuneralFDC0000000687D250301,,126.5,,1498265.43
2025/03/01,2025/03/01,SF FuneralFDC00000006CG1250301,,126.5,,1498391.93
2025/03/01,2025/03/01,SF FuneralF805072       250301,,126.5,,1498518.43
2025/03/01,2025/03/01,SF FuneralF813588       250301,,126.5,,1498644.93
2025/03/01,2025/03/01,SF FuneralF1129416      250301,,126.5,,1498771.43
2025/03/01,2025/02/27,SF FuneralF812363       250227,,126.5,,1498897.93
2025/03/01,2025/02/27,SF FuneralF814286       250227,,126.5,,1499024.43
2025/03/01,2025/02/27,SF FuneralF1127897      250227,,126.5,,1499150.93
2025/03/01,2025/02/26,SF FuneralF981315       250226,,126.5,,1499277.43
2025/03/01,2025/02/22,SF FuneralF991686       250222,,126.5,,1499403.93
2025/03/01,2025/02/25,SF FuneralFDC0000000788B250225,,31.63,,1499435.56
2025/03/01,2025/03/01,SF FuneralF1075268      250302,,126.5,,1499562.06
2025/03/01,2025/03/01,SF FuneralF1085128      250301,,126.5,,1499688.56
2025/03/01,2025/02/28,SF FuneralFDC00000006NJC250228,,126.5,,1499815.06
2025/03/01,2025/02/28,SF FuneralFDC00000008SRR250228,,126.5,,1499941.56
2025/03/01,2025/02/28,SF FuneralFDC00000009WXL250228,,126.5,,1500068.06
2025/03/01,2025/02/24,SF FuneralF900666       250224,,126.5,,1500194.56
2025/03/01,2025/02/25,SF FuneralFDC0000000JV80250225,,126.5,,1500321.06
2025/03/01,2025/02/25,SF FuneralF1021366      250225,,126.5,,1500447.56
2025/03/01,2025/02/25,SF FuneralF1060329      250225,,126.5,,1500574.06
2025/03/01,2025/02/25,SF FuneralF1104066      250225,,126.5,,1500700.56
2025/03/01,2025/02/25,SF FuneralF1122750      250225,,31.63,,1500732.19
2025/03/01,2025/02/28,SF FuneralFDC00000006DKR250228,,126.5,,1500858.69
2025/03/01,2025/02/28,SF FuneralFDC000000082KC250228,,126.5,,1500985.19
2025/03/01,2025/02/28,SF FuneralFDC00000008C1M250228,,126.5,,1501111.69
2025/03/01,2025/01/02,Rev SF FuneralFDC00000006R1Y250101,,-126.5,,1500985.19
2025/03/01,2025/02/01,Rev SF FuneralFDC00000006R1Y250201,,-126.5,,1500858.69
2025/03/01,2025/02/26,Rev SF FuneralFDC0000000JFXT250226,,-126.5,,1500732.19
2025/03/01,2025/02/21,Rev SF FuneralFDC000000075L7250221,,-63.25,,1500668.94
2025/03/01,2025/02/24,Rev SF FuneralFDC00000006LCM250224,,-126.5,,1500542.44
2025/03/01,2025/02/24,Rev SF FuneralFDC000000090G7250223,,-126.5,,1500415.94
2025/03/01,2025/02/28,Rev SF FuneralFDC0000000NPT2250228,,-126.5,,1500289.44
2025/03/01,2025/02/28,Rev SF FuneralFDC0000000LVNH250228,,-126.5,,1500162.94
2025/03/01,2025/02/27,Rev SF FuneralFDC0000000NZGJ250227,,-126.5,,1500036.44
2025/03/01,2025/02/27,Rev SF FuneralFDC00000006BBY250227,,-126.5,,1499909.94
2025/03/01,2025/02/25,Rev SF FuneralFDC00000007NTY250225,,-126.5,,1499783.44
2025/03/01,2025/02/27,Rev SF FuneralFDC00000006BCQ250227,,-126.5,,1499656.94
2025/03/01,2025/02/28,Rev SF FuneralFDC0000000GFB9250228,,-126.5,,1499530.44
2025/03/01,2025/02/24,Rev SF FuneralFDC00000008JYB250224,,-63.25,,1499467.19
2025/03/01,2025/02/27,Rev SF FuneralFDC00000005GBC250227,,-126.5,,1499340.69
2025/03/01,2025/02/24,Rev SF FuneralFDC00000008JY9250224,,-63.25,,1499277.44
2025/03/01,2025/03/01,Rev SF FuneralFDC000000075JH250301,,-126.5,,1499150.94
2025/03/01,2025/02/24,Rev SF FuneralFDC0000000JNDN250224,,-126.5,,1499024.44
2025/03/01,2025/02/28,Rev SF FuneralFDC000000077WS250228,,-126.5,,1498897.94
2025/03/01,2025/02/28,Rev SF FuneralFDC00000007RZ3250228,,-126.5,,1498771.44
2025/03/01,2025/02/28,Rev SF FuneralFDC0000000KW31250228,,-126.5,,1498644.94
2025/03/01,2025/02/28,Rev SF FuneralFDC00000006HKH250228,,-126.5,,1498518.44
2025/03/01,2025/02/24,Rev SF FuneralFDC0000000N7NV250224,,-126.5,,1498391.94
2025/03/01,2025/02/24,SF FuneralFDC00000005XG9250224,,31.63,,1498423.57
2025/03/01,2025/02/24,SF FuneralF817754       250223,,126.5,,1498550.07
2025/03/01,2025/02/25,SF FuneralF1079715      250225,,126.5,,1498676.57
2025/03/01,2025/02/25,SF FuneralF1130845      250225,,126.5,,1498803.07
2025/03/01,2025/02/26,SF FuneralF992445       250226,,126.5,,1498929.57
2025/03/01,2025/02/27,SF FuneralF809362       250227,,126.5,,1499056.07
2025/03/01,2025/02/27,SF FuneralF1120827      250227,,126.5,,1499182.57
2025/03/01,2025/02/28,SF FuneralFDC000000064F4250228,,126.5,,1499309.07
2025/03/01,2025/02/28,SF FuneralF1104243      250228,,31.63,,1499340.7
2025/03/01,2025/02/28,SF FuneralF1125665      250228,,126.5,,1499467.2
2025/03/01,2025/02/28,SF FuneralF1132541      250228,,126.5,,1499593.7
2025/03/01,2025/03/01,SF FuneralFDC000000073CX250301,,126.5,,1499720.2
2025/03/01,2025/03/01,SF FuneralFDC0000000768W250301,,126.5,,1499846.7
2025/03/01,2025/03/01,SF FuneralF810774       250301,,126.5,,1499973.2
2025/03/01,2025/02/20,SF FuneralFDC00000005R3Q250220,,126.5,,1500099.7
2025/03/01,2025/02/22,SF FuneralFDC00000005Y9L250222,,126.5,,1500226.2
2025/03/01,2025/02/22,SF FuneralFDC00000006WY3250222,,126.5,,1500352.7
2025/03/01,2025/02/22,SF FuneralFDC00000008G22250222,,126.5,,1500479.2
2025/03/01,2025/02/24,SF FuneralFDC00000007ZFY250224,,126.5,,1500605.7
2025/03/01,2025/02/24,SF FuneralF1055287      250224,,126.5,,1500732.2
2025/03/01,2025/02/25,SF FuneralFDC00000007NMX250225,,126.5,,1500858.7
2025/03/01,2025/02/25,SF FuneralFDC00000007R7R250225,,126.5,,1500985.2
2025/03/01,2025/02/25,SF FuneralFDC00000007V9V250225,,126.5,,1501111.7
2025/03/01,2025/02/25,SF FuneralF795306       250225,,126.5,,1501238.2
2025/03/01,2025/02/25,SF FuneralF833760       250225,,126.5,,1501364.7
2025/03/01,2025/02/25,SF FuneralF987697       250225,,126.5,,1501491.2
2025/03/01,2025/02/25,SF FuneralF901011       250225,,126.5,,1501617.7
2025/03/01,2025/02/25,SF FuneralF1103971      250225,,126.5,,1501744.2
2025/03/01,2025/02/27,SF FuneralF813927       250227,,126.5,,1501870.7
2025/03/01,2025/02/27,SF FuneralF823716       250227,,126.5,,1501997.2
2025/03/01,2025/02/28,SF FuneralFDC00000002XBX250228,,220,,1502217.2
2025/03/01,2025/02/28,SF FuneralFDC000000087LX250228,,126.5,,1502343.7
2025/03/01,2025/02/28,SF FuneralF809330       250228,,126.5,,1502470.2
2025/03/01,2025/02/28,SF FuneralF813220       250228,,126.5,,1502596.7
2025/03/01,2025/02/28,SF FuneralF817492       250228,,126.5,,1502723.2
2025/03/01,2025/02/28,SF FuneralF817999       250228,,126.5,,1502849.7
2025/03/01,2025/02/28,SF FuneralF834145       250228,,126.5,,1502976.2
2025/03/01,2025/02/28,SF FuneralF900562       250228,,126.5,,1503102.7
2025/03/01,2025/02/28,SF FuneralF986843       250301,,126.5,,1503229.2
2025/03/01,2025/02/28,SF FuneralFDC0000000PJKW250228,,126.5,,1503355.7
2025/03/01,2025/02/28,SF FuneralF1130273      250228,,126.5,,1503482.2
2025/03/01,2025/03/01,SF FuneralFDC000000033XY250301,,220,,1503702.2
2025/03/01,2025/03/01,SF FuneralFDC00000006DYM250301,,126.5,,1503828.7
2025/03/01,2025/03/01,SF FuneralF805194       250301,,126.5,,1503955.2
2025/03/01,2025/03/01,SF FuneralF810459       250301,,126.5,,1504081.7
2025/03/01,2025/03/01,SF FuneralF810607       250301,,126.5,,1504208.2
2025/03/01,2025/03/01,SF FuneralF834231       250301,,126.5,,1504334.7
2025/03/01,2025/03/01,SF FuneralF1021616      250301,,126.5,,1504461.2
2025/03/01,2025/03/01,SF FuneralF1060606      250301,,126.5,,1504587.7
2025/03/02,2025/02/22,SF FuneralFDC0000000NJ3J250222,,126.5,,1504714.2
2025/03/02,2025/02/28,SF FuneralFDC00000006LD5250228,,126.5,,1504840.7
2025/03/02,2025/02/28,SF FuneralFDC00000007Q48250228,,31.63,,1504872.33
2025/03/02,2025/02/28,SF FuneralF816250       250228,,126.5,,1504998.83
2025/03/02,2025/02/28,SF FuneralF1110461      250228,,126.5,,1505125.33
2025/03/02,2025/03/01,SF FuneralF1129150      250302,,126.5,,1505251.83
2025/03/02,2025/02/28,SF FuneralFDC0000000FQWF250228,,31.63,,1505283.46
2025/03/02,2025/02/28,SF FuneralFDC0000000LMH8250228,,31.63,,1505315.09
2025/03/02,2025/03/01,SF FuneralFDC0000000LNR4250302,,31.63,,1505346.72
2025/03/02,2025/02/28,SF FuneralFDC00000006Y27250228,,126.5,,1505473.22
2025/03/02,2025/02/28,SF FuneralFDC000000075FG250228,,126.5,,1505599.72
2025/03/02,2025/02/28,SF FuneralFDC000000075FH250228,,126.5,,1505726.22
2025/03/02,2025/02/28,SF FuneralFDC00000007BP4250228,,126.5,,1505852.72
2025/03/02,2025/02/28,SF FuneralFDC00000009W6K250228,,126.5,,1505979.22
2025/03/02,2025/02/28,SF FuneralF755332       250228,,191.5,,1506170.72
2025/03/02,2025/02/28,SF FuneralF821022       250228,,126.5,,1506297.22
2025/03/02,2025/02/28,SF FuneralF981614       250301,,126.5,,1506423.72
2025/03/02,2025/02/28,SF FuneralF776209       250301,,126.5,,1506550.22
2025/03/02,2025/02/28,SF FuneralFDC0000000PG58250228,,126.5,,1506676.72
2025/03/02,2025/03/01,SF FuneralFDC00000005SWG250301,,126.5,,1506803.22
2025/03/02,2025/03/01,SF FuneralFDC00000006TP2250301,,126.5,,1506929.72
2025/03/02,2025/03/01,SF FuneralFDC000000073XX250301,,126.5,,1507056.22
2025/03/02,2025/03/01,SF FuneralFDC000000078DB250301,,126.5,,1507182.72
2025/03/02,2025/03/01,SF FuneralF812100       250301,,126.5,,1507309.22
2025/03/02,2025/03/01,SF FuneralF828334       250301,,126.5,,1507435.72
2025/03/02,2025/03/01,SF FuneralF832304       250301,,126.5,,1507562.22
2025/03/02,2025/03/01,SF FuneralF1021945      250301,,126.5,,1507688.72
2025/03/02,2025/03/01,SF FuneralF1084694      250301,,126.5,,1507815.22
2025/03/02,2025/03/01,SF FuneralF987556       250301,,126.5,,1507941.72
2025/03/02,2025/03/01,SF FuneralFDC0000000MXXW250301,,126.5,,1508068.22
2025/03/02,2025/03/01,SF FuneralFDC0000000N3JN250301,,126.5,,1508194.72
2025/03/02,2025/03/01,SF FuneralFDC0000000NJRN250301,,126.5,,1508321.22
2025/03/02,2025/03/01,SF FuneralF1123390      250301,,126.5,,1508447.72
2025/03/02,2025/03/01,SF FuneralFDC0000000Q46D250301,,126.5,,1508574.22
2025/03/02,2025/02/27,SF FuneralFDC00000006D99250227,,126.5,,1508700.72
2025/03/02,2025/02/27,SF FuneralFDC0000000G072250227,,126.5,,1508827.22
2025/03/02,2025/02/27,SF FuneralFDC0000000L0CH250227,,126.5,,1508953.72
2025/03/02,2025/02/26,SF FuneralF992629       250226,,126.5,,1509080.22
2025/03/02,2025/02/28,SF FuneralF815700       250228,,126.5,,1509206.72
2025/03/02,2025/03/01,SF FuneralFDC00000007HBC250301,,126.5,,1509333.22
2025/03/02,2025/03/01,SF FuneralF1130989      250301,,126.5,,1509459.72
2025/03/02,2025/03/01,SF FuneralF1131592      250302,,126.5,,1509586.22
2025/03/02,2025/02/22,SF FuneralFDC0000000373S250222,,220,,1509806.22
2025/03/02,2025/02/22,SF FuneralF805585       250222,,126.5,,1509932.72
2025/03/02,2025/02/22,SF FuneralF833114       250222,,126.5,,1510059.22
2025/03/02,2025/02/24,SF FuneralFDC0000000NC8P250224,,126.5,,1510185.72
2025/03/02,2025/02/25,SF FuneralF1080210      250225,,126.5,,1510312.22
2025/03/02,2025/02/28,SF FuneralFDC0000000JV0H250228,,126.5,,1510438.72
2025/03/02,2025/02/28,SF FuneralF1115197      250228,,126.5,,1510565.22
2025/03/02,2025/02/28,SF FuneralF1117930      250228,,126.5,,1510691.72
2025/03/02,2025/02/27,SF FuneralF811986       250227,,126.5,,1510818.22
2025/03/02,2025/02/27,SF FuneralF1111363      250227,,126.5,,1510944.72
2025/03/02,2025/03/02,SF FuneralF833253       250302,,31.63,,1510976.35
2025/03/02,2025/02/22,SF FuneralFDC0000000LCSQ250222,,126.5,,1511102.85
2025/03/02,2025/02/22,SF FuneralFDC0000000LCSR250222,,126.5,,1511229.35
2025/03/02,2025/02/28,SF FuneralF1085037      250228,,126.5,,1511355.85
2025/03/02,2025/03/01,SF FuneralF1084483      250301,,126.5,,1511482.35
2025/03/02,2025/03/01,SF FuneralFDC000000050KP250301,,126.5,,1511608.85
2025/03/02,2025/02/26,SF FuneralF1132911      250226,,31.63,,1511640.48
2025/03/02,2025/02/25,SF FuneralFDC0000000N37K250225,,126.5,,1511766.98
2025/03/02,2025/03/01,SF FuneralFDC00000006M79250301,,126.5,,1511893.48
2025/03/02,2025/03/01,SF FuneralF821493       250301,,126.5,,1512019.98
2025/03/02,2025/03/01,SF FuneralF992293       250301,,126.5,,1512146.48
2025/03/02,2025/03/01,SF FuneralFDC0000000N95J250302,,256.5,,1512402.98
2025/03/02,2025/03/01,SF FuneralFDC0000000PL99250301,,126.5,,1512529.48
2025/03/02,2025/02/22,SF FuneralFDC0000000373R250222,,220,,1512749.48
2025/03/02,2025/02/22,SF FuneralFDC000000062BS250222,,126.5,,1512875.98
2025/03/02,2025/02/24,SF FuneralF827755       250223,,126.5,,1513002.48
2025/03/02,2025/02/28,SF FuneralF1113549      250228,,126.5,,1513128.98
2025/03/02,2025/02/28,SF FuneralF1126895      250228,,126.5,,1513255.48
2025/03/02,2025/02/28,SF FuneralF1127351      250228,,31.63,,1513287.11
2025/03/02,2025/02/21,SF FuneralFDC0000000K474250221,,126.5,,1513413.61
2025/03/02,2025/02/22,SF FuneralF840847       250222,,126.5,,1513540.11
2025/03/02,2025/02/27,SF FuneralF1021104      250227,,126.5,,1513666.61
2025/03/02,2025/02/28,SF FuneralFDC000000086V3250228,,126.5,,1513793.11
2025/03/02,2025/02/28,SF FuneralFDC00000008BHF250228,,126.5,,1513919.61
2025/03/02,2025/02/28,SF FuneralF987110       250301,,126.5,,1514046.11
2025/03/02,2025/03/01,SF FuneralFDC00000006748250301,,126.5,,1514172.61
2025/03/02,2025/03/01,SF FuneralF812681       250301,,126.5,,1514299.11
2025/03/02,2025/03/01,SF FuneralFDC0000000NCRN250301,,63.25,,1514362.36
2025/03/02,2025/02/28,SF FuneralF822891       250228,,126.5,,1514488.86
2025/03/02,2025/03/01,SF FuneralF1125812      250301,,126.5,,1514615.36
2025/03/02,2025/03/01,SF FuneralF1073786      250301,,126.5,,1514741.86
2025/03/02,2025/03/01,SF FuneralF1128987      250301,,126.5,,1514868.36
2025/03/03,2025/03/01,SF FuneralF1118450      250301,,126.5,,1514994.86
2025/03/03,2025/02/28,SF FuneralF831018       250228,,126.5,,1515121.36
2025/03/03,2025/02/28,SF FuneralF900949       250228,,126.5,,1515247.86
2025/03/03,2025/02/28,SF FuneralF1117907      250228,,126.5,,1515374.36
2025/03/03,2025/02/25,SF FuneralFDC00000008HK9250225,,126.5,,1515500.86
2025/03/03,2025/02/28,SF FuneralFDC00000005MMP250228,,126.5,,1515627.36
2025/03/03,2025/03/01,SF FuneralF840498       250301,,126.5,,1515753.86
2025/03/03,2025/03/03,SF FuneralFDC000000030LF250302,,220,,1515973.86
2025/03/03,2025/02/22,SF FuneralF1116032      250222,,126.5,,1516100.36
2025/03/03,2025/02/28,SF FuneralFDC00000007BKW250228,,126.5,,1516226.86
2025/03/03,2025/03/01,SF FuneralFDC00000006B9L250301,,126.5,,1516353.36
2025/03/03,2025/03/01,SF FuneralF810282       250301,,126.5,,1516479.86
2025/03/03,2025/03/01,SF FuneralFDC00000009G12250301,,126.5,,1516606.36
2025/03/03,2025/03/01,SF FuneralF821212       250301,,126.5,,1516732.86
2025/03/03,2025/03/01,SF FuneralF992675       250301,,126.5,,1516859.36
2025/03/03,2025/03/01,SF FuneralF1129066      250301,,126.5,,1516985.86
2025/03/03,2025/02/27,SF FuneralFDC0000000LJWS250227,,126.5,,1517112.36
2025/03/03,2025/02/28,SF FuneralF814048       250228,,126.5,,1517238.86
2025/03/03,2025/03/01,SF FuneralFDC00000007D4X250301,,126.5,,1517365.36
2025/03/03,2025/03/01,SF FuneralF1130605      250301,,126.5,,1517491.86
2025/03/03,2025/02/22,SF FuneralFDC000000056MX250222,,126.5,,1517618.36
2025/03/03,2025/02/24,SF FuneralFDC00000006YY9250224,,126.5,,1517744.86
2025/03/03,2025/03/01,SF FuneralF1067958      250301,,126.5,,1517871.36
2025/03/03,2025/02/24,SF FuneralFDC0000000756L250223,,31.63,,1517902.99
2025/03/03,2025/02/25,SF FuneralF841421       250225,,31.63,,1517934.62
2025/03/03,2025/02/27,SF FuneralF843570       250227,,31.63,,1517966.25
2025/03/03,2025/02/28,SF FuneralF1103821      250228,,31.63,,1517997.88
2025/03/03,2025/03/01,SF FuneralFDC00000007VYC250301,,126.5,,1518124.38
2025/03/03,2025/03/01,SF FuneralF1128172      250301,,126.5,,1518250.88
2025/03/03,2025/02/25,SF FuneralF1075037      250225,,126.5,,1518377.38
2025/03/03,2025/02/27,SF FuneralFDC00000003NT6250227,,220,,1518597.38
2025/03/03,2025/02/28,SF FuneralF1066005      250228,,126.5,,1518723.88
2025/03/03,2025/03/01,SF FuneralFDC00000005LZ0250301,,126.5,,1518850.38
2025/03/03,2025/03/01,SF FuneralFDC00000005LZC250301,,126.5,,1518976.88
2025/03/03,2025/03/01,SF FuneralFDC00000006KJF250301,,126.5,,1519103.38
2025/03/03,2025/03/01,SF FuneralFDC00000007XFK250301,,126.5,,1519229.88
2025/03/03,2025/03/01,SF FuneralF819181       250301,,126.5,,1519356.38
2025/03/03,2025/03/01,SF FuneralF1084546      250301,,126.5,,1519482.88
2025/03/03,2025/03/01,SF FuneralF1119778      250301,,126.5,,1519609.38
2025/03/03,2025/03/01,SF FuneralFDC0000000PXK2250301,,126.5,,1519735.88
2025/03/03,2025/03/01,SF FuneralF1129128      250301,,126.5,,1519862.38
2025/03/03,2025/02/25,SF FuneralF1125736      250225,,126.5,,1519988.88
2025/03/03,2025/02/26,SF FuneralF830959       250226,,126.5,,1520115.38
2025/03/03,2025/02/26,SF FuneralF990706       250226,,63.25,,1520178.63
2025/03/03,2025/02/26,SF FuneralF1017085      250226,,63.25,,1520241.88
2025/03/03,2025/02/26,SF FuneralFDC0000000M2N1250226,,63.25,,1520305.13
2025/03/03,2025/02/28,SF FuneralFDC000000068VL250228,,126.5,,1520431.63
2025/03/03,2025/02/28,SF FuneralFDC000000068VV250228,,126.5,,1520558.13
2025/03/03,2025/02/28,SF FuneralFDC000000068VZ250228,,126.5,,1520684.63
2025/03/03,2025/02/28,SF FuneralFDC00000006GQV250228,,126.5,,1520811.13
2025/03/03,2025/02/28,SF FuneralFDC00000006PSF250228,,31.63,,1520842.76
2025/03/03,2025/02/28,SF FuneralFDC000000073JG250228,,126.5,,1520969.26
2025/03/03,2025/02/28,SF FuneralF822267       250228,,31.63,,1521000.89
2025/03/03,2025/02/28,SF FuneralF981579       250228,,126.5,,1521127.39
2025/03/03,2025/02/28,SF FuneralFDC0000000L8B0250228,,31.63,,1521159.02
2025/03/03,2025/02/28,SF FuneralF1083877      250228,,126.5,,1521285.52
2025/03/03,2025/02/28,SF FuneralF1108943      250228,,126.5,,1521412.02
2025/03/03,2025/02/28,SF FuneralF1125978      250228,,126.5,,1521538.52
2025/03/03,2025/02/28,SF FuneralF1126874      250228,,31.63,,1521570.15
2025/03/03,2025/02/28,SF FuneralF1129393      250228,,126.5,,1521696.65
2025/03/03,2025/02/28,SF FuneralF1132255      250228,,31.63,,1521728.28
2025/03/03,2025/03/01,SF FuneralF811267       250301,,126.5,,1521854.78
2025/03/03,2025/02/22,SF FuneralF819400       250222,,126.5,,1521981.28
2025/03/03,2025/03/03,SF FuneralFDC00000007FPS250303,,31.63,,1522012.91
2025/03/03,2025/03/03,SF FuneralFDC000000088TJ250303,,191.5,,1522204.41
2025/03/03,2025/03/03,SF FuneralFDC000000089NB250302,,126.5,,1522330.91
2025/03/03,2025/03/03,SF FuneralF844600       250301,,126.5,,1522457.41
2025/03/03,2025/03/03,SF FuneralF1066274      250303,,31.63,,1522489.04
2025/03/03,2025/03/03,SF FuneralF1078604      250303,,126.5,,1522615.54
2025/03/03,2025/02/28,SF FuneralF819053       250228,,31.63,,1522647.17
2025/03/03,2025/03/03,SF FuneralF828566       250303,,31.63,,1522678.8
2025/03/03,2025/03/03,SF FuneralF988318       250303,,31.63,,1522710.43
2025/03/03,2025/03/03,SF FuneralF1124411      250303,,31.63,,1522742.06
2025/03/03,2025/03/03,SF FuneralF1132115      250303,,31.63,,1522773.69
2025/03/03,2025/02/28,SF FuneralFDC00000007WBL250228,,31.63,,1522805.32
2025/03/03,2025/02/28,SF FuneralFDC00000007WJL250228,,31.63,,1522836.95
2025/03/03,2025/02/28,SF FuneralF795812       250228,,31.63,,1522868.58
2025/03/03,2025/02/28,SF FuneralF1072884      250228,,31.63,,1522900.21
2025/03/03,2025/02/28,SF FuneralF1123008      250228,,31.63,,1522931.84
2025/03/03,2025/03/01,SF FuneralFDC00000006HHY250301,,31.63,,1522963.47
2025/03/03,2025/03/01,SF FuneralF1017512      250302,,31.63,,1522995.1
2025/03/03,2025/03/03,SF FuneralFDC00000005F1K250303,,31.63,,1523026.73
2025/03/03,2025/02/28,SF FuneralFDC0000000JFC4250228,,31.63,,1523058.36
2025/03/03,2025/03/01,SF FuneralFDC00000007G0S250301,,31.63,,1523089.99
2025/03/03,2025/03/01,SF FuneralF1060024      250301,,31.63,,1523121.62
2025/03/03,2025/03/03,SF FuneralFDC00000005NR4250303,,31.63,,1523153.25
2025/03/03,2025/03/03,SF FuneralFDC00000005NT1250303,,31.63,,1523184.88
2025/03/03,2025/02/27,SF FuneralF1108113      250227,,31.63,,1523216.51
2025/03/03,2025/02/28,SF FuneralF811119       250228,,31.63,,1523248.14
2025/03/03,2025/02/28,SF FuneralF813030       250228,,31.63,,1523279.77
2025/03/03,2025/02/28,SF FuneralF814303       250228,,31.63,,1523311.4
2025/03/03,2025/02/28,SF FuneralF843596       250228,,31.63,,1523343.03
2025/03/03,2025/02/28,SF FuneralF1111672      250228,,31.63,,1523374.66
2025/03/03,2025/02/28,SF FuneralF1115119      250228,,31.63,,1523406.29
2025/03/03,2025/03/03,SF FuneralFDC00000005XG9250303,,31.63,,1523437.92
2025/03/03,2025/03/03,SF FuneralF1129452      250303,,31.63,,1523469.55
2025/03/03,2025/02/28,SF FuneralFDC00000005GY1250228,,31.63,,1523501.18
2025/03/03,2025/02/28,SF FuneralFDC000000069RZ250228,,31.63,,1523532.81
2025/03/03,2025/02/28,SF FuneralF832777       250228,,31.63,,1523564.44
2025/03/03,2025/02/28,SF FuneralF844636       250228,,31.63,,1523596.07
2025/03/03,2025/03/03,SF FuneralFDC000000086PW250302,,31.63,,1523627.7
2025/03/03,2025/03/03,SF FuneralF830431       250303,,31.63,,1523659.33
2025/03/03,2025/03/03,SF FuneralF831617       250303,,31.63,,1523690.96
2025/03/03,2025/02/25,SF FuneralF1104197      250225,,31.63,,1523722.59
2025/03/03,2025/02/28,SF FuneralFDC00000005PXF250228,,31.63,,1523754.22
2025/03/03,2025/02/28,SF FuneralF817463       250228,,31.63,,1523785.85
2025/03/03,2025/02/28,SF FuneralF1033620      250228,,31.63,,1523817.48
2025/03/03,2025/02/28,SF FuneralF1104196      250228,,31.63,,1523849.11
2025/03/03,2025/02/28,SF FuneralF1122752      250228,,31.63,,1523880.74
2025/03/03,2025/02/28,SF FuneralF1123947      250228,,31.63,,1523912.37
2025/03/03,2025/02/28,SF FuneralFDC0000000Q7FQ250228,,31.63,,1523944
2025/03/03,2025/03/03,SF FuneralFDC00000007GS9250303,,31.63,,1523975.63
2025/03/03,2025/03/03,SF FuneralF801722       250303,,31.63,,1524007.26
2025/03/03,2025/03/03,SF FuneralF803226       250303,,31.63,,1524038.89
2025/03/03,2025/03/03,SF FuneralF810250       250303,,31.63,,1524070.52
2025/03/03,2025/03/03,SF FuneralFDC00000009958250303,,31.63,,1524102.15
2025/03/03,2025/03/03,SF FuneralF811324       250303,,112.88,,1524215.03
2025/03/03,2025/03/03,SF FuneralFDC00000009G6R250303,,31.63,,1524246.66
2025/03/03,2025/03/03,SF FuneralF820012       250303,,31.63,,1524278.29
2025/03/03,2025/03/03,SF FuneralF1118324      250303,,31.63,,1524309.92
2025/03/03,2025/02/27,SF FuneralF1085168      250227,,31.63,,1524341.55
2025/03/03,2025/03/03,SF FuneralF1117767      250303,,31.63,,1524373.18
2025/03/03,2025/02/28,SF FuneralFDC00000006R81250228,,31.63,,1524404.81
2025/03/03,2025/02/28,SF FuneralFDC0000000J2XM250302,,31.63,,1524436.44
2025/03/03,2025/02/28,SF FuneralFDC0000000K7CQ250228,,31.63,,1524468.07
2025/03/03,2025/02/28,SF FuneralFDC0000000KLCD250228,,31.63,,1524499.7
2025/03/03,2025/02/28,SF FuneralF1061613      250228,,31.63,,1524531.33
2025/03/03,2025/02/28,SF FuneralF1084400      250228,,31.63,,1524562.96
2025/03/03,2025/02/28,SF FuneralF1132194      250228,,31.63,,1524594.59
2025/03/03,2025/03/03,SF FuneralFDC0000000N7Y7250303,,31.63,,1524626.22
2025/03/03,2025/03/03,SF FuneralF1117412      250303,,31.63,,1524657.85
2025/03/03,2025/03/03,SF FuneralFDC0000000NPG9250303,,31.63,,1524689.48
2025/03/03,2025/03/03,SF FuneralFDC0000000PYVQ250303,,31.63,,1524721.11
2025/03/03,2025/03/03,SF FuneralF1129402      250303,,31.63,,1524752.74
2025/03/03,2025/02/28,SF FuneralFDC00000005QCT250228,,31.63,,1524784.37
2025/03/03,2025/02/28,SF FuneralFDC00000007MW5250228,,31.63,,1524816
2025/03/03,2025/02/28,SF FuneralFDC000000086Y9250228,,31.63,,1524847.63
2025/03/03,2025/02/28,SF FuneralF790399       250228,,47.88,,1524895.51
2025/03/03,2025/02/28,SF FuneralF815510       250228,,31.63,,1524927.14
2025/03/03,2025/02/28,SF FuneralF823750       250228,,31.63,,1524958.77
2025/03/03,2025/02/28,SF FuneralF829118       250228,,31.63,,1524990.4
2025/03/03,2025/02/28,SF FuneralF830931       250228,,31.63,,1525022.03
2025/03/03,2025/02/28,SF FuneralF986934       250228,,31.63,,1525053.66
2025/03/03,2025/02/28,SF FuneralF992752       250228,,31.63,,1525085.29
2025/03/03,2025/02/28,SF FuneralF993205       250228,,31.63,,1525116.92
2025/03/03,2025/02/28,SF FuneralF993478       250228,,31.63,,1525148.55
2025/03/03,2025/02/28,SF FuneralF1065649      250228,,31.63,,1525180.18
2025/03/03,2025/02/28,SF FuneralF1073030      250228,,31.63,,1525211.81
2025/03/03,2025/02/28,SF FuneralF1119753      250228,,31.63,,1525243.44
2025/03/03,2025/02/28,SF FuneralF1130369      250228,,31.63,,1525275.07
2025/03/03,2025/02/28,SF FuneralFDC0000000Q9Z0250228,,31.63,,1525306.7
2025/03/03,2025/02/28,SF FuneralF1132933      250228,,31.63,,1525338.33
2025/03/03,2025/03/03,SF FuneralFDC00000007BGG250302,,31.63,,1525369.96
2025/03/03,2025/03/03,SF FuneralF841615       250303,,31.63,,1525401.59
2025/03/03,2025/03/03,SF FuneralF841850       250303,,31.63,,1525433.22
2025/03/03,2025/03/03,SF FuneralF1017111      250303,,31.63,,1525464.85
2025/03/03,2025/02/28,SF FuneralF812708       250228,,126.5,,1525591.35
2025/03/03,2025/03/03,SF FuneralF1017480      250303,,126.5,,1525717.85
2025/03/03,2025/03/03,SF FuneralF1124342      250303,,126.5,,1525844.35
2025/03/03,2025/02/22,SF FuneralFDC00000005HF0250222,,126.5,,1525970.85
2025/03/03,2025/02/24,SF FuneralF816165       250223,,126.5,,1526097.35
2025/03/03,2025/02/28,SF FuneralFDC0000000HYW8250228,,63.25,,1526160.6
2025/03/03,2025/02/28,SF FuneralF1125433      250228,,126.5,,1526287.1
2025/03/03,2025/03/01,SF FuneralF1127848      250301,,126.5,,1526413.6
2025/03/03,2025/03/03,SF FuneralFDC00000008JTG250303,,63.25,,1526476.85
2025/03/03,2025/03/03,SF FuneralFDC00000008JXH250303,,63.25,,1526540.1
2025/03/03,2025/03/03,SF FuneralFDC00000008JYZ250303,,63.25,,1526603.35
2025/03/03,2025/03/03,SF FuneralFDC0000000F5ZS250302,,126.5,,1526729.85
2025/03/03,2025/02/22,SF FuneralF1120381      250222,,126.5,,1526856.35
2025/03/03,2025/02/28,SF FuneralF1126858      250228,,126.5,,1526982.85
2025/03/03,2025/03/01,SF FuneralFDC0000000JW08250301,,126.5,,1527109.35
2025/03/03,2025/03/01,SF FuneralF1132447      250301,,126.5,,1527235.85
2025/03/03,2025/03/03,SF FuneralF812315       250303,,63.25,,1527299.1
2025/03/03,2025/03/03,SF FuneralF843528       250301,,126.5,,1527425.6
2025/03/03,2025/03/03,SF FuneralF1020847      250303,,63.25,,1527488.85
2025/03/03,2025/03/03,SF FuneralF1084993      250303,,63.25,,1527552.1
2025/03/03,2025/03/03,SF FuneralF1118407      250303,,63.25,,1527615.35
2025/03/03,2025/02/27,SF FuneralFDC000000088KQ250227,,126.5,,1527741.85
2025/03/03,2025/03/03,SF FuneralFDC0000000GG6K250301,,126.5,,1527868.35
2025/03/03,2025/02/22,SF FuneralF986664       250222,,126.5,,1527994.85
2025/03/03,2025/02/25,SF FuneralFDC00000007NJH250225,,126.5,,1528121.35
2025/03/03,2025/02/28,SF FuneralF818080       250228,,126.5,,1528247.85
2025/03/03,2025/03/01,SF FuneralF1108560      250302,,126.5,,1528374.35
2025/03/03,2025/03/03,SF FuneralFDC00000007M2D250302,,63.25,,1528437.6
2025/03/03,2025/03/03,SF FuneralFDC00000007MVX250303,,126.5,,1528564.1
2025/03/03,2025/03/03,SF FuneralF843935       250303,,63.25,,1528627.35
2025/03/03,2025/02/24,SF FuneralFDC0000000KFK0250224,,126.5,,1528753.85
2025/03/03,2025/02/27,SF FuneralF802458       250227,,126.5,,1528880.35
2025/03/03,2025/02/27,SF FuneralF1075024      250227,,126.5,,1529006.85
2025/03/03,2025/02/28,SF FuneralFDC0000000KY2H250228,,63.25,,1529070.1
2025/03/03,2025/03/01,SF FuneralF1074580      250301,,63.25,,1529133.35
2025/03/03,2025/03/03,SF FuneralFDC00000003B4L250303,,220,,1529353.35
2025/03/03,2025/03/03,SF FuneralFDC00000005LZD250302,,126.5,,1529479.85
2025/03/03,2025/03/03,SF FuneralFDC00000005SZ4250303,,63.25,,1529543.1
2025/03/03,2025/03/03,SF FuneralFDC00000006PJZ250303,,126.5,,1529669.6
2025/03/03,2025/03/03,SF FuneralF1108797      250303,,63.25,,1529732.85
2025/03/03,2025/02/27,SF FuneralFDC00000007X43250227,,126.5,,1529859.35
2025/03/03,2025/02/27,SF FuneralF989879       250227,,126.5,,1529985.85
2025/03/03,2025/03/01,SF FuneralFDC00000005K0V250301,,126.5,,1530112.35
2025/03/03,2025/03/01,SF FuneralF812406       250301,,126.5,,1530238.85
2025/03/03,2025/03/03,SF FuneralFDC000000072B6250303,,63.25,,1530302.1
2025/03/03,2025/02/28,SF FuneralFDC00000005V4S250228,,31.63,,1530333.73
2025/03/03,2025/02/28,SF FuneralF815340       250228,,31.63,,1530365.36
2025/03/03,2025/02/28,SF FuneralF832185       250228,,31.63,,1530396.99
2025/03/03,2025/02/28,SF FuneralF774474       250228,,156.28,,1530553.27
2025/03/03,2025/02/28,SF FuneralF1068145      250228,,31.63,,1530584.9
2025/03/03,2025/02/28,SF FuneralFDC0000000NNGY250228,,31.63,,1530616.53
2025/03/03,2025/02/28,SF FuneralF1120399      250228,,31.63,,1530648.16
2025/03/03,2025/02/28,SF FuneralF1130338      250228,,31.63,,1530679.79
2025/03/03,2025/02/28,SF FuneralF1132265      250228,,31.63,,1530711.42
2025/03/03,2025/02/24,SF FuneralF1084574      250224,,126.5,,1530837.92
2025/03/03,2025/02/28,SF FuneralFDC000000067XG250228,,126.5,,1530964.42
2025/03/03,2025/02/28,SF FuneralF1114144      250228,,126.5,,1531090.92
2025/03/03,2025/03/01,SF FuneralF1078898      250301,,126.5,,1531217.42
2025/03/03,2025/03/01,SF FuneralF1110493      250301,,126.5,,1531343.92
2025/03/03,2025/03/03,SF FuneralFDC00000006VB7250302,,126.5,,1531470.42
2025/03/03,2025/02/28,SF FuneralFDC00000007G54250228,,31.63,,1531502.05
2025/03/03,2025/02/28,SF FuneralF821927       250228,,31.63,,1531533.68
2025/03/03,2025/02/28,SF FuneralF1123167      250228,,31.63,,1531565.31
2025/03/03,2025/03/03,SF FuneralFDC00000008KVS250302,,126.5,,1531691.81
2025/03/03,2025/03/03,SF FuneralF1060731      250303,,126.5,,1531818.31
2025/03/03,2025/03/03,SF FuneralFDC0000000KZ2C250303,,31.63,,1531849.94
2025/03/03,2025/03/03,SF FuneralF1125487      250303,,31.63,,1531881.57
2025/03/03,2025/03/03,SF FuneralF1126036      250303,,126.5,,1532008.07
2025/03/03,2025/02/27,SF FuneralF808876       250227,,126.5,,1532134.57
2025/03/03,2025/02/28,SF FuneralF989153       250301,,126.5,,1532261.07
2025/03/03,2025/03/01,SF FuneralFDC000000075VN250301,,126.5,,1532387.57
2025/03/03,2025/03/01,SF FuneralF1131790      250301,,126.5,,1532514.07
2025/03/03,2025/03/03,SF FuneralF1061948      250303,,126.5,,1532640.57
2025/03/03,2025/03/03,SF FuneralFDC0000000MR2H250303,,31.63,,1532672.2
2025/03/03,2025/03/03,SF FuneralF1113735      250303,,31.63,,1532703.83
2025/03/03,2025/02/26,SF FuneralF1075025      250226,,126.5,,1532830.33
2025/03/03,2025/02/28,SF FuneralFDC00000005TX1250228,,31.63,,1532861.96
2025/03/03,2025/02/28,SF FuneralFDC00000006NFW250228,,31.63,,1532893.59
2025/03/03,2025/02/28,SF FuneralF779346       250228,,31.63,,1532925.22
2025/03/03,2025/03/03,SF FuneralF1127801      250303,,31.63,,1532956.85
2025/03/03,2025/03/03,SF FuneralFDC000000089G2250302,,31.63,,1532988.48
2025/03/03,2025/03/03,SF FuneralF1113217      250303,,126.5,,1533114.98
2025/03/03,2025/02/22,SF FuneralFDC00000008SSP250222,,126.5,,1533241.48
2025/03/03,2025/02/28,SF FuneralFDC000000070CD250228,,31.63,,1533273.11
2025/03/03,2025/02/28,SF FuneralF814074       250228,,31.63,,1533304.74
2025/03/03,2025/02/28,SF FuneralF842737       250228,,31.63,,1533336.37
2025/03/03,2025/02/28,SF FuneralF1104255      250228,,31.63,,1533368
2025/03/03,2025/02/28,SF FuneralF1128672      250228,,31.63,,1533399.63
2025/03/03,2025/03/01,SF FuneralF1132211      250301,,126.5,,1533526.13
2025/03/03,2025/03/03,SF FuneralF1112136      250303,,31.63,,1533557.76
2025/03/03,2025/02/25,SF FuneralFDC00000006874250225,,126.5,,1533684.26
2025/03/03,2025/02/26,SF FuneralF987016       250226,,31.63,,1533715.89
2025/03/03,2025/02/28,SF FuneralFDC00000006KKK250228,,126.5,,1533842.39
2025/03/03,2025/03/01,SF FuneralF1066744      250301,,126.5,,1533968.89
2025/03/03,2025/03/03,SF FuneralFDC00000005H8J250302,,31.63,,1534000.52
2025/03/03,2025/02/26,Rev SF FuneralFDC00000007DMT250226,,-31.63,,1533968.89
2025/03/03,2025/02/28,Rev SF FuneralFDC00000007MW5250228,,-31.63,,1533937.26
2025/03/03,2025/02/28,Rev SF FuneralFDC0000000KLCD250228,,-31.63,,1533905.63
2025/03/03,2025/02/28,Rev SF FuneralFDC00000006RNF250228,,-126.5,,1533779.13
2025/03/03,2025/02/28,Rev SF FuneralFDC00000005WRL250228,,-220,,1533559.13
2025/03/03,2025/02/28,Rev SF FuneralFDC000000089KV250228,,-126.5,,1533432.63
2025/03/03,2025/02/28,Rev SF FuneralFDC00000007BP4250228,,-126.5,,1533306.13
2025/03/03,2025/02/28,Rev SF FuneralFDC0000000768V250228,,-126.5,,1533179.63
2025/03/03,2025/02/28,Rev SF FuneralFDC0000000PN8C250228,,-126.5,,1533053.13
2025/03/03,2025/02/28,Rev SF FuneralFDC00000006DNK250228,,-126.5,,1532926.63
2025/03/03,2025/03/01,Rev SF FuneralFDC00000006CG1250301,,-126.5,,1532800.13
2025/03/03,2025/03/01,Rev SF FuneralFDC0000000L5VH250301,,-126.5,,1532673.63
2025/03/03,2025/03/01,Rev SF FuneralFDC00000007HBC250301,,-126.5,,1532547.13
2025/03/03,2025/02/22,Rev SF FuneralFDC0000000373R250222,,-220,,1532327.13
2025/03/03,2025/02/22,Rev SF FuneralFDC00000007W65250222,,-126.5,,1532200.63
2025/03/03,2025/02/22,Rev SF FuneralFDC000000063V7250222,,-126.5,,1532074.13
2025/03/03,2025/02/22,Rev SF FuneralFDC00000005MT5250222,,-220,,1531854.13
2025/03/03,2025/02/24,Rev SF FuneralFDC00000006YY9250224,,-126.5,,1531727.63
2025/03/03,2025/02/19,Rev SF FuneralFDC0000000PW8D250219,,-126.5,,1531601.13
2025/03/03,2025/02/26,Rev SF FuneralFDC0000000P186250226,,-126.5,,1531474.63
2025/03/03,2025/02/27,Rev SF FuneralFDC00000004GM0250227,,-220,,1531254.63
2025/03/03,2025/02/25,Rev SF FuneralFDC00000006RB3250225,,-126.5,,1531128.13
2025/03/03,2025/02/25,Rev SF FuneralFDC000000064LG250225,,-126.5,,1531001.63
2025/03/03,2025/02/27,Rev SF FuneralFDC0000000L0CH250227,,-126.5,,1530875.13
2025/03/03,2025/02/27,Rev SF FuneralFDC0000000J8YF250227,,-126.5,,1530748.63
2025/03/03,2025/02/22,Rev SF FuneralFDC0000000373S250222,,-220,,1530528.63
2025/03/03,2025/02/22,Rev SF FuneralFDC00000006WY3250222,,-126.5,,1530402.13
2025/03/03,2025/02/22,Rev SF FuneralFDC00000007N1T250222,,-126.5,,1530275.63
2025/03/03,2025/02/22,Rev SF FuneralFDC00000007JT0250222,,-126.5,,1530149.13
2025/03/03,2025/02/01,Rev SF FuneralFDC0000000L5VH250201,,-126.5,,1530022.63
2025/03/03,2025/02/24,Rev SF FuneralFDC0000000NC8P250224,,-126.5,,1529896.13
2025/03/03,2025/02/25,Rev SF FuneralFDC00000007VNT250225,,-126.5,,1529769.63
2025/03/03,2025/02/25,Rev SF FuneralFDC0000000PRPN250225,,-126.5,,1529643.13
2025/03/03,2025/02/27,Rev SF FuneralFDC0000000G072250227,,-126.5,,1529516.63
2025/03/03,2025/02/27,Rev SF FuneralFDC0000000LDRG250227,,-126.5,,1529390.13
2025/03/03,2025/02/27,Rev SF FuneralFDC0000000L0CK250227,,-126.5,,1529263.63
2025/03/03,2025/02/27,Rev SF FuneralFDC00000006D99250227,,-126.5,,1529137.13
2025/03/03,2025/02/26,Rev SF FuneralFDC0000000774H250226,,-126.5,,1529010.63
2025/03/03,2025/02/28,Rev SF FuneralFDC000000075FG250228,,-126.5,,1528884.13
2025/03/03,2025/02/28,Rev SF FuneralFDC000000075FH250228,,-126.5,,1528757.63
2025/03/03,2025/02/28,Rev SF FuneralFDC00000009HWN250228,,-126.5,,1528631.13
2025/03/03,2025/02/28,Rev SF FuneralFDC000000086V3250228,,-126.5,,1528504.63
2025/03/03,2025/02/28,Rev SF FuneralFDC00000005SHB250228,,-126.5,,1528378.13
2025/03/03,2025/02/28,Rev SF FuneralFDC00000008BHF250228,,-126.5,,1528251.63
2025/03/03,2025/03/01,Rev SF FuneralFDC0000000NCRN250301,,-63.25,,1528188.38
2025/03/03,2025/03/01,Rev SF FuneralFDC00000005LZ0250301,,-126.5,,1528061.88
2025/03/03,2025/03/01,Rev SF FuneralFDC00000005LZC250301,,-126.5,,1527935.38
2025/03/03,2025/03/01,Rev SF FuneralFDC00000007DMS250301,,-126.5,,1527808.88
2025/03/03,2025/03/01,Rev SF FuneralFDC0000000LNR4250302,,-31.63,,1527777.25
2025/03/03,2025/03/01,Rev SF FuneralFDC0000000KH3D250302,,-31.63,,1527745.62
2025/03/03,2025/02/28,Rev SF FuneralFDC00000008NYM250228,,-31.63,,1527713.99
2025/03/03,2025/02/28,Rev SF FuneralFDC00000007TC1250228,,-31.63,,1527682.36
2025/03/03,2024/12/31,Rev SF FuneralFDC0000000L5VH250101,,-126.5,,1527555.86
2025/03/03,2025/02/24,Rev SF FuneralFDC00000005XG9250224,,-31.63,,1527524.23
2025/03/03,2025/02/24,Rev SF FuneralFDC000000069C5250224,,-31.63,,1527492.6
2025/03/03,2025/02/27,Rev SF FuneralFDC00000005P8B250227,,-31.63,,1527460.97
2025/03/03,2025/02/27,SF FuneralF993676       250227,,126.5,,1527587.47
2025/03/03,2025/02/28,SF FuneralF1127746      250228,,126.5,,1527713.97
2025/03/03,2025/02/28,SF FuneralF1130754      250228,,31.63,,1527745.6
2025/03/03,2025/03/01,SF FuneralFDC0000000B16T250301,,126.5,,1527872.1
2025/03/03,2025/03/01,SF FuneralF1114663      250301,,126.5,,1527998.6
2025/03/03,2025/03/01,SF FuneralFDC0000000P1G5250301,,126.5,,1528125.1
2025/03/03,2025/03/03,SF FuneralF816565       250303,,31.63,,1528156.73
2025/03/03,2025/02/22,SF FuneralFDC00000007984250222,,126.5,,1528283.23
2025/03/03,2025/02/22,SF FuneralF820957       250222,,126.5,,1528409.73
2025/03/03,2025/02/22,SF FuneralF992898       250222,,126.5,,1528536.23
2025/03/03,2025/02/22,SF FuneralF1061662      250222,,126.5,,1528662.73
2025/03/03,2025/02/22,SF FuneralFDC0000000L1SQ250222,,126.5,,1528789.23
2025/03/03,2025/02/22,SF FuneralF1113321      250222,,126.5,,1528915.73
2025/03/03,2025/02/24,SF FuneralFDC000000060CJ250223,,126.5,,1529042.23
2025/03/03,2025/02/25,SF FuneralFDC000000062H1250225,,126.5,,1529168.73
2025/03/03,2025/02/25,SF FuneralFDC000000063TD250225,,126.5,,1529295.23
2025/03/03,2025/02/25,SF FuneralFDC0000000738X250225,,63.25,,1529358.48
2025/03/03,2025/02/25,SF FuneralF1111516      250225,,63.25,,1529421.73
2025/03/03,2025/02/26,SF FuneralF843100       250226,,126.5,,1529548.23
2025/03/03,2025/02/26,SF FuneralF1061004      250226,,63.25,,1529611.48
2025/03/03,2025/02/27,SF FuneralF815968       250227,,126.5,,1529737.98
2025/03/03,2025/02/27,SF FuneralF1065732      250227,,126.5,,1529864.48
2025/03/03,2025/02/27,SF FuneralF1113191      250227,,126.5,,1529990.98
2025/03/03,2025/02/28,SF FuneralFDC00000006G6T250228,,191.5,,1530182.48
2025/03/03,2025/02/28,SF FuneralF798144       250228,,126.5,,1530308.98
2025/03/03,2025/02/28,SF FuneralF799854       250228,,126.5,,1530435.48
2025/03/03,2025/02/28,SF FuneralF809721       250228,,126.5,,1530561.98
2025/03/03,2025/02/28,SF FuneralF816413       250228,,126.5,,1530688.48
2025/03/03,2025/02/28,SF FuneralF833249       250228,,126.5,,1530814.98
2025/03/03,2025/02/28,SF FuneralF989084       250301,,126.5,,1530941.48
2025/03/03,2025/02/28,SF FuneralF1065771      250228,,126.5,,1531067.98
2025/03/03,2025/02/28,SF FuneralF1118332      250228,,63.25,,1531131.23
2025/03/03,2025/02/28,SF FuneralF1131039      250228,,63.25,,1531194.48
2025/03/03,2025/03/01,SF FuneralFDC000000087KM250301,,126.5,,1531320.98
2025/03/03,2025/03/01,SF FuneralF1052150      250301,,126.5,,1531447.48
2025/03/03,2025/03/01,SF FuneralF1066539      250301,,126.5,,1531573.98
2025/03/03,2025/03/01,SF FuneralF1079378      250302,,126.5,,1531700.48
2025/03/03,2025/03/01,SF FuneralF1109751      250301,,126.5,,1531826.98
2025/03/03,2025/03/03,SF FuneralF832549       250302,,126.5,,1531953.48
2025/03/03,2025/03/03,SF FuneralF842252       250303,,63.25,,1532016.73
2025/03/03,2025/03/03,SF FuneralF1123976      250303,,63.25,,1532079.98
2025/03/03,2025/02/28,Rev SF FuneralFDC00000006W33250228,,-126.5,,1531953.48
2025/03/03,2025/02/27,Rev SF FuneralFDC000000066HH250227,,-126.5,,1531826.98
2025/03/03,2025/02/27,Rev SF FuneralFDC000000066J1250227,,-126.5,,1531700.48
2025/03/03,2025/02/28,Rev SF FuneralFDC0000000DZLN250228,,-126.5,,1531573.98
2025/03/03,2025/02/22,Rev SF FuneralFDC00000006CW1250222,,-126.5,,1531447.48
2025/03/03,2025/02/22,Rev SF FuneralFDC00000006CWM250222,,-126.5,,1531320.98
2025/03/03,2025/02/22,Rev SF FuneralFDC00000006CZ4250222,,-126.5,,1531194.48
2025/03/03,2025/03/03,Fee-Teller Transactions,,-11.91,,1531182.57
2025/03/03,2025/03/03,Dep-Cash-SFTAP2023804554,,126.5,11.91,1531309.07
2025/03/03,2025/03/01,SF FuneralF815328       250301,,126.5,,1531435.57
2025/03/03,2025/02/22,SF FuneralF819761       250222,,126.5,,1531562.07
2025/03/03,2025/02/22,SF FuneralF1112011      250223,,126.5,,1531688.57
2025/03/03,2025/02/25,SF FuneralFDC00000007WG9250225,,191.5,,1531880.07
2025/03/03,2025/02/25,SF FuneralF812754       250225,,126.5,,1532006.57
2025/03/03,2025/02/27,SF FuneralFDC0000000FRBY250227,,126.5,,1532133.07
2025/03/03,2025/02/28,SF FuneralFDC00000006G66250228,,126.5,,1532259.57
2025/03/03,2025/02/28,SF FuneralFDC00000007PTH250228,,126.5,,1532386.07
2025/03/03,2025/02/28,SF FuneralF833505       250228,,126.5,,1532512.57
2025/03/03,2025/02/28,SF FuneralF1128243      250228,,126.5,,1532639.07
2025/03/03,2025/03/01,SF FuneralFDC00000002W28250301,,220,,1532859.07
2025/03/03,2025/03/01,SF FuneralFDC000000067FF250301,,126.5,,1532985.57
2025/03/03,2025/03/01,SF FuneralF798408       250301,,126.5,,1533112.07
2025/03/03,2025/03/01,SF FuneralF821659       250301,,126.5,,1533238.57
2025/03/03,2025/03/01,SF FuneralF1084757      250301,,126.5,,1533365.07
2025/03/03,2025/03/01,SF FuneralFDC0000000Q68R250302,,126.5,,1533491.57
2025/03/03,2025/03/03,SF FuneralF802331       250303,,31.63,,1533523.2
2025/03/03,2025/02/27,SF FuneralF1114481      250227,,126.5,,1533649.7
2025/03/03,2025/03/01,SF FuneralF1130062      250301,,126.5,,1533776.2
2025/03/03,2025/02/25,SF FuneralF1103868      250225,,126.5,,1533902.7
2025/03/03,2025/03/01,SF FuneralFDC00000003LFT250301,,220,,1534122.7
2025/03/03,2025/03/01,SF FuneralF1132917      250302,,31.63,,1534154.33
2025/03/03,2025/02/24,SF FuneralFDC0000000FGX6250222,,126.5,,1534280.83
2025/03/03,2025/02/26,SF FuneralF991933       250226,,126.5,,1534407.33
2025/03/03,2025/02/28,SF FuneralFDC00000005XC4250228,,220,,1534627.33
2025/03/03,2025/02/28,SF FuneralF843757       250228,,31.63,,1534658.96
2025/03/03,2025/02/28,SF FuneralF1079387      250228,,126.5,,1534785.46
2025/03/03,2025/02/28,SF FuneralF1127614      250228,,31.63,,1534817.09
2025/03/03,2025/03/01,SF FuneralF1079004      250302,,31.63,,1534848.72
2025/03/03,2025/02/26,SF FuneralF1123062      250226,,126.5,,1534975.22
2025/03/03,2025/02/28,SF FuneralFDC00000007G9J250228,,191.5,,1535166.72
2025/03/03,2025/02/28,SF FuneralFDC0000000NJ9V250228,,126.5,,1535293.22
2025/03/03,2025/02/28,SF FuneralF1128229      250228,,126.5,,1535419.72
2025/03/03,2025/03/01,SF FuneralF1114582      250301,,126.5,,1535546.22
2025/03/03,2025/03/01,SF FuneralFDC0000000NLXM250301,,126.5,,1535672.72
2025/03/03,2025/03/01,SF FuneralF1126008      250302,,126.5,,1535799.22
2025/03/03,2025/02/25,SF FuneralFDC000000072HJ250225,,126.5,,1535925.72
2025/03/03,2025/02/25,SF FuneralFDC000000072HR250225,,126.5,,1536052.22
2025/03/03,2025/03/01,SF FuneralF1022189      250301,,126.5,,1536178.72
2025/03/03,2025/03/01,SF FuneralF1065845      250301,,126.5,,1536305.22
2025/03/03,2025/02/27,SF FuneralF1083869      250227,,126.5,,1536431.72
2025/03/03,2025/02/28,SF FuneralF1061782      250228,,31.63,,1536463.35
2025/03/03,2025/03/01,SF FuneralF1130825      250301,,31.63,,1536494.98
2025/03/03,2025/03/03,SF FuneralF834627       250302,,31.63,,1536526.61
2025/03/03,2025/02/22,SF FuneralFDC00000006M44250222,,126.5,,1536653.11
2025/03/03,2025/02/22,SF FuneralF812991       250222,,126.5,,1536779.61
2025/03/03,2025/02/25,SF FuneralFDC000000069VK250225,,126.5,,1536906.11
2025/03/03,2025/02/25,SF FuneralFDC000000069VR250225,,126.5,,1537032.61
2025/03/03,2025/02/25,SF FuneralF1131918      250225,,126.5,,1537159.11
2025/03/03,2025/02/26,SF FuneralF980412       250226,,126.5,,1537285.61
2025/03/03,2025/02/27,SF FuneralFDC0000000FJKR250227,,126.5,,1537412.11
2025/03/03,2025/02/27,SF FuneralF1132399      250227,,126.5,,1537538.61
2025/03/03,2025/02/28,SF FuneralFDC00000003DG3250228,,220,,1537758.61
2025/03/03,2025/02/28,SF FuneralF798304       250228,,126.5,,1537885.11
2025/03/03,2025/02/28,SF FuneralF832730       250228,,126.5,,1538011.61
2025/03/03,2025/02/28,SF FuneralF847452       250228,,31.63,,1538043.24
2025/03/03,2025/02/28,SF FuneralF1080434      250228,,126.5,,1538169.74
2025/03/03,2025/02/28,SF FuneralF1104118      250228,,126.5,,1538296.24
2025/03/03,2025/03/01,SF FuneralFDC000000069J0250301,,126.5,,1538422.74
2025/03/03,2025/03/01,SF FuneralFDC000000069ZQ250301,,126.5,,1538549.24
2025/03/03,2025/03/01,SF FuneralF798396       250301,,126.5,,1538675.74
2025/03/03,2025/03/01,SF FuneralF820498       250301,,126.5,,1538802.24
2025/03/03,2025/03/01,SF FuneralF992716       250302,,126.5,,1538928.74
2025/03/03,2025/03/01,SF FuneralF1016685      250301,,126.5,,1539055.24
2025/03/03,2025/03/01,SF FuneralF1110321      250301,,126.5,,1539181.74
2025/03/03,2025/03/01,SF FuneralF1124112      250301,,126.5,,1539308.24
2025/03/03,2025/03/01,SF FuneralF1125904      250301,,126.5,,1539434.74
2025/03/03,2025/03/01,SF FuneralF1125906      250301,,126.5,,1539561.24
2025/03/03,2025/03/03,SF FuneralFDC0000000FJ69250302,,256.5,,1539817.74
2025/03/03,2025/03/03,SF FuneralF986911       250303,,31.63,,1539849.37
2025/03/03,2025/02/17,Rev SF FuneralFDC00000005YVB250217,,-126.5,,1539722.87
2025/03/03,2025/02/28,Rev SF FuneralFDC00000007PTH250228,,-126.5,,1539596.37
2025/03/03,2025/02/28,Rev SF FuneralFDC0000000JVBW250228,,-126.5,,1539469.87
2025/03/03,2025/01/17,Rev SF FuneralFDC00000005YVB250117,,-126.5,,1539343.37
2025/03/03,2025/02/24,Rev SF FuneralFDC000000070HF250224,,-126.5,,1539216.87
2025/03/03,2025/03/03,Rev SF FuneralFDC00000007MVX250303,,-126.5,,1539090.37
2025/03/03,2025/03/03,Rev SF FuneralFDC00000008JTG250303,,-63.25,,1539027.12
2025/03/03,2025/03/03,Rev SF FuneralFDC00000008JXH250303,,-63.25,,1538963.87
2025/03/03,2025/03/03,Rev SF FuneralFDC00000008JYZ250303,,-63.25,,1538900.62
2025/03/03,2025/02/28,Rev SF FuneralFDC0000000NGZF250228,,-126.5,,1538774.12
2025/03/03,2025/03/01,Rev SF FuneralFDC0000000NLXM250301,,-126.5,,1538647.62
2025/03/03,2025/02/28,Rev SF FuneralFDC000000069RZ250228,,-31.63,,1538615.99
2025/03/03,2025/03/03,Rev SF FuneralFDC00000005NT1250303,,-31.63,,1538584.36
2025/03/03,2025/03/03,Rev SF FuneralFDC00000005XG9250303,,-31.63,,1538552.73
2025/03/03,2025/02/28,Rev SF FuneralFDC00000007WBL250228,,-31.63,,1538521.1
2025/03/03,2025/02/28,Rev SF FuneralFDC0000000JFC4250228,,-31.63,,1538489.47
2025/03/03,2025/02/28,Rev SF FuneralFDC0000000KYQT250228,,-126.5,,1538362.97
2025/03/03,2025/02/28,Rev SF FuneralFDC00000007BKW250228,,-126.5,,1538236.47
2025/03/03,2025/02/28,Rev SF FuneralFDC00000005MMP250228,,-126.5,,1538109.97
2025/03/03,2025/02/28,Rev SF FuneralFDC00000006G6T250228,,-191.5,,1537918.47
2025/03/03,2025/02/24,Rev SF FuneralFDC0000000KFK0250224,,-126.5,,1537791.97
2025/03/03,2025/02/28,Rev SF FuneralFDC00000007191250228,,-126.5,,1537665.47
2025/03/03,2025/02/28,Rev SF FuneralFDC00000005XC4250228,,-220,,1537445.47
2025/03/03,2025/02/27,Rev SF FuneralFDC00000003ML6250227,,-220,,1537225.47
2025/03/03,2025/03/01,Rev SF FuneralFDC0000000349F250301,,-220,,1537005.47
2025/03/03,2025/02/25,Rev SF FuneralFDC00000007V1W250225,,-126.5,,1536878.97
2025/03/03,2025/02/27,Rev SF FuneralFDC0000000BQQ3250227,,-126.5,,1536752.47
2025/03/03,2025/03/03,Rev SF FuneralFDC00000007M2D250302,,-63.25,,1536689.22
2025/03/03,2025/01/24,Rev SF FuneralF816607       250127,,-126.5,,1536562.72
2025/03/03,2025/01/22,Rev SF FuneralFDC00000005XG7250122,,-126.5,,1536436.22
2025/03/03,2025/03/01,Rev SF FuneralFDC0000000P09M250301,,-126.5,,1536309.72
2025/03/03,2025/02/22,Rev SF FuneralFDC00000007YVT250222,,-126.5,,1536183.22
2025/03/03,2025/02/27,Rev SF FuneralFDC0000000F5C8250227,,-126.5,,1536056.72
2025/03/03,2025/02/22,Rev SF FuneralFDC0000000L1SQ250222,,-126.5,,1535930.22
2025/03/03,2025/02/27,Rev SF FuneralFDC00000007X43250227,,-126.5,,1535803.72
2025/03/03,2025/02/27,Rev SF FuneralFDC0000000FRBY250227,,-126.5,,1535677.22
2025/03/03,2025/02/22,Rev SF FuneralFDC00000005XG7250222,,-126.5,,1535550.72
2025/03/03,2025/02/27,Rev SF FuneralFDC0000000BNK6250227,,-126.5,,1535424.22
2025/03/03,2025/02/28,Rev SF FuneralFDC00000005MZR250228,,-126.5,,1535297.72
2025/03/03,2025/02/25,Rev SF FuneralFDC000000069VK250225,,-126.5,,1535171.22
2025/03/03,2025/03/01,Rev SF FuneralFDC000000087KM250301,,-126.5,,1535044.72
2025/03/03,2025/03/01,Rev SF FuneralFDC00000007TNR250301,,-126.5,,1534918.22
2025/03/03,2025/02/26,Rev SF FuneralFDC0000000J7LW250226,,-126.5,,1534791.72
2025/03/03,2025/02/28,SF FuneralF1083976      250228,,126.5,,1534918.22
2025/03/03,2025/02/28,SF FuneralF1124030      250228,,126.5,,1535044.72
2025/03/03,2025/03/03,SF FuneralF1102815      250303,,31.63,,1535076.35
2025/03/03,2025/02/28,SF FuneralFDC00000005GV2250228,,126.5,,1535202.85
2025/03/03,2025/02/28,SF FuneralFDC00000006DJ4250228,,126.5,,1535329.35
2025/03/03,2025/02/22,SF FuneralFDC000000061QL250222,,126.5,,1535455.85
2025/03/03,2025/03/01,SF FuneralFDC000000073QN250301,,126.5,,1535582.35
2025/03/03,2025/02/22,Rev SF FuneralFDC00000008HY7250222,,-126.5,,1535455.85
2025/03/04,2025/02/26,SF FuneralFDC00000002PY8250226,,220,,1535675.85
2025/03/04,2025/02/26,SF FuneralF1131714      250226,,126.5,,1535802.35
2025/03/04,2025/03/03,SF FuneralFDC00000005Z06250303,,31.63,,1535833.98
2025/03/04,2025/03/03,SF FuneralFDC00000005Z12250303,,31.63,,1535865.61
2025/03/04,2025/03/03,SF FuneralFDC00000005Z25250303,,31.63,,1535897.24
2025/03/04,2025/03/03,SF FuneralFDC000000075VG250302,,126.5,,1536023.74
2025/03/04,2025/03/03,SF FuneralF808790       250303,,126.5,,1536150.24
2025/03/04,2025/03/03,SF FuneralF812437       250302,,126.5,,1536276.74
2025/03/04,2025/03/03,SF FuneralF814011       250302,,126.5,,1536403.24
2025/03/04,2025/03/03,SF FuneralF843748       250301,,126.5,,1536529.74
2025/03/04,2025/03/03,SF FuneralFDC0000000FQ1L250301,,126.5,,1536656.24
2025/03/04,2025/03/03,SF FuneralF993010       250303,,126.5,,1536782.74
2025/03/04,2025/03/03,SF FuneralF1124382      250303,,126.5,,1536909.24
2025/03/04,2025/03/03,SF FuneralFDC0000000Q4SF250303,,126.5,,1537035.74
2025/03/04,2025/03/03,SF FuneralF1132135      250303,,126.5,,1537162.24
2025/03/04,2025/02/27,SF FuneralFDC000000079GH250227,,126.5,,1537288.74
2025/03/04,2025/02/27,SF FuneralFDC00000007PLM250227,,126.5,,1537415.24
2025/03/04,2025/02/27,SF FuneralF994028       250227,,126.5,,1537541.74
2025/03/04,2025/02/27,SF FuneralF1059452      250227,,126.5,,1537668.24
2025/03/04,2025/02/25,SF FuneralF842856       250225,,126.5,,1537794.74
2025/03/04,2025/03/01,SF FuneralFDC00000002V5X250301,,220,,1538014.74
2025/03/04,2025/03/01,SF FuneralFDC00000002YTV250301,,220,,1538234.74
2025/03/04,2025/03/01,SF FuneralFDC0000000347V250301,,220,,1538454.74
2025/03/04,2025/03/01,SF FuneralFDC000000034YS250301,,220,,1538674.74
2025/03/04,2025/03/01,SF FuneralFDC00000003L1W250301,,220,,1538894.74
2025/03/04,2025/03/01,SF FuneralFDC00000003P3N250301,,220,,1539114.74
2025/03/04,2025/03/01,SF FuneralFDC0000000416Z250301,,220,,1539334.74
2025/03/04,2025/03/01,SF FuneralFDC00000004MF7250301,,220,,1539554.74
2025/03/04,2025/03/01,SF FuneralFDC000000058T0250301,,220,,1539774.74
2025/03/04,2025/03/01,SF FuneralFDC00000005DS5250301,,129,,1539903.74
2025/03/04,2025/03/01,SF FuneralFDC00000005HPT250301,,126.5,,1540030.24
2025/03/04,2025/03/01,SF FuneralFDC00000005MKT250301,,126.5,,1540156.74
2025/03/04,2025/03/01,SF FuneralFDC00000005NP7250301,,126.5,,1540283.24
2025/03/04,2025/03/01,SF FuneralFDC00000005QFJ250301,,126.5,,1540409.74
2025/03/04,2025/03/01,SF FuneralFDC00000005SQ8250301,,126.5,,1540536.24
2025/03/04,2025/03/01,SF FuneralFDC00000005XZS250301,,126.5,,1540662.74
2025/03/04,2025/03/01,SF FuneralFDC000000067M8250301,,126.5,,1540789.24
2025/03/04,2025/03/01,SF FuneralFDC000000067SD250301,,126.5,,1540915.74
2025/03/04,2025/03/01,SF FuneralFDC000000067X1250301,,126.5,,1541042.24
2025/03/04,2025/03/01,SF FuneralFDC0000000689P250301,,126.5,,1541168.74
2025/03/04,2025/03/01,SF FuneralFDC000000068D9250301,,126.5,,1541295.24
2025/03/04,2025/03/01,SF FuneralFDC00000006974250301,,126.5,,1541421.74
2025/03/04,2025/03/01,SF FuneralFDC0000000698C250301,,126.5,,1541548.24
2025/03/04,2025/03/01,SF FuneralFDC000000069D1250301,,126.5,,1541674.74
2025/03/04,2025/03/01,SF FuneralFDC000000069R5250301,,126.5,,1541801.24
2025/03/04,2025/03/01,SF FuneralFDC000000069X4250301,,126.5,,1541927.74
2025/03/04,2025/03/01,SF FuneralFDC00000006BBW250301,,126.5,,1542054.24
2025/03/04,2025/03/01,SF FuneralFDC00000006BDG250301,,126.5,,1542180.74
2025/03/04,2025/03/01,SF FuneralFDC00000006CQ0250301,,126.5,,1542307.24
2025/03/04,2025/03/01,SF FuneralFDC00000006D0W250301,,126.5,,1542433.74
2025/03/04,2025/03/01,SF FuneralFDC00000006DV6250301,,126.5,,1542560.24
2025/03/04,2025/03/01,SF FuneralFDC00000006DZY250301,,126.5,,1542686.74
2025/03/04,2025/03/01,SF FuneralFDC00000006FWR250301,,126.5,,1542813.24
2025/03/04,2025/03/01,SF FuneralFDC00000006GJH250301,,126.5,,1542939.74
2025/03/04,2025/03/01,SF FuneralFDC00000006GQG250301,,126.5,,1543066.24
2025/03/04,2025/03/01,SF FuneralFDC00000006GVG250301,,126.5,,1543192.74
2025/03/04,2025/03/01,SF FuneralFDC00000006HSP250301,,126.5,,1543319.24
2025/03/04,2025/03/01,SF FuneralFDC00000006JPT250301,,220,,1543539.24
2025/03/04,2025/03/01,SF FuneralFDC00000006L00250301,,126.5,,1543665.74
2025/03/04,2025/03/01,SF FuneralFDC00000006L4D250301,,126.5,,1543792.24
2025/03/04,2025/03/01,SF FuneralFDC00000006L98250301,,126.5,,1543918.74
2025/03/04,2025/03/01,SF FuneralFDC00000006S7B250301,,126.5,,1544045.24
2025/03/04,2025/03/01,SF FuneralFDC00000006VCL250301,,126.5,,1544171.74
2025/03/04,2025/03/01,SF FuneralFDC00000006WQ9250301,,126.5,,1544298.24
2025/03/04,2025/03/01,SF FuneralFDC00000006YGW250301,,126.5,,1544424.74
2025/03/04,2025/03/01,SF FuneralFDC00000007181250301,,126.5,,1544551.24
2025/03/04,2025/03/01,SF FuneralFDC000000073G2250301,,126.5,,1544677.74
2025/03/04,2025/03/01,SF FuneralFDC000000073L2250301,,126.5,,1544804.24
2025/03/04,2025/03/01,SF FuneralFDC000000073TX250301,,126.5,,1544930.74
2025/03/04,2025/03/01,SF FuneralFDC00000007443250301,,126.5,,1545057.24
2025/03/04,2025/03/01,SF FuneralFDC0000000744M250301,,126.5,,1545183.74
2025/03/04,2025/03/01,SF FuneralFDC000000074F6250301,,220,,1545403.74
2025/03/04,2025/03/01,SF FuneralFDC000000074FC250301,,126.5,,1545530.24
2025/03/04,2025/03/01,SF FuneralFDC000000074MY250301,,126.5,,1545656.74
2025/03/04,2025/03/01,SF FuneralFDC000000074NS250301,,126.5,,1545783.24
2025/03/04,2025/03/01,SF FuneralFDC000000074SJ250301,,126.5,,1545909.74
2025/03/04,2025/03/01,SF FuneralFDC000000074T1250301,,126.5,,1546036.24
2025/03/04,2025/03/01,SF FuneralFDC000000074TG250301,,126.5,,1546162.74
2025/03/04,2025/03/01,SF FuneralFDC000000075B4250301,,126.5,,1546289.24
2025/03/04,2025/03/01,SF FuneralFDC000000075C5250301,,126.5,,1546415.74
2025/03/04,2025/03/01,SF FuneralFDC000000075G0250301,,126.5,,1546542.24
2025/03/04,2025/03/01,SF FuneralFDC000000076RY250301,,126.5,,1546668.74
2025/03/04,2025/03/01,SF FuneralFDC000000078CR250301,,126.5,,1546795.24
2025/03/04,2025/03/01,SF FuneralFDC000000079M1250301,,126.5,,1546921.74
2025/03/04,2025/03/01,SF FuneralFDC00000007CND250301,,126.5,,1547048.24
2025/03/04,2025/03/01,SF FuneralFDC00000007CSC250301,,126.5,,1547174.74
2025/03/04,2025/03/01,SF FuneralFDC00000007KX6250301,,126.5,,1547301.24
2025/03/04,2025/03/01,SF FuneralFDC00000007P17250301,,126.5,,1547427.74
2025/03/04,2025/03/01,SF FuneralFDC00000007P9K250301,,126.5,,1547554.24
2025/03/04,2025/03/01,SF FuneralFDC00000007PL3250301,,126.5,,1547680.74
2025/03/04,2025/03/01,SF FuneralFDC00000007PLP250301,,126.5,,1547807.24
2025/03/04,2025/03/01,SF FuneralFDC00000007Q7X250301,,126.5,,1547933.74
2025/03/04,2025/03/01,SF FuneralFDC00000007QD4250301,,126.5,,1548060.24
2025/03/04,2025/03/01,SF FuneralFDC00000007QHR250301,,126.5,,1548186.74
2025/03/04,2025/03/01,SF FuneralFDC00000007QL4250301,,126.5,,1548313.24
2025/03/04,2025/03/01,SF FuneralFDC00000007QTS250301,,126.5,,1548439.74
2025/03/04,2025/03/01,SF FuneralF794309       250301,,126.5,,1548566.24
2025/03/04,2025/03/01,SF FuneralFDC00000007RXL250301,,126.5,,1548692.74
2025/03/04,2025/03/01,SF FuneralFDC00000007SBP250301,,126.5,,1548819.24
2025/03/04,2025/03/01,SF FuneralFDC00000007SVN250301,,126.5,,1548945.74
2025/03/04,2025/03/01,SF FuneralFDC00000007SYC250301,,126.5,,1549072.24
2025/03/04,2025/03/01,SF FuneralF794826       250301,,126.5,,1549198.74
2025/03/04,2025/03/01,SF FuneralFDC00000007W7P250301,,126.5,,1549325.24
2025/03/04,2025/03/01,SF FuneralFDC00000007WGL250301,,126.5,,1549451.74
2025/03/04,2025/03/01,SF FuneralFDC00000007WSX250301,,126.5,,1549578.24
2025/03/04,2025/03/01,SF FuneralFDC00000007YYN250301,,126.5,,1549704.74
2025/03/04,2025/03/01,SF FuneralFDC00000007Z9K250301,,126.5,,1549831.24
2025/03/04,2025/03/01,SF FuneralFDC000000083GT250301,,126.5,,1549957.74
2025/03/04,2025/03/01,SF FuneralFDC000000083N8250301,,126.5,,1550084.24
2025/03/04,2025/03/01,SF FuneralFDC000000084LK250301,,126.5,,1550210.74
2025/03/04,2025/03/01,SF FuneralF798328       250301,,126.5,,1550337.24
2025/03/04,2025/03/01,SF FuneralFDC000000085GJ250301,,126.5,,1550463.74
2025/03/04,2025/03/01,SF FuneralF798985       250301,,126.5,,1550590.24
2025/03/04,2025/03/01,SF FuneralFDC000000086QX250301,,126.5,,1550716.74
2025/03/04,2025/03/01,SF FuneralFDC000000089S9250301,,126.5,,1550843.24
2025/03/04,2025/03/01,SF FuneralF800965       250301,,126.5,,1550969.74
2025/03/04,2025/03/01,SF FuneralF802487       250301,,126.5,,1551096.24
2025/03/04,2025/03/01,SF FuneralFDC00000008KTB250301,,126.5,,1551222.74
2025/03/04,2025/03/01,SF FuneralF802669       250301,,126.5,,1551349.24
2025/03/04,2025/03/01,SF FuneralF802832       250301,,126.5,,1551475.74
2025/03/04,2025/03/01,SF FuneralF802880       250301,,126.5,,1551602.24
2025/03/04,2025/03/01,SF FuneralFDC00000008MDC250301,,126.5,,1551728.74
2025/03/04,2025/03/01,SF FuneralFDC00000008MJL250301,,126.5,,1551855.24
2025/03/04,2025/03/01,SF FuneralFDC00000008MVL250301,,126.5,,1551981.74
2025/03/04,2025/03/01,SF FuneralFDC00000008NKB250301,,126.5,,1552108.24
2025/03/04,2025/03/01,SF FuneralF803900       250301,,126.5,,1552234.74
2025/03/04,2025/03/01,SF FuneralFDC00000008RKY250301,,126.5,,1552361.24
2025/03/04,2025/03/01,SF FuneralF804964       250301,,126.5,,1552487.74
2025/03/04,2025/03/01,SF FuneralF805055       250301,,126.5,,1552614.24
2025/03/04,2025/03/01,SF FuneralF808424       250301,,126.5,,1552740.74
2025/03/04,2025/03/01,SF FuneralF808459       250301,,126.5,,1552867.24
2025/03/04,2025/03/01,SF FuneralF808615       250301,,126.5,,1552993.74
2025/03/04,2025/03/01,SF FuneralF808645       250301,,126.5,,1553120.24
2025/03/04,2025/03/01,SF FuneralF809629       250301,,126.5,,1553246.74
2025/03/04,2025/03/01,SF FuneralF810146       250301,,126.5,,1553373.24
2025/03/04,2025/03/01,SF FuneralF810226       250301,,126.5,,1553499.74
2025/03/04,2025/03/01,SF FuneralF810303       250301,,126.5,,1553626.24
2025/03/04,2025/03/01,SF FuneralF812175       250301,,126.5,,1553752.74
2025/03/04,2025/03/01,SF FuneralF812447       250301,,126.5,,1553879.24
2025/03/04,2025/03/01,SF FuneralF812524       250301,,126.5,,1554005.74
2025/03/04,2025/03/01,SF FuneralF812728       250301,,126.5,,1554132.24
2025/03/04,2025/03/01,SF FuneralF813553       250301,,126.5,,1554258.74
2025/03/04,2025/03/01,SF FuneralF814524       250301,,126.5,,1554385.24
2025/03/04,2025/03/01,SF FuneralF814641       250301,,126.5,,1554511.74
2025/03/04,2025/03/01,SF FuneralF815355       250301,,126.5,,1554638.24
2025/03/04,2025/03/01,SF FuneralF816618       250301,,126.5,,1554764.74
2025/03/04,2025/03/01,SF FuneralF816749       250301,,126.5,,1554891.24
2025/03/04,2025/03/01,SF FuneralF816757       250301,,126.5,,1555017.74
2025/03/04,2025/03/01,SF FuneralF816756       250301,,126.5,,1555144.24
2025/03/04,2025/03/01,SF FuneralF816804       250301,,126.5,,1555270.74
2025/03/04,2025/03/01,SF FuneralF816966       250301,,126.5,,1555397.24
2025/03/04,2025/03/01,SF FuneralF817279       250301,,126.5,,1555523.74
2025/03/04,2025/03/01,SF FuneralF817395       250301,,126.5,,1555650.24
2025/03/04,2025/03/01,SF FuneralF819834       250301,,126.5,,1555776.74
2025/03/04,2025/03/01,SF FuneralF820402       250301,,126.5,,1555903.24
2025/03/04,2025/03/01,SF FuneralF820564       250301,,126.5,,1556029.74
2025/03/04,2025/03/01,SF FuneralF821541       250301,,126.5,,1556156.24
2025/03/04,2025/03/01,SF FuneralF821597       250301,,126.5,,1556282.74
2025/03/04,2025/03/01,SF FuneralF822176       250301,,126.5,,1556409.24
2025/03/04,2025/03/01,SF FuneralF822800       250301,,126.5,,1556535.74
2025/03/04,2025/03/01,SF FuneralF828118       250301,,126.5,,1556662.24
2025/03/04,2025/03/01,SF FuneralF828163       250301,,126.5,,1556788.74
2025/03/04,2025/03/01,SF FuneralF828171       250301,,126.5,,1556915.24
2025/03/04,2025/03/01,SF FuneralF828291       250301,,126.5,,1557041.74
2025/03/04,2025/03/01,SF FuneralF828338       250301,,126.5,,1557168.24
2025/03/04,2025/03/01,SF FuneralF828776       250301,,126.5,,1557294.74
2025/03/04,2025/03/01,SF FuneralF828889       250301,,126.5,,1557421.24
2025/03/04,2025/03/01,SF FuneralF829115       250301,,126.5,,1557547.74
2025/03/04,2025/03/01,SF FuneralFDC0000000BRBR250301,,126.5,,1557674.24
2025/03/04,2025/03/01,SF FuneralF829747       250301,,126.5,,1557800.74
2025/03/04,2025/03/01,SF FuneralF830935       250301,,126.5,,1557927.24
2025/03/04,2025/03/01,SF FuneralF830988       250301,,126.5,,1558053.74
2025/03/04,2025/03/01,SF FuneralF831077       250301,,126.5,,1558180.24
2025/03/04,2025/03/01,SF FuneralF832034       250301,,126.5,,1558306.74
2025/03/04,2025/03/01,SF FuneralFDC0000000CHRP250301,,126.5,,1558433.24
2025/03/04,2025/03/01,SF FuneralF832189       250301,,126.5,,1558559.74
2025/03/04,2025/03/01,SF FuneralF832249       250301,,126.5,,1558686.24
2025/03/04,2025/03/01,SF FuneralF832363       250301,,126.5,,1558812.74
2025/03/04,2025/03/01,SF FuneralF832928       250301,,126.5,,1558939.24
2025/03/04,2025/03/01,SF FuneralF833105       250301,,126.5,,1559065.74
2025/03/04,2025/03/01,SF FuneralFDC0000000CR2C250301,,126.5,,1559192.24
2025/03/04,2025/03/01,SF FuneralF833465       250301,,126.5,,1559318.74
2025/03/04,2025/03/01,SF FuneralF834877       250301,,126.5,,1559445.24
2025/03/04,2025/03/01,SF FuneralF841456       250301,,126.5,,1559571.74
2025/03/04,2025/03/01,SF FuneralF841493       250301,,126.5,,1559698.24
2025/03/04,2025/03/01,SF FuneralF841549       250301,,126.5,,1559824.74
2025/03/04,2025/03/01,SF FuneralF842012       250301,,126.5,,1559951.24
2025/03/04,2025/03/01,SF FuneralF842315       250301,,126.5,,1560077.74
2025/03/04,2025/03/01,SF FuneralF842342       250301,,126.5,,1560204.24
2025/03/04,2025/03/01,SF FuneralF774436       250301,,191.5,,1560395.74
2025/03/04,2025/03/01,SF FuneralF842371       250301,,126.5,,1560522.24
2025/03/04,2025/03/01,SF FuneralF842749       250301,,126.5,,1560648.74
2025/03/04,2025/03/01,SF FuneralF992710       250301,,126.5,,1560775.24
2025/03/04,2025/03/01,SF FuneralF992953       250301,,126.5,,1560901.74
2025/03/04,2025/03/01,SF FuneralFDC0000000JBJD250301,,126.5,,1561028.24
2025/03/04,2025/03/01,SF FuneralF993214       250301,,126.5,,1561154.74
2025/03/04,2025/03/01,SF FuneralF993673       250301,,126.5,,1561281.24
2025/03/04,2025/03/01,SF FuneralF1017466      250301,,126.5,,1561407.74
2025/03/04,2025/03/01,SF FuneralF1021271      250301,,126.5,,1561534.24
2025/03/04,2025/03/01,SF FuneralF1016909      250301,,126.5,,1561660.74
2025/03/04,2025/03/01,SF FuneralFDC0000000JVXT250301,,126.5,,1561787.24
2025/03/04,2025/03/01,SF FuneralF1021521      250301,,126.5,,1561913.74
2025/03/04,2025/03/01,SF FuneralF1033550      250302,,126.5,,1562040.24
2025/03/04,2025/03/01,SF FuneralFDC0000000K8YR250301,,126.5,,1562166.74
2025/03/04,2025/03/01,SF FuneralF1059852      250301,,126.5,,1562293.24
2025/03/04,2025/03/01,SF FuneralF1060127      250301,,126.5,,1562419.74
2025/03/04,2025/03/01,SF FuneralF1066676      250301,,126.5,,1562546.24
2025/03/04,2025/03/01,SF FuneralFDC0000000KYPH250301,,126.5,,1562672.74
2025/03/04,2025/03/01,SF FuneralFDC0000000KYZH250301,,126.5,,1562799.24
2025/03/04,2025/03/01,SF FuneralF1072717      250301,,126.5,,1562925.74
2025/03/04,2025/03/01,SF FuneralF1072814      250301,,126.5,,1563052.24
2025/03/04,2025/03/01,SF FuneralF1073817      250301,,126.5,,1563178.74
2025/03/04,2025/03/01,SF FuneralF1078071      250301,,126.5,,1563305.24
2025/03/04,2025/03/01,SF FuneralF1078320      250301,,126.5,,1563431.74
2025/03/04,2025/03/01,SF FuneralF1078329      250301,,126.5,,1563558.24
2025/03/04,2025/03/01,SF FuneralF1078538      250301,,126.5,,1563684.74
2025/03/04,2025/03/01,SF FuneralF1078642      250301,,126.5,,1563811.24
2025/03/04,2025/03/01,SF FuneralFDC0000000LHDF250301,,126.5,,1563937.74
2025/03/04,2025/03/01,SF FuneralF1078897      250301,,126.5,,1564064.24
2025/03/04,2025/03/01,SF FuneralFDC0000000LHYW250301,,126.5,,1564190.74
2025/03/04,2025/03/01,SF FuneralFDC0000000LHZ2250301,,126.5,,1564317.24
2025/03/04,2025/03/01,SF FuneralF1079091      250301,,126.5,,1564443.74
2025/03/04,2025/03/01,SF FuneralF1079811      250301,,126.5,,1564570.24
2025/03/04,2025/03/01,SF FuneralF1080348      250301,,126.5,,1564696.74
2025/03/04,2025/03/01,SF FuneralF1080359      250301,,126.5,,1564823.24
2025/03/04,2025/03/01,SF FuneralF1084005      250301,,126.5,,1564949.74
2025/03/04,2025/03/01,SF FuneralFDC0000000LVS2250301,,126.5,,1565076.24
2025/03/04,2025/03/01,SF FuneralF1084557      250301,,126.5,,1565202.74
2025/03/04,2025/03/01,SF FuneralF1084617      250301,,126.5,,1565329.24
2025/03/04,2025/03/01,SF FuneralF1085078      250301,,126.5,,1565455.74
2025/03/04,2025/03/01,SF FuneralF1103773      250301,,126.5,,1565582.24
2025/03/04,2025/03/01,SF FuneralF1104084      250301,,126.5,,1565708.74
2025/03/04,2025/03/01,SF FuneralF1104097      250301,,126.5,,1565835.24
2025/03/04,2025/03/01,SF FuneralF1108756      250301,,126.5,,1565961.74
2025/03/04,2025/03/01,SF FuneralF1108769      250301,,126.5,,1566088.24
2025/03/04,2025/03/01,SF FuneralF1108776      250301,,126.5,,1566214.74
2025/03/04,2025/03/01,SF FuneralF1108836      250301,,126.5,,1566341.24
2025/03/04,2025/03/01,SF FuneralF1108917      250301,,126.5,,1566467.74
2025/03/04,2025/03/01,SF FuneralF1108962      250301,,126.5,,1566594.24
2025/03/04,2025/03/01,SF FuneralF1109016      250301,,126.5,,1566720.74
2025/03/04,2025/03/01,SF FuneralF1109047      250301,,126.5,,1566847.24
2025/03/04,2025/03/01,SF FuneralF1109619      250301,,126.5,,1566973.74
2025/03/04,2025/03/01,SF FuneralF1110383      250301,,126.5,,1567100.24
2025/03/04,2025/03/01,SF FuneralFDC0000000MN6J250301,,126.5,,1567226.74
2025/03/04,2025/03/01,SF FuneralF1110416      250301,,126.5,,1567353.24
2025/03/04,2025/03/01,SF FuneralF1110422      250301,,126.5,,1567479.74
2025/03/04,2025/03/01,SF FuneralF1111340      250301,,126.5,,1567606.24
2025/03/04,2025/03/01,SF FuneralF1111497      250301,,126.5,,1567732.74
2025/03/04,2025/03/01,SF FuneralF1113154      250301,,126.5,,1567859.24
2025/03/04,2025/03/01,SF FuneralF1113218      250301,,126.5,,1567985.74
2025/03/04,2025/03/01,SF FuneralF1113846      250301,,126.5,,1568112.24
2025/03/04,2025/03/01,SF FuneralFDC0000000N697250301,,126.5,,1568238.74
2025/03/04,2025/03/01,SF FuneralF1114230      250301,,126.5,,1568365.24
2025/03/04,2025/03/01,SF FuneralF1114428      250301,,126.5,,1568491.74
2025/03/04,2025/03/01,SF FuneralFDC0000000N97F250301,,191.5,,1568683.24
2025/03/04,2025/03/01,SF FuneralF1116987      250301,,126.5,,1568809.74
2025/03/04,2025/03/01,SF FuneralF1117129      250301,,126.5,,1568936.24
2025/03/04,2025/03/01,SF FuneralF1117237      250301,,126.5,,1569062.74
2025/03/04,2025/03/01,SF FuneralF1117867      250302,,126.5,,1569189.24
2025/03/04,2025/03/01,SF FuneralF1117926      250301,,126.5,,1569315.74
2025/03/04,2025/03/01,SF FuneralF1118045      250301,,126.5,,1569442.24
2025/03/04,2025/03/01,SF FuneralF1118360      250301,,126.5,,1569568.74
2025/03/04,2025/03/01,SF FuneralF1120806      250301,,126.5,,1569695.24
2025/03/04,2025/03/01,SF FuneralF1122666      250301,,126.5,,1569821.74
2025/03/04,2025/03/01,SF FuneralFDC0000000P1KP250301,,126.5,,1569948.24
2025/03/04,2025/03/01,SF FuneralF1122949      250301,,126.5,,1570074.74
2025/03/04,2025/03/01,SF FuneralF1122956      250301,,126.5,,1570201.24
2025/03/04,2025/03/01,SF FuneralF1122960      250301,,126.5,,1570327.74
2025/03/04,2025/03/01,SF FuneralFDC0000000P38T250301,,126.5,,1570454.24
2025/03/04,2025/03/01,SF FuneralFDC0000000P38Z250301,,126.5,,1570580.74
2025/03/04,2025/03/01,SF FuneralFDC0000000P658250301,,126.5,,1570707.24
2025/03/04,2025/03/01,SF FuneralFDC0000000P6LN250301,,126.5,,1570833.74
2025/03/04,2025/03/01,SF FuneralF1124370      250301,,126.5,,1570960.24
2025/03/04,2025/03/01,SF FuneralFDC0000000PBRD250301,,126.5,,1571086.74
2025/03/04,2025/03/01,SF FuneralF1125277      250301,,126.5,,1571213.24
2025/03/04,2025/03/01,SF FuneralFDC0000000PJR5250301,,126.5,,1571339.74
2025/03/04,2025/03/01,SF FuneralF1125985      250301,,126.5,,1571466.24
2025/03/04,2025/03/01,SF FuneralF1126112      250301,,126.5,,1571592.74
2025/03/04,2025/03/01,SF FuneralF1126124      250301,,126.5,,1571719.24
2025/03/04,2025/03/01,SF FuneralF1126228      250301,,126.5,,1571845.74
2025/03/04,2025/03/01,SF FuneralF1126917      250301,,126.5,,1571972.24
2025/03/04,2025/03/01,SF FuneralF1127908      250301,,126.5,,1572098.74
2025/03/04,2025/03/01,SF FuneralF1127927      250301,,126.5,,1572225.24
2025/03/04,2025/03/01,SF FuneralFDC0000000PTD1250301,,126.5,,1572351.74
2025/03/04,2025/03/01,SF FuneralFDC0000000PTFK250301,,126.5,,1572478.24
2025/03/04,2025/03/01,SF FuneralFDC0000000PVCV250301,,126.5,,1572604.74
2025/03/04,2025/03/01,SF FuneralFDC0000000PVCX250301,,126.5,,1572731.24
2025/03/04,2025/03/01,SF FuneralF1117629      250301,,126.5,,1572857.74
2025/03/04,2025/03/01,SF FuneralF1125773      250301,,191.5,,1573049.24
2025/03/04,2025/03/01,SF FuneralF1128800      250301,,126.5,,1573175.74
2025/03/04,2025/03/01,SF FuneralF1128928      250301,,126.5,,1573302.24
2025/03/04,2025/03/01,SF FuneralF1129059      250301,,126.5,,1573428.74
2025/03/04,2025/03/01,SF FuneralF1129211      250301,,126.5,,1573555.24
2025/03/04,2025/03/01,SF FuneralF1129227      250301,,126.5,,1573681.74
2025/03/04,2025/03/01,SF FuneralFDC0000000Q1QF250301,,126.5,,1573808.24
2025/03/04,2025/03/01,SF FuneralF1130674      250301,,126.5,,1573934.74
2025/03/04,2025/03/01,SF FuneralF1131221      250301,,126.5,,1574061.24
2025/03/04,2025/03/01,SF FuneralF1131643      250301,,126.5,,1574187.74
2025/03/04,2025/03/01,SF FuneralF1131676      250301,,126.5,,1574314.24
2025/03/04,2025/03/01,SF FuneralFDC0000000Q6LD250301,,126.5,,1574440.74
2025/03/04,2025/03/01,SF FuneralF1131968      250301,,126.5,,1574567.24
2025/03/04,2025/02/28,SF FuneralFDC000000033F8250228,,220,,1574787.24
2025/03/04,2025/02/28,SF FuneralFDC000000064DV250228,,126.5,,1574913.74
2025/03/04,2025/02/28,SF FuneralFDC000000066R9250228,,126.5,,1575040.24
2025/03/04,2025/02/28,SF FuneralFDC000000067PW250228,,126.5,,1575166.74
2025/03/04,2025/02/28,SF FuneralFDC000000067YD250228,,126.5,,1575293.24
2025/03/04,2025/02/28,SF FuneralFDC00000006B65250228,,126.5,,1575419.74
2025/03/04,2025/02/28,SF FuneralFDC00000006HWT250228,,126.5,,1575546.24
2025/03/04,2025/02/28,SF FuneralFDC00000007494250228,,126.5,,1575672.74
2025/03/04,2025/02/28,SF FuneralFDC000000078DS250228,,126.5,,1575799.24
2025/03/04,2025/02/28,SF FuneralFDC00000007BD0250228,,126.5,,1575925.74
2025/03/04,2025/02/28,SF FuneralFDC00000007D64250228,,126.5,,1576052.24
2025/03/04,2025/02/28,SF FuneralFDC00000007D69250228,,126.5,,1576178.74
2025/03/04,2025/02/28,SF FuneralFDC00000007F9C250228,,126.5,,1576305.24
2025/03/04,2025/02/28,SF FuneralFDC00000007T5V250228,,126.5,,1576431.74
2025/03/04,2025/02/28,SF FuneralFDC00000007WM7250228,,126.5,,1576558.24
2025/03/04,2025/02/28,SF FuneralFDC000000082L1250228,,126.5,,1576684.74
2025/03/04,2025/02/28,SF FuneralF798394       250228,,126.5,,1576811.24
2025/03/04,2025/02/28,SF FuneralF805076       250228,,126.5,,1576937.74
2025/03/04,2025/02/28,SF FuneralF813158       250228,,126.5,,1577064.24
2025/03/04,2025/02/28,SF FuneralF841583       250228,,126.5,,1577190.74
2025/03/04,2025/02/28,SF FuneralF901407       250301,,126.5,,1577317.24
2025/03/04,2025/02/28,SF FuneralF981295       250301,,126.5,,1577443.74
2025/03/04,2025/02/28,SF FuneralFDC0000000HCT7250301,,126.5,,1577570.24
2025/03/04,2025/02/28,SF FuneralF981813       250301,,126.5,,1577696.74
2025/03/04,2025/02/28,SF FuneralF987112       250301,,126.5,,1577823.24
2025/03/04,2025/02/28,SF FuneralF987553       250301,,126.5,,1577949.74
2025/03/04,2025/02/28,SF FuneralFDC0000000HSN2250228,,126.5,,1578076.24
2025/03/04,2025/02/28,SF FuneralFDC0000000HTZW250301,,126.5,,1578202.74
2025/03/04,2025/02/28,SF FuneralFDC0000000HX7W250228,,31.63,,1578234.37
2025/03/04,2025/02/28,SF FuneralF988772       250301,,126.5,,1578360.87
2025/03/04,2025/02/28,SF FuneralF988960       250301,,126.5,,1578487.37
2025/03/04,2025/02/28,SF FuneralF989475       250301,,126.5,,1578613.87
2025/03/04,2025/02/28,SF FuneralF989578       250301,,126.5,,1578740.37
2025/03/04,2025/02/28,SF FuneralFDC0000000J0YB250301,,126.5,,1578866.87
2025/03/04,2025/02/28,SF FuneralF990249       250301,,126.5,,1578993.37
2025/03/04,2025/02/28,SF FuneralF1068183      250228,,126.5,,1579119.87
2025/03/04,2025/02/28,SF FuneralF1079321      250228,,63.25,,1579183.12
2025/03/04,2025/02/28,SF FuneralF1108953      250228,,126.5,,1579309.62
2025/03/04,2025/02/28,SF FuneralF1113236      250228,,126.5,,1579436.12
2025/03/04,2025/02/28,SF FuneralFDC0000000NMYD250228,,126.5,,1579562.62
2025/03/04,2025/02/28,SF FuneralF1121983      250228,,126.5,,1579689.12
2025/03/04,2025/02/28,SF FuneralF1129945      250228,,31.63,,1579720.75
2025/03/04,2025/02/28,SF FuneralFDC0000000Q91V250228,,126.5,,1579847.25
2025/03/04,2025/02/22,SF FuneralFDC00000003F7Y250222,,220,,1580067.25
2025/03/04,2025/02/22,SF FuneralFDC00000007V5W250222,,126.5,,1580193.75
2025/03/04,2025/02/24,SF FuneralF1060252      250224,,126.5,,1580320.25
2025/03/04,2025/02/24,SF FuneralF1112530      250224,,126.5,,1580446.75
2025/03/04,2025/02/25,SF FuneralF992412       250225,,126.5,,1580573.25
2025/03/04,2025/02/25,SF FuneralF1127477      250225,,63.25,,1580636.5
2025/03/04,2025/02/26,SF FuneralF992310       250226,,126.5,,1580763
2025/03/04,2025/02/27,SF FuneralFDC00000006JT3250227,,126.5,,1580889.5
2025/03/04,2025/02/27,SF FuneralF809246       250227,,126.5,,1581016
2025/03/04,2025/02/28,SF FuneralFDC00000003WNV250228,,220,,1581236
2025/03/04,2025/02/28,SF FuneralFDC000000058V9250228,,126.5,,1581362.5
2025/03/04,2025/02/28,SF FuneralFDC00000006GXN250228,,126.5,,1581489
2025/03/04,2025/02/28,SF FuneralFDC00000006KCY250228,,126.5,,1581615.5
2025/03/04,2025/02/28,SF FuneralFDC00000007FK7250228,,126.5,,1581742
2025/03/04,2025/02/28,SF FuneralF900720       250228,,126.5,,1581868.5
2025/03/04,2025/02/28,SF FuneralF785787       250228,,63.25,,1581931.75
2025/03/04,2025/02/28,SF FuneralF1021387      250228,,126.5,,1582058.25
2025/03/04,2025/02/28,SF FuneralF1061063      250228,,191.5,,1582249.75
2025/03/04,2025/02/28,SF FuneralF1085281      250228,,126.5,,1582376.25
2025/03/04,2025/02/28,SF FuneralFDC0000000N59F250228,,126.5,,1582502.75
2025/03/04,2025/02/28,SF FuneralFDC0000000N997250228,,126.5,,1582629.25
2025/03/04,2025/02/28,SF FuneralF1116760      250228,,126.5,,1582755.75
2025/03/04,2025/02/28,SF FuneralF1118596      250228,,126.5,,1582882.25
2025/03/04,2025/02/28,SF FuneralFDC0000000PKNL250228,,126.5,,1583008.75
2025/03/04,2025/02/28,SF FuneralF1126195      250228,,126.5,,1583135.25
2025/03/04,2025/03/01,SF FuneralFDC00000006JN0250301,,126.5,,1583261.75
2025/03/04,2025/03/01,SF FuneralFDC0000000857G250301,,126.5,,1583388.25
2025/03/04,2025/03/01,SF FuneralFDC0000000860N250301,,126.5,,1583514.75
2025/03/04,2025/03/01,SF FuneralF799134       250301,,126.5,,1583641.25
2025/03/04,2025/03/01,SF FuneralF1085450      250301,,126.5,,1583767.75
2025/03/04,2025/03/03,SF FuneralFDC000000071RV250303,,126.5,,1583894.25
2025/03/04,2025/03/03,SF FuneralF820741       250303,,63.25,,1583957.5
2025/03/04,2025/03/03,SF FuneralF1102870      250303,,63.25,,1584020.75
2025/03/04,2025/02/25,SF FuneralF1132492      250225,,31.63,,1584052.38
2025/03/04,2025/02/28,SF FuneralF988945       250302,,31.63,,1584084.01
2025/03/04,2025/02/28,SF FuneralF1073818      250228,,31.63,,1584115.64
2025/03/04,2025/02/28,SF FuneralF1054780      250228,,31.63,,1584147.27
2025/03/04,2025/03/01,SF FuneralF1054925      250302,,31.63,,1584178.9
2025/03/04,2025/03/03,SF FuneralFDC00000005DFB250303,,31.63,,1584210.53
2025/03/04,2025/03/03,SF FuneralF819012       250303,,31.63,,1584242.16
2025/03/04,2025/03/03,SF FuneralF1073374      250303,,31.63,,1584273.79
2025/03/04,2025/03/03,SF FuneralF1103857      250303,,31.63,,1584305.42
2025/03/04,2025/03/03,SF FuneralF1131541      250303,,31.63,,1584337.05
2025/03/04,2025/02/28,SF FuneralF805275       250228,,31.63,,1584368.68
2025/03/04,2025/03/03,SF FuneralF1118005      250303,,31.63,,1584400.31
2025/03/04,2025/02/25,SF FuneralFDC0000000784N250225,,126.5,,1584526.81
2025/03/04,2025/02/25,SF FuneralF812495       250225,,126.5,,1584653.31
2025/03/04,2025/02/27,SF FuneralFDC000000073K5250227,,126.5,,1584779.81
2025/03/04,2025/02/27,SF FuneralFDC00000008KK6250227,,126.5,,1584906.31
2025/03/04,2025/02/27,SF FuneralFDC0000000FT33250227,,126.5,,1585032.81
2025/03/04,2025/02/28,SF FuneralF1079270      250228,,126.5,,1585159.31
2025/03/04,2025/02/28,SF FuneralF1083667      250228,,126.5,,1585285.81
2025/03/04,2025/02/28,SF FuneralF1117729      250228,,126.5,,1585412.31
2025/03/04,2025/02/28,SF FuneralF1129098      250228,,126.5,,1585538.81
2025/03/04,2025/03/01,SF FuneralFDC000000048Z6250301,,220,,1585758.81
2025/03/04,2025/03/01,SF FuneralF1121985      250301,,126.5,,1585885.31
2025/03/04,2025/03/03,SF FuneralFDC00000006VB5250302,,126.5,,1586011.81
2025/03/04,2025/03/03,SF FuneralFDC00000007F83250302,,126.5,,1586138.31
2025/03/04,2025/02/26,SF FuneralFDC00000002PY1250226,,220,,1586358.31
2025/03/04,2025/02/27,SF FuneralFDC00000007PP4250227,,126.5,,1586484.81
2025/03/04,2025/02/27,SF FuneralFDC00000007PSB250227,,126.5,,1586611.31
2025/03/04,2025/02/27,SF FuneralFDC00000007PZH250227,,126.5,,1586737.81
2025/03/04,2025/02/27,SF FuneralFDC00000007Q16250227,,126.5,,1586864.31
2025/03/04,2025/02/27,SF FuneralFDC00000007QL3250227,,126.5,,1586990.81
2025/03/04,2025/02/27,SF FuneralFDC00000007R6C250227,,126.5,,1587117.31
2025/03/04,2025/02/27,SF FuneralFDC00000007RT2250227,,126.5,,1587243.81
2025/03/04,2025/02/27,SF FuneralF1084581      250227,,126.5,,1587370.31
2025/03/04,2025/02/28,SF FuneralFDC00000002R0W250228,,220,,1587590.31
2025/03/04,2025/02/28,SF FuneralFDC00000002VVZ250228,,220,,1587810.31
2025/03/04,2025/02/28,SF FuneralFDC00000002VW3250228,,220,,1588030.31
2025/03/04,2025/02/28,SF FuneralFDC00000002W68250228,,220,,1588250.31
2025/03/04,2025/02/28,SF FuneralFDC000000030LY250228,,220,,1588470.31
2025/03/04,2025/02/28,SF FuneralFDC000000032T3250228,,220,,1588690.31
2025/03/04,2025/02/28,SF FuneralFDC000000032W4250228,,220,,1588910.31
2025/03/04,2025/02/28,SF FuneralFDC000000033F1250228,,220,,1589130.31
2025/03/04,2025/02/28,SF FuneralFDC000000033W4250228,,220,,1589350.31
2025/03/04,2025/02/28,SF FuneralFDC000000033X5250228,,220,,1589570.31
2025/03/04,2025/02/28,SF FuneralFDC000000034B7250228,,220,,1589790.31
2025/03/04,2025/02/28,SF FuneralFDC000000034B8250228,,220,,1590010.31
2025/03/04,2025/02/28,SF FuneralFDC000000034BB250228,,220,,1590230.31
2025/03/04,2025/02/28,SF FuneralFDC000000034C1250228,,220,,1590450.31
2025/03/04,2025/02/28,SF FuneralFDC000000035SY250228,,220,,1590670.31
2025/03/04,2025/02/28,SF FuneralFDC00000003B9R250228,,220,,1590890.31
2025/03/04,2025/02/28,SF FuneralFDC00000003CJC250228,,220,,1591110.31
2025/03/04,2025/02/28,SF FuneralFDC00000003CYL250228,,220,,1591330.31
2025/03/04,2025/02/28,SF FuneralFDC00000003K14250228,,220,,1591550.31
2025/03/04,2025/02/28,SF FuneralFDC00000003VPK250228,,220,,1591770.31
2025/03/04,2025/02/28,SF FuneralFDC00000003VQ7250228,,220,,1591990.31
2025/03/04,2025/02/28,SF FuneralFDC000000040N9250228,,220,,1592210.31
2025/03/04,2025/02/28,SF FuneralFDC0000000418B250228,,220,,1592430.31
2025/03/04,2025/02/28,SF FuneralFDC0000000419R250228,,220,,1592650.31
2025/03/04,2025/02/28,SF FuneralFDC000000042C3250228,,220,,1592870.31
2025/03/04,2025/02/28,SF FuneralFDC000000043KR250228,,220,,1593090.31
2025/03/04,2025/02/28,SF FuneralFDC000000043L7250228,,220,,1593310.31
2025/03/04,2025/02/28,SF FuneralFDC000000043LG250228,,220,,1593530.31
2025/03/04,2025/02/28,SF FuneralFDC000000043LL250228,,220,,1593750.31
2025/03/04,2025/02/28,SF FuneralFDC0000000493M250228,,220,,1593970.31
2025/03/04,2025/02/28,SF FuneralFDC000000049DM250228,,220,,1594190.31
2025/03/04,2025/02/28,SF FuneralFDC00000004GQD250228,,220,,1594410.31
2025/03/04,2025/02/28,SF FuneralFDC00000004HHF250228,,220,,1594630.31
2025/03/04,2025/02/28,SF FuneralFDC00000004YL3250228,,220,,1594850.31
2025/03/04,2025/02/28,SF FuneralFDC00000004YL6250228,,220,,1595070.31
2025/03/04,2025/02/28,SF FuneralFDC00000004ZXF250228,,126.5,,1595196.81
2025/03/04,2025/02/28,SF FuneralFDC000000056Q3250228,,126.5,,1595323.31
2025/03/04,2025/02/28,SF FuneralFDC0000000589Y250228,,126.5,,1595449.81
2025/03/04,2025/02/28,SF FuneralFDC00000005CT1250228,,126.5,,1595576.31
2025/03/04,2025/02/28,SF FuneralFDC00000005HZM250228,,126.5,,1595702.81
2025/03/04,2025/02/28,SF FuneralFDC00000005KLV250228,,126.5,,1595829.31
2025/03/04,2025/02/28,SF FuneralFDC00000005LRL250228,,126.5,,1595955.81
2025/03/04,2025/02/28,SF FuneralFDC00000005N0R250228,,126.5,,1596082.31
2025/03/04,2025/02/28,SF FuneralFDC00000005N42250228,,126.5,,1596208.81
2025/03/04,2025/02/28,SF FuneralFDC00000005NWF250228,,126.5,,1596335.31
2025/03/04,2025/02/28,SF FuneralFDC00000005NXS250228,,126.5,,1596461.81
2025/03/04,2025/02/28,SF FuneralFDC00000005S1V250228,,126.5,,1596588.31
2025/03/04,2025/02/28,SF FuneralFDC00000005SWZ250228,,126.5,,1596714.81
2025/03/04,2025/02/28,SF FuneralFDC00000005SXC250228,,126.5,,1596841.31
2025/03/04,2025/02/28,SF FuneralFDC00000005VYD250228,,126.5,,1596967.81
2025/03/04,2025/02/28,SF FuneralFDC00000005VZK250228,,126.5,,1597094.31
2025/03/04,2025/02/28,SF FuneralFDC00000005W03250228,,126.5,,1597220.81
2025/03/04,2025/02/28,SF FuneralFDC00000005WVZ250228,,220,,1597440.81
2025/03/04,2025/02/28,SF FuneralFDC00000005X6X250228,,220,,1597660.81
2025/03/04,2025/02/28,SF FuneralFDC00000005XZL250228,,220,,1597880.81
2025/03/04,2025/02/28,SF FuneralFDC00000005Y06250228,,126.5,,1598007.31
2025/03/04,2025/02/28,SF FuneralFDC00000005Y2T250228,,126.5,,1598133.81
2025/03/04,2025/02/28,SF FuneralFDC00000005Z53250228,,126.5,,1598260.31
2025/03/04,2025/02/28,SF FuneralFDC0000000600G250228,,220,,1598480.31
2025/03/04,2025/02/28,SF FuneralFDC000000063BY250228,,126.5,,1598606.81
2025/03/04,2025/02/28,SF FuneralFDC00000006853250228,,126.5,,1598733.31
2025/03/04,2025/02/28,SF FuneralFDC000000068GY250228,,126.5,,1598859.81
2025/03/04,2025/02/28,SF FuneralFDC000000068T2250228,,126.5,,1598986.31
2025/03/04,2025/02/28,SF FuneralFDC000000069HJ250228,,126.5,,1599112.81
2025/03/04,2025/02/28,SF FuneralFDC000000069HV250228,,126.5,,1599239.31
2025/03/04,2025/02/28,SF FuneralFDC000000069Q2250228,,126.5,,1599365.81
2025/03/04,2025/02/28,SF FuneralFDC00000006DQX250228,,126.5,,1599492.31
2025/03/04,2025/02/28,SF FuneralFDC00000006DW7250228,,126.5,,1599618.81
2025/03/04,2025/02/28,SF FuneralFDC00000006F07250228,,126.5,,1599745.31
2025/03/04,2025/02/28,SF FuneralFDC00000006GLP250228,,126.5,,1599871.81
2025/03/04,2025/02/28,SF FuneralFDC00000006GMR250228,,126.5,,1599998.31
2025/03/04,2025/02/28,SF FuneralFDC00000006K7P250228,,126.5,,1600124.81
2025/03/04,2025/02/28,SF FuneralFDC00000006PKB250228,,126.5,,1600251.31
2025/03/04,2025/02/28,SF FuneralFDC00000006QY3250228,,126.5,,1600377.81
2025/03/04,2025/02/28,SF FuneralFDC00000006XT5250228,,220,,1600597.81
2025/03/04,2025/02/28,SF FuneralFDC00000006Y5W250228,,126.5,,1600724.31
2025/03/04,2025/02/28,SF FuneralFDC0000000736Z250228,,126.5,,1600850.81
2025/03/04,2025/02/28,SF FuneralFDC000000073JC250228,,126.5,,1600977.31
2025/03/04,2025/02/28,SF FuneralFDC000000073L4250228,,126.5,,1601103.81
2025/03/04,2025/02/28,SF FuneralFDC0000000754C250228,,126.5,,1601230.31
2025/03/04,2025/02/28,SF FuneralFDC000000075LM250228,,126.5,,1601356.81
2025/03/04,2025/02/28,SF FuneralFDC000000075MQ250228,,126.5,,1601483.31
2025/03/04,2025/02/28,SF FuneralFDC000000075VC250228,,126.5,,1601609.81
2025/03/04,2025/02/28,SF FuneralFDC000000075XF250228,,220,,1601829.81
2025/03/04,2025/02/28,SF FuneralFDC000000078XR250228,,220,,1602049.81
2025/03/04,2025/02/28,SF FuneralFDC00000007B0G250228,,126.5,,1602176.31
2025/03/04,2025/02/28,SF FuneralFDC00000007C4H250228,,126.5,,1602302.81
2025/03/04,2025/02/28,SF FuneralFDC00000007FDL250228,,126.5,,1602429.31
2025/03/04,2025/02/28,SF FuneralFDC00000007GJM250228,,126.5,,1602555.81
2025/03/04,2025/02/28,SF FuneralFDC00000007P1L250228,,126.5,,1602682.31
2025/03/04,2025/02/28,SF FuneralFDC00000007PTG250228,,126.5,,1602808.81
2025/03/04,2025/02/28,SF FuneralFDC000000083JP250228,,126.5,,1602935.31
2025/03/04,2025/02/28,SF FuneralF781147       250228,,126.5,,1603061.81
2025/03/04,2025/02/28,SF FuneralFDC000000092TS250228,,126.5,,1603188.31
2025/03/04,2025/02/28,SF FuneralFDC00000009K4V250228,,126.5,,1603314.81
2025/03/04,2025/02/28,SF FuneralFDC0000000CH05250228,,126.5,,1603441.31
2025/03/04,2025/02/28,SF FuneralFDC0000000H8TQ250228,,126.5,,1603567.81
2025/03/04,2025/02/28,SF FuneralFDC0000000HKGV250301,,126.5,,1603694.31
2025/03/04,2025/02/28,SF FuneralF986769       250301,,126.5,,1603820.81
2025/03/04,2025/02/28,SF FuneralF987237       250301,,126.5,,1603947.31
2025/03/04,2025/02/28,SF FuneralF987560       250301,,126.5,,1604073.81
2025/03/04,2025/02/28,SF FuneralF987678       250301,,126.5,,1604200.31
2025/03/04,2025/02/28,SF FuneralF987844       250301,,126.5,,1604326.81
2025/03/04,2025/02/28,SF FuneralFDC0000000HVF5250301,,126.5,,1604453.31
2025/03/04,2025/02/28,SF FuneralF988158       250301,,126.5,,1604579.81
2025/03/04,2025/02/28,SF FuneralF988571       250301,,126.5,,1604706.31
2025/03/04,2025/02/28,SF FuneralF988920       250301,,126.5,,1604832.81
2025/03/04,2025/02/28,SF FuneralF1052293      250228,,126.5,,1604959.31
2025/03/04,2025/02/28,SF FuneralFDC0000000KS8Y250228,,126.5,,1605085.81
2025/03/04,2025/02/28,SF FuneralF1084367      250228,,126.5,,1605212.31
2025/03/04,2025/02/28,SF FuneralF1108757      250228,,126.5,,1605338.81
2025/03/04,2025/02/28,SF FuneralF1127898      250228,,126.5,,1605465.31
2025/03/04,2025/03/01,SF FuneralFDC00000002PXQ250301,,220,,1605685.31
2025/03/04,2025/03/01,SF FuneralFDC00000002QYZ250301,,220,,1605905.31
2025/03/04,2025/03/01,SF FuneralFDC00000002R7Y250301,,220,,1606125.31
2025/03/04,2025/03/01,SF FuneralFDC00000002RNB250301,,220,,1606345.31
2025/03/04,2025/03/01,SF FuneralFDC00000002SMF250301,,220,,1606565.31
2025/03/04,2025/03/01,SF FuneralFDC00000002SMG250301,,220,,1606785.31
2025/03/04,2025/03/01,SF FuneralFDC00000002TC5250301,,220,,1607005.31
2025/03/04,2025/03/01,SF FuneralFDC00000002TN6250301,,220,,1607225.31
2025/03/04,2025/03/01,SF FuneralFDC00000002TP2250301,,220.2,,1607445.51
2025/03/04,2025/03/01,SF FuneralFDC00000002TPH250301,,220,,1607665.51
2025/03/04,2025/03/01,SF FuneralFDC00000002TPK250301,,220,,1607885.51
2025/03/04,2025/03/01,SF FuneralFDC00000002TQ2250301,,220,,1608105.51
2025/03/04,2025/03/01,SF FuneralFDC00000002TR6250301,,220,,1608325.51
2025/03/04,2025/03/01,SF FuneralFDC00000002TVC250301,,220,,1608545.51
2025/03/04,2025/03/01,SF FuneralFDC00000002TW3250301,,220,,1608765.51
2025/03/04,2025/03/01,SF FuneralFDC00000002V0T250301,,220,,1608985.51
2025/03/04,2025/03/01,SF FuneralFDC00000002V19250301,,220,,1609205.51
2025/03/04,2025/03/01,SF FuneralFDC00000002V57250301,,220,,1609425.51
2025/03/04,2025/03/01,SF FuneralFDC00000002V5L250301,,220,,1609645.51
2025/03/04,2025/03/01,SF FuneralFDC00000002VR9250301,,220,,1609865.51
2025/03/04,2025/03/01,SF FuneralFDC00000002VWT250301,,220,,1610085.51
2025/03/04,2025/03/01,SF FuneralFDC00000002VWV250301,,220,,1610305.51
2025/03/04,2025/03/01,SF FuneralFDC00000002VWW250301,,220,,1610525.51
2025/03/04,2025/03/01,SF FuneralFDC00000002VZV250301,,220,,1610745.51
2025/03/04,2025/03/01,SF FuneralFDC00000002XBC250301,,220,,1610965.51
2025/03/04,2025/03/01,SF FuneralFDC00000002XMK250301,,220,,1611185.51
2025/03/04,2025/03/01,SF FuneralFDC00000002XNJ250301,,220,,1611405.51
2025/03/04,2025/03/01,SF FuneralFDC00000002XVQ250301,,220,,1611625.51
2025/03/04,2025/03/01,SF FuneralFDC00000002XY5250301,,220,,1611845.51
2025/03/04,2025/03/01,SF FuneralFDC00000002YHV250301,,220,,1612065.51
2025/03/04,2025/03/01,SF FuneralFDC00000002YQL250301,,220,,1612285.51
2025/03/04,2025/03/01,SF FuneralFDC00000002YVB250301,,220,,1612505.51
2025/03/04,2025/03/01,SF FuneralFDC00000002YYK250301,,220,,1612725.51
2025/03/04,2025/03/01,SF FuneralFDC00000002YZP250301,,220,,1612945.51
2025/03/04,2025/03/01,SF FuneralFDC00000002Z64250301,,220,,1613165.51
2025/03/04,2025/03/01,SF FuneralFDC000000030GX250301,,220,,1613385.51
2025/03/04,2025/03/01,SF FuneralFDC000000032WZ250301,,220,,1613605.51
2025/03/04,2025/03/01,SF FuneralFDC000000032X1250301,,220,,1613825.51
2025/03/04,2025/03/01,SF FuneralFDC000000032XP250301,,220,,1614045.51
2025/03/04,2025/03/01,SF FuneralFDC000000032YZ250301,,220,,1614265.51
2025/03/04,2025/03/01,SF FuneralFDC0000000330G250301,,220,,1614485.51
2025/03/04,2025/03/01,SF FuneralFDC0000000330H250301,,220,,1614705.51
2025/03/04,2025/03/01,SF FuneralFDC00000003315250301,,220,,1614925.51
2025/03/04,2025/03/01,SF FuneralFDC0000000335M250301,,220,,1615145.51
2025/03/04,2025/03/01,SF FuneralFDC0000000335P250301,,220,,1615365.51
2025/03/04,2025/03/01,SF FuneralFDC000000033P8250301,,220,,1615585.51
2025/03/04,2025/03/01,SF FuneralFDC000000033YY250301,,220,,1615805.51
2025/03/04,2025/03/01,SF FuneralFDC000000033ZH250301,,220,,1616025.51
2025/03/04,2025/03/01,SF FuneralFDC00000003452250301,,220,,1616245.51
2025/03/04,2025/03/01,SF FuneralFDC0000000347Q250301,,220,,1616465.51
2025/03/04,2025/03/01,SF FuneralFDC000000034FV250301,,220,,1616685.51
2025/03/04,2025/03/01,SF FuneralFDC000000034PZ250301,,220,,1616905.51
2025/03/04,2025/03/01,SF FuneralFDC000000034VV250301,,220,,1617125.51
2025/03/04,2025/03/01,SF FuneralFDC0000000356J250301,,220,,1617345.51
2025/03/04,2025/03/01,SF FuneralFDC000000035JR250301,,220,,1617565.51
2025/03/04,2025/03/01,SF FuneralFDC000000036CC250301,,220,,1617785.51
2025/03/04,2025/03/01,SF FuneralFDC000000036CJ250301,,220,,1618005.51
2025/03/04,2025/03/01,SF FuneralFDC00000003808250301,,220,,1618225.51
2025/03/04,2025/03/01,SF FuneralFDC0000000380T250301,,220,,1618445.51
2025/03/04,2025/03/01,SF FuneralFDC000000039CY250301,,220,,1618665.51
2025/03/04,2025/03/01,SF FuneralFDC000000039V7250301,,220,,1618885.51
2025/03/04,2025/03/01,SF FuneralFDC00000003B0L250301,,220,,1619105.51
2025/03/04,2025/03/01,SF FuneralFDC00000003BWG250301,,220,,1619325.51
2025/03/04,2025/03/01,SF FuneralFDC00000003BYC250301,,220,,1619545.51
2025/03/04,2025/03/01,SF FuneralFDC00000003BYD250301,,220,,1619765.51
2025/03/04,2025/03/01,SF FuneralFDC00000003C1G250301,,220,,1619985.51
2025/03/04,2025/03/01,SF FuneralFDC00000003C2Y250301,,220,,1620205.51
2025/03/04,2025/03/01,SF FuneralFDC00000003CJ7250301,,220,,1620425.51
2025/03/04,2025/03/01,SF FuneralFDC00000003CR0250301,,220,,1620645.51
2025/03/04,2025/03/01,SF FuneralFDC00000003CSQ250301,,220,,1620865.51
2025/03/04,2025/03/01,SF FuneralFDC00000003CX3250301,,220,,1621085.51
2025/03/04,2025/03/01,SF FuneralFDC00000003FCK250301,,220,,1621305.51
2025/03/04,2025/03/01,SF FuneralFDC00000003FQF250301,,220,,1621525.51
2025/03/04,2025/03/01,SF FuneralFDC00000003K0R250301,,220,,1621745.51
2025/03/04,2025/03/01,SF FuneralFDC00000003K1K250301,,220,,1621965.51
2025/03/04,2025/03/01,SF FuneralFDC00000003KBS250301,,220,,1622185.51
2025/03/04,2025/03/01,SF FuneralFDC00000003KTD250301,,220,,1622405.51
2025/03/04,2025/03/01,SF FuneralFDC00000003KVB250301,,220,,1622625.51
2025/03/04,2025/03/01,SF FuneralFDC00000003LDD250301,,220,,1622845.51
2025/03/04,2025/03/01,SF FuneralFDC00000003MBT250301,,220,,1623065.51
2025/03/04,2025/03/01,SF FuneralFDC00000003MFR250301,,220,,1623285.51
2025/03/04,2025/03/01,SF FuneralFDC00000003MFT250301,,220,,1623505.51
2025/03/04,2025/03/01,SF FuneralFDC00000003NQK250301,,220,,1623725.51
2025/03/04,2025/03/01,SF FuneralFDC00000003SJ7250301,,220,,1623945.51
2025/03/04,2025/03/01,SF FuneralFDC00000003VK9250301,,220,,1624165.51
2025/03/04,2025/03/01,SF FuneralFDC00000003X18250301,,220,,1624385.51
2025/03/04,2025/03/01,SF FuneralFDC00000003XFN250301,,220,,1624605.51
2025/03/04,2025/03/01,SF FuneralFDC00000003YGW250301,,220,,1624825.51
2025/03/04,2025/03/01,SF FuneralFDC000000040DR250301,,220,,1625045.51
2025/03/04,2025/03/01,SF FuneralFDC000000040F0250301,,220,,1625265.51
2025/03/04,2025/03/01,SF FuneralFDC000000040G2250301,,220,,1625485.51
2025/03/04,2025/03/01,SF FuneralFDC000000040SF250301,,220,,1625705.51
2025/03/04,2025/03/01,SF FuneralFDC000000043B6250301,,220,,1625925.51
2025/03/04,2025/03/01,SF FuneralFDC000000043CR250301,,220,,1626145.51
2025/03/04,2025/03/01,SF FuneralFDC000000043YG250301,,220,,1626365.51
2025/03/04,2025/03/01,SF FuneralFDC000000044S6250301,,220,,1626585.51
2025/03/04,2025/03/01,SF FuneralFDC000000046YP250301,,220,,1626805.51
2025/03/04,2025/03/01,SF FuneralFDC000000046ZK250301,,220,,1627025.51
2025/03/04,2025/03/01,SF FuneralFDC000000047BC250301,,220,,1627245.51
2025/03/04,2025/03/01,SF FuneralFDC00000004HJN250301,,220,,1627465.51
2025/03/04,2025/03/01,SF FuneralFDC00000004KSP250301,,220,,1627685.51
2025/03/04,2025/03/01,SF FuneralFDC00000004KSV250301,,220,,1627905.51
2025/03/04,2025/03/01,SF FuneralFDC00000004L1B250301,,220,,1628125.51
2025/03/04,2025/03/01,SF FuneralFDC00000004MPW250301,,220,,1628345.51
2025/03/04,2025/03/01,SF FuneralFDC00000004MQL250301,,220,,1628565.51
2025/03/04,2025/03/01,SF FuneralFDC00000004MRZ250301,,220,,1628785.51
2025/03/04,2025/03/01,SF FuneralFDC00000004MVB250301,,220,,1629005.51
2025/03/04,2025/03/01,SF FuneralFDC00000004TQK250301,,220,,1629225.51
2025/03/04,2025/03/01,SF FuneralFDC000000052HZ250301,,220,,1629445.51
2025/03/04,2025/03/01,SF FuneralFDC00000005754250301,,220,,1629665.51
2025/03/04,2025/03/01,SF FuneralFDC0000000577C250301,,126.5,,1629792.01
2025/03/04,2025/03/01,SF FuneralFDC000000058DM250301,,126.5,,1629918.51
2025/03/04,2025/03/01,SF FuneralFDC000000058P2250301,,220,,1630138.51
2025/03/04,2025/03/01,SF FuneralFDC000000058V5250301,,126.5,,1630265.01
2025/03/04,2025/03/01,SF FuneralFDC00000005BRP250301,,220,,1630485.01
2025/03/04,2025/03/01,SF FuneralFDC00000005BRT250301,,220,,1630705.01
2025/03/04,2025/03/01,SF FuneralFDC00000005BVW250301,,126.5,,1630831.51
2025/03/04,2025/03/01,SF FuneralFDC00000005CST250301,,126.5,,1630958.01
2025/03/04,2025/03/01,SF FuneralFDC00000005DG2250301,,126.5,,1631084.51
2025/03/04,2025/03/01,SF FuneralFDC00000005GFT250301,,126.5,,1631211.01
2025/03/04,2025/03/01,SF FuneralFDC00000005GWF250301,,126.5,,1631337.51
2025/03/04,2025/03/01,SF FuneralFDC00000005H0F250301,,126.5,,1631464.01
2025/03/04,2025/03/01,SF FuneralFDC00000005H3Y250301,,126.5,,1631590.51
2025/03/04,2025/03/01,SF FuneralFDC00000005H4Z250301,,126.5,,1631717.01
2025/03/04,2025/03/01,SF FuneralFDC00000005H92250301,,126.5,,1631843.51
2025/03/04,2025/03/01,SF FuneralFDC00000005J15250301,,220,,1632063.51
2025/03/04,2025/03/01,SF FuneralFDC00000005J7S250301,,126.5,,1632190.01
2025/03/04,2025/03/01,SF FuneralFDC00000005JC8250301,,126.5,,1632316.51
2025/03/04,2025/03/01,SF FuneralFDC00000005JDP250301,,126.5,,1632443.01
2025/03/04,2025/03/01,SF FuneralFDC00000005KDS250301,,220,,1632663.01
2025/03/04,2025/03/01,SF FuneralFDC00000005L39250301,,126.5,,1632789.51
2025/03/04,2025/03/01,SF FuneralFDC00000005LJY250301,,126.5,,1632916.01
2025/03/04,2025/03/01,SF FuneralFDC00000005LZV250301,,220,,1633136.01
2025/03/04,2025/03/01,SF FuneralFDC00000005M13250301,,126.5,,1633262.51
2025/03/04,2025/03/01,SF FuneralFDC00000005M6T250301,,220,,1633482.51
2025/03/04,2025/03/01,SF FuneralFDC00000005M7K250301,,220,,1633702.51
2025/03/04,2025/03/01,SF FuneralFDC00000005MGP250301,,126.5,,1633829.01
2025/03/04,2025/03/01,SF FuneralFDC00000005MMT250301,,126.5,,1633955.51
2025/03/04,2025/03/01,SF FuneralFDC00000005MNB250301,,220,,1634175.51
2025/03/04,2025/03/01,SF FuneralFDC00000005MPT250301,,126.5,,1634302.01
2025/03/04,2025/03/01,SF FuneralFDC00000005MRG250301,,220,,1634522.01
2025/03/04,2025/03/01,SF FuneralFDC00000005MXY250301,,126.5,,1634648.51
2025/03/04,2025/03/01,SF FuneralFDC00000005N9D250301,,126.5,,1634775.01
2025/03/04,2025/03/01,SF FuneralFDC00000005Q0L250301,,126.5,,1634901.51
2025/03/04,2025/03/01,SF FuneralFDC00000005Q3K250301,,126.5,,1635028.01
2025/03/04,2025/03/01,SF FuneralFDC00000005QF5250301,,126.5,,1635154.51
2025/03/04,2025/03/01,SF FuneralFDC00000005RJC250301,,126.5,,1635281.01
2025/03/04,2025/03/01,SF FuneralFDC00000005RV7250301,,220,,1635501.01
2025/03/04,2025/03/01,SF FuneralFDC00000005RVB250301,,220,,1635721.01
2025/03/04,2025/03/01,SF FuneralFDC00000005RVV250301,,220,,1635941.01
2025/03/04,2025/03/01,SF FuneralFDC00000005RZ0250301,,126.5,,1636067.51
2025/03/04,2025/03/01,SF FuneralFDC00000005S1G250301,,256.5,,1636324.01
2025/03/04,2025/03/01,SF FuneralFDC00000005S4Z250301,,220,,1636544.01
2025/03/04,2025/03/01,SF FuneralFDC00000005SNM250301,,126.5,,1636670.51
2025/03/04,2025/03/01,SF FuneralFDC00000005TWK250301,,126.5,,1636797.01
2025/03/04,2025/03/01,SF FuneralFDC00000005TZQ250301,,220,,1637017.01
2025/03/04,2025/03/01,SF FuneralFDC00000005TZR250301,,220,,1637237.01
2025/03/04,2025/03/01,SF FuneralFDC00000005V04250301,,126.5,,1637363.51
2025/03/04,2025/03/01,SF FuneralFDC00000005V0F250301,,126.5,,1637490.01
2025/03/04,2025/03/01,SF FuneralFDC00000005V73250301,,126.5,,1637616.51
2025/03/04,2025/03/01,SF FuneralFDC00000005VNB250301,,126.5,,1637743.01
2025/03/04,2025/03/01,SF FuneralFDC00000005VW3250301,,126.5,,1637869.51
2025/03/04,2025/03/01,SF FuneralFDC00000005VZQ250301,,126.5,,1637996.01
2025/03/04,2025/03/01,SF FuneralFDC00000005WMN250301,,126.5,,1638122.51
2025/03/04,2025/03/01,SF FuneralFDC00000005WXX250301,,220,,1638342.51
2025/03/04,2025/03/01,SF FuneralFDC00000005X6Y250301,,126.5,,1638469.01
2025/03/04,2025/03/01,SF FuneralFDC000000060QD250301,,126.5,,1638595.51
2025/03/04,2025/03/01,SF FuneralFDC0000000641N250301,,126.5,,1638722.01
2025/03/04,2025/03/01,SF FuneralFDC0000000643Q250301,,126.5,,1638848.51
2025/03/04,2025/03/01,SF FuneralFDC0000000643R250301,,220,,1639068.51
2025/03/04,2025/03/01,SF FuneralFDC0000000675Q250301,,126.5,,1639195.01
2025/03/04,2025/03/01,SF FuneralFDC000000067KP250301,,126.5,,1639321.51
2025/03/04,2025/03/01,SF FuneralFDC000000067LS250301,,126.5,,1639448.01
2025/03/04,2025/03/01,SF FuneralFDC000000067T7250301,,126.5,,1639574.51
2025/03/04,2025/03/01,SF FuneralFDC000000067F4250301,,126.5,,1639701.01
2025/03/04,2025/03/01,SF FuneralFDC000000067N1250301,,126.5,,1639827.51
2025/03/04,2025/03/01,SF FuneralFDC000000067R0250301,,126.5,,1639954.01
2025/03/04,2025/03/01,SF FuneralFDC000000067VP250301,,126.5,,1640080.51
2025/03/04,2025/03/01,SF FuneralFDC00000006817250301,,126.5,,1640207.01
2025/03/04,2025/03/01,SF FuneralFDC0000000684H250301,,126.5,,1640333.51
2025/03/04,2025/03/01,SF FuneralFDC0000000687N250301,,126.5,,1640460.01
2025/03/04,2025/03/01,SF FuneralFDC000000068FL250301,,126.5,,1640586.51
2025/03/04,2025/03/01,SF FuneralFDC000000068HR250301,,126.5,,1640713.01
2025/03/04,2025/03/01,SF FuneralFDC000000068NQ250301,,126.5,,1640839.51
2025/03/04,2025/03/01,SF FuneralFDC000000068Q5250301,,126.5,,1640966.01
2025/03/04,2025/03/01,SF FuneralFDC00000006916250301,,126.5,,1641092.51
2025/03/04,2025/03/01,SF FuneralFDC0000000697L250301,,126.5,,1641219.01
2025/03/04,2025/03/01,SF FuneralFDC0000000699P250301,,126.5,,1641345.51
2025/03/04,2025/03/01,SF FuneralFDC000000069CC250301,,126.5,,1641472.01
2025/03/04,2025/03/01,SF FuneralFDC000000069HR250301,,126.5,,1641598.51
2025/03/04,2025/03/01,SF FuneralFDC000000069HS250301,,126.5,,1641725.01
2025/03/04,2025/03/01,SF FuneralFDC000000069MX250301,,126.5,,1641851.51
2025/03/04,2025/03/01,SF FuneralFDC000000069TZ250301,,220,,1642071.51
2025/03/04,2025/03/01,SF FuneralFDC00000006B07250301,,126.5,,1642198.01
2025/03/04,2025/03/01,SF FuneralFDC00000006B9C250301,,126.5,,1642324.51
2025/03/04,2025/03/01,SF FuneralFDC00000006BGY250301,,126.5,,1642451.01
2025/03/04,2025/03/01,SF FuneralFDC00000006BJ8250301,,126.5,,1642577.51
2025/03/04,2025/03/01,SF FuneralFDC00000006BLW250301,,126.5,,1642704.01
2025/03/04,2025/03/01,SF FuneralFDC00000006BYL250301,,126.5,,1642830.51
2025/03/04,2025/03/01,SF FuneralFDC00000006CNT250301,,126.5,,1642957.01
2025/03/04,2025/03/01,SF FuneralFDC00000006CQ8250301,,126.5,,1643083.51
2025/03/04,2025/03/01,SF FuneralFDC00000006CXR250301,,126.5,,1643210.01
2025/03/04,2025/03/01,SF FuneralFDC00000006D3P250301,,126.5,,1643336.51
2025/03/04,2025/03/01,SF FuneralFDC00000006D6P250301,,126.5,,1643463.01
2025/03/04,2025/03/01,SF FuneralFDC00000006D7Y250301,,126.5,,1643589.51
2025/03/04,2025/03/01,SF FuneralFDC00000006D92250301,,126.5,,1643716.01
2025/03/04,2025/03/01,SF FuneralFDC00000006DGP250301,,126.5,,1643842.51
2025/03/04,2025/03/01,SF FuneralFDC00000006DLB250301,,126.5,,1643969.01
2025/03/04,2025/03/01,SF FuneralFDC00000006DSF250301,,126.5,,1644095.51
2025/03/04,2025/03/01,SF FuneralFDC00000006DWS250301,,126.5,,1644222.01
2025/03/04,2025/03/01,SF FuneralFDC00000006DX9250301,,126.5,,1644348.51
2025/03/04,2025/03/01,SF FuneralFDC00000006DXC250301,,126.5,,1644475.01
2025/03/04,2025/03/01,SF FuneralFDC00000006DYF250301,,126.5,,1644601.51
2025/03/04,2025/03/01,SF FuneralFDC00000006DYK250301,,126.5,,1644728.01
2025/03/04,2025/03/01,SF FuneralFDC00000006F1X250301,,126.5,,1644854.51
2025/03/04,2025/03/01,SF FuneralFDC00000006F6D250301,,126.5,,1644981.01
2025/03/04,2025/03/01,SF FuneralFDC00000006F9Y250301,,126.5,,1645107.51
2025/03/04,2025/03/01,SF FuneralFDC00000006FB9250301,,126.5,,1645234.01
2025/03/04,2025/03/01,SF FuneralFDC00000006FTQ250301,,126.5,,1645360.51
2025/03/04,2025/03/01,SF FuneralFDC00000006G1G250301,,126.5,,1645487.01
2025/03/04,2025/03/01,SF FuneralFDC00000006G38250301,,126.5,,1645613.51
2025/03/04,2025/03/01,SF FuneralFDC00000006G6F250301,,126.5,,1645740.01
2025/03/04,2025/03/01,SF FuneralFDC00000006GJS250301,,126.5,,1645866.51
2025/03/04,2025/03/01,SF FuneralFDC00000006GJX250301,,126.5,,1645993.01
2025/03/04,2025/03/01,SF FuneralFDC00000006GKJ250301,,126.5,,1646119.51
2025/03/04,2025/03/01,SF FuneralFDC00000006GQ2250301,,126.5,,1646246.01
2025/03/04,2025/03/01,SF FuneralFDC00000006GT3250301,,126.5,,1646372.51
2025/03/04,2025/03/01,SF FuneralFDC00000006GY4250301,,126.5,,1646499.01
2025/03/04,2025/03/01,SF FuneralFDC00000006H0R250301,,126.5,,1646625.51
2025/03/04,2025/03/01,SF FuneralFDC00000006H42250301,,126.5,,1646752.01
2025/03/04,2025/03/01,SF FuneralFDC00000006H6T250301,,126.5,,1646878.51
2025/03/04,2025/03/01,SF FuneralFDC00000006HK1250301,,126.5,,1647005.01
2025/03/04,2025/03/01,SF FuneralFDC00000006J0X250301,,126.5,,1647131.51
2025/03/04,2025/03/01,SF FuneralFDC00000006JFT250301,,126.5,,1647258.01
2025/03/04,2025/03/01,SF FuneralFDC00000006JG1250301,,126.5,,1647384.51
2025/03/04,2025/03/01,SF FuneralFDC00000006JG9250301,,126.5,,1647511.01
2025/03/04,2025/03/01,SF FuneralFDC00000006JJD250301,,126.5,,1647637.51
2025/03/04,2025/03/01,SF FuneralFDC00000006KVC250301,,126.5,,1647764.01
2025/03/04,2025/03/01,SF FuneralFDC00000006J3J250301,,126.5,,1647890.51
2025/03/04,2025/03/01,SF FuneralFDC00000006JJP250301,,126.5,,1648017.01
2025/03/04,2025/03/01,SF FuneralFDC00000006KHG250301,,126.5,,1648143.51
2025/03/04,2025/03/01,SF FuneralFDC00000006KPF250301,,126.5,,1648270.01
2025/03/04,2025/03/01,SF FuneralFDC00000006KT5250301,,126.5,,1648396.51
2025/03/04,2025/03/01,SF FuneralFDC00000006L06250301,,126.5,,1648523.01
2025/03/04,2025/03/01,SF FuneralFDC00000006L7C250301,,126.5,,1648649.51
2025/03/04,2025/03/01,SF FuneralFDC00000006L7S250301,,126.5,,1648776.01
2025/03/04,2025/03/01,SF FuneralFDC00000006L8L250301,,126.5,,1648902.51
2025/03/04,2025/03/01,SF FuneralFDC00000006LB4250301,,126.5,,1649029.01
2025/03/04,2025/03/01,SF FuneralFDC00000006LB8250301,,126.5,,1649155.51
2025/03/04,2025/03/01,SF FuneralFDC00000006LC0250301,,126.5,,1649282.01
2025/03/04,2025/03/01,SF FuneralFDC00000006LC8250301,,126.5,,1649408.51
2025/03/04,2025/03/01,SF FuneralFDC00000006LGJ250301,,126.5,,1649535.01
2025/03/04,2025/03/01,SF FuneralFDC00000006LM6250301,,126.5,,1649661.51
2025/03/04,2025/03/01,SF FuneralFDC00000006LPB250301,,126.5,,1649788.01
2025/03/04,2025/03/01,SF FuneralFDC00000006LQ0250301,,126.5,,1649914.51
2025/03/04,2025/03/01,SF FuneralFDC00000006LZ2250301,,126.5,,1650041.01
2025/03/04,2025/03/01,SF FuneralFDC00000006M1R250301,,126.5,,1650167.51
2025/03/04,2025/03/01,SF FuneralFDC00000006M1W250301,,126.5,,1650294.01
2025/03/04,2025/03/01,SF FuneralFDC00000006MLL250301,,126.5,,1650420.51
2025/03/04,2025/03/01,SF FuneralFDC00000006MMH250301,,126.5,,1650547.01
2025/03/04,2025/03/01,SF FuneralFDC00000006N1W250301,,126.5,,1650673.51
2025/03/04,2025/03/01,SF FuneralFDC00000006NNY250301,,126.5,,1650800.01
2025/03/04,2025/03/01,SF FuneralFDC00000006NPB250301,,126.5,,1650926.51
2025/03/04,2025/03/01,SF FuneralFDC00000006P5D250301,,126.5,,1651053.01
2025/03/04,2025/03/01,SF FuneralFDC00000006Q52250301,,126.5,,1651179.51
2025/03/04,2025/03/01,SF FuneralFDC00000006Q70250301,,126.5,,1651306.01
2025/03/04,2025/03/01,SF FuneralFDC00000006Q73250301,,126.5,,1651432.51
2025/03/04,2025/03/01,SF FuneralFDC00000006Q93250301,,126.5,,1651559.01
2025/03/04,2025/03/01,SF FuneralFDC00000006QH0250301,,126.5,,1651685.51
2025/03/04,2025/03/01,SF FuneralFDC00000006QH6250301,,126.5,,1651812.01
2025/03/04,2025/03/01,SF FuneralFDC00000006QKY250301,,126.5,,1651938.51
2025/03/04,2025/03/01,SF FuneralFDC00000006R3K250301,,126.5,,1652065.01
2025/03/04,2025/03/01,SF FuneralFDC00000006R6H250301,,126.5,,1652191.51
2025/03/04,2025/03/01,SF FuneralFDC00000006RVQ250301,,126.5,,1652318.01
2025/03/04,2025/03/01,SF FuneralFDC00000006TH0250301,,126.5,,1652444.51
2025/03/04,2025/03/01,SF FuneralFDC00000006VDF250301,,126.5,,1652571.01
2025/03/04,2025/03/01,SF FuneralFDC00000006W4Q250301,,126.5,,1652697.51
2025/03/04,2025/03/01,SF FuneralFDC00000006X5T250301,,126.5,,1652824.01
2025/03/04,2025/03/01,SF FuneralFDC00000006VZZ250301,,126.5,,1652950.51
2025/03/04,2025/03/01,SF FuneralFDC00000006WRF250301,,126.5,,1653077.01
2025/03/04,2025/03/01,SF FuneralFDC00000006WW9250301,,126.5,,1653203.51
2025/03/04,2025/03/01,SF FuneralFDC00000006XMT250301,,126.5,,1653330.01
2025/03/04,2025/03/01,SF FuneralFDC00000006XN4250301,,126.5,,1653456.51
2025/03/04,2025/03/01,SF FuneralFDC00000006XP7250301,,191.5,,1653648.01
2025/03/04,2025/03/01,SF FuneralFDC00000006XSL250301,,126.5,,1653774.51
2025/03/04,2025/03/01,SF FuneralFDC0000000709J250301,,126.5,,1653901.01
2025/03/04,2025/03/01,SF FuneralFDC000000070ZF250301,,126.5,,1654027.51
2025/03/04,2025/03/01,SF FuneralFDC0000000736W250301,,126.5,,1654154.01
2025/03/04,2025/03/01,SF FuneralFDC0000000738D250301,,126.5,,1654280.51
2025/03/04,2025/03/01,SF FuneralFDC0000000738L250301,,126.5,,1654407.01
2025/03/04,2025/03/01,SF FuneralFDC00000007391250301,,126.5,,1654533.51
2025/03/04,2025/03/01,SF FuneralFDC000000073BS250301,,126.5,,1654660.01
2025/03/04,2025/03/01,SF FuneralFDC000000073CC250301,,126.5,,1654786.51
2025/03/04,2025/03/01,SF FuneralFDC000000073HC250301,,126.5,,1654913.01
2025/03/04,2025/03/01,SF FuneralFDC000000073M1250301,,126.5,,1655039.51
2025/03/04,2025/03/01,SF FuneralFDC000000073NJ250301,,126.5,,1655166.01
2025/03/04,2025/03/01,SF FuneralFDC000000073S4250301,,126.5,,1655292.51
2025/03/04,2025/03/01,SF FuneralFDC000000073XR250301,,126.5,,1655419.01
2025/03/04,2025/03/01,SF FuneralFDC000000073Y8250301,,126.5,,1655545.51
2025/03/04,2025/03/01,SF FuneralFDC000000073ZY250301,,126.5,,1655672.01
2025/03/04,2025/03/01,SF FuneralFDC0000000742T250301,,126.5,,1655798.51
2025/03/04,2025/03/01,SF FuneralFDC0000000743B250301,,126.5,,1655925.01
2025/03/04,2025/03/01,SF FuneralFDC0000000744H250301,,126.5,,1656051.51
2025/03/04,2025/03/01,SF FuneralFDC0000000749J250301,,126.5,,1656178.01
2025/03/04,2025/03/01,SF FuneralFDC000000074DX250301,,126.5,,1656304.51
2025/03/04,2025/03/01,SF FuneralFDC000000074FS250301,,126.5,,1656431.01
2025/03/04,2025/03/01,SF FuneralFDC000000074J2250301,,126.5,,1656557.51
2025/03/04,2025/03/01,SF FuneralFDC000000074NQ250301,,126.5,,1656684.01
2025/03/04,2025/03/01,SF FuneralFDC000000074SX250301,,126.5,,1656810.51
2025/03/04,2025/03/01,SF FuneralFDC000000074TC250301,,126.5,,1656937.01
2025/03/04,2025/03/01,SF FuneralFDC000000074TJ250301,,126.5,,1657063.51
2025/03/04,2025/03/01,SF FuneralFDC0000000755Z250301,,126.5,,1657190.01
2025/03/04,2025/03/01,SF FuneralFDC00000007585250301,,126.5,,1657316.51
2025/03/04,2025/03/01,SF FuneralFDC000000075QQ250301,,126.5,,1657443.01
2025/03/04,2025/03/01,SF FuneralFDC000000075X3250301,,126.5,,1657569.51
2025/03/04,2025/03/01,SF FuneralFDC000000075YC250301,,126.5,,1657696.01
2025/03/04,2025/03/01,SF FuneralFDC0000000760Z250301,,126.5,,1657822.51
2025/03/04,2025/03/01,SF FuneralFDC0000000764W250301,,126.5,,1657949.01
2025/03/04,2025/03/01,SF FuneralFDC000000076B0250301,,126.5,,1658075.51
2025/03/04,2025/03/01,SF FuneralFDC000000076HZ250301,,126.5,,1658202.01
2025/03/04,2025/03/01,SF FuneralFDC000000076MP250301,,126.5,,1658328.51
2025/03/04,2025/03/01,SF FuneralFDC000000076QH250301,,126.5,,1658455.01
2025/03/04,2025/03/01,SF FuneralFDC0000000772C250301,,126.5,,1658581.51
2025/03/04,2025/03/01,SF FuneralFDC000000077XB250301,,126.5,,1658708.01
2025/03/04,2025/03/01,SF FuneralFDC0000000780B250301,,126.5,,1658834.51
2025/03/04,2025/03/01,SF FuneralFDC0000000784Y250301,,126.5,,1658961.01
2025/03/04,2025/03/01,SF FuneralFDC00000007856250301,,126.5,,1659087.51
2025/03/04,2025/03/01,SF FuneralFDC000000078NR250301,,126.5,,1659214.01
2025/03/04,2025/03/01,SF FuneralFDC000000078Q5250301,,126.5,,1659340.51
2025/03/04,2025/03/01,SF FuneralFDC000000078T5250301,,126.5,,1659467.01
2025/03/04,2025/03/01,SF FuneralFDC000000079V2250301,,126.5,,1659593.51
2025/03/04,2025/03/01,SF FuneralFDC00000007B42250301,,126.5,,1659720.01
2025/03/04,2025/03/01,SF FuneralFDC00000007B45250301,,126.5,,1659846.51
2025/03/04,2025/03/01,SF FuneralFDC00000007B48250301,,126.5,,1659973.01
2025/03/04,2025/03/01,SF FuneralFDC00000007B4K250301,,126.5,,1660099.51
2025/03/04,2025/03/01,SF FuneralFDC00000007BCJ250301,,126.5,,1660226.01
2025/03/04,2025/03/01,SF FuneralFDC00000007BF2250301,,126.5,,1660352.51
2025/03/04,2025/03/01,SF FuneralFDC00000007BQP250301,,126.5,,1660479.01
2025/03/04,2025/03/01,SF FuneralFDC00000007C0Q250301,,126.5,,1660605.51
2025/03/04,2025/03/01,SF FuneralFDC00000007CNN250301,,126.5,,1660732.01
2025/03/04,2025/03/01,SF FuneralFDC00000007DYV250301,,126.5,,1660858.51
2025/03/04,2025/03/01,SF FuneralFDC00000007F7W250301,,126.5,,1660985.01
2025/03/04,2025/03/01,SF FuneralFDC00000007FVG250301,,126.5,,1661111.51
2025/03/04,2025/03/01,SF FuneralFDC00000007FWT250301,,126.5,,1661238.01
2025/03/04,2025/03/01,SF FuneralFDC00000007H5F250301,,126.5,,1661364.51
2025/03/04,2025/03/01,SF FuneralFDC00000007J1Z250301,,126.5,,1661491.01
2025/03/04,2025/03/01,SF FuneralFDC00000007JHQ250301,,126.5,,1661617.51
2025/03/04,2025/03/01,SF FuneralFDC00000007JPF250301,,126.5,,1661744.01
2025/03/04,2025/03/01,SF FuneralFDC00000007K29250301,,126.5,,1661870.51
2025/03/04,2025/03/01,SF FuneralFDC00000007KR7250301,,126.5,,1661997.01
2025/03/04,2025/03/01,SF FuneralFDC00000007P1J250301,,126.5,,1662123.51
2025/03/04,2025/03/01,SF FuneralFDC00000007P8K250301,,126.5,,1662250.01
2025/03/04,2025/03/01,SF FuneralFDC00000007PKF250301,,126.5,,1662376.51
2025/03/04,2025/03/01,SF FuneralFDC00000007PL9250301,,126.5,,1662503.01
2025/03/04,2025/03/01,SF FuneralFDC00000007PR7250301,,126.5,,1662629.51
2025/03/04,2025/03/01,SF FuneralFDC00000007PZK250301,,126.5,,1662756.01
2025/03/04,2025/03/01,SF FuneralFDC00000007Q01250301,,126.5,,1662882.51
2025/03/04,2025/03/01,SF FuneralFDC00000007Q49250301,,126.5,,1663009.01
2025/03/04,2025/03/01,SF FuneralFDC00000007Q52250301,,126.5,,1663135.51
2025/03/04,2025/03/01,SF FuneralFDC00000007QC4250301,,126.5,,1663262.01
2025/03/04,2025/03/01,SF FuneralFDC00000007QCR250301,,126.5,,1663388.51
2025/03/04,2025/03/01,SF FuneralFDC00000007QG5250301,,126.5,,1663515.01
2025/03/04,2025/03/01,SF FuneralFDC00000007QGQ250301,,126.5,,1663641.51
2025/03/04,2025/03/01,SF FuneralFDC00000007Q5C250301,,126.5,,1663768.01
2025/03/04,2025/03/01,SF FuneralFDC00000007Q6N250301,,126.5,,1663894.51
2025/03/04,2025/03/01,SF FuneralFDC00000007Q7Y250301,,126.5,,1664021.01
2025/03/04,2025/03/01,SF FuneralF793894       250301,,126.5,,1664147.51
2025/03/04,2025/03/01,SF FuneralFDC00000007QM0250301,,126.5,,1664274.01
2025/03/04,2025/03/01,SF FuneralFDC00000007QVN250301,,126.5,,1664400.51
2025/03/04,2025/03/01,SF FuneralFDC00000007R0S250301,,126.5,,1664527.01
2025/03/04,2025/03/01,SF FuneralFDC00000007R1F250301,,126.5,,1664653.51
2025/03/04,2025/03/01,SF FuneralFDC00000007R30250301,,126.5,,1664780.01
2025/03/04,2025/03/01,SF FuneralFDC00000007R38250301,,126.5,,1664906.51
2025/03/04,2025/03/01,SF FuneralFDC00000007R5X250301,,126.5,,1665033.01
2025/03/04,2025/03/01,SF FuneralFDC00000007R9B250301,,126.5,,1665159.51
2025/03/04,2025/03/01,SF FuneralFDC00000007RBR250301,,126.5,,1665286.01
2025/03/04,2025/03/01,SF FuneralFDC00000007RCQ250301,,126.5,,1665412.51
2025/03/04,2025/03/01,SF FuneralF794244       250301,,126.5,,1665539.01
2025/03/04,2025/03/01,SF FuneralFDC00000007RKT250301,,126.5,,1665665.51
2025/03/04,2025/03/01,SF FuneralFDC00000007RSQ250301,,220,,1665885.51
2025/03/04,2025/03/01,SF FuneralFDC00000007RX0250301,,220,,1666105.51
2025/03/04,2025/03/01,SF FuneralFDC00000007S45250301,,126.5,,1666232.01
2025/03/04,2025/03/01,SF FuneralFDC00000007SGP250301,,126.5,,1666358.51
2025/03/04,2025/03/01,SF FuneralFDC00000007SHM250301,,126.5,,1666485.01
2025/03/04,2025/03/01,SF FuneralFDC00000007SRS250301,,126.5,,1666611.51
2025/03/04,2025/03/01,SF FuneralFDC00000007SX9250301,,126.5,,1666738.01
2025/03/04,2025/03/01,SF FuneralFDC00000007TBG250301,,126.5,,1666864.51
2025/03/04,2025/03/01,SF FuneralFDC00000007TJN250301,,126.5,,1666991.01
2025/03/04,2025/03/01,SF FuneralFDC00000007TWP250301,,126.5,,1667117.51
2025/03/04,2025/03/01,SF FuneralFDC00000007VRH250301,,126.5,,1667244.01
2025/03/04,2025/03/01,SF FuneralFDC00000007VTV250301,,126.5,,1667370.51
2025/03/04,2025/03/01,SF FuneralFDC00000007W0G250301,,126.5,,1667497.01
2025/03/04,2025/03/01,SF FuneralFDC00000007W38250301,,126.5,,1667623.51
2025/03/04,2025/03/01,SF FuneralFDC00000007W9X250301,,126.5,,1667750.01
2025/03/04,2025/03/01,SF FuneralFDC00000007WDP250301,,126.5,,1667876.51
2025/03/04,2025/03/01,SF FuneralFDC00000007X6R250301,,126.5,,1668003.01
2025/03/04,2025/03/01,SF FuneralF795949       250301,,126.5,,1668129.51
2025/03/04,2025/03/01,SF FuneralF795982       250301,,126.5,,1668256.01
2025/03/04,2025/03/01,SF FuneralFDC00000007Z7B250301,,126.5,,1668382.51
2025/03/04,2025/03/01,SF FuneralF796095       250301,,126.5,,1668509.01
2025/03/04,2025/03/01,SF FuneralFDC00000007XR9250301,,126.5,,1668635.51
2025/03/04,2025/03/01,SF FuneralFDC00000007YNM250301,,126.5,,1668762.01
2025/03/04,2025/03/01,SF FuneralFDC00000007ZDP250301,,126.5,,1668888.51
2025/03/04,2025/03/01,SF FuneralFDC00000007ZM4250301,,126.5,,1669015.01
2025/03/04,2025/03/01,SF FuneralFDC0000000835Y250301,,126.5,,1669141.51
2025/03/04,2025/03/01,SF FuneralFDC000000083DK250301,,126.5,,1669268.01
2025/03/04,2025/03/01,SF FuneralFDC000000083K7250301,,126.5,,1669394.51
2025/03/04,2025/03/01,SF FuneralFDC000000083M4250301,,126.5,,1669521.01
2025/03/04,2025/03/01,SF FuneralFDC000000084LY250301,,126.5,,1669647.51
2025/03/04,2025/03/01,SF FuneralF798346       250301,,126.5,,1669774.01
2025/03/04,2025/03/01,SF FuneralFDC000000084Q6250301,,126.5,,1669900.51
2025/03/04,2025/03/01,SF FuneralFDC000000084R6250301,,126.5,,1670027.01
2025/03/04,2025/03/01,SF FuneralFDC0000000858M250301,,126.5,,1670153.51
2025/03/04,2025/03/01,SF FuneralFDC000000085BW250301,,126.5,,1670280.01
2025/03/04,2025/03/01,SF FuneralFDC000000085PG250301,,126.5,,1670406.51
2025/03/04,2025/03/01,SF FuneralFDC000000085SN250301,,126.5,,1670533.01
2025/03/04,2025/03/01,SF FuneralFDC0000000860K250301,,126.5,,1670659.51
2025/03/04,2025/03/01,SF FuneralFDC00000008692250301,,126.5,,1670786.01
2025/03/04,2025/03/01,SF FuneralFDC0000000869T250301,,126.5,,1670912.51
2025/03/04,2025/03/01,SF FuneralFDC000000086QY250301,,126.5,,1671039.01
2025/03/04,2025/03/01,SF FuneralFDC000000086T2250301,,126.5,,1671165.51
2025/03/04,2025/03/01,SF FuneralFDC000000086TV250301,,126.5,,1671292.01
2025/03/04,2025/03/01,SF FuneralFDC000000087B5250301,,126.5,,1671418.51
2025/03/04,2025/03/01,SF FuneralFDC000000087D2250301,,126.5,,1671545.01
2025/03/04,2025/03/01,SF FuneralF799602       250301,,126.5,,1671671.51
2025/03/04,2025/03/01,SF FuneralFDC000000088HS250301,,126.5,,1671798.01
2025/03/04,2025/03/01,SF FuneralFDC00000008918250301,,126.5,,1671924.51
2025/03/04,2025/03/01,SF FuneralFDC000000089Q0250301,,126.5,,1672051.01
2025/03/04,2025/03/01,SF FuneralFDC000000089XC250301,,126.5,,1672177.51
2025/03/04,2025/03/01,SF FuneralF800735       250301,,126.5,,1672304.01
2025/03/04,2025/03/01,SF FuneralFDC00000008CGP250301,,126.5,,1672430.51
2025/03/04,2025/03/01,SF FuneralFDC00000008FHM250301,,126.5,,1672557.01
2025/03/04,2025/03/01,SF FuneralFDC00000008JCY250301,,126.5,,1672683.51
2025/03/04,2025/03/01,SF FuneralF802155       250301,,126.5,,1672810.01
2025/03/04,2025/03/01,SF FuneralFDC00000008KCB250301,,126.5,,1672936.51
2025/03/04,2025/03/01,SF FuneralFDC00000008KXG250301,,126.5,,1673063.01
2025/03/04,2025/03/01,SF FuneralF802644       250301,,126.5,,1673189.51
2025/03/04,2025/03/01,SF FuneralF802694       250301,,126.5,,1673316.01
2025/03/04,2025/03/01,SF FuneralF802796       250301,,126.5,,1673442.51
2025/03/04,2025/03/01,SF FuneralFDC00000008LGJ250301,,126.5,,1673569.01
2025/03/04,2025/03/01,SF FuneralFDC00000008LMN250301,,126.5,,1673695.51
2025/03/04,2025/03/01,SF FuneralF802999       250301,,126.5,,1673822.01
2025/03/04,2025/03/01,SF FuneralFDC00000008LQZ250301,,126.5,,1673948.51
2025/03/04,2025/03/01,SF FuneralF803064       250301,,126.5,,1674075.01
2025/03/04,2025/03/01,SF FuneralFDC00000008LXP250301,,126.5,,1674201.51
2025/03/04,2025/03/01,SF FuneralF803338       250301,,126.5,,1674328.01
2025/03/04,2025/03/01,SF FuneralFDC00000008MS5250301,,126.5,,1674454.51
2025/03/04,2025/03/01,SF FuneralF803641       250301,,126.5,,1674581.01
2025/03/04,2025/03/01,SF FuneralF803661       250301,,126.5,,1674707.51
2025/03/04,2025/03/01,SF FuneralF803677       250301,,126.5,,1674834.01
2025/03/04,2025/03/01,SF FuneralFDC00000008NRC250301,,126.5,,1674960.51
2025/03/04,2025/03/01,SF FuneralF803809       250301,,126.5,,1675087.01
2025/03/04,2025/03/01,SF FuneralF804010       250301,,126.5,,1675213.51
2025/03/04,2025/03/01,SF FuneralFDC00000008RJ7250301,,126.5,,1675340.01
2025/03/04,2025/03/01,SF FuneralFDC00000008S5B250301,,126.5,,1675466.51
2025/03/04,2025/03/01,SF FuneralF804960       250301,,126.5,,1675593.01
2025/03/04,2025/03/01,SF FuneralF805032       250301,,126.5,,1675719.51
2025/03/04,2025/03/01,SF FuneralFDC00000008SZQ250301,,191.5,,1675911.01
2025/03/04,2025/03/01,SF FuneralF808426       250301,,126.5,,1676037.51
2025/03/04,2025/03/01,SF FuneralF808437       250301,,126.5,,1676164.01
2025/03/04,2025/03/01,SF FuneralF808448       250301,,126.5,,1676290.51
2025/03/04,2025/03/01,SF FuneralF808453       250301,,126.5,,1676417.01
2025/03/04,2025/03/01,SF FuneralF808495       250301,,126.5,,1676543.51
2025/03/04,2025/03/01,SF FuneralF808516       250301,,126.5,,1676670.01
2025/03/04,2025/03/01,SF FuneralF808529       250301,,126.5,,1676796.51
2025/03/04,2025/03/01,SF FuneralF808644       250301,,126.5,,1676923.01
2025/03/04,2025/03/01,SF FuneralF808806       250301,,126.5,,1677049.51
2025/03/04,2025/03/01,SF FuneralF808862       250301,,126.5,,1677176.01
2025/03/04,2025/03/01,SF FuneralF809011       250301,,126.5,,1677302.51
2025/03/04,2025/03/01,SF FuneralF809173       250301,,126.5,,1677429.01
2025/03/04,2025/03/01,SF FuneralF809232       250301,,126.5,,1677555.51
2025/03/04,2025/03/01,SF FuneralF803048       250301,,126.5,,1677682.01
2025/03/04,2025/03/01,SF FuneralF809276       250301,,126.5,,1677808.51
2025/03/04,2025/03/01,SF FuneralFDC0000000930J250301,,126.5,,1677935.01
2025/03/04,2025/03/01,SF FuneralF809788       250301,,126.5,,1678061.51
2025/03/04,2025/03/01,SF FuneralF788700       250301,,191.5,,1678253.01
2025/03/04,2025/03/01,SF FuneralF810261       250301,,126.5,,1678379.51
2025/03/04,2025/03/01,SF FuneralF810660       250301,,126.5,,1678506.01
2025/03/04,2025/03/01,SF FuneralF810877       250301,,126.5,,1678632.51
2025/03/04,2025/03/01,SF FuneralF810901       250301,,126.5,,1678759.01
2025/03/04,2025/03/01,SF FuneralFDC000000098J6250301,,126.5,,1678885.51
2025/03/04,2025/03/01,SF FuneralFDC000000098MQ250301,,126.5,,1679012.01
2025/03/04,2025/03/01,SF FuneralF811466       250301,,126.5,,1679138.51
2025/03/04,2025/03/01,SF FuneralF812111       250301,,126.5,,1679265.01
2025/03/04,2025/03/01,SF FuneralF812132       250301,,126.5,,1679391.51
2025/03/04,2025/03/01,SF FuneralF812145       250301,,126.5,,1679518.01
2025/03/04,2025/03/01,SF FuneralF812264       250301,,126.5,,1679644.51
2025/03/04,2025/03/01,SF FuneralF812284       250301,,126.5,,1679771.01
2025/03/04,2025/03/01,SF FuneralF812320       250301,,126.5,,1679897.51
2025/03/04,2025/03/01,SF FuneralF812343       250301,,126.5,,1680024.01
2025/03/04,2025/03/01,SF FuneralF812445       250301,,126.5,,1680150.51
2025/03/04,2025/03/01,SF FuneralF812510       250301,,126.5,,1680277.01
2025/03/04,2025/03/01,SF FuneralF812557       250301,,126.5,,1680403.51
2025/03/04,2025/03/01,SF FuneralF809994       250301,,126.5,,1680530.01
2025/03/04,2025/03/01,SF FuneralF812726       250301,,126.5,,1680656.51
2025/03/04,2025/03/01,SF FuneralF812960       250301,,126.5,,1680783.01
2025/03/04,2025/03/01,SF FuneralF813052       250301,,126.5,,1680909.51
2025/03/04,2025/03/01,SF FuneralF813295       250301,,126.5,,1681036.01
2025/03/04,2025/03/01,SF FuneralFDC00000009H3H250301,,191.5,,1681227.51
2025/03/04,2025/03/01,SF FuneralF813499       250301,,126.5,,1681354.01
2025/03/04,2025/03/01,SF FuneralF813837       250301,,126.5,,1681480.51
2025/03/04,2025/03/01,SF FuneralF736177       250301,,126.5,,1681607.01
2025/03/04,2025/03/01,SF FuneralF816390       250301,,126.5,,1681733.51
2025/03/04,2025/03/01,SF FuneralF816391       250301,,126.5,,1681860.01
2025/03/04,2025/03/01,SF FuneralF816408       250301,,126.5,,1681986.51
2025/03/04,2025/03/01,SF FuneralF816416       250301,,126.5,,1682113.01
2025/03/04,2025/03/01,SF FuneralF816423       250301,,126.5,,1682239.51
2025/03/04,2025/03/01,SF FuneralF816481       250301,,126.5,,1682366.01
2025/03/04,2025/03/01,SF FuneralF816688       250301,,126.5,,1682492.51
2025/03/04,2025/03/01,SF FuneralF816695       250301,,126.5,,1682619.01
2025/03/04,2025/03/01,SF FuneralF812143       250301,,126.5,,1682745.51
2025/03/04,2025/03/01,SF FuneralF816924       250301,,191.5,,1682937.01
2025/03/04,2025/03/01,SF FuneralF817045       250301,,126.5,,1683063.51
2025/03/04,2025/03/01,SF FuneralF817048       250301,,126.5,,1683190.01
2025/03/04,2025/03/01,SF FuneralF817121       250301,,126.5,,1683316.51
2025/03/04,2025/03/01,SF FuneralF817162       250301,,126.5,,1683443.01
2025/03/04,2025/03/01,SF FuneralF817235       250301,,126.5,,1683569.51
2025/03/04,2025/03/01,SF FuneralF817265       250301,,126.5,,1683696.01
2025/03/04,2025/03/01,SF FuneralF817339       250301,,126.5,,1683822.51
2025/03/04,2025/03/01,SF FuneralFDC00000009Y01250301,,126.5,,1683949.01
2025/03/04,2025/03/01,SF FuneralF818299       250301,,126.5,,1684075.51
2025/03/04,2025/03/01,SF FuneralF818319       250301,,126.5,,1684202.01
2025/03/04,2025/03/01,SF FuneralF818471       250301,,126.5,,1684328.51
2025/03/04,2025/03/01,SF FuneralF818760       250301,,126.5,,1684455.01
2025/03/04,2025/03/01,SF FuneralF819185       250301,,126.5,,1684581.51
2025/03/04,2025/03/01,SF FuneralFDC0000000B3GF250301,,191.5,,1684773.01
2025/03/04,2025/03/01,SF FuneralFDC0000000B538250301,,191.5,,1684964.51
2025/03/04,2025/03/01,SF FuneralF820295       250301,,126.5,,1685091.01
2025/03/04,2025/03/01,SF FuneralFDC0000000B874250301,,126.5,,1685217.51
2025/03/04,2025/03/01,SF FuneralFDC0000000B878250301,,126.5,,1685344.01
2025/03/04,2025/03/01,SF FuneralF820666       250301,,126.5,,1685470.51
2025/03/04,2025/03/01,SF FuneralF820739       250301,,126.5,,1685597.01
2025/03/04,2025/03/01,SF FuneralFDC0000000B8KH250301,,126.5,,1685723.51
2025/03/04,2025/03/01,SF FuneralF780987       250301,,191.5,,1685915.01
2025/03/04,2025/03/01,SF FuneralF821275       250301,,126.5,,1686041.51
2025/03/04,2025/03/01,SF FuneralF821508       250301,,126.5,,1686168.01
2025/03/04,2025/03/01,SF FuneralF821849       250301,,126.5,,1686294.51
2025/03/04,2025/03/01,SF FuneralF821896       250301,,126.5,,1686421.01
2025/03/04,2025/03/01,SF FuneralFDC0000000BDFG250301,,126.5,,1686547.51
2025/03/04,2025/03/01,SF FuneralF752451       250301,,126.5,,1686674.01
2025/03/04,2025/03/01,SF FuneralFDC0000000BGCH250301,,126.5,,1686800.51
2025/03/04,2025/03/01,SF FuneralF823119       250301,,126.5,,1686927.01
2025/03/04,2025/03/01,SF FuneralFDC0000000BNQG250301,,126.5,,1687053.51
2025/03/04,2025/03/01,SF FuneralF780930       250301,,191.5,,1687245.01
2025/03/04,2025/03/01,SF FuneralF828032       250301,,126.5,,1687371.51
2025/03/04,2025/03/01,SF FuneralF788452       250301,,126.5,,1687498.01
2025/03/04,2025/03/01,SF FuneralF828077       250301,,126.5,,1687624.51
2025/03/04,2025/03/01,SF FuneralF828087       250301,,126.5,,1687751.01
2025/03/04,2025/03/01,SF FuneralF828138       250301,,126.5,,1687877.51
2025/03/04,2025/03/01,SF FuneralF828241       250301,,126.5,,1688004.01
2025/03/04,2025/03/01,SF FuneralF828317       250301,,126.5,,1688130.51
2025/03/04,2025/03/01,SF FuneralFDC0000000BPKJ250301,,191.5,,1688322.01
2025/03/04,2025/03/01,SF FuneralF830007       250301,,126.5,,1688448.51
2025/03/04,2025/03/01,SF FuneralF830513       250301,,126.5,,1688575.01
2025/03/04,2025/03/01,SF FuneralF740930       250301,,126.5,,1688701.51
2025/03/04,2025/03/01,SF FuneralF832117       250301,,126.5,,1688828.01
2025/03/04,2025/03/01,SF FuneralF832118       250301,,126.5,,1688954.51
2025/03/04,2025/03/01,SF FuneralF832224       250301,,126.5,,1689081.01
2025/03/04,2025/03/01,SF FuneralFDC0000000CJVL250301,,126.5,,1689207.51
2025/03/04,2025/03/01,SF FuneralF832359       250301,,126.5,,1689334.01
2025/03/04,2025/03/01,SF FuneralFDC0000000CN2Y250301,,126.5,,1689460.51
2025/03/04,2025/03/01,SF FuneralF832847       250301,,126.5,,1689587.01
2025/03/04,2025/03/01,SF FuneralF832870       250301,,126.5,,1689713.51
2025/03/04,2025/03/01,SF FuneralF832890       250301,,126.5,,1689840.01
2025/03/04,2025/03/01,SF FuneralF833015       250301,,126.5,,1689966.51
2025/03/04,2025/03/01,SF FuneralF833848       250301,,126.5,,1690093.01
2025/03/04,2025/03/01,SF FuneralF833920       250301,,126.5,,1690219.51
2025/03/04,2025/03/01,SF FuneralF834248       250301,,126.5,,1690346.01
2025/03/04,2025/03/01,SF FuneralFDC0000000D2YW250301,,126.5,,1690472.51
2025/03/04,2025/03/01,SF FuneralF841475       250301,,126.5,,1690599.01
2025/03/04,2025/03/01,SF FuneralFDC0000000DZ16250301,,126.5,,1690725.51
2025/03/04,2025/03/01,SF FuneralF841814       250301,,126.5,,1690852.01
2025/03/04,2025/03/01,SF FuneralF841856       250301,,126.5,,1690978.51
2025/03/04,2025/03/01,SF FuneralF842218       250301,,126.5,,1691105.01
2025/03/04,2025/03/01,SF FuneralF842777       250301,,126.5,,1691231.51
2025/03/04,2025/03/01,SF FuneralF992191       250301,,126.5,,1691358.01
2025/03/04,2025/03/01,SF FuneralF992195       250301,,126.5,,1691484.51
2025/03/04,2025/03/01,SF FuneralF992932       250301,,126.5,,1691611.01
2025/03/04,2025/03/01,SF FuneralFDC0000000JBX7250301,,126.5,,1691737.51
2025/03/04,2025/03/01,SF FuneralF993234       250301,,126.5,,1691864.01
2025/03/04,2025/03/01,SF FuneralF993503       250301,,126.5,,1691990.51
2025/03/04,2025/03/01,SF FuneralF796542       250301,,126.5,,1692117.01
2025/03/04,2025/03/01,SF FuneralF1017042      250301,,126.5,,1692243.51
2025/03/04,2025/03/01,SF FuneralF828064       250301,,126.5,,1692370.01
2025/03/04,2025/03/01,SF FuneralFDC0000000JV5C250301,,191.5,,1692561.51
2025/03/04,2025/03/01,SF FuneralFDC0000000JVRY250301,,126.5,,1692688.01
2025/03/04,2025/03/01,SF FuneralF1021460      250301,,126.5,,1692814.51
2025/03/04,2025/03/01,SF FuneralFDC0000000JZ3N250301,,126.5,,1692941.01
2025/03/04,2025/03/01,SF FuneralF1021932      250301,,126.5,,1693067.51
2025/03/04,2025/03/01,SF FuneralF1055179      250301,,126.5,,1693194.01
2025/03/04,2025/03/01,SF FuneralF1055215      250301,,126.5,,1693320.51
2025/03/04,2025/03/01,SF FuneralF1058758      250301,,126.5,,1693447.01
2025/03/04,2025/03/01,SF FuneralF1058806      250301,,126.5,,1693573.51
2025/03/04,2025/03/01,SF FuneralF1058807      250301,,126.5,,1693700.01
2025/03/04,2025/03/01,SF FuneralF1059433      250301,,126.5,,1693826.51
2025/03/04,2025/03/01,SF FuneralF1060059      250301,,126.5,,1693953.01
2025/03/04,2025/03/01,SF FuneralF1060808      250301,,126.5,,1694079.51
2025/03/04,2025/03/01,SF FuneralF1060894      250301,,126.5,,1694206.01
2025/03/04,2025/03/01,SF FuneralF1060917      250301,,126.5,,1694332.51
2025/03/04,2025/03/01,SF FuneralFDC0000000KKYW250301,,126.5,,1694459.01
2025/03/04,2025/03/01,SF FuneralF990615       250301,,126.5,,1694585.51
2025/03/04,2025/03/01,SF FuneralF1073295      250301,,126.5,,1694712.01
2025/03/04,2025/03/01,SF FuneralF1073681      250301,,126.5,,1694838.51
2025/03/04,2025/03/01,SF FuneralFDC0000000LBJ3250301,,191.5,,1695030.01
2025/03/04,2025/03/01,SF FuneralF1075142      250302,,126.5,,1695156.51
2025/03/04,2025/03/01,SF FuneralF1075152      250301,,126.5,,1695283.01
2025/03/04,2025/03/01,SF FuneralFDC0000000LDMM250301,,126.5,,1695409.51
2025/03/04,2025/03/01,SF FuneralFDC0000000LF86250301,,126.5,,1695536.01
2025/03/04,2025/03/01,SF FuneralF1079159      250301,,126.5,,1695662.51
2025/03/04,2025/03/01,SF FuneralF1084305      250301,,126.5,,1695789.01
2025/03/04,2025/03/01,SF FuneralFDC0000000LY13250302,,126.5,,1695915.51
2025/03/04,2025/03/01,SF FuneralF1084888      250301,,126.5,,1696042.01
2025/03/04,2025/03/01,SF FuneralF1085324      250301,,126.5,,1696168.51
2025/03/04,2025/03/01,SF FuneralFDC0000000M1TB250301,,126.5,,1696295.01
2025/03/04,2025/03/01,SF FuneralF1093787      250301,,126.5,,1696421.51
2025/03/04,2025/03/01,SF FuneralFDC0000000M8FT250301,,126.5,,1696548.01
2025/03/04,2025/03/01,SF FuneralF1108818      250301,,126.5,,1696674.51
2025/03/04,2025/03/01,SF FuneralF1109036      250301,,126.5,,1696801.01
2025/03/04,2025/03/01,SF FuneralFDC0000000MKPT250301,,126.5,,1696927.51
2025/03/04,2025/03/01,SF FuneralFDC0000000MLRQ250301,,126.5,,1697054.01
2025/03/04,2025/03/01,SF FuneralFDC0000000MMVR250301,,126.5,,1697180.51
2025/03/04,2025/03/01,SF FuneralF789174       250301,,256.5,,1697437.01
2025/03/04,2025/03/01,SF FuneralF1110617      250301,,126.5,,1697563.51
2025/03/04,2025/03/01,SF FuneralF1112283      250301,,126.5,,1697690.01
2025/03/04,2025/03/01,SF FuneralF1113978      250301,,126.5,,1697816.51
2025/03/04,2025/03/01,SF FuneralFDC0000000N7NH250301,,126.5,,1697943.01
2025/03/04,2025/03/01,SF FuneralFDC0000000N7W0250301,,126.5,,1698069.51
2025/03/04,2025/03/01,SF FuneralF1114708      250301,,126.5,,1698196.01
2025/03/04,2025/03/01,SF FuneralFDC0000000N9JB250301,,126.5,,1698322.51
2025/03/04,2025/03/01,SF FuneralFDC0000000N9JS250301,,126.5,,1698449.01
2025/03/04,2025/03/01,SF FuneralF1117987      250301,,126.5,,1698575.51
2025/03/04,2025/03/01,SF FuneralF1118261      250301,,126.5,,1698702.01
2025/03/04,2025/03/01,SF FuneralFDC0000000NXT7250301,,220,,1698922.01
2025/03/04,2025/03/01,SF FuneralF765108       250301,,220,,1699142.01
2025/03/04,2025/03/01,SF FuneralF1122011      250301,,126.5,,1699268.51
2025/03/04,2025/03/01,SF FuneralF1122242      250301,,126.5,,1699395.01
2025/03/04,2025/03/01,SF FuneralF1122261      250301,,126.5,,1699521.51
2025/03/04,2025/03/01,SF FuneralF1122267      250301,,126.5,,1699648.01
2025/03/04,2025/03/01,SF FuneralFDC0000000P0WJ250301,,126.5,,1699774.51
2025/03/04,2025/03/01,SF FuneralF1122669      250301,,126.5,,1699901.01
2025/03/04,2025/03/01,SF FuneralF1122903      250301,,126.5,,1700027.51
2025/03/04,2025/03/01,SF FuneralF1123285      250301,,126.5,,1700154.01
2025/03/04,2025/03/01,SF FuneralFDC0000000QBR7250301,,126.5,,1700280.51
2025/03/04,2025/03/03,SF FuneralFDC00000003G42250302,,220,,1700500.51
2025/03/04,2025/03/03,SF FuneralFDC000000041TN250302,,220,,1700720.51
2025/03/04,2025/03/03,SF FuneralFDC00000004509250302,,220,,1700940.51
2025/03/04,2025/03/03,SF FuneralFDC00000006G5M250302,,126.5,,1701067.01
2025/03/04,2025/03/03,SF FuneralFDC000000075FC250302,,126.5,,1701193.51
2025/03/04,2025/03/03,SF FuneralFDC000000075G7250302,,126.5,,1701320.01
2025/03/04,2025/03/03,SF FuneralFDC0000000866L250303,,126.5,,1701446.51
2025/03/04,2025/03/03,SF FuneralF802925       250302,,126.5,,1701573.01
2025/03/04,2025/03/03,SF FuneralF812171       250303,,126.5,,1701699.51
2025/03/04,2025/03/03,SF FuneralF816698       250302,,126.5,,1701826.01
2025/03/04,2025/03/03,SF FuneralF842967       250301,,191.5,,1702017.51
2025/03/04,2025/03/03,SF FuneralF843641       250301,,126.5,,1702144.01
2025/03/04,2025/03/03,SF FuneralF843653       250301,,126.5,,1702270.51
2025/03/04,2025/03/03,SF FuneralF781975       250301,,126.5,,1702397.01
2025/03/04,2025/03/04,SF FuneralFDC00000005MNV250304,,126.5,,1702523.51
2025/03/04,2025/03/04,SF FuneralFDC00000005MP0250304,,126.5,,1702650.01
2025/03/04,2025/03/01,SF FuneralFDC0000000PLYK250301,,126.5,,1702776.51
2025/03/04,2025/03/01,SF FuneralF1129326      250301,,126.5,,1702903.01
2025/03/04,2025/03/01,SF FuneralFDC0000000PYXM250301,,220,,1703123.01
2025/03/04,2025/03/01,SF FuneralFDC0000000PYXQ250301,,220,,1703343.01
2025/03/04,2025/03/01,SF FuneralFDC0000000PZ92250301,,220,,1703563.01
2025/03/04,2025/03/01,SF FuneralF754751       250301,,220,,1703783.01
2025/03/04,2025/03/01,SF FuneralF741009       250301,,220,,1704003.01
2025/03/04,2025/03/01,SF FuneralF781684       250301,,126.5,,1704129.51
2025/03/04,2025/03/01,SF FuneralF1131695      250301,,126.5,,1704256.01
2025/03/04,2025/02/22,SF FuneralFDC00000006T2Z250222,,126.5,,1704382.51
2025/03/04,2025/02/22,SF FuneralF1054627      250222,,126.5,,1704509.01
2025/03/04,2025/02/25,SF FuneralFDC00000006DFY250225,,126.5,,1704635.51
2025/03/04,2025/02/25,SF FuneralF1132189      250225,,126.5,,1704762.01
2025/03/04,2025/03/01,SF FuneralF1062683      250302,,126.5,,1704888.51
2025/03/04,2025/02/27,SF FuneralFDC00000009DYM250227,,126.5,,1705015.01
2025/03/04,2025/02/27,SF FuneralF844225       250227,,126.5,,1705141.51
2025/03/04,2025/02/28,SF FuneralFDC00000003L0T250228,,220,,1705361.51
2025/03/04,2025/03/04,SF FuneralFDC00000007G81250304,,63.25,,1705424.76
2025/03/04,2025/03/04,SF FuneralFDC0000000KCRX250304,,126.5,,1705551.26
2025/03/04,2025/03/04,SF FuneralFDC0000000KFFJ250304,,31.63,,1705582.89
2025/03/04,2025/03/04,SF FuneralF1114513      250304,,31.63,,1705614.52
2025/03/04,2025/02/26,SF FuneralF800963       250226,,191.5,,1705806.02
2025/03/04,2025/03/01,SF FuneralFDC00000005KXR250301,,31.63,,1705837.65
2025/03/04,2025/03/01,SF FuneralF1121775      250302,,47.88,,1705885.53
2025/03/04,2025/03/01,SF FuneralF1121892      250302,,31.63,,1705917.16
2025/03/04,2025/03/01,SF FuneralF1122035      250302,,31.63,,1705948.79
2025/03/04,2025/03/01,SF FuneralF1122059      250302,,31.63,,1705980.42
2025/03/04,2025/03/01,SF FuneralF1122066      250302,,31.63,,1706012.05
2025/03/04,2025/03/01,SF FuneralFDC0000000P0VX250302,,31.63,,1706043.68
2025/03/04,2025/03/01,SF FuneralFDC0000000P0VY250302,,31.63,,1706075.31
2025/03/04,2025/03/01,SF FuneralFDC0000000P0W3250302,,31.63,,1706106.94
2025/03/04,2025/03/01,SF FuneralF1122269      250302,,31.63,,1706138.57
2025/03/04,2025/03/01,SF FuneralF1122642      250302,,31.63,,1706170.2
2025/03/04,2025/03/01,SF FuneralF1122847      250302,,31.63,,1706201.83
2025/03/04,2025/03/01,SF FuneralF1131726      250301,,31.63,,1706233.46
2025/03/04,2025/03/03,SF FuneralF1084032      250303,,31.63,,1706265.09
2025/03/04,2025/02/25,SF FuneralFDC000000084XF250225,,126.5,,1706391.59
2025/03/04,2025/02/25,SF FuneralF816877       250225,,63.25,,1706454.84
2025/03/04,2025/02/25,SF FuneralFDC0000000N8NW250225,,63.25,,1706518.09
2025/03/04,2025/02/26,SF FuneralFDC000000073B9250226,,63.25,,1706581.34
2025/03/04,2025/02/26,SF FuneralFDC00000007DZN250226,,126.5,,1706707.84
2025/03/04,2025/02/26,SF FuneralF793906       250226,,126.5,,1706834.34
2025/03/04,2025/02/26,SF FuneralF793930       250226,,126.5,,1706960.84
2025/03/04,2025/02/26,SF FuneralF794145       250226,,126.5,,1707087.34
2025/03/04,2025/02/26,SF FuneralF795804       250226,,126.5,,1707213.84
2025/03/04,2025/02/26,SF FuneralF1131731      250226,,126.5,,1707340.34
2025/03/04,2025/02/27,SF FuneralFDC00000005H0S250227,,126.5,,1707466.84
2025/03/04,2025/02/27,SF FuneralFDC00000007QX5250227,,126.5,,1707593.34
2025/03/04,2025/02/27,SF FuneralF798436       250227,,126.5,,1707719.84
2025/03/04,2025/02/27,SF FuneralFDC000000086FV250227,,126.5,,1707846.34
2025/03/04,2025/02/27,SF FuneralF992704       250227,,126.5,,1707972.84
2025/03/04,2025/02/27,SF FuneralF1078942      250227,,126.5,,1708099.34
2025/03/04,2025/02/27,SF FuneralF1114887      250227,,126.5,,1708225.84
2025/03/04,2025/02/26,SF FuneralFDC00000003FS6250226,,55,,1708280.84
2025/03/04,2025/03/04,SF FuneralFDC00000003V68250304,,55,,1708335.84
2025/03/04,2025/03/04,SF FuneralFDC00000005PFJ250304,,31.63,,1708367.47
2025/03/04,2025/03/04,SF FuneralFDC00000005R1B250304,,31.63,,1708399.1
2025/03/04,2025/03/04,SF FuneralFDC00000005YYS250304,,31.63,,1708430.73
2025/03/04,2025/03/04,SF FuneralFDC0000000690Q250304,,31.63,,1708462.36
2025/03/04,2025/03/04,SF FuneralFDC00000006Q68250304,,31.63,,1708493.99
2025/03/04,2025/03/04,SF FuneralFDC000000073P4250304,,31.63,,1708525.62
2025/03/04,2025/03/04,SF FuneralF793715       250304,,31.63,,1708557.25
2025/03/04,2025/03/04,SF FuneralFDC00000007X30250304,,31.63,,1708588.88
2025/03/04,2025/03/04,SF FuneralFDC00000007X31250304,,31.63,,1708620.51
2025/03/04,2025/03/04,SF FuneralFDC00000007YZB250304,,31.63,,1708652.14
2025/03/04,2025/03/04,SF FuneralFDC00000008G43250304,,31.63,,1708683.77
2025/03/04,2025/03/04,SF FuneralFDC00000008H47250304,,31.63,,1708715.4
2025/03/04,2025/03/04,SF FuneralFDC00000008YCZ250304,,31.63,,1708747.03
2025/03/04,2025/03/04,SF FuneralF811401       250304,,31.63,,1708778.66
2025/03/04,2025/03/04,SF FuneralF812125       250304,,31.63,,1708810.29
2025/03/04,2025/03/04,SF FuneralF814431       250304,,31.63,,1708841.92
2025/03/04,2025/03/04,SF FuneralF817293       250304,,31.63,,1708873.55
2025/03/04,2025/03/04,SF FuneralF819158       250304,,31.63,,1708905.18
2025/03/04,2025/03/04,SF FuneralFDC0000000HK7D250304,,31.63,,1708936.81
2025/03/04,2025/03/04,SF FuneralFDC0000000HN9N250304,,31.63,,1708968.44
2025/03/04,2025/03/04,SF FuneralF990591       250304,,31.63,,1709000.07
2025/03/04,2025/03/04,SF FuneralF991480       250304,,31.63,,1709031.7
2025/03/04,2025/03/04,SF FuneralF992519       250304,,31.63,,1709063.33
2025/03/04,2025/03/04,SF FuneralF1020683      250304,,31.63,,1709094.96
2025/03/04,2025/03/04,SF FuneralF1050833      250304,,31.63,,1709126.59
2025/03/04,2025/03/04,SF FuneralF1059867      250304,,31.63,,1709158.22
2025/03/04,2025/03/04,SF FuneralF1067990      250304,,31.63,,1709189.85
2025/03/04,2025/03/04,SF FuneralF1068027      250304,,31.63,,1709221.48
2025/03/04,2025/03/04,SF FuneralF1068212      250304,,31.63,,1709253.11
2025/03/04,2025/03/04,SF FuneralFDC0000000L0TL250304,,31.63,,1709284.74
2025/03/04,2025/03/04,SF FuneralFDC0000000L0TM250304,,31.63,,1709316.37
2025/03/04,2025/03/04,SF FuneralF1073801      250304,,31.63,,1709348
2025/03/04,2025/03/04,SF FuneralF1074647      250304,,31.63,,1709379.63
2025/03/04,2025/03/04,SF FuneralF1102942      250304,,31.63,,1709411.26
2025/03/04,2025/03/04,SF FuneralF1112035      250304,,31.63,,1709442.89
2025/03/04,2025/03/04,SF FuneralF1113741      250304,,31.63,,1709474.52
2025/03/04,2025/03/04,SF FuneralFDC0000000N8G1250304,,31.63,,1709506.15
2025/03/04,2025/03/04,SF FuneralF1115225      250304,,31.63,,1709537.78
2025/03/04,2025/03/04,SF FuneralF1118335      250304,,31.63,,1709569.41
2025/03/04,2025/03/04,SF FuneralF1118338      250304,,31.63,,1709601.04
2025/03/04,2025/03/04,SF FuneralFDC0000000NT58250304,,31.63,,1709632.67
2025/03/04,2025/03/04,SF FuneralFDC0000000NTBQ250304,,31.63,,1709664.3
2025/03/04,2025/03/04,SF FuneralF1120133      250304,,31.63,,1709695.93
2025/03/04,2025/03/04,SF FuneralF1121908      250304,,31.63,,1709727.56
2025/03/04,2025/03/04,SF FuneralF1128951      250304,,31.63,,1709759.19
2025/03/04,2025/03/04,SF FuneralF1129064      250304,,31.63,,1709790.82
2025/03/04,2025/03/04,SF FuneralF1129356      250304,,31.63,,1709822.45
2025/03/04,2025/03/04,SF FuneralF1130733      250304,,31.63,,1709854.08
2025/03/04,2025/03/04,SF FuneralF1130870      250304,,31.63,,1709885.71
2025/03/04,2025/03/04,SF FuneralF743038       250304,,31.63,,1709917.34
2025/03/04,2025/03/04,SF FuneralF1132366      250304,,31.63,,1709948.97
2025/03/04,2025/03/01,SF FuneralF1127875      250301,,126.5,,1710075.47
2025/03/04,2025/03/01,SF FuneralF1127877      250301,,126.5,,1710201.97
2025/03/04,2025/03/01,SF FuneralF1127879      250301,,126.5,,1710328.47
2025/03/04,2025/03/01,SF FuneralF1127901      250301,,126.5,,1710454.97
2025/03/04,2025/03/01,SF FuneralF1127915      250301,,126.5,,1710581.47
2025/03/04,2025/03/01,SF FuneralF1127926      250301,,126.5,,1710707.97
2025/03/04,2025/03/01,SF FuneralF1127935      250301,,126.5,,1710834.47
2025/03/04,2025/03/01,SF FuneralF1127994      250301,,126.5,,1710960.97
2025/03/04,2025/03/01,SF FuneralF1128054      250301,,126.5,,1711087.47
2025/03/04,2025/03/01,SF FuneralFDC0000000PV5S250301,,126.5,,1711213.97
2025/03/04,2025/03/01,SF FuneralF1128077      250301,,126.5,,1711340.47
2025/03/04,2025/03/01,SF FuneralF1128086      250301,,126.5,,1711466.97
2025/03/04,2025/03/01,SF FuneralF1128131      250301,,126.5,,1711593.47
2025/03/04,2025/03/01,SF FuneralF1128149      250301,,126.5,,1711719.97
2025/03/04,2025/03/01,SF FuneralF1128206      250301,,126.5,,1711846.47
2025/03/04,2025/03/01,SF FuneralF1128212      250301,,126.5,,1711972.97
2025/03/04,2025/03/01,SF FuneralFDC0000000PVL5250301,,126.5,,1712099.47
2025/03/04,2025/03/01,SF FuneralF1128659      250301,,126.5,,1712225.97
2025/03/04,2025/03/01,SF FuneralF1128662      250301,,126.5,,1712352.47
2025/03/04,2025/03/01,SF FuneralF1128666      250301,,126.5,,1712478.97
2025/03/04,2025/03/01,SF FuneralF1128758      250301,,126.5,,1712605.47
2025/03/04,2025/03/01,SF FuneralF1128779      250301,,126.5,,1712731.97
2025/03/04,2025/03/01,SF FuneralF1128843      250301,,126.5,,1712858.47
2025/03/04,2025/03/01,SF FuneralF1128844      250301,,126.5,,1712984.97
2025/03/04,2025/03/01,SF FuneralF1128934      250301,,126.5,,1713111.47
2025/03/04,2025/03/01,SF FuneralF1129131      250301,,126.5,,1713237.97
2025/03/04,2025/03/01,SF FuneralF1129166      250301,,126.5,,1713364.47
2025/03/04,2025/03/01,SF FuneralF1129320      250301,,126.5,,1713490.97
2025/03/04,2025/03/01,SF FuneralF1129388      250301,,126.5,,1713617.47
2025/03/04,2025/03/01,SF FuneralF1129442      250301,,126.5,,1713743.97
2025/03/04,2025/03/01,SF FuneralF1129480      250301,,126.5,,1713870.47
2025/03/04,2025/03/01,SF FuneralFDC0000000PZLM250301,,126.5,,1713996.97
2025/03/04,2025/03/01,SF FuneralF775153       250301,,126.5,,1714123.47
2025/03/04,2025/03/01,SF FuneralF1130032      250301,,126.5,,1714249.97
2025/03/04,2025/03/01,SF FuneralF1130040      250301,,126.5,,1714376.47
2025/03/04,2025/03/01,SF FuneralF1130209      250301,,126.5,,1714502.97
2025/03/04,2025/03/01,SF FuneralF1130264      250301,,126.5,,1714629.47
2025/03/04,2025/03/01,SF FuneralFDC0000000Q189250301,,126.5,,1714755.97
2025/03/04,2025/03/01,SF FuneralFDC0000000Q18F250301,,126.5,,1714882.47
2025/03/04,2025/03/01,SF FuneralF1130411      250301,,126.5,,1715008.97
2025/03/04,2025/03/01,SF FuneralFDC0000000Q1FD250301,,126.5,,1715135.47
2025/03/04,2025/03/01,SF FuneralF1130984      250301,,126.5,,1715261.97
2025/03/04,2025/03/01,SF FuneralF1131107      250301,,126.5,,1715388.47
2025/03/04,2025/03/01,SF FuneralF1131111      250301,,126.5,,1715514.97
2025/03/04,2025/03/01,SF FuneralF1131124      250301,,126.5,,1715641.47
2025/03/04,2025/03/01,SF FuneralF1131127      250301,,126.5,,1715767.97
2025/03/04,2025/03/01,SF FuneralF1131161      250301,,126.5,,1715894.47
2025/03/04,2025/03/01,SF FuneralF1131225      250301,,126.5,,1716020.97
2025/03/04,2025/03/01,SF FuneralF1131231      250301,,126.5,,1716147.47
2025/03/04,2025/03/01,SF FuneralF1131242      250302,,126.5,,1716273.97
2025/03/04,2025/03/01,SF FuneralF1131464      250301,,126.5,,1716400.47
2025/03/04,2025/03/01,SF FuneralF1131475      250301,,126.5,,1716526.97
2025/03/04,2025/03/01,SF FuneralF1131538      250301,,126.5,,1716653.47
2025/03/04,2025/03/01,SF FuneralF1131612      250301,,126.5,,1716779.97
2025/03/04,2025/03/01,SF FuneralF1131639      250301,,126.5,,1716906.47
2025/03/04,2025/03/01,SF FuneralF1131687      250301,,126.5,,1717032.97
2025/03/04,2025/03/01,SF FuneralF1131718      250301,,126.5,,1717159.47
2025/03/04,2025/03/01,SF FuneralF1131749      250301,,126.5,,1717285.97
2025/03/04,2025/03/01,SF FuneralF1131770      250301,,126.5,,1717412.47
2025/03/04,2025/03/01,SF FuneralF1131943      250301,,126.5,,1717538.97
2025/03/04,2025/03/04,SF FuneralFDC00000005X6K250304,,126.5,,1717665.47
2025/03/04,2025/03/04,SF FuneralFDC000000062B9250304,,63.25,,1717728.72
2025/03/04,2025/03/04,SF FuneralF829691       250304,,126.5,,1717855.22
2025/03/04,2025/03/04,SF FuneralF1111770      250304,,63.25,,1717918.47
2025/03/04,2025/03/04,SF FuneralF1123020      250304,,126.5,,1718044.97
2025/03/04,2025/03/04,SF FuneralF1131287      250304,,63.25,,1718108.22
2025/03/04,2025/03/03,SF FuneralFDC000000075ZV250303,,126.5,,1718234.72
2025/03/04,2025/03/03,SF FuneralF808841       250303,,126.5,,1718361.22
2025/03/04,2025/03/03,SF FuneralF809350       250302,,126.5,,1718487.72
2025/03/04,2025/03/03,SF FuneralF810184       250302,,126.5,,1718614.22
2025/03/04,2025/03/03,SF FuneralF816772       250302,,126.5,,1718740.72
2025/03/04,2025/03/03,SF FuneralF816981       250303,,126.5,,1718867.22
2025/03/04,2025/03/03,SF FuneralF818067       250303,,126.5,,1718993.72
2025/03/04,2025/03/03,SF FuneralF820869       250302,,126.5,,1719120.22
2025/03/04,2025/03/03,SF FuneralF828246       250303,,126.5,,1719246.72
2025/03/04,2025/03/03,SF FuneralF828266       250303,,126.5,,1719373.22
2025/03/04,2025/03/03,SF FuneralF828553       250303,,126.5,,1719499.72
2025/03/04,2025/03/03,SF FuneralF830438       250303,,126.5,,1719626.22
2025/03/04,2025/03/03,SF FuneralFDC0000000CL5K250302,,126.5,,1719752.72
2025/03/04,2025/03/03,SF FuneralF832821       250303,,126.5,,1719879.22
2025/03/04,2025/03/03,SF FuneralF832917       250303,,126.5,,1720005.72
2025/03/04,2025/03/03,SF FuneralFDC0000000F9MW250301,,126.5,,1720132.22
2025/03/04,2025/03/03,SF FuneralF842918       250301,,126.5,,1720258.72
2025/03/04,2025/03/03,SF FuneralF842942       250301,,126.5,,1720385.22
2025/03/04,2025/03/03,SF FuneralF842959       250301,,126.5,,1720511.72
2025/03/04,2025/03/03,SF FuneralF843148       250301,,126.5,,1720638.22
2025/03/04,2025/03/03,SF FuneralF843158       250301,,126.5,,1720764.72
2025/03/04,2025/03/03,SF FuneralF843183       250301,,126.5,,1720891.22
2025/03/04,2025/03/03,SF FuneralF843322       250301,,126.5,,1721017.72
2025/03/04,2025/03/03,SF FuneralF843363       250301,,126.5,,1721144.22
2025/03/04,2025/03/03,SF FuneralF843427       250301,,126.5,,1721270.72
2025/03/04,2025/03/03,SF FuneralF843473       250301,,126.5,,1721397.22
2025/03/04,2025/03/03,SF FuneralF843657       250301,,126.5,,1721523.72
2025/03/04,2025/03/03,SF FuneralF843706       250301,,126.5,,1721650.22
2025/03/04,2025/03/03,SF FuneralF843749       250301,,126.5,,1721776.72
2025/03/04,2025/03/03,SF FuneralF843819       250301,,126.5,,1721903.22
2025/03/04,2025/03/03,SF FuneralF843840       250301,,126.5,,1722029.72
2025/03/04,2025/03/03,SF FuneralF843858       250301,,126.5,,1722156.22
2025/03/04,2025/03/03,SF FuneralF843905       250301,,126.5,,1722282.72
2025/03/04,2025/03/03,SF FuneralF843978       250301,,126.5,,1722409.22
2025/03/04,2025/03/03,SF FuneralFDC0000000FQV3250301,,126.5,,1722535.72
2025/03/04,2025/03/03,SF FuneralF844537       250301,,126.5,,1722662.22
2025/03/04,2025/03/03,SF FuneralF844546       250301,,126.5,,1722788.72
2025/03/04,2025/03/03,SF FuneralFDC0000000G123250301,,126.5,,1722915.22
2025/03/04,2025/03/03,SF FuneralF844719       250301,,126.5,,1723041.72
2025/03/04,2025/03/03,SF FuneralF859288       250301,,126.5,,1723168.22
2025/03/04,2025/03/03,SF FuneralF900487       250301,,126.5,,1723294.72
2025/03/04,2025/03/03,SF FuneralFDC0000000GRSX250301,,126.5,,1723421.22
2025/03/04,2025/03/03,SF FuneralF900523       250301,,126.5,,1723547.72
2025/03/04,2025/03/03,SF FuneralF900542       250301,,126.5,,1723674.22
2025/03/04,2025/03/03,SF FuneralF900631       250301,,126.5,,1723800.72
2025/03/04,2025/03/03,SF FuneralF900676       250301,,126.5,,1723927.22
2025/03/04,2025/03/03,SF FuneralF900766       250301,,126.5,,1724053.72
2025/03/04,2025/03/03,SF FuneralF900772       250301,,126.5,,1724180.22
2025/03/04,2025/03/03,SF FuneralF1021277      250303,,126.5,,1724306.72
2025/03/04,2025/03/03,SF FuneralF1021653      250303,,126.5,,1724433.22
2025/03/04,2025/03/03,SF FuneralF1033564      250303,,126.5,,1724559.72
2025/03/04,2025/03/03,SF FuneralF1058742      250303,,126.5,,1724686.22
2025/03/04,2025/03/03,SF FuneralF1058809      250303,,126.5,,1724812.72
2025/03/04,2025/03/03,SF FuneralF1067017      250303,,126.5,,1724939.22
2025/03/04,2025/03/03,SF FuneralF1068295      250303,,126.5,,1725065.72
2025/03/04,2025/03/03,SF FuneralF1110065      250303,,126.5,,1725192.22
2025/03/04,2025/03/03,SF FuneralF1113810      250303,,126.5,,1725318.72
2025/03/04,2025/03/03,SF FuneralF1128241      250303,,126.5,,1725445.22
2025/03/04,2025/03/03,SF FuneralF1131302      250303,,126.5,,1725571.72
2025/03/04,2025/03/03,SF FuneralF1132804      250303,,126.5,,1725698.22
2025/03/04,2025/03/04,SF FuneralFDC00000007DNK250304,,63.25,,1725761.47
2025/03/04,2025/03/04,SF FuneralFDC00000007J6D250304,,63.25,,1725824.72
2025/03/04,2025/03/04,SF FuneralF812955       250304,,126.5,,1725951.22
2025/03/04,2025/03/04,SF FuneralF820389       250304,,126.5,,1726077.72
2025/03/04,2025/03/04,SF FuneralF833247       250304,,63.25,,1726140.97
2025/03/04,2025/03/04,SF FuneralF834979       250304,,63.25,,1726204.22
2025/03/04,2025/03/04,SF FuneralF843810       250304,,63.25,,1726267.47
2025/03/04,2025/03/04,SF FuneralF990305       250304,,126.5,,1726393.97
2025/03/04,2025/03/04,SF FuneralF1021468      250304,,63.25,,1726457.22
2025/03/04,2025/03/04,SF FuneralF1114001      250304,,126.5,,1726583.72
2025/03/04,2025/03/04,SF FuneralFDC0000000NL0D250304,,63.25,,1726646.97
2025/03/04,2025/03/04,SF FuneralF1125287      250304,,63.25,,1726710.22
2025/03/04,2025/03/04,SF FuneralF1129043      250304,,63.25,,1726773.47
2025/03/04,2025/03/04,SF FuneralF1131800      250304,,63.25,,1726836.72
2025/03/04,2025/02/28,SF FuneralFDC00000002Q57250228,,220,,1727056.72
2025/03/04,2025/02/28,SF FuneralFDC000000033D5250228,,220,,1727276.72
2025/03/04,2025/02/28,SF FuneralFDC0000000507S250228,,220,,1727496.72
2025/03/04,2025/02/28,SF FuneralFDC0000000578B250228,,126.5,,1727623.22
2025/03/04,2025/02/28,SF FuneralFDC00000005S90250228,,126.5,,1727749.72
2025/03/04,2025/02/28,SF FuneralFDC00000005SKG250228,,220,,1727969.72
2025/03/04,2025/02/28,SF FuneralFDC00000005W0Y250228,,126.5,,1728096.22
2025/03/04,2025/02/28,SF FuneralFDC00000005X08250228,,191.5,,1728287.72
2025/03/04,2025/02/28,SF FuneralFDC00000005XD6250228,,220,,1728507.72
2025/03/04,2025/02/28,SF FuneralFDC0000000675G250228,,126.5,,1728634.22
2025/03/04,2025/02/28,SF FuneralFDC000000067G5250228,,126.5,,1728760.72
2025/03/04,2025/02/28,SF FuneralFDC000000067VY250228,,126.5,,1728887.22
2025/03/04,2025/02/28,SF FuneralFDC00000006KKD250228,,126.5,,1729013.72
2025/03/04,2025/02/28,SF FuneralFDC00000006MCM250228,,126.5,,1729140.22
2025/03/04,2025/02/28,SF FuneralFDC00000006PHV250228,,126.5,,1729266.72
2025/03/04,2025/02/28,SF FuneralFDC00000006VYW250228,,126.5,,1729393.22
2025/03/04,2025/02/28,SF FuneralFDC00000006Y0D250228,,126.5,,1729519.72
2025/03/04,2025/02/28,SF FuneralFDC000000073KZ250228,,126.5,,1729646.22
2025/03/04,2025/02/28,SF FuneralFDC000000073PN250228,,126.5,,1729772.72
2025/03/04,2025/02/28,SF FuneralFDC000000073QT250228,,126.5,,1729899.22
2025/03/04,2025/02/28,SF FuneralFDC000000074W5250228,,126.5,,1730025.72
2025/03/04,2025/02/28,SF FuneralFDC0000000752K250228,,126.5,,1730152.22
2025/03/04,2025/02/28,SF FuneralFDC00000007629250228,,126.5,,1730278.72
2025/03/04,2025/02/28,SF FuneralFDC000000077Q4250228,,126.5,,1730405.22
2025/03/04,2025/02/28,SF FuneralFDC000000078ZL250228,,126.5,,1730531.72
2025/03/04,2025/02/28,SF FuneralFDC00000007BK0250228,,126.5,,1730658.22
2025/03/04,2025/02/28,SF FuneralFDC00000007PZP250228,,126.5,,1730784.72
2025/03/04,2025/02/28,SF FuneralFDC00000007QKG250228,,126.5,,1730911.22
2025/03/04,2025/02/28,SF FuneralFDC00000007QKJ250228,,126.5,,1731037.72
2025/03/04,2025/02/28,SF FuneralFDC00000007QV6250228,,126.5,,1731164.22
2025/03/04,2025/02/28,SF FuneralF809474       250228,,126.5,,1731290.72
2025/03/04,2025/02/28,SF FuneralF809599       250228,,126.5,,1731417.22
2025/03/04,2025/02/28,SF FuneralF812141       250228,,126.5,,1731543.72
2025/03/04,2025/02/28,SF FuneralF828113       250228,,126.5,,1731670.22
2025/03/04,2025/02/28,SF FuneralF813832       250228,,126.5,,1731796.72
2025/03/04,2025/02/28,SF FuneralFDC0000000CQJ9250228,,126.5,,1731923.22
2025/03/04,2025/02/28,SF FuneralF900486       250228,,126.5,,1732049.72
2025/03/04,2025/02/28,SF FuneralF900534       250228,,126.5,,1732176.22
2025/03/04,2025/02/28,SF FuneralFDC0000000H0TM250228,,126.5,,1732302.72
2025/03/04,2025/02/28,SF FuneralFDC0000000H15Y250301,,126.5,,1732429.22
2025/03/04,2025/02/28,SF FuneralF900880       250301,,126.5,,1732555.72
2025/03/04,2025/02/28,SF FuneralF900961       250301,,126.5,,1732682.22
2025/03/04,2025/02/28,SF FuneralF901055       250301,,126.5,,1732808.72
2025/03/04,2025/02/28,SF FuneralF901542       250301,,126.5,,1732935.22
2025/03/04,2025/02/28,SF FuneralF980271       250301,,126.5,,1733061.72
2025/03/04,2025/02/28,SF FuneralF980421       250301,,126.5,,1733188.22
2025/03/04,2025/02/28,SF FuneralF980431       250301,,126.5,,1733314.72
2025/03/04,2025/02/28,SF FuneralF980442       250301,,126.5,,1733441.22
2025/03/04,2025/02/28,SF FuneralF981607       250301,,126.5,,1733567.72
2025/03/04,2025/02/28,SF FuneralF981660       250301,,126.5,,1733694.22
2025/03/04,2025/02/28,SF FuneralF981791       250301,,126.5,,1733820.72
2025/03/04,2025/02/28,SF FuneralF986826       250301,,126.5,,1733947.22
2025/03/04,2025/02/28,SF FuneralFDC0000000HLPD250301,,126.5,,1734073.72
2025/03/04,2025/02/28,SF FuneralF986997       250301,,126.5,,1734200.22
2025/03/04,2025/02/28,SF FuneralF987213       250301,,126.5,,1734326.72
2025/03/04,2025/02/28,SF FuneralF987427       250301,,126.5,,1734453.22
2025/03/04,2025/02/28,SF FuneralFDC0000000HSKW250301,,126.5,,1734579.72
2025/03/04,2025/02/28,SF FuneralF987575       250301,,126.5,,1734706.22
2025/03/04,2025/02/28,SF FuneralF987586       250228,,126.5,,1734832.72
2025/03/04,2025/02/28,SF FuneralF987599       250301,,126.5,,1734959.22
2025/03/04,2025/02/28,SF FuneralF987605       250301,,126.5,,1735085.72
2025/03/04,2025/02/28,SF FuneralF987668       250301,,126.5,,1735212.22
2025/03/04,2025/02/28,SF FuneralF987675       250301,,126.5,,1735338.72
2025/03/04,2025/02/28,SF FuneralF987681       250301,,126.5,,1735465.22
2025/03/04,2025/02/28,SF FuneralF987877       250301,,126.5,,1735591.72
2025/03/04,2025/02/28,SF FuneralF987947       250301,,126.5,,1735718.22
2025/03/04,2025/02/28,SF FuneralF988336       250301,,126.5,,1735844.72
2025/03/04,2025/02/28,SF FuneralF988475       250301,,126.5,,1735971.22
2025/03/04,2025/02/28,SF FuneralF988500       250301,,126.5,,1736097.72
2025/03/04,2025/02/28,SF FuneralF988504       250301,,126.5,,1736224.22
2025/03/04,2025/02/28,SF FuneralF988519       250301,,126.5,,1736350.72
2025/03/04,2025/02/28,SF FuneralF988528       250301,,126.5,,1736477.22
2025/03/04,2025/02/28,SF FuneralF988567       250301,,126.5,,1736603.72
2025/03/04,2025/02/28,SF FuneralF988947       250301,,126.5,,1736730.22
2025/03/04,2025/02/28,SF FuneralFDC0000000HYRW250301,,126.5,,1736856.72
2025/03/04,2025/02/28,SF FuneralFDC0000000HZ66250301,,126.5,,1736983.22
2025/03/04,2025/02/28,SF FuneralF989422       250301,,126.5,,1737109.72
2025/03/04,2025/02/28,SF FuneralF989427       250301,,126.5,,1737236.22
2025/03/04,2025/02/28,SF FuneralF989469       250301,,126.5,,1737362.72
2025/03/04,2025/02/28,SF FuneralF989476       250301,,126.5,,1737489.22
2025/03/04,2025/02/28,SF FuneralF989546       250301,,126.5,,1737615.72
2025/03/04,2025/02/28,SF FuneralF989638       250301,,126.5,,1737742.22
2025/03/04,2025/02/28,SF FuneralFDC0000000J052250301,,126.5,,1737868.72
2025/03/04,2025/02/28,SF FuneralF989934       250301,,126.5,,1737995.22
2025/03/04,2025/02/28,SF FuneralFDC0000000J3HR250301,,126.5,,1738121.72
2025/03/04,2025/02/28,SF FuneralF991424       250301,,126.5,,1738248.22
2025/03/04,2025/02/28,SF FuneralF994091       250228,,126.5,,1738374.72
2025/03/04,2025/02/28,SF FuneralF1055200      250228,,126.5,,1738501.22
2025/03/04,2025/02/28,SF FuneralF900551       250228,,126.5,,1738627.72
2025/03/04,2025/02/28,SF FuneralF1072952      250228,,126.5,,1738754.22
2025/03/04,2025/02/28,SF FuneralF1075029      250228,,126.5,,1738880.72
2025/03/04,2025/02/28,SF FuneralF1075068      250228,,126.5,,1739007.22
2025/03/04,2025/02/28,SF FuneralF1084382      250228,,126.5,,1739133.72
2025/03/04,2025/02/28,SF FuneralF1108749      250228,,126.5,,1739260.22
2025/03/04,2025/02/28,SF FuneralF1108755      250228,,126.5,,1739386.72
2025/03/04,2025/02/28,SF FuneralFDC0000000N3YP250228,,126.5,,1739513.22
2025/03/04,2025/02/28,SF FuneralF1113555      250228,,126.5,,1739639.72
2025/03/04,2025/02/28,SF FuneralF1118760      250228,,126.5,,1739766.22
2025/03/04,2025/02/28,SF FuneralF1121876      250228,,126.5,,1739892.72
2025/03/04,2025/02/28,SF FuneralF1121897      250228,,126.5,,1740019.22
2025/03/04,2025/02/28,SF FuneralF1124126      250228,,126.5,,1740145.72
2025/03/04,2025/02/28,SF FuneralF1125396      250228,,126.5,,1740272.22
2025/03/04,2025/02/28,SF FuneralF1127852      250228,,126.5,,1740398.72
2025/03/04,2025/02/28,SF FuneralFDC0000000Q5GQ250228,,126.5,,1740525.22
2025/03/04,2025/02/28,SF FuneralFDC0000000331P250228,,220,,1740745.22
2025/03/04,2025/02/28,SF FuneralFDC00000005VQ5250228,,126.5,,1740871.72
2025/03/04,2025/02/28,SF FuneralFDC00000006CV6250228,,126.5,,1740998.22
2025/03/04,2025/02/28,SF FuneralFDC00000006D1K250228,,126.5,,1741124.72
2025/03/04,2025/02/28,SF FuneralFDC00000006N69250228,,126.5,,1741251.22
2025/03/04,2025/02/28,SF FuneralFDC00000006Q0Q250228,,126.5,,1741377.72
2025/03/04,2025/02/28,SF FuneralFDC000000078LH250228,,126.5,,1741504.22
2025/03/04,2025/02/28,SF FuneralF813380       250228,,126.5,,1741630.72
2025/03/04,2025/02/28,SF FuneralF832125       250228,,126.5,,1741757.22
2025/03/04,2025/02/28,SF FuneralF840850       250228,,126.5,,1741883.72
2025/03/04,2025/02/28,SF FuneralF841301       250228,,126.5,,1742010.22
2025/03/04,2025/02/28,SF FuneralF841429       250228,,126.5,,1742136.72
2025/03/04,2025/02/28,SF FuneralF828408       250301,,126.5,,1742263.22
2025/03/04,2025/02/28,SF FuneralF901034       250301,,126.5,,1742389.72
2025/03/04,2025/02/28,SF FuneralF901030       250301,,126.5,,1742516.22
2025/03/04,2025/02/28,SF FuneralF901118       250301,,126.5,,1742642.72
2025/03/04,2025/02/28,SF FuneralF901298       250301,,126.5,,1742769.22
2025/03/04,2025/02/28,SF FuneralF980292       250301,,126.5,,1742895.72
2025/03/04,2025/02/28,SF FuneralF980330       250301,,126.5,,1743022.22
2025/03/04,2025/02/28,SF FuneralF980369       250301,,126.5,,1743148.72
2025/03/04,2025/02/28,SF FuneralF980818       250301,,126.5,,1743275.22
2025/03/04,2025/02/28,SF FuneralF981060       250301,,126.5,,1743401.72
2025/03/04,2025/02/28,SF FuneralF796457       250301,,256.5,,1743658.22
2025/03/04,2025/02/28,SF FuneralF981337       250301,,126.5,,1743784.72
2025/03/04,2025/02/28,SF FuneralF981376       250301,,126.5,,1743911.22
2025/03/04,2025/02/28,SF FuneralF981694       250301,,126.5,,1744037.72
2025/03/04,2025/02/28,SF FuneralF981742       250301,,126.5,,1744164.22
2025/03/04,2025/02/28,SF FuneralF987652       250228,,126.5,,1744290.72
2025/03/04,2025/02/28,SF FuneralF987654       250301,,126.5,,1744417.22
2025/03/04,2025/02/28,SF FuneralF987832       250301,,126.5,,1744543.72
2025/03/04,2025/02/28,SF FuneralF987917       250228,,126.5,,1744670.22
2025/03/04,2025/02/28,SF FuneralF987927       250301,,126.5,,1744796.72
2025/03/04,2025/02/28,SF FuneralF988017       250301,,126.5,,1744923.22
2025/03/04,2025/02/28,SF FuneralF788755       250301,,126.5,,1745049.72
2025/03/04,2025/02/28,SF FuneralF988285       250301,,126.5,,1745176.22
2025/03/04,2025/02/28,SF FuneralF988375       250301,,126.5,,1745302.72
2025/03/04,2025/02/28,SF FuneralF988391       250301,,126.5,,1745429.22
2025/03/04,2025/02/28,SF FuneralF988401       250301,,126.5,,1745555.72
2025/03/04,2025/02/28,SF FuneralF802810       250301,,126.5,,1745682.22
2025/03/04,2025/02/28,SF FuneralF988891       250301,,126.5,,1745808.72
2025/03/04,2025/02/28,SF FuneralFDC0000000HY0G250301,,126.5,,1745935.22
2025/03/04,2025/02/28,SF FuneralF989188       250301,,126.5,,1746061.72
2025/03/04,2025/02/28,SF FuneralF989407       250301,,126.5,,1746188.22
2025/03/04,2025/02/28,SF FuneralF990004       250301,,126.5,,1746314.72
2025/03/04,2025/02/28,SF FuneralF990435       250301,,126.5,,1746441.22
2025/03/04,2025/02/28,SF FuneralF990466       250301,,126.5,,1746567.72
2025/03/04,2025/02/28,SF FuneralF991084       250301,,126.5,,1746694.22
2025/03/04,2025/02/28,SF FuneralF993530       250228,,126.5,,1746820.72
2025/03/04,2025/02/28,SF FuneralF1052773      250228,,126.5,,1746947.22
2025/03/04,2025/02/28,SF FuneralF1055234      250228,,126.5,,1747073.72
2025/03/04,2025/02/28,SF FuneralF1055274      250228,,126.5,,1747200.22
2025/03/04,2025/02/28,SF FuneralF1084621      250228,,126.5,,1747326.72
2025/03/04,2025/02/28,SF FuneralF1084727      250228,,126.5,,1747453.22
2025/03/04,2025/02/28,SF FuneralF1108800      250228,,126.5,,1747579.72
2025/03/04,2025/02/28,SF FuneralF1114122      250228,,126.5,,1747706.22
2025/03/04,2025/02/28,SF FuneralF1121889      250228,,126.5,,1747832.72
2025/03/04,2025/02/28,SF FuneralF1121927      250228,,126.5,,1747959.22
2025/03/04,2025/02/28,SF FuneralF1122178      250228,,126.5,,1748085.72
2025/03/04,2025/02/28,SF FuneralF1124330      250228,,126.5,,1748212.22
2025/03/04,2025/02/28,SF FuneralF1127498      250228,,126.5,,1748338.72
2025/03/04,2025/02/28,SF FuneralF1129305      250228,,126.5,,1748465.22
2025/03/04,2025/02/28,SF FuneralF1131442      250228,,126.5,,1748591.72
2025/03/04,2025/03/01,SF FuneralFDC00000002QK7250301,,220,,1748811.72
2025/03/04,2025/03/01,SF FuneralFDC00000002V4G250301,,220,,1749031.72
2025/03/04,2025/03/01,SF FuneralFDC00000002WT8250301,,220,,1749251.72
2025/03/04,2025/03/01,SF FuneralFDC00000002X6Y250301,,220,,1749471.72
2025/03/04,2025/03/01,SF FuneralFDC00000002Y4R250301,,220,,1749691.72
2025/03/04,2025/03/01,SF FuneralFDC000000032G7250301,,220,,1749911.72
2025/03/04,2025/03/01,SF FuneralFDC000000032T1250301,,220,,1750131.72
2025/03/04,2025/03/01,SF FuneralFDC000000033J5250301,,220,,1750351.72
2025/03/04,2025/03/01,SF FuneralFDC000000035ZH250301,,220,,1750571.72
2025/03/04,2025/03/01,SF FuneralFDC00000003LNL250301,,220,,1750791.72
2025/03/04,2025/03/01,SF FuneralFDC00000003SY9250301,,220,,1751011.72
2025/03/04,2025/03/01,SF FuneralFDC00000004TFW250301,,220,,1751231.72
2025/03/04,2025/03/01,SF FuneralFDC00000004ZGD250301,,191.05,,1751422.77
2025/03/04,2025/03/01,SF FuneralFDC000000058B6250301,,126.5,,1751549.27
2025/03/04,2025/03/01,SF FuneralFDC000000058Q4250301,,126.5,,1751675.77
2025/03/04,2025/03/01,SF FuneralFDC00000005F07250301,,126.5,,1751802.27
2025/03/04,2025/03/01,SF FuneralFDC00000005F1Y250301,,126.5,,1751928.77
2025/03/04,2025/03/01,SF FuneralFDC00000005H8B250301,,126.5,,1752055.27
2025/03/04,2025/03/01,SF FuneralFDC00000005LW5250301,,126.5,,1752181.77
2025/03/04,2025/03/01,SF FuneralFDC00000005M8L250301,,220,,1752401.77
2025/03/04,2025/03/01,SF FuneralFDC00000005MDX250301,,126.5,,1752528.27
2025/03/04,2025/03/01,SF FuneralFDC00000005MGK250301,,126.5,,1752654.77
2025/03/04,2025/03/01,SF FuneralFDC00000005N7N250301,,126.5,,1752781.27
2025/03/04,2025/03/01,SF FuneralFDC00000005Q8H250301,,126.5,,1752907.77
2025/03/04,2025/03/01,SF FuneralFDC00000005QBY250301,,126.5,,1753034.27
2025/03/04,2025/03/01,SF FuneralFDC00000005QQD250301,,126.5,,1753160.77
2025/03/04,2025/03/01,SF FuneralFDC00000005RY1250301,,126.5,,1753287.27
2025/03/04,2025/03/01,SF FuneralFDC00000005RZ6250301,,126.5,,1753413.77
2025/03/04,2025/03/01,SF FuneralFDC00000005SVX250301,,126.5,,1753540.27
2025/03/04,2025/03/01,SF FuneralFDC00000005TXX250301,,126.5,,1753666.77
2025/03/04,2025/03/01,SF FuneralFDC00000005W4K250301,,126.5,,1753793.27
2025/03/04,2025/03/01,SF FuneralFDC00000005WFL250301,,126.5,,1753919.77
2025/03/04,2025/03/01,SF FuneralFDC00000005X5Q250301,,126.5,,1754046.27
2025/03/04,2025/03/01,SF FuneralFDC00000005Z14250301,,126.5,,1754172.77
2025/03/04,2025/03/01,SF FuneralFDC00000006167250301,,126.5,,1754299.27
2025/03/04,2025/03/01,SF FuneralFDC0000000622L250301,,126.5,,1754425.77
2025/03/04,2025/03/01,SF FuneralFDC000000065RK250301,,126.5,,1754552.27
2025/03/04,2025/03/01,SF FuneralFDC000000067K1250301,,126.5,,1754678.77
2025/03/04,2025/03/01,SF FuneralFDC000000067R1250301,,126.5,,1754805.27
2025/03/04,2025/03/01,SF FuneralFDC000000067VS250301,,126.5,,1754931.77
2025/03/04,2025/03/01,SF FuneralFDC0000000685H250301,,126.5,,1755058.27
2025/03/04,2025/03/01,SF FuneralFDC000000068KY250301,,126.5,,1755184.77
2025/03/04,2025/03/01,SF FuneralFDC000000068MX250301,,126.5,,1755311.27
2025/03/04,2025/03/01,SF FuneralFDC000000068P8250301,,126.5,,1755437.77
2025/03/04,2025/03/01,SF FuneralFDC000000068VB250301,,126.5,,1755564.27
2025/03/04,2025/03/01,SF FuneralFDC0000000697Z250301,,126.5,,1755690.77
2025/03/04,2025/03/01,SF FuneralFDC000000069CX250301,,126.5,,1755817.27
2025/03/04,2025/03/01,SF FuneralFDC000000069JR250301,,126.5,,1755943.77
2025/03/04,2025/03/01,SF FuneralFDC000000069LZ250301,,126.5,,1756070.27
2025/03/04,2025/03/01,SF FuneralFDC000000069XR250301,,126.5,,1756196.77
2025/03/04,2025/03/01,SF FuneralFDC000000069YT250301,,126.5,,1756323.27
2025/03/04,2025/03/01,SF FuneralFDC000000069Z1250301,,126.5,,1756449.77
2025/03/04,2025/03/01,SF FuneralFDC00000006B33250301,,126.5,,1756576.27
2025/03/04,2025/03/01,SF FuneralFDC00000006BRY250301,,126.5,,1756702.77
2025/03/04,2025/03/01,SF FuneralFDC00000006BW2250301,,126.5,,1756829.27
2025/03/04,2025/03/01,SF FuneralFDC00000006CB7250301,,126.5,,1756955.77
2025/03/04,2025/03/01,SF FuneralFDC00000006CD0250301,,126.5,,1757082.27
2025/03/04,2025/03/01,SF FuneralFDC00000006CLJ250301,,126.5,,1757208.77
2025/03/04,2025/03/01,SF FuneralFDC00000006CXQ250301,,126.5,,1757335.27
2025/03/04,2025/03/01,SF FuneralFDC00000006D0B250301,,126.5,,1757461.77
2025/03/04,2025/03/01,SF FuneralFDC00000006D27250301,,126.5,,1757588.27
2025/03/04,2025/03/01,SF FuneralFDC00000006DGV250301,,126.5,,1757714.77
2025/03/04,2025/03/01,SF FuneralFDC00000006DLX250301,,126.5,,1757841.27
2025/03/04,2025/03/01,SF FuneralFDC00000006DWF250301,,126.5,,1757967.77
2025/03/04,2025/03/01,SF FuneralFDC00000006F8J250301,,126.5,,1758094.27
2025/03/04,2025/03/01,SF FuneralFDC00000006FB5250301,,126.5,,1758220.77
2025/03/04,2025/03/01,SF FuneralFDC00000006FFH250301,,126.5,,1758347.27
2025/03/04,2025/03/01,SF FuneralFDC00000006FMT250301,,126.5,,1758473.77
2025/03/04,2025/03/01,SF FuneralFDC00000006FN4250301,,126.5,,1758600.27
2025/03/04,2025/03/01,SF FuneralFDC00000006G12250301,,126.5,,1758726.77
2025/03/04,2025/03/01,SF FuneralFDC00000006G5B250301,,126.5,,1758853.27
2025/03/04,2025/03/01,SF FuneralFDC00000006GC5250301,,126.5,,1758979.77
2025/03/04,2025/03/01,SF FuneralFDC00000006GHZ250301,,126.5,,1759106.27
2025/03/04,2025/03/01,SF FuneralFDC00000006GLR250301,,126.5,,1759232.77
2025/03/04,2025/03/01,SF FuneralFDC00000006GRL250301,,126.5,,1759359.27
2025/03/04,2025/03/01,SF FuneralFDC00000006GSM250301,,126.5,,1759485.77
2025/03/04,2025/03/01,SF FuneralFDC00000006H0G250301,,220,,1759705.77
2025/03/04,2025/03/01,SF FuneralFDC00000006HZT250301,,126.5,,1759832.27
2025/03/04,2025/03/01,SF FuneralFDC00000006JCQ250301,,126.5,,1759958.77
2025/03/04,2025/03/01,SF FuneralFDC00000006JFM250301,,220,,1760178.77
2025/03/04,2025/03/01,SF FuneralFDC00000006JWW250301,,126.5,,1760305.27
2025/03/04,2025/03/01,SF FuneralFDC00000006K17250301,,126.5,,1760431.77
2025/03/04,2025/03/01,SF FuneralFDC00000006KHX250301,,126.5,,1760558.27
2025/03/04,2025/03/01,SF FuneralFDC00000006KKY250301,,126.5,,1760684.77
2025/03/04,2025/03/01,SF FuneralFDC00000006KV7250301,,126.5,,1760811.27
2025/03/04,2025/03/01,SF FuneralFDC00000006LNL250301,,126.5,,1760937.77
2025/03/04,2025/03/01,SF FuneralFDC00000006LR1250301,,126.5,,1761064.27
2025/03/04,2025/03/01,SF FuneralFDC00000006LT4250301,,126.5,,1761190.77
2025/03/04,2025/03/01,SF FuneralFDC00000006LVM250301,,126.5,,1761317.27
2025/03/04,2025/03/01,SF FuneralFDC00000006LW6250301,,126.5,,1761443.77
2025/03/04,2025/03/01,SF FuneralFDC00000006LX2250301,,126.5,,1761570.27
2025/03/04,2025/03/01,SF FuneralFDC00000006M99250301,,126.5,,1761696.77
2025/03/04,2025/03/01,SF FuneralFDC00000006MS1250301,,126.5,,1761823.27
2025/03/04,2025/03/01,SF FuneralFDC00000006RS5250301,,126.5,,1761949.77
2025/03/04,2025/03/01,SF FuneralFDC00000006RXG250301,,126.5,,1762076.27
2025/03/04,2025/03/01,SF FuneralFDC00000006S71250301,,126.5,,1762202.77
2025/03/04,2025/03/01,SF FuneralFDC00000006V6H250301,,126.5,,1762329.27
2025/03/04,2025/03/01,SF FuneralFDC00000006VXL250301,,126.5,,1762455.77
2025/03/04,2025/03/01,SF FuneralFDC00000006W0Y250301,,126.5,,1762582.27
2025/03/04,2025/03/01,SF FuneralFDC00000006WQY250301,,126.5,,1762708.77
2025/03/04,2025/03/01,SF FuneralFDC000000070V2250301,,126.5,,1762835.27
2025/03/04,2025/03/01,SF FuneralFDC0000000715T250301,,126.5,,1762961.77
2025/03/04,2025/03/01,SF FuneralFDC000000071JR250301,,126.5,,1763088.27
2025/03/04,2025/03/01,SF FuneralFDC0000000737N250301,,126.5,,1763214.77
2025/03/04,2025/03/01,SF FuneralFDC000000073CQ250301,,126.5,,1763341.27
2025/03/04,2025/03/01,SF FuneralFDC000000073DC250301,,126.5,,1763467.77
2025/03/04,2025/03/01,SF FuneralFDC000000073DN250301,,126.5,,1763594.27
2025/03/04,2025/03/01,SF FuneralFDC000000073P0250301,,126.5,,1763720.77
2025/03/04,2025/03/01,SF FuneralFDC000000073SP250301,,126.5,,1763847.27
2025/03/04,2025/03/01,SF FuneralFDC000000074F3250301,,126.5,,1763973.77
2025/03/04,2025/03/01,SF FuneralFDC0000000766W250301,,126.5,,1764100.27
2025/03/04,2025/03/01,SF FuneralFDC000000076QT250301,,126.5,,1764226.77
2025/03/04,2025/03/01,SF FuneralFDC000000077C5250301,,126.5,,1764353.27
2025/03/04,2025/03/01,SF FuneralFDC000000077NV250301,,126.5,,1764479.77
2025/03/04,2025/03/01,SF FuneralFDC000000077Q8250301,,126.5,,1764606.27
2025/03/04,2025/03/01,SF FuneralFDC00000007815250301,,126.5,,1764732.77
2025/03/04,2025/03/01,SF FuneralFDC0000000792V250301,,126.5,,1764859.27
2025/03/04,2025/03/01,SF FuneralFDC000000079KS250301,,126.5,,1764985.77
2025/03/04,2025/03/01,SF FuneralFDC000000079KX250301,,126.5,,1765112.27
2025/03/04,2025/03/01,SF FuneralFDC000000079PT250301,,220,,1765332.27
2025/03/04,2025/03/01,SF FuneralFDC00000007BKD250301,,126.5,,1765458.77
2025/03/04,2025/03/01,SF FuneralFDC00000007BSL250301,,126.5,,1765585.27
2025/03/04,2025/03/01,SF FuneralFDC00000007CJR250301,,126.5,,1765711.77
2025/03/04,2025/03/01,SF FuneralFDC00000007CJS250301,,126.5,,1765838.27
2025/03/04,2025/03/01,SF FuneralFDC00000007D3S250301,,126.5,,1765964.77
2025/03/04,2025/03/01,SF FuneralFDC00000007D65250301,,220,,1766184.77
2025/03/04,2025/03/01,SF FuneralFDC00000007D8Q250301,,126.5,,1766311.27
2025/03/04,2025/03/01,SF FuneralFDC00000007DG1250301,,126.5,,1766437.77
2025/03/04,2025/03/01,SF FuneralFDC00000007FFP250301,,126.5,,1766564.27
2025/03/04,2025/03/01,SF FuneralFDC00000007HFH250301,,126.5,,1766690.77
2025/03/04,2025/03/01,SF FuneralF794279       250301,,126.5,,1766817.27
2025/03/04,2025/03/01,SF FuneralFDC00000007RLF250301,,126.5,,1766943.77
2025/03/04,2025/03/01,SF FuneralFDC00000007RM8250301,,126.5,,1767070.27
2025/03/04,2025/03/01,SF FuneralF794644       250301,,126.5,,1767196.77
2025/03/04,2025/03/01,SF FuneralFDC00000007SJP250301,,126.5,,1767323.27
2025/03/04,2025/03/01,SF FuneralFDC00000007SK3250301,,126.5,,1767449.77
2025/03/04,2025/03/01,SF FuneralFDC00000007SYS250301,,126.5,,1767576.27
2025/03/04,2025/03/01,SF FuneralFDC00000007T11250301,,126.5,,1767702.77
2025/03/04,2025/03/01,SF FuneralFDC00000007TMF250301,,126.5,,1767829.27
2025/03/04,2025/03/01,SF FuneralFDC00000007TRN250301,,126.5,,1767955.77
2025/03/04,2025/03/01,SF FuneralFDC00000007TRQ250301,,126.5,,1768082.27
2025/03/04,2025/03/01,SF FuneralFDC000000083KP250301,,126.5,,1768208.77
2025/03/04,2025/03/01,SF FuneralFDC000000083M2250301,,126.5,,1768335.27
2025/03/04,2025/03/01,SF FuneralFDC000000083SQ250301,,126.5,,1768461.77
2025/03/04,2025/03/01,SF FuneralF798270       250301,,126.5,,1768588.27
2025/03/04,2025/03/01,SF FuneralF798283       250301,,126.5,,1768714.77
2025/03/04,2025/03/01,SF FuneralFDC000000084H0250301,,126.5,,1768841.27
2025/03/04,2025/03/01,SF FuneralF798296       250301,,126.5,,1768967.77
2025/03/04,2025/03/01,SF FuneralF798342       250301,,126.5,,1769094.27
2025/03/04,2025/03/01,SF FuneralF798515       250301,,126.5,,1769220.77
2025/03/04,2025/03/01,SF FuneralF798588       250301,,126.5,,1769347.27
2025/03/04,2025/03/01,SF FuneralFDC000000085NZ250301,,126.5,,1769473.77
2025/03/04,2025/03/01,SF FuneralFDC000000085XW250301,,126.5,,1769600.27
2025/03/04,2025/03/01,SF FuneralF798748       250301,,191.5,,1769791.77
2025/03/04,2025/03/01,SF FuneralF798869       250301,,126.5,,1769918.27
2025/03/04,2025/03/01,SF FuneralF799181       250301,,126.5,,1770044.77
2025/03/04,2025/03/01,SF FuneralFDC00000008HQG250301,,126.5,,1770171.27
2025/03/04,2025/03/01,SF FuneralF801917       250301,,126.5,,1770297.77
2025/03/04,2025/03/01,SF FuneralFDC00000008KPH250301,,126.5,,1770424.27
2025/03/04,2025/03/01,SF FuneralF802574       250301,,126.5,,1770550.77
2025/03/04,2025/03/01,SF FuneralF802583       250301,,126.5,,1770677.27
2025/03/04,2025/03/01,SF FuneralF802585       250301,,126.5,,1770803.77
2025/03/04,2025/03/01,SF FuneralFDC00000008L1Y250301,,126.5,,1770930.27
2025/03/04,2025/03/01,SF FuneralF802692       250301,,126.5,,1771056.77
2025/03/04,2025/03/01,SF FuneralFDC00000008LCW250301,,126.5,,1771183.27
2025/03/04,2025/03/01,SF FuneralFDC00000008LKW250301,,191.5,,1771374.77
2025/03/04,2025/03/01,SF FuneralF803036       250301,,126.5,,1771501.27
2025/03/04,2025/03/01,SF FuneralF804363       250301,,126.5,,1771627.77
2025/03/04,2025/03/01,SF FuneralF805064       250301,,126.5,,1771754.27
2025/03/04,2025/03/01,SF FuneralFDC00000008VDP250301,,126.5,,1771880.77
2025/03/04,2025/03/01,SF FuneralF808441       250301,,126.5,,1772007.27
2025/03/04,2025/03/01,SF FuneralF808458       250301,,126.5,,1772133.77
2025/03/04,2025/03/01,SF FuneralF808510       250301,,126.5,,1772260.27
2025/03/04,2025/03/01,SF FuneralF808547       250301,,126.5,,1772386.77
2025/03/04,2025/03/01,SF FuneralF808551       250301,,126.5,,1772513.27
2025/03/04,2025/03/01,SF FuneralFDC00000009035250301,,126.5,,1772639.77
2025/03/04,2025/03/01,SF FuneralFDC00000009038250301,,126.5,,1772766.27
2025/03/04,2025/03/01,SF FuneralF808596       250301,,126.5,,1772892.77
2025/03/04,2025/03/01,SF FuneralF808672       250301,,126.5,,1773019.27
2025/03/04,2025/03/01,SF FuneralF808743       250301,,126.5,,1773145.77
2025/03/04,2025/03/01,SF FuneralF808830       250301,,126.5,,1773272.27
2025/03/04,2025/03/01,SF FuneralF808856       250301,,126.5,,1773398.77
2025/03/04,2025/03/01,SF FuneralF808883       250301,,126.5,,1773525.27
2025/03/04,2025/03/01,SF FuneralF808966       250301,,126.5,,1773651.77
2025/03/04,2025/03/01,SF FuneralF809040       250301,,126.5,,1773778.27
2025/03/04,2025/03/01,SF FuneralF809157       250301,,126.5,,1773904.77
2025/03/04,2025/03/01,SF FuneralF809227       250301,,126.5,,1774031.27
2025/03/04,2025/03/01,SF FuneralFDC000000092TF250301,,126.5,,1774157.77
2025/03/04,2025/03/01,SF FuneralF809349       250301,,126.5,,1774284.27
2025/03/04,2025/03/01,SF FuneralFDC000000093B2250301,,126.5,,1774410.77
2025/03/04,2025/03/01,SF FuneralF809614       250301,,126.5,,1774537.27
2025/03/04,2025/03/01,SF FuneralF809752       250301,,126.5,,1774663.77
2025/03/04,2025/03/01,SF FuneralF810863       250301,,126.5,,1774790.27
2025/03/04,2025/03/01,SF FuneralF810875       250301,,126.5,,1774916.77
2025/03/04,2025/03/01,SF FuneralFDC000000097ZQ250301,,126.5,,1775043.27
2025/03/04,2025/03/01,SF FuneralF781009       250301,,126.5,,1775169.77
2025/03/04,2025/03/01,SF FuneralF810963       250301,,126.5,,1775296.27
2025/03/04,2025/03/01,SF FuneralF810410       250301,,191.5,,1775487.77
2025/03/04,2025/03/01,SF FuneralF811708       250301,,126.5,,1775614.27
2025/03/04,2025/03/01,SF FuneralF811970       250301,,126.5,,1775740.77
2025/03/04,2025/03/01,SF FuneralF812158       250301,,126.5,,1775867.27
2025/03/04,2025/03/01,SF FuneralF812172       250301,,126.5,,1775993.77
2025/03/04,2025/03/01,SF FuneralF812189       250301,,126.5,,1776120.27
2025/03/04,2025/03/01,SF FuneralF812323       250301,,126.5,,1776246.77
2025/03/04,2025/03/01,SF FuneralF812400       250301,,126.5,,1776373.27
2025/03/04,2025/03/01,SF FuneralF812460       250301,,126.5,,1776499.77
2025/03/04,2025/03/01,SF FuneralF812466       250301,,126.5,,1776626.27
2025/03/04,2025/03/01,SF FuneralF812491       250301,,126.5,,1776752.77
2025/03/04,2025/03/01,SF FuneralF812513       250301,,126.5,,1776879.27
2025/03/04,2025/03/01,SF FuneralF812563       250301,,126.5,,1777005.77
2025/03/04,2025/03/01,SF FuneralF812566       250301,,126.5,,1777132.27
2025/03/04,2025/03/01,SF FuneralFDC00000009FDB250301,,126.5,,1777258.77
2025/03/04,2025/03/01,SF FuneralF812616       250301,,126.5,,1777385.27
2025/03/04,2025/03/01,SF FuneralF812673       250301,,126.5,,1777511.77
2025/03/04,2025/03/01,SF FuneralF784101       250301,,126.5,,1777638.27
2025/03/04,2025/03/01,SF FuneralF812722       250301,,126.5,,1777764.77
2025/03/04,2025/03/01,SF FuneralF812789       250301,,126.5,,1777891.27
2025/03/04,2025/03/01,SF FuneralF812875       250301,,126.5,,1778017.77
2025/03/04,2025/03/01,SF FuneralF812918       250301,,126.5,,1778144.27
2025/03/04,2025/03/01,SF FuneralF812925       250301,,126.5,,1778270.77
2025/03/04,2025/03/01,SF FuneralF813164       250301,,126.5,,1778397.27
2025/03/04,2025/03/01,SF FuneralF813181       250301,,126.5,,1778523.77
2025/03/04,2025/03/01,SF FuneralF813439       250301,,126.5,,1778650.27
2025/03/04,2025/03/01,SF FuneralF813721       250301,,126.5,,1778776.77
2025/03/04,2025/03/01,SF FuneralF813893       250301,,126.5,,1778903.27
2025/03/04,2025/03/01,SF FuneralF813911       250301,,126.5,,1779029.77
2025/03/04,2025/03/01,SF FuneralF814070       250301,,126.5,,1779156.27
2025/03/04,2025/03/01,SF FuneralF814080       250301,,126.5,,1779282.77
2025/03/04,2025/03/01,SF FuneralF814213       250301,,126.5,,1779409.27
2025/03/04,2025/03/01,SF FuneralF814434       250301,,126.5,,1779535.77
2025/03/04,2025/03/01,SF FuneralFDC00000009LQN250301,,126.5,,1779662.27
2025/03/04,2025/03/01,SF FuneralF814478       250301,,126.5,,1779788.77
2025/03/04,2025/03/01,SF FuneralF814624       250301,,126.5,,1779915.27
2025/03/04,2025/03/01,SF FuneralF814681       250301,,126.5,,1780041.77
2025/03/04,2025/03/01,SF FuneralF814828       250301,,126.5,,1780168.27
2025/03/04,2025/03/01,SF FuneralF814836       250301,,126.5,,1780294.77
2025/03/04,2025/03/01,SF FuneralF814911       250301,,126.5,,1780421.27
2025/03/04,2025/03/01,SF FuneralF815023       250301,,126.5,,1780547.77
2025/03/04,2025/03/01,SF FuneralF815160       250301,,126.5,,1780674.27
2025/03/04,2025/03/01,SF FuneralF816370       250301,,126.5,,1780800.77
2025/03/04,2025/03/01,SF FuneralF816411       250301,,126.5,,1780927.27
2025/03/04,2025/03/01,SF FuneralF816426       250301,,126.5,,1781053.77
2025/03/04,2025/03/01,SF FuneralF816447       250301,,126.5,,1781180.27
2025/03/04,2025/03/01,SF FuneralF816497       250301,,126.5,,1781306.77
2025/03/04,2025/03/01,SF FuneralF816508       250301,,126.5,,1781433.27
2025/03/04,2025/03/01,SF FuneralF816525       250301,,126.5,,1781559.77
2025/03/04,2025/03/01,SF FuneralF816534       250301,,126.5,,1781686.27
2025/03/04,2025/03/01,SF FuneralFDC00000009WGZ250301,,126.5,,1781812.77
2025/03/04,2025/03/01,SF FuneralF816703       250301,,126.5,,1781939.27
2025/03/04,2025/03/01,SF FuneralF816737       250301,,126.5,,1782065.77
2025/03/04,2025/03/01,SF FuneralF816742       250301,,126.5,,1782192.27
2025/03/04,2025/03/01,SF FuneralF816797       250301,,126.5,,1782318.77
2025/03/04,2025/03/01,SF FuneralF816867       250301,,126.5,,1782445.27
2025/03/04,2025/03/01,SF FuneralF816932       250301,,126.5,,1782571.77
2025/03/04,2025/03/01,SF FuneralF816976       250301,,126.5,,1782698.27
2025/03/04,2025/03/01,SF FuneralF816986       250301,,126.5,,1782824.77
2025/03/04,2025/03/01,SF FuneralF817111       250301,,126.5,,1782951.27
2025/03/04,2025/03/01,SF FuneralF817237       250301,,126.5,,1783077.77
2025/03/04,2025/03/01,SF FuneralF817253       250301,,126.5,,1783204.27
2025/03/04,2025/03/01,SF FuneralF817371       250301,,126.5,,1783330.77
2025/03/04,2025/03/01,SF FuneralF817383       250301,,126.5,,1783457.27
2025/03/04,2025/03/01,SF FuneralF817415       250301,,126.5,,1783583.77
2025/03/04,2025/03/01,SF FuneralF817503       250301,,126.5,,1783710.27
2025/03/04,2025/03/01,SF FuneralF817504       250301,,126.5,,1783836.77
2025/03/04,2025/03/01,SF FuneralF817950       250301,,126.5,,1783963.27
2025/03/04,2025/03/01,SF FuneralF817952       250301,,126.5,,1784089.77
2025/03/04,2025/03/01,SF FuneralF813008       250301,,126.5,,1784216.27
2025/03/04,2025/03/01,SF FuneralF818126       250301,,126.5,,1784342.77
2025/03/04,2025/03/01,SF FuneralF818129       250301,,126.5,,1784469.27
2025/03/04,2025/03/01,SF FuneralF818316       250301,,126.5,,1784595.77
2025/03/04,2025/03/01,SF FuneralF818336       250301,,126.5,,1784722.27
2025/03/04,2025/03/01,SF FuneralF819203       250301,,126.5,,1784848.77
2025/03/04,2025/03/01,SF FuneralF819863       250301,,126.5,,1784975.27
2025/03/04,2025/03/01,SF FuneralF819976       250301,,126.5,,1785101.77
2025/03/04,2025/03/01,SF FuneralFDC0000000B7GC250301,,126.5,,1785228.27
2025/03/04,2025/03/01,SF FuneralF820326       250301,,126.5,,1785354.77
2025/03/04,2025/03/01,SF FuneralFDC0000000B7MT250301,,126.5,,1785481.27
2025/03/04,2025/03/01,SF FuneralF802683       250301,,256.5,,1785737.77
2025/03/04,2025/03/01,SF FuneralF820555       250301,,126.5,,1785864.27
2025/03/04,2025/03/01,SF FuneralF820556       250301,,126.5,,1785990.77
2025/03/04,2025/03/01,SF FuneralF808620       250301,,126.5,,1786117.27
2025/03/04,2025/03/01,SF FuneralF820662       250301,,126.5,,1786243.77
2025/03/04,2025/03/01,SF FuneralF820665       250301,,126.5,,1786370.27
2025/03/04,2025/03/01,SF FuneralF820799       250301,,126.5,,1786496.77
2025/03/04,2025/03/01,SF FuneralF820879       250301,,126.5,,1786623.27
2025/03/04,2025/03/01,SF FuneralF821123       250301,,126.5,,1786749.77
2025/03/04,2025/03/01,SF FuneralF821160       250301,,126.5,,1786876.27
2025/03/04,2025/03/01,SF FuneralF821315       250301,,126.5,,1787002.77
2025/03/04,2025/03/01,SF FuneralF821319       250301,,126.5,,1787129.27
2025/03/04,2025/03/01,SF FuneralF821351       250301,,126.5,,1787255.77
2025/03/04,2025/03/01,SF FuneralF821437       250301,,126.5,,1787382.27
2025/03/04,2025/03/01,SF FuneralFDC0000000BB5Z250301,,126.5,,1787508.77
2025/03/04,2025/03/01,SF FuneralF821448       250301,,126.5,,1787635.27
2025/03/04,2025/03/01,SF FuneralF821497       250301,,126.5,,1787761.77
2025/03/04,2025/03/01,SF FuneralF821506       250301,,126.5,,1787888.27
2025/03/04,2025/03/01,SF FuneralF821622       250301,,126.5,,1788014.77
2025/03/04,2025/03/01,SF FuneralF821702       250301,,126.5,,1788141.27
2025/03/04,2025/03/01,SF FuneralF821788       250301,,126.5,,1788267.77
2025/03/04,2025/03/01,SF FuneralF822178       250301,,126.5,,1788394.27
2025/03/04,2025/03/01,SF FuneralF822526       250301,,126.5,,1788520.77
2025/03/04,2025/03/01,SF FuneralF828078       250301,,126.5,,1788647.27
2025/03/04,2025/03/01,SF FuneralF828967       250301,,126.5,,1788773.77
2025/03/04,2025/03/01,SF FuneralF828974       250301,,126.5,,1788900.27
2025/03/04,2025/03/01,SF FuneralF828981       250301,,126.5,,1789026.77
2025/03/04,2025/03/01,SF FuneralF828986       250301,,126.5,,1789153.27
2025/03/04,2025/03/01,SF FuneralF830812       250301,,126.5,,1789279.77
2025/03/04,2025/03/01,SF FuneralF830911       250301,,126.5,,1789406.27
2025/03/04,2025/03/01,SF FuneralF832079       250301,,126.5,,1789532.77
2025/03/04,2025/03/01,SF FuneralFDC0000000CJ2S250301,,126.5,,1789659.27
2025/03/04,2025/03/01,SF FuneralF832216       250301,,126.5,,1789785.77
2025/03/04,2025/03/01,SF FuneralF832258       250301,,126.5,,1789912.27
2025/03/04,2025/03/01,SF FuneralF832283       250301,,126.5,,1790038.77
2025/03/04,2025/03/01,SF FuneralF832387       250301,,126.5,,1790165.27
2025/03/04,2025/03/01,SF FuneralFDC0000000CK5L250301,,126.5,,1790291.77
2025/03/04,2025/03/01,SF FuneralF832506       250301,,126.5,,1790418.27
2025/03/04,2025/03/01,SF FuneralF832607       250301,,126.5,,1790544.77
2025/03/04,2025/03/01,SF FuneralF832633       250301,,126.5,,1790671.27
2025/03/04,2025/03/01,SF FuneralF832767       250301,,126.5,,1790797.77
2025/03/04,2025/03/01,SF FuneralF832845       250301,,126.5,,1790924.27
2025/03/04,2025/03/01,SF FuneralF833022       250301,,126.5,,1791050.77
2025/03/04,2025/03/01,SF FuneralF833124       250301,,126.5,,1791177.27
2025/03/04,2025/03/01,SF FuneralF833167       250301,,126.5,,1791303.77
2025/03/04,2025/03/01,SF FuneralF833256       250301,,126.5,,1791430.27
2025/03/04,2025/03/01,SF FuneralF833299       250301,,126.5,,1791556.77
2025/03/04,2025/03/01,SF FuneralF833333       250301,,126.5,,1791683.27
2025/03/04,2025/03/01,SF FuneralF833309       250301,,126.5,,1791809.77
2025/03/04,2025/03/01,SF FuneralF833456       250301,,126.5,,1791936.27
2025/03/04,2025/03/01,SF FuneralF833521       250301,,126.5,,1792062.77
2025/03/04,2025/03/01,SF FuneralF833589       250301,,126.5,,1792189.27
2025/03/04,2025/03/01,SF FuneralF833571       250301,,126.5,,1792315.77
2025/03/04,2025/03/01,SF FuneralF833751       250301,,126.5,,1792442.27
2025/03/04,2025/03/01,SF FuneralF833766       250301,,126.5,,1792568.77
2025/03/04,2025/03/01,SF FuneralF834011       250301,,126.5,,1792695.27
2025/03/04,2025/03/01,SF FuneralF834053       250301,,126.5,,1792821.77
2025/03/04,2025/03/01,SF FuneralF834401       250301,,126.5,,1792948.27
2025/03/04,2025/03/01,SF FuneralF834416       250301,,126.5,,1793074.77
2025/03/04,2025/03/01,SF FuneralF834431       250301,,126.5,,1793201.27
2025/03/04,2025/03/01,SF FuneralFDC0000000D0HF250301,,126.5,,1793327.77
2025/03/04,2025/03/01,SF FuneralF834713       250301,,126.5,,1793454.27
2025/03/04,2025/03/01,SF FuneralF838824       250301,,126.5,,1793580.77
2025/03/04,2025/03/01,SF FuneralF841401       250301,,126.5,,1793707.27
2025/03/04,2025/03/01,SF FuneralF841410       250301,,126.5,,1793833.77
2025/03/04,2025/03/01,SF FuneralF841413       250301,,126.5,,1793960.27
2025/03/04,2025/03/01,SF FuneralF841426       250301,,126.5,,1794086.77
2025/03/04,2025/03/01,SF FuneralF841453       250301,,126.5,,1794213.27
2025/03/04,2025/03/01,SF FuneralF841450       250301,,126.5,,1794339.77
2025/03/04,2025/03/01,SF FuneralF841336       250301,,191.5,,1794531.27
2025/03/04,2025/03/01,SF FuneralF841468       250301,,126.5,,1794657.77
2025/03/04,2025/03/01,SF FuneralF841576       250301,,126.5,,1794784.27
2025/03/04,2025/03/01,SF FuneralF842144       250301,,126.5,,1794910.77
2025/03/04,2025/03/01,SF FuneralF842272       250301,,126.5,,1795037.27
2025/03/04,2025/03/01,SF FuneralF842435       250301,,126.5,,1795163.77
2025/03/04,2025/03/01,SF FuneralF842535       250301,,126.5,,1795290.27
2025/03/04,2025/03/01,SF FuneralFDC0000000F7DT250301,,126.5,,1795416.77
2025/03/04,2025/03/01,SF FuneralF842538       250301,,126.5,,1795543.27
2025/03/04,2025/03/01,SF FuneralF842805       250301,,126.5,,1795669.77
2025/03/04,2025/03/01,SF FuneralFDC0000000F98K250301,,126.5,,1795796.27
2025/03/04,2025/03/01,SF FuneralF814243       250301,,126.5,,1795922.77
2025/03/04,2025/03/01,SF FuneralF991693       250301,,126.5,,1796049.27
2025/03/04,2025/03/01,SF FuneralF808523       250301,,126.5,,1796175.77
2025/03/04,2025/03/01,SF FuneralF991917       250301,,126.5,,1796302.27
2025/03/04,2025/03/01,SF FuneralF992283       250301,,126.5,,1796428.77
2025/03/04,2025/03/01,SF FuneralF992282       250301,,126.5,,1796555.27
2025/03/04,2025/03/01,SF FuneralF992306       250301,,126.5,,1796681.77
2025/03/04,2025/03/01,SF FuneralF992326       250301,,126.5,,1796808.27
2025/03/04,2025/03/01,SF FuneralF992449       250301,,126.5,,1796934.77
2025/03/04,2025/03/01,SF FuneralF992454       250301,,126.5,,1797061.27
2025/03/04,2025/03/01,SF FuneralF992465       250301,,126.5,,1797187.77
2025/03/04,2025/03/01,SF FuneralF992477       250301,,126.5,,1797314.27
2025/03/04,2025/03/01,SF FuneralF992526       250301,,126.5,,1797440.77
2025/03/04,2025/03/01,SF FuneralFDC0000000J9KL250301,,126.5,,1797567.27
2025/03/04,2025/03/01,SF FuneralF992651       250301,,126.5,,1797693.77
2025/03/04,2025/03/01,SF FuneralF992715       250301,,126.5,,1797820.27
2025/03/04,2025/03/01,SF FuneralF992744       250301,,126.5,,1797946.77
2025/03/04,2025/03/01,SF FuneralFDC0000000J9T8250301,,126.5,,1798073.27
2025/03/04,2025/03/01,SF FuneralF992746       250301,,126.5,,1798199.77
2025/03/04,2025/03/01,SF FuneralF992773       250301,,126.5,,1798326.27
2025/03/04,2025/03/01,SF FuneralF992795       250301,,126.5,,1798452.77
2025/03/04,2025/03/01,SF FuneralF992906       250301,,126.5,,1798579.27
2025/03/04,2025/03/01,SF FuneralF993045       250301,,126.5,,1798705.77
2025/03/04,2025/03/01,SF FuneralF993057       250301,,126.5,,1798832.27
2025/03/04,2025/03/01,SF FuneralF993122       250301,,126.5,,1798958.77
2025/03/04,2025/03/01,SF FuneralF993124       250301,,126.5,,1799085.27
2025/03/04,2025/03/01,SF FuneralF993244       250301,,126.5,,1799211.77
2025/03/04,2025/03/01,SF FuneralF993301       250301,,126.5,,1799338.27
2025/03/04,2025/03/01,SF FuneralFDC0000000JC4G250301,,126.5,,1799464.77
2025/03/04,2025/03/01,SF FuneralF993342       250301,,126.5,,1799591.27
2025/03/04,2025/03/01,SF FuneralF993346       250301,,126.5,,1799717.77
2025/03/04,2025/03/01,SF FuneralF993353       250301,,126.5,,1799844.27
2025/03/04,2025/03/01,SF FuneralF993470       250301,,126.5,,1799970.77
2025/03/04,2025/03/01,SF FuneralF993548       250301,,126.5,,1800097.27
2025/03/04,2025/03/01,SF FuneralF993608       250301,,126.5,,1800223.77
2025/03/04,2025/03/01,SF FuneralF993863       250301,,126.5,,1800350.27
2025/03/04,2025/03/01,SF FuneralF994003       250301,,126.5,,1800476.77
2025/03/04,2025/03/01,SF FuneralFDC0000000JG30250301,,126.5,,1800603.27
2025/03/04,2025/03/01,SF FuneralFDC0000000JHX2250301,,126.5,,1800729.77
2025/03/04,2025/03/01,SF FuneralF1017198      250301,,126.5,,1800856.27
2025/03/04,2025/03/01,SF FuneralF1017290      250301,,126.5,,1800982.77
2025/03/04,2025/03/01,SF FuneralF992633       250301,,126.5,,1801109.27
2025/03/04,2025/03/01,SF FuneralFDC0000000JK0C250301,,126.5,,1801235.77
2025/03/04,2025/03/01,SF FuneralF1017492      250301,,126.5,,1801362.27
2025/03/04,2025/03/01,SF FuneralF1017903      250301,,126.5,,1801488.77
2025/03/04,2025/03/01,SF FuneralF1021209      250301,,126.5,,1801615.27
2025/03/04,2025/03/01,SF FuneralF1021493      250301,,126.5,,1801741.77
2025/03/04,2025/03/01,SF FuneralF1021508      250302,,126.5,,1801868.27
2025/03/04,2025/03/01,SF FuneralF1021546      250301,,126.5,,1801994.77
2025/03/04,2025/03/01,SF FuneralF1021585      250301,,126.5,,1802121.27
2025/03/04,2025/03/01,SF FuneralF1021598      250301,,126.5,,1802247.77
2025/03/04,2025/03/01,SF FuneralF1021604      250301,,126.5,,1802374.27
2025/03/04,2025/03/01,SF FuneralF1021614      250301,,126.5,,1802500.77
2025/03/04,2025/03/01,SF FuneralF1021771      250301,,126.5,,1802627.27
2025/03/04,2025/03/01,SF FuneralF1021905      250301,,126.5,,1802753.77
2025/03/04,2025/03/01,SF FuneralF1022038      250301,,126.5,,1802880.27
2025/03/04,2025/03/01,SF FuneralF1022142      250301,,126.5,,1803006.77
2025/03/04,2025/03/01,SF FuneralF1022271      250301,,126.5,,1803133.27
2025/03/04,2025/03/01,SF FuneralF1022274      250301,,126.5,,1803259.77
2025/03/04,2025/03/01,SF FuneralF1022276      250301,,126.5,,1803386.27
2025/03/04,2025/03/01,SF FuneralF1033527      250301,,126.5,,1803512.77
2025/03/04,2025/03/01,SF FuneralF1033554      250301,,126.5,,1803639.27
2025/03/04,2025/03/01,SF FuneralF1033642      250301,,126.5,,1803765.77
2025/03/04,2025/03/01,SF FuneralF1033684      250301,,126.5,,1803892.27
2025/03/04,2025/03/01,SF FuneralF1033686      250301,,126.5,,1804018.77
2025/03/04,2025/03/01,SF FuneralF1033695      250301,,126.5,,1804145.27
2025/03/04,2025/03/01,SF FuneralF1033728      250301,,126.5,,1804271.77
2025/03/04,2025/03/01,SF FuneralF1033734      250301,,126.5,,1804398.27
2025/03/04,2025/03/01,SF FuneralF1033846      250301,,126.5,,1804524.77
2025/03/04,2025/03/01,SF FuneralF1033864      250301,,126.5,,1804651.27
2025/03/04,2025/03/01,SF FuneralFDC0000000JZF2250301,,126.5,,1804777.77
2025/03/04,2025/03/01,SF FuneralF1033978      250301,,126.5,,1804904.27
2025/03/04,2025/03/01,SF FuneralF1047421      250301,,126.5,,1805030.77
2025/03/04,2025/03/01,SF FuneralF1047419      250301,,126.5,,1805157.27
2025/03/04,2025/03/01,SF FuneralF1050692      250301,,126.5,,1805283.77
2025/03/04,2025/03/01,SF FuneralF1050706      250301,,126.5,,1805410.27
2025/03/04,2025/03/01,SF FuneralF1050790      250301,,126.5,,1805536.77
2025/03/04,2025/03/01,SF FuneralF1050820      250301,,126.5,,1805663.27
2025/03/04,2025/03/01,SF FuneralF1050749      250301,,126.5,,1805789.77
2025/03/04,2025/03/01,SF FuneralF1050852      250301,,126.5,,1805916.27
2025/03/04,2025/03/01,SF FuneralF1052264      250301,,126.5,,1806042.77
2025/03/04,2025/03/01,SF FuneralF1052366      250301,,126.5,,1806169.27
2025/03/04,2025/03/01,SF FuneralF1052815      250301,,126.5,,1806295.77
2025/03/04,2025/03/01,SF FuneralF1052899      250301,,126.5,,1806422.27
2025/03/04,2025/03/01,SF FuneralF1052936      250301,,126.5,,1806548.77
2025/03/04,2025/03/01,SF FuneralF1054513      250301,,126.5,,1806675.27
2025/03/04,2025/03/01,SF FuneralF1054545      250301,,126.5,,1806801.77
2025/03/04,2025/03/01,SF FuneralFDC0000000K42S250301,,126.5,,1806928.27
2025/03/04,2025/03/01,SF FuneralFDC0000000K4ZC250301,,126.5,,1807054.77
2025/03/04,2025/03/01,SF FuneralF1055167      250301,,126.5,,1807181.27
2025/03/04,2025/03/01,SF FuneralF740921       250301,,126.5,,1807307.77
2025/03/04,2025/03/01,SF FuneralF1055191      250301,,126.5,,1807434.27
2025/03/04,2025/03/01,SF FuneralF1055201      250301,,126.5,,1807560.77
2025/03/04,2025/03/01,SF FuneralF1055226      250301,,126.5,,1807687.27
2025/03/04,2025/03/01,SF FuneralF1055227      250301,,126.5,,1807813.77
2025/03/04,2025/03/01,SF FuneralF1055231      250301,,126.5,,1807940.27
2025/03/04,2025/03/01,SF FuneralF1055236      250301,,126.5,,1808066.77
2025/03/04,2025/03/01,SF FuneralF1055240      250301,,126.5,,1808193.27
2025/03/04,2025/03/01,SF FuneralF981022       250301,,126.5,,1808319.77
2025/03/04,2025/03/01,SF FuneralFDC0000000K8KW250301,,126.5,,1808446.27
2025/03/04,2025/03/01,SF FuneralF1055278      250301,,126.5,,1808572.77
2025/03/04,2025/03/01,SF FuneralF1058593      250301,,126.5,,1808699.27
2025/03/04,2025/03/01,SF FuneralF1058673      250301,,126.5,,1808825.77
2025/03/04,2025/03/01,SF FuneralF1059485      250301,,126.5,,1808952.27
2025/03/04,2025/03/01,SF FuneralF1059845      250301,,126.5,,1809078.77
2025/03/04,2025/03/01,SF FuneralF1059863      250301,,126.5,,1809205.27
2025/03/04,2025/03/01,SF FuneralF1060066      250301,,126.5,,1809331.77
2025/03/04,2025/03/01,SF FuneralF1060106      250301,,126.5,,1809458.27
2025/03/04,2025/03/01,SF FuneralFDC0000000KCT8250302,,126.5,,1809584.77
2025/03/04,2025/03/01,SF FuneralF1060358      250301,,126.5,,1809711.27
2025/03/04,2025/03/01,SF FuneralFDC0000000KFH0250301,,126.5,,1809837.77
2025/03/04,2025/03/01,SF FuneralF1060501      250301,,126.5,,1809964.27
2025/03/04,2025/03/01,SF FuneralFDC0000000KFV9250301,,126.5,,1810090.77
2025/03/04,2025/03/01,SF FuneralF1060629      250301,,126.5,,1810217.27
2025/03/04,2025/03/01,SF FuneralF1060661      250301,,126.5,,1810343.77
2025/03/04,2025/03/01,SF FuneralF1060700      250301,,126.5,,1810470.27
2025/03/04,2025/03/01,SF FuneralF1060967      250301,,126.5,,1810596.77
2025/03/04,2025/03/01,SF FuneralF1061030      250301,,126.5,,1810723.27
2025/03/04,2025/03/01,SF FuneralF1066154      250301,,126.5,,1810849.77
2025/03/04,2025/03/01,SF FuneralF1066191      250301,,126.5,,1810976.27
2025/03/04,2025/03/01,SF FuneralF1066245      250301,,126.5,,1811102.77
2025/03/04,2025/03/01,SF FuneralF1066316      250301,,126.5,,1811229.27
2025/03/04,2025/03/01,SF FuneralF1066368      250301,,126.5,,1811355.77
2025/03/04,2025/03/01,SF FuneralF1066375      250301,,126.5,,1811482.27
2025/03/04,2025/03/01,SF FuneralF1066378      250301,,126.5,,1811608.77
2025/03/04,2025/03/01,SF FuneralF1066385      250301,,126.5,,1811735.27
2025/03/04,2025/03/01,SF FuneralF1066405      250301,,126.5,,1811861.77
2025/03/04,2025/03/01,SF FuneralF1066402      250301,,191.5,,1812053.27
2025/03/04,2025/03/01,SF FuneralF777453       250301,,126.5,,1812179.77
2025/03/04,2025/03/01,SF FuneralF1066544      250301,,126.5,,1812306.27
2025/03/04,2025/03/01,SF FuneralF1066556      250301,,126.5,,1812432.77
2025/03/04,2025/03/01,SF FuneralFDC0000000KWQH250301,,126.5,,1812559.27
2025/03/04,2025/03/01,SF FuneralF1066631      250301,,126.5,,1812685.77
2025/03/04,2025/03/01,SF FuneralF1066731      250301,,126.5,,1812812.27
2025/03/04,2025/03/01,SF FuneralF1066738      250301,,126.5,,1812938.77
2025/03/04,2025/03/01,SF FuneralF1068229      250301,,126.5,,1813065.27
2025/03/04,2025/03/01,SF FuneralF1068337      250301,,126.5,,1813191.77
2025/03/04,2025/03/01,SF FuneralF1072972      250301,,126.5,,1813318.27
2025/03/04,2025/03/01,SF FuneralFDC0000000L177250301,,126.5,,1813444.77
2025/03/04,2025/03/01,SF FuneralF1073126      250301,,126.5,,1813571.27
2025/03/04,2025/03/01,SF FuneralF1073351      250301,,126.5,,1813697.77
2025/03/04,2025/03/01,SF FuneralF1073381      250301,,126.5,,1813824.27
2025/03/04,2025/03/01,SF FuneralF1073600      250301,,126.5,,1813950.77
2025/03/04,2025/03/01,SF FuneralFDC0000000L46S250301,,126.5,,1814077.27
2025/03/04,2025/03/01,SF FuneralF1073699      250301,,126.5,,1814203.77
2025/03/04,2025/03/01,SF FuneralF1073829      250301,,126.5,,1814330.27
2025/03/04,2025/03/01,SF FuneralF1075003      250301,,126.5,,1814456.77
2025/03/04,2025/03/01,SF FuneralF1075028      250301,,126.5,,1814583.27
2025/03/04,2025/03/01,SF FuneralF1075081      250301,,126.5,,1814709.77
2025/03/04,2025/03/01,SF FuneralF1075082      250301,,126.5,,1814836.27
2025/03/04,2025/03/01,SF FuneralF1075087      250301,,126.5,,1814962.77
2025/03/04,2025/03/01,SF FuneralF1075194      250301,,126.5,,1815089.27
2025/03/04,2025/03/01,SF FuneralF1075206      250301,,126.5,,1815215.77
2025/03/04,2025/03/01,SF FuneralF1075216      250301,,126.5,,1815342.27
2025/03/04,2025/03/01,SF FuneralF1075222      250301,,126.5,,1815468.77
2025/03/04,2025/03/01,SF FuneralF1075230      250301,,126.5,,1815595.27
2025/03/04,2025/03/01,SF FuneralF1075241      250301,,126.5,,1815721.77
2025/03/04,2025/03/01,SF FuneralF1075283      250301,,126.5,,1815848.27
2025/03/04,2025/03/01,SF FuneralF1075303      250301,,126.5,,1815974.77
2025/03/04,2025/03/01,SF FuneralF1075311      250301,,126.5,,1816101.27
2025/03/04,2025/03/01,SF FuneralF1078086      250301,,126.5,,1816227.77
2025/03/04,2025/03/01,SF FuneralF1078089      250301,,126.5,,1816354.27
2025/03/04,2025/03/01,SF FuneralF1078286      250301,,126.5,,1816480.77
2025/03/04,2025/03/01,SF FuneralF1078330      250301,,126.5,,1816607.27
2025/03/04,2025/03/01,SF FuneralF1078449      250301,,126.5,,1816733.77
2025/03/04,2025/03/01,SF FuneralF1078628      250301,,126.5,,1816860.27
2025/03/04,2025/03/01,SF FuneralF1078695      250301,,126.5,,1816986.77
2025/03/04,2025/03/01,SF FuneralF1078868      250301,,126.5,,1817113.27
2025/03/04,2025/03/01,SF FuneralF1078896      250301,,126.5,,1817239.77
2025/03/04,2025/03/01,SF FuneralF1078975      250301,,126.5,,1817366.27
2025/03/04,2025/03/01,SF FuneralF1078990      250301,,126.5,,1817492.77
2025/03/04,2025/03/01,SF FuneralF1079043      250301,,126.5,,1817619.27
2025/03/04,2025/03/01,SF FuneralFDC0000000LK8N250301,,126.5,,1817745.77
2025/03/04,2025/03/01,SF FuneralF1079459      250301,,126.5,,1817872.27
2025/03/04,2025/03/01,SF FuneralF1079492      250301,,126.5,,1817998.77
2025/03/04,2025/03/01,SF FuneralF1079533      250301,,126.5,,1818125.27
2025/03/04,2025/03/01,SF FuneralF1079560      250301,,126.5,,1818251.77
2025/03/04,2025/03/01,SF FuneralF1080150      250301,,126.5,,1818378.27
2025/03/04,2025/03/01,SF FuneralF1080365      250301,,126.5,,1818504.77
2025/03/04,2025/03/01,SF FuneralF1080383      250301,,126.5,,1818631.27
2025/03/04,2025/03/01,SF FuneralFDC0000000LNP3250301,,126.5,,1818757.77
2025/03/04,2025/03/01,SF FuneralF1080457      250301,,126.5,,1818884.27
2025/03/04,2025/03/01,SF FuneralF1080515      250301,,126.5,,1819010.77
2025/03/04,2025/03/01,SF FuneralFDC0000000LQSC250301,,126.5,,1819137.27
2025/03/04,2025/03/01,SF FuneralF988426       250301,,126.5,,1819263.77
2025/03/04,2025/03/01,SF FuneralF1083999      250301,,126.5,,1819390.27
2025/03/04,2025/03/01,SF FuneralF1084006      250301,,126.5,,1819516.77
2025/03/04,2025/03/01,SF FuneralF1084324      250301,,126.5,,1819643.27
2025/03/04,2025/03/01,SF FuneralF1084371      250301,,126.5,,1819769.77
2025/03/04,2025/03/01,SF FuneralF1084585      250301,,126.5,,1819896.27
2025/03/04,2025/03/01,SF FuneralF1084597      250301,,126.5,,1820022.77
2025/03/04,2025/03/01,SF FuneralF1084670      250301,,126.5,,1820149.27
2025/03/04,2025/03/01,SF FuneralF1084725      250301,,126.5,,1820275.77
2025/03/04,2025/03/01,SF FuneralF1084981      250302,,126.5,,1820402.27
2025/03/04,2025/03/01,SF FuneralF1084986      250301,,126.5,,1820528.77
2025/03/04,2025/03/01,SF FuneralF812346       250301,,126.5,,1820655.27
2025/03/04,2025/03/01,SF FuneralF1085006      250301,,126.5,,1820781.77
2025/03/04,2025/03/01,SF FuneralF1085028      250301,,126.5,,1820908.27
2025/03/04,2025/03/01,SF FuneralF1085062      250301,,126.5,,1821034.77
2025/03/04,2025/03/01,SF FuneralF1085060      250301,,126.5,,1821161.27
2025/03/04,2025/03/01,SF FuneralF1085298      250302,,126.5,,1821287.77
2025/03/04,2025/03/01,SF FuneralF1102983      250301,,126.5,,1821414.27
2025/03/04,2025/03/01,SF FuneralF1103010      250301,,126.5,,1821540.77
2025/03/04,2025/03/01,SF FuneralFDC0000000M3DG250301,,213.31,,1821754.08
2025/03/04,2025/03/01,SF FuneralF1103624      250301,,126.5,,1821880.58
2025/03/04,2025/03/01,SF FuneralF1103735      250301,,126.5,,1822007.08
2025/03/04,2025/03/01,SF FuneralF1103744      250301,,126.5,,1822133.58
2025/03/04,2025/03/01,SF FuneralF1104031      250301,,126.5,,1822260.08
2025/03/04,2025/03/01,SF FuneralF1104049      250301,,126.5,,1822386.58
2025/03/04,2025/03/01,SF FuneralF1108068      250301,,126.5,,1822513.08
2025/03/04,2025/03/01,SF FuneralF1108562      250301,,126.5,,1822639.58
2025/03/04,2025/03/01,SF FuneralF1108766      250301,,126.5,,1822766.08
2025/03/04,2025/03/01,SF FuneralF1108770      250301,,126.5,,1822892.58
2025/03/04,2025/03/01,SF FuneralF1108779      250301,,126.5,,1823019.08
2025/03/04,2025/03/01,SF FuneralF1108792      250301,,126.5,,1823145.58
2025/03/04,2025/03/01,SF FuneralF1108793      250301,,126.5,,1823272.08
2025/03/04,2025/03/01,SF FuneralF1108795      250301,,126.5,,1823398.58
2025/03/04,2025/03/01,SF FuneralF1108796      250301,,126.5,,1823525.08
2025/03/04,2025/03/01,SF FuneralF1108815      250301,,126.5,,1823651.58
2025/03/04,2025/03/01,SF FuneralF1108826      250301,,126.5,,1823778.08
2025/03/04,2025/03/01,SF FuneralF1108873      250301,,126.5,,1823904.58
2025/03/04,2025/03/01,SF FuneralF1108973      250301,,126.5,,1824031.08
2025/03/04,2025/03/01,SF FuneralF1108987      250301,,126.5,,1824157.58
2025/03/04,2025/03/01,SF FuneralF1108997      250301,,126.5,,1824284.08
2025/03/04,2025/03/01,SF FuneralFDC0000000MJHS250301,,126.5,,1824410.58
2025/03/04,2025/03/01,SF FuneralF1109053      250301,,126.5,,1824537.08
2025/03/04,2025/03/01,SF FuneralF1109067      250302,,126.5,,1824663.58
2025/03/04,2025/03/01,SF FuneralF1109084      250301,,126.5,,1824790.08
2025/03/04,2025/03/01,SF FuneralF1109081      250301,,126.5,,1824916.58
2025/03/04,2025/03/01,SF FuneralF1109104      250302,,126.5,,1825043.08
2025/03/04,2025/03/01,SF FuneralF1109109      250301,,126.5,,1825169.58
2025/03/04,2025/03/01,SF FuneralF1109346      250301,,126.5,,1825296.08
2025/03/04,2025/03/01,SF FuneralF1109549      250301,,126.5,,1825422.58
2025/03/04,2025/03/01,SF FuneralF1109560      250301,,126.5,,1825549.08
2025/03/04,2025/03/01,SF FuneralF1109613      250302,,126.5,,1825675.58
2025/03/04,2025/03/01,SF FuneralF1109686      250301,,126.5,,1825802.08
2025/03/04,2025/03/01,SF FuneralF1110094      250301,,126.5,,1825928.58
2025/03/04,2025/03/01,SF FuneralF1110177      250301,,126.5,,1826055.08
2025/03/04,2025/03/01,SF FuneralF1110188      250301,,126.5,,1826181.58
2025/03/04,2025/03/01,SF FuneralF1110240      250301,,126.5,,1826308.08
2025/03/04,2025/03/01,SF FuneralF1110257      250301,,126.5,,1826434.58
2025/03/04,2025/03/01,SF FuneralF1110352      250301,,126.5,,1826561.08
2025/03/04,2025/03/01,SF FuneralF1110372      250301,,126.5,,1826687.58
2025/03/04,2025/03/01,SF FuneralF1110408      250301,,126.5,,1826814.08
2025/03/04,2025/03/01,SF FuneralF1110440      250301,,126.5,,1826940.58
2025/03/04,2025/03/01,SF FuneralF1110469      250301,,126.5,,1827067.08
2025/03/04,2025/03/01,SF FuneralF1110481      250301,,126.5,,1827193.58
2025/03/04,2025/03/01,SF FuneralF1110657      250301,,126.5,,1827320.08
2025/03/04,2025/03/01,SF FuneralF1110670      250301,,126.5,,1827446.58
2025/03/04,2025/03/01,SF FuneralF1111435      250301,,126.5,,1827573.08
2025/03/04,2025/03/01,SF FuneralF1111560      250301,,126.5,,1827699.58
2025/03/04,2025/03/01,SF FuneralF1111599      250301,,126.5,,1827826.08
2025/03/04,2025/03/01,SF FuneralF1112427      250301,,126.5,,1827952.58
2025/03/04,2025/03/01,SF FuneralF1113096      250301,,126.5,,1828079.08
2025/03/04,2025/03/01,SF FuneralF1113117      250301,,126.5,,1828205.58
2025/03/04,2025/03/01,SF FuneralF1113133      250301,,126.5,,1828332.08
2025/03/04,2025/03/01,SF FuneralF1113134      250301,,126.5,,1828458.58
2025/03/04,2025/03/01,SF FuneralF1113135      250301,,126.5,,1828585.08
2025/03/04,2025/03/01,SF FuneralF1113144      250301,,126.5,,1828711.58
2025/03/04,2025/03/01,SF FuneralF1113221      250301,,126.5,,1828838.08
2025/03/04,2025/03/01,SF FuneralF1113235      250301,,126.5,,1828964.58
2025/03/04,2025/03/01,SF FuneralF1113257      250301,,126.5,,1829091.08
2025/03/04,2025/03/01,SF FuneralF1113269      250301,,126.5,,1829217.58
2025/03/04,2025/03/01,SF FuneralF1113274      250301,,126.5,,1829344.08
2025/03/04,2025/03/01,SF FuneralFDC0000000N4J5250301,,126.5,,1829470.58
2025/03/04,2025/03/01,SF FuneralF1113341      250301,,126.5,,1829597.08
2025/03/04,2025/03/01,SF FuneralF1113563      250301,,126.5,,1829723.58
2025/03/04,2025/03/01,SF FuneralF1113773      250301,,126.5,,1829850.08
2025/03/04,2025/03/01,SF FuneralF1113855      250301,,126.5,,1829976.58
2025/03/04,2025/03/01,SF FuneralF1114339      250301,,126.5,,1830103.08
2025/03/04,2025/03/01,SF FuneralF1114380      250301,,126.5,,1830229.58
2025/03/04,2025/03/01,SF FuneralF1114495      250301,,126.5,,1830356.08
2025/03/04,2025/03/01,SF FuneralF1114563      250301,,126.5,,1830482.58
2025/03/04,2025/03/01,SF FuneralFDC0000000NBKM250301,,126.5,,1830609.08
2025/03/04,2025/03/01,SF FuneralF1115853      250301,,126.5,,1830735.58
2025/03/04,2025/03/01,SF FuneralF1116091      250301,,126.5,,1830862.08
2025/03/04,2025/03/01,SF FuneralF1116816      250301,,126.5,,1830988.58
2025/03/04,2025/03/01,SF FuneralFDC0000000NHPV250301,,213.31,,1831201.89
2025/03/04,2025/03/01,SF FuneralF1116920      250301,,126.5,,1831328.39
2025/03/04,2025/03/01,SF FuneralF1116954      250301,,126.5,,1831454.89
2025/03/04,2025/03/01,SF FuneralFDC0000000NJ43250301,,126.5,,1831581.39
2025/03/04,2025/03/01,SF FuneralF1117018      250301,,126.5,,1831707.89
2025/03/04,2025/03/01,SF FuneralF774354       250301,,220,,1831927.89
2025/03/04,2025/03/01,SF FuneralF1117162      250301,,126.5,,1832054.39
2025/03/04,2025/03/01,SF FuneralF1117223      250301,,126.5,,1832180.89
2025/03/04,2025/03/01,SF FuneralF1117229      250301,,126.5,,1832307.39
2025/03/04,2025/03/01,SF FuneralF1117228      250301,,126.5,,1832433.89
2025/03/04,2025/03/01,SF FuneralF1117418      250301,,126.5,,1832560.39
2025/03/04,2025/03/01,SF FuneralF1117626      250301,,126.5,,1832686.89
2025/03/04,2025/03/01,SF FuneralF1117643      250301,,126.5,,1832813.39
2025/03/04,2025/03/01,SF FuneralF1117681      250301,,126.5,,1832939.89
2025/03/04,2025/03/01,SF FuneralF1117711      250301,,126.5,,1833066.39
2025/03/04,2025/03/01,SF FuneralF1118037      250301,,126.5,,1833192.89
2025/03/04,2025/03/01,SF FuneralF1118511      250301,,126.5,,1833319.39
2025/03/04,2025/03/01,SF FuneralF1118145      250301,,126.5,,1833445.89
2025/03/04,2025/03/01,SF FuneralF1118681      250301,,126.5,,1833572.39
2025/03/04,2025/03/01,SF FuneralF1120135      250301,,126.5,,1833698.89
2025/03/04,2025/03/01,SF FuneralF1120178      250301,,126.5,,1833825.39
2025/03/04,2025/03/01,SF FuneralF1120183      250301,,126.5,,1833951.89
2025/03/04,2025/03/01,SF FuneralF1075158      250301,,126.5,,1834078.39
2025/03/04,2025/03/01,SF FuneralF1120409      250301,,126.5,,1834204.89
2025/03/04,2025/03/01,SF FuneralF1120529      250301,,126.5,,1834331.39
2025/03/04,2025/03/01,SF FuneralF1121774      250301,,126.5,,1834457.89
2025/03/04,2025/03/01,SF FuneralF1121777      250301,,126.5,,1834584.39
2025/03/04,2025/03/01,SF FuneralF1121919      250301,,126.5,,1834710.89
2025/03/04,2025/03/01,SF FuneralF1121926      250301,,126.5,,1834837.39
2025/03/04,2025/03/01,SF FuneralF1121974      250301,,126.5,,1834963.89
2025/03/04,2025/03/01,SF FuneralF1121977      250301,,126.5,,1835090.39
2025/03/04,2025/03/01,SF FuneralF1121987      250301,,126.5,,1835216.89
2025/03/04,2025/03/01,SF FuneralF1121990      250301,,126.5,,1835343.39
2025/03/04,2025/03/01,SF FuneralF1122074      250301,,126.5,,1835469.89
2025/03/04,2025/03/01,SF FuneralFDC0000000P0MH250301,,126.5,,1835596.39
2025/03/04,2025/03/01,SF FuneralF1122161      250301,,126.5,,1835722.89
2025/03/04,2025/03/01,SF FuneralF1122169      250301,,126.5,,1835849.39
2025/03/04,2025/03/01,SF FuneralF1122276      250301,,126.5,,1835975.89
2025/03/04,2025/03/01,SF FuneralF1122285      250301,,126.5,,1836102.39
2025/03/04,2025/03/01,SF FuneralF1122566      250301,,126.5,,1836228.89
2025/03/04,2025/03/01,SF FuneralF1122647      250301,,126.5,,1836355.39
2025/03/04,2025/03/01,SF FuneralF1122810      250301,,126.5,,1836481.89
2025/03/04,2025/03/01,SF FuneralF783420       250301,,191.5,,1836673.39
2025/03/04,2025/03/01,SF FuneralF1122863      250301,,126.5,,1836799.89
2025/03/04,2025/03/01,SF FuneralF1123283      250301,,126.5,,1836926.39
2025/03/04,2025/03/01,SF FuneralF1123325      250301,,126.5,,1837052.89
2025/03/04,2025/03/01,SF FuneralF1123491      250301,,126.5,,1837179.39
2025/03/04,2025/03/01,SF FuneralF1123950      250301,,126.5,,1837305.89
2025/03/04,2025/03/01,SF FuneralF1124023      250301,,126.5,,1837432.39
2025/03/04,2025/03/01,SF FuneralF1124150      250301,,126.5,,1837558.89
2025/03/04,2025/03/01,SF FuneralF799573       250301,,126.5,,1837685.39
2025/03/04,2025/03/01,SF FuneralF797990       250301,,126.5,,1837811.89
2025/03/04,2025/03/01,SF FuneralF1125694      250301,,126.5,,1837938.39
2025/03/04,2025/03/01,SF FuneralF1125703      250301,,126.5,,1838064.89
2025/03/04,2025/03/01,SF FuneralFDC0000000PHJK250301,,126.5,,1838191.39
2025/03/04,2025/03/01,SF FuneralF1125737      250301,,126.5,,1838317.89
2025/03/04,2025/03/01,SF FuneralF1125781      250301,,126.5,,1838444.39
2025/03/04,2025/03/01,SF FuneralFDC0000000PJ60250301,,126.5,,1838570.89
2025/03/04,2025/03/01,SF FuneralF1125885      250301,,126.5,,1838697.39
2025/03/04,2025/03/01,SF FuneralF1021796      250301,,126.5,,1838823.89
2025/03/04,2025/03/01,SF FuneralF782608       250301,,126.5,,1838950.39
2025/03/04,2025/03/01,SF FuneralFDC0000000PJPF250301,,126.5,,1839076.89
2025/03/04,2025/03/01,SF FuneralF1126002      250301,,126.5,,1839203.39
2025/03/04,2025/03/01,SF FuneralFDC0000000PJVX250301,,126.5,,1839329.89
2025/03/04,2025/03/01,SF FuneralFDC0000000PK3B250301,,126.5,,1839456.39
2025/03/04,2025/03/01,SF FuneralF1126081      250301,,126.5,,1839582.89
2025/03/04,2025/03/01,SF FuneralF1126160      250301,,126.5,,1839709.39
2025/03/04,2025/03/01,SF FuneralF1126163      250301,,126.5,,1839835.89
2025/03/04,2025/03/01,SF FuneralF1126272      250301,,126.5,,1839962.39
2025/03/04,2025/03/01,SF FuneralF1126288      250301,,126.5,,1840088.89
2025/03/04,2025/03/01,SF FuneralF1126952      250301,,126.5,,1840215.39
2025/03/04,2025/03/01,SF FuneralF1126957      250301,,126.5,,1840341.89
2025/03/04,2025/03/01,SF FuneralF1127101      250302,,126.5,,1840468.39
2025/03/04,2025/03/01,SF FuneralFDC0000000PNDM250301,,126.5,,1840594.89
2025/03/04,2025/03/01,SF FuneralFDC0000000PNYS250301,,126.5,,1840721.39
2025/03/04,2025/03/01,SF FuneralF1127486      250301,,126.5,,1840847.89
2025/03/04,2025/03/01,SF FuneralF1127558      250301,,126.5,,1840974.39
2025/03/04,2025/03/01,SF FuneralFDC0000000PSQD250301,,191.5,,1841165.89
2025/03/04,2025/03/01,SF FuneralF1127888      250301,,126.5,,1841292.39
2025/03/04,2025/03/01,SF FuneralF1127917      250301,,126.5,,1841418.89
2025/03/04,2025/03/01,SF FuneralF1127964      250301,,126.5,,1841545.39
2025/03/04,2025/03/01,SF FuneralF1128006      250301,,126.5,,1841671.89
2025/03/04,2025/03/01,SF FuneralF1128026      250301,,126.5,,1841798.39
2025/03/04,2025/03/01,SF FuneralF1128029      250301,,126.5,,1841924.89
2025/03/04,2025/03/01,SF FuneralFDC0000000PV0M250301,,126.5,,1842051.39
2025/03/04,2025/03/01,SF FuneralF1128050      250301,,126.5,,1842177.89
2025/03/04,2025/03/01,SF FuneralFDC0000000PVH6250301,,126.5,,1842304.39
2025/03/04,2025/03/01,SF FuneralF1128215      250301,,126.5,,1842430.89
2025/03/04,2025/03/01,SF FuneralF1128217      250301,,126.5,,1842557.39
2025/03/04,2025/03/01,SF FuneralF1128220      250301,,126.5,,1842683.89
2025/03/04,2025/03/01,SF FuneralF1128249      250301,,126.5,,1842810.39
2025/03/04,2025/03/01,SF FuneralF1128251      250301,,126.5,,1842936.89
2025/03/04,2025/03/01,SF FuneralFDC0000000PVNL250301,,126.5,,1843063.39
2025/03/04,2025/03/01,SF FuneralFDC0000000PVP2250301,,126.5,,1843189.89
2025/03/04,2025/03/01,SF FuneralF1128690      250301,,126.5,,1843316.39
2025/03/04,2025/03/01,SF FuneralF1128725      250301,,126.5,,1843442.89
2025/03/04,2025/03/01,SF FuneralF1128750      250301,,126.5,,1843569.39
2025/03/04,2025/03/01,SF FuneralFDC0000000PW30250301,,126.5,,1843695.89
2025/03/04,2025/03/01,SF FuneralF1128790      250301,,126.5,,1843822.39
2025/03/04,2025/03/01,SF FuneralF1128804      250301,,126.5,,1843948.89
2025/03/04,2025/03/01,SF FuneralF1128808      250301,,126.5,,1844075.39
2025/03/04,2025/03/01,SF FuneralF1128812      250301,,126.5,,1844201.89
2025/03/04,2025/03/01,SF FuneralF1128945      250301,,126.5,,1844328.39
2025/03/04,2025/03/01,SF FuneralF1128952      250301,,126.5,,1844454.89
2025/03/04,2025/03/01,SF FuneralF1128961      250301,,126.5,,1844581.39
2025/03/04,2025/03/01,SF FuneralFDC0000000PX9V250301,,126.5,,1844707.89
2025/03/04,2025/03/01,SF FuneralF1129077      250301,,126.5,,1844834.39
2025/03/04,2025/03/01,SF FuneralF1129081      250301,,126.5,,1844960.89
2025/03/04,2025/03/01,SF FuneralF1129347      250301,,126.5,,1845087.39
2025/03/04,2025/03/01,SF FuneralF803093       250301,,126.5,,1845213.89
2025/03/04,2025/03/01,SF FuneralF1129472      250301,,126.5,,1845340.39
2025/03/04,2025/03/01,SF FuneralF1129999      250301,,126.5,,1845466.89
2025/03/04,2025/03/01,SF FuneralF1130500      250301,,126.5,,1845593.39
2025/03/04,2025/03/01,SF FuneralF1130741      250301,,126.5,,1845719.89
2025/03/04,2025/03/01,SF FuneralF1130753      250301,,126.5,,1845846.39
2025/03/04,2025/03/01,SF FuneralFDC0000000Q2JW250301,,126.5,,1845972.89
2025/03/04,2025/03/01,SF FuneralF1131061      250301,,126.5,,1846099.39
2025/03/04,2025/03/01,SF FuneralF1131088      250301,,126.5,,1846225.89
2025/03/04,2025/02/28,SF FuneralFDC0000000801P250228,,126.5,,1846352.39
2025/03/04,2025/02/28,SF FuneralF981564       250301,,126.5,,1846478.89
2025/03/04,2025/03/01,SF FuneralFDC00000002VHN250301,,220,,1846698.89
2025/03/04,2025/03/01,SF FuneralFDC00000006F04250301,,126.5,,1846825.39
2025/03/04,2025/03/01,SF FuneralF832238       250301,,126.5,,1846951.89
2025/03/04,2025/03/01,SF FuneralF1060101      250301,,126.5,,1847078.39
2025/03/04,2025/03/01,SF FuneralF993483       250301,,126.5,,1847204.89
2025/03/04,2025/03/01,SF FuneralFDC0000000MM95250301,,191.5,,1847396.39
2025/03/04,2025/03/01,SF FuneralF1117349      250301,,126.5,,1847522.89
2025/03/04,2025/03/01,SF FuneralF1128860      250301,,126.5,,1847649.39
2025/03/04,2025/03/03,SF FuneralF1072867      250303,,126.5,,1847775.89
2025/03/04,2025/03/03,SF FuneralF1110647      250303,,126.5,,1847902.39
2025/03/04,2025/03/01,SF FuneralF1131139      250301,,126.5,,1848028.89
2025/03/04,2025/03/01,SF FuneralFDC0000000Q4HC250301,,126.5,,1848155.39
2025/03/04,2025/03/01,SF FuneralF1131181      250301,,126.5,,1848281.89
2025/03/04,2025/03/01,SF FuneralF1131213      250301,,126.5,,1848408.39
2025/03/04,2025/03/01,SF FuneralF1131249      250301,,126.5,,1848534.89
2025/03/04,2025/03/01,SF FuneralF828123       250301,,126.5,,1848661.39
2025/03/04,2025/03/01,SF FuneralF1131259      250301,,126.5,,1848787.89
2025/03/04,2025/03/01,SF FuneralF1131311      250301,,126.5,,1848914.39
2025/03/04,2025/03/01,SF FuneralF1131350      250301,,126.5,,1849040.89
2025/03/04,2025/03/01,SF FuneralF1131341      250301,,126.5,,1849167.39
2025/03/04,2025/03/01,SF FuneralFDC0000000Q55M250301,,126.5,,1849293.89
2025/03/04,2025/03/01,SF FuneralFDC0000000Q57G250301,,126.5,,1849420.39
2025/03/04,2025/03/01,SF FuneralFDC0000000Q57J250301,,126.5,,1849546.89
2025/03/04,2025/03/01,SF FuneralF1131600      250301,,126.5,,1849673.39
2025/03/04,2025/03/01,SF FuneralF1131609      250301,,126.5,,1849799.89
2025/03/04,2025/03/01,SF FuneralF1131624      250301,,126.5,,1849926.39
2025/03/04,2025/03/01,SF FuneralF1131860      250301,,126.5,,1850052.89
2025/03/04,2025/03/01,SF FuneralF1131870      250301,,126.5,,1850179.39
2025/03/04,2025/03/01,SF FuneralF1131889      250301,,126.5,,1850305.89
2025/03/04,2025/03/01,SF FuneralF1132108      250301,,126.5,,1850432.39
2025/03/04,2025/03/01,SF FuneralF1132128      250301,,126.5,,1850558.89
2025/03/04,2025/03/01,SF FuneralF1128328      250301,,126.5,,1850685.39
2025/03/04,2025/03/01,SF FuneralF1132244      250301,,126.5,,1850811.89
2025/03/04,2025/03/01,SF FuneralF1132248      250301,,126.5,,1850938.39
2025/03/04,2025/03/01,SF FuneralF1132270      250301,,126.5,,1851064.89
2025/03/04,2025/03/01,SF FuneralF1132303      250301,,126.5,,1851191.39
2025/03/04,2025/03/01,SF FuneralFDC0000000Q823250301,,126.5,,1851317.89
2025/03/04,2025/03/01,SF FuneralF1132390      250301,,126.5,,1851444.39
2025/03/04,2025/03/01,SF FuneralF1132529      250301,,126.5,,1851570.89
2025/03/04,2025/03/01,SF FuneralF1132777      250301,,126.5,,1851697.39
2025/03/04,2025/03/01,SF FuneralF1132805      250301,,126.5,,1851823.89
2025/03/04,2025/03/01,SF FuneralF1132842      250301,,126.5,,1851950.39
2025/03/04,2025/03/01,SF FuneralF1132914      250301,,126.5,,1852076.89
2025/03/04,2025/03/01,SF FuneralFDC00000002V81250301,,220,,1852296.89
2025/03/04,2025/03/01,SF FuneralFDC00000002VGH250301,,220,,1852516.89
2025/03/04,2025/03/01,SF FuneralFDC00000002VK9250301,,220,,1852736.89
2025/03/04,2025/03/01,SF FuneralFDC00000002VV2250301,,220,,1852956.89
2025/03/04,2025/03/01,SF FuneralFDC00000002W18250301,,220,,1853176.89
2025/03/04,2025/03/01,SF FuneralFDC00000002W34250301,,220,,1853396.89
2025/03/04,2025/03/01,SF FuneralFDC00000002W89250301,,220,,1853616.89
2025/03/04,2025/03/01,SF FuneralFDC000000033MH250301,,220,,1853836.89
2025/03/04,2025/03/01,SF FuneralFDC000000033YD250301,,220,,1854056.89
2025/03/04,2025/03/01,SF FuneralFDC000000039PJ250301,,220,,1854276.89
2025/03/04,2025/03/01,SF FuneralFDC00000004G9L250301,,220,,1854496.89
2025/03/04,2025/03/01,SF FuneralFDC00000004GC6250301,,220,,1854716.89
2025/03/04,2025/03/01,SF FuneralFDC000000057FM250301,,126.5,,1854843.39
2025/03/04,2025/03/01,SF FuneralFDC000000057QF250301,,126.5,,1854969.89
2025/03/04,2025/03/01,SF FuneralFDC000000058MX250301,,126.5,,1855096.39
2025/03/04,2025/03/01,SF FuneralFDC000000059MJ250301,,126.5,,1855222.89
2025/03/04,2025/03/01,SF FuneralFDC00000005BQJ250301,,126.5,,1855349.39
2025/03/04,2025/03/01,SF FuneralFDC00000005DFV250301,,126.5,,1855475.89
2025/03/04,2025/03/01,SF FuneralFDC00000005FWS250301,,126.5,,1855602.39
2025/03/04,2025/03/01,SF FuneralFDC00000005GBW250301,,126.5,,1855728.89
2025/03/04,2025/03/01,SF FuneralFDC00000005GHR250301,,126.5,,1855855.39
2025/03/04,2025/03/01,SF FuneralFDC00000005GLT250301,,126.5,,1855981.89
2025/03/04,2025/03/01,SF FuneralFDC00000005JTS250301,,126.5,,1856108.39
2025/03/04,2025/03/01,SF FuneralFDC00000005M8K250301,,220,,1856328.39
2025/03/04,2025/03/01,SF FuneralFDC00000005XJ3250301,,126.5,,1856454.89
2025/03/04,2025/03/01,SF FuneralFDC00000005Y87250301,,126.5,,1856581.39
2025/03/04,2025/03/01,SF FuneralFDC0000000676Z250301,,126.5,,1856707.89
2025/03/04,2025/03/01,SF FuneralFDC00000006772250301,,126.5,,1856834.39
2025/03/04,2025/03/01,SF FuneralFDC00000006793250301,,126.5,,1856960.89
2025/03/04,2025/03/01,SF FuneralFDC000000067LL250301,,126.5,,1857087.39
2025/03/04,2025/03/01,SF FuneralFDC000000067NH250301,,126.5,,1857213.89
2025/03/04,2025/03/01,SF FuneralFDC000000067P6250301,,126.5,,1857340.39
2025/03/04,2025/03/01,SF FuneralFDC00000006821250301,,126.5,,1857466.89
2025/03/04,2025/03/01,SF FuneralFDC0000000688D250301,,126.5,,1857593.39
2025/03/04,2025/03/01,SF FuneralFDC000000068C4250301,,126.5,,1857719.89
2025/03/04,2025/03/01,SF FuneralFDC000000068DX250301,,126.5,,1857846.39
2025/03/04,2025/03/01,SF FuneralFDC000000068F7250301,,126.5,,1857972.89
2025/03/04,2025/03/01,SF FuneralFDC000000069TX250301,,126.5,,1858099.39
2025/03/04,2025/03/01,SF FuneralFDC000000069ZK250301,,126.5,,1858225.89
2025/03/04,2025/03/01,SF FuneralFDC00000006B8V250301,,126.5,,1858352.39
2025/03/04,2025/03/01,SF FuneralFDC00000006GWG250301,,126.5,,1858478.89
2025/03/04,2025/03/01,SF FuneralFDC00000006H3W250301,,126.5,,1858605.39
2025/03/04,2025/03/01,SF FuneralFDC00000006HHS250301,,126.5,,1858731.89
2025/03/04,2025/03/01,SF FuneralFDC00000006HSF250301,,126.5,,1858858.39
2025/03/04,2025/03/01,SF FuneralFDC00000006J3N250301,,126.5,,1858984.89
2025/03/04,2025/03/01,SF FuneralFDC00000006J9Z250301,,126.5,,1859111.39
2025/03/04,2025/03/01,SF FuneralFDC00000006JBR250301,,126.5,,1859237.89
2025/03/04,2025/03/01,SF FuneralFDC00000006JCP250301,,126.5,,1859364.39
2025/03/04,2025/03/01,SF FuneralFDC00000006JQF250301,,126.5,,1859490.89
2025/03/04,2025/03/01,SF FuneralFDC00000006JT7250301,,126.5,,1859617.39
2025/03/04,2025/03/01,SF FuneralFDC00000006K95250301,,126.5,,1859743.89
2025/03/04,2025/03/01,SF FuneralFDC00000006KG3250301,,126.5,,1859870.39
2025/03/04,2025/03/01,SF FuneralFDC00000006MMT250301,,126.5,,1859996.89
2025/03/04,2025/03/01,SF FuneralFDC00000006N1H250301,,126.5,,1860123.39
2025/03/04,2025/03/01,SF FuneralFDC00000006N1L250301,,126.5,,1860249.89
2025/03/04,2025/03/01,SF FuneralFDC00000006NG8250301,,126.5,,1860376.39
2025/03/04,2025/03/01,SF FuneralFDC00000006NLG250301,,126.5,,1860502.89
2025/03/04,2025/03/01,SF FuneralFDC00000006NQW250301,,126.5,,1860629.39
2025/03/04,2025/03/01,SF FuneralFDC00000006NVG250301,,126.5,,1860755.89
2025/03/04,2025/03/01,SF FuneralFDC00000006P1R250301,,126.5,,1860882.39
2025/03/04,2025/03/01,SF FuneralFDC00000006Q10250301,,126.5,,1861008.89
2025/03/04,2025/03/01,SF FuneralFDC00000006Q7L250301,,126.5,,1861135.39
2025/03/04,2025/03/01,SF FuneralFDC00000006Q81250301,,126.5,,1861261.89
2025/03/04,2025/03/01,SF FuneralFDC00000006R2W250301,,126.5,,1861388.39
2025/03/04,2025/03/01,SF FuneralFDC00000006R2X250301,,126.5,,1861514.89
2025/03/04,2025/03/01,SF FuneralFDC00000006RFR250301,,126.5,,1861641.39
2025/03/04,2025/03/01,SF FuneralFDC00000006RM7250301,,126.5,,1861767.89
2025/03/04,2025/03/01,SF FuneralFDC00000006RMR250301,,126.5,,1861894.39
2025/03/04,2025/03/01,SF FuneralFDC00000006RNH250301,,126.5,,1862020.89
2025/03/04,2025/03/01,SF FuneralFDC00000006SDN250301,,126.5,,1862147.39
2025/03/04,2025/03/01,SF FuneralFDC00000006SG5250301,,220,,1862367.39
2025/03/04,2025/03/01,SF FuneralFDC00000006SJT250301,,126.5,,1862493.89
2025/03/04,2025/03/01,SF FuneralFDC00000006STT250301,,126.5,,1862620.39
2025/03/04,2025/03/01,SF FuneralFDC00000006STY250301,,126.5,,1862746.89
2025/03/04,2025/03/01,SF FuneralFDC00000006SVM250301,,126.5,,1862873.39
2025/03/04,2025/03/01,SF FuneralFDC00000006TWX250301,,126.5,,1862999.89
2025/03/04,2025/03/01,SF FuneralFDC00000006W32250301,,126.5,,1863126.39
2025/03/04,2025/03/01,SF FuneralFDC00000006W3M250301,,126.5,,1863252.89
2025/03/04,2025/03/01,SF FuneralFDC00000006XLM250301,,126.5,,1863379.39
2025/03/04,2025/03/01,SF FuneralFDC00000006YJ0250301,,126.5,,1863505.89
2025/03/04,2025/03/01,SF FuneralFDC00000006YXW250301,,126.5,,1863632.39
2025/03/04,2025/03/01,SF FuneralFDC000000073GV250301,,126.5,,1863758.89
2025/03/04,2025/03/01,SF FuneralFDC000000073J2250301,,126.5,,1863885.39
2025/03/04,2025/03/01,SF FuneralFDC000000073LH250301,,126.5,,1864011.89
2025/03/04,2025/03/01,SF FuneralFDC000000073TJ250301,,126.5,,1864138.39
2025/03/04,2025/03/01,SF FuneralFDC000000073V0250301,,126.5,,1864264.89
2025/03/04,2025/03/01,SF FuneralFDC0000000747P250301,,126.5,,1864391.39
2025/03/04,2025/03/01,SF FuneralFDC000000074FR250301,,126.5,,1864517.89
2025/03/04,2025/03/01,SF FuneralFDC000000074NG250301,,126.5,,1864644.39
2025/03/04,2025/03/01,SF FuneralFDC000000074SQ250301,,126.5,,1864770.89
2025/03/04,2025/03/01,SF FuneralFDC000000074Y3250301,,126.5,,1864897.39
2025/03/04,2025/03/01,SF FuneralFDC00000007516250301,,126.5,,1865023.89
2025/03/04,2025/03/01,SF FuneralFDC0000000751M250301,,126.5,,1865150.39
2025/03/04,2025/03/01,SF FuneralFDC0000000751P250301,,126.5,,1865276.89
2025/03/04,2025/03/01,SF FuneralFDC00000007570250301,,220,,1865496.89
2025/03/04,2025/03/01,SF FuneralFDC0000000759C250301,,126.5,,1865623.39
2025/03/04,2025/03/01,SF FuneralFDC000000075B0250301,,126.5,,1865749.89
2025/03/04,2025/03/01,SF FuneralFDC000000075B2250301,,126.5,,1865876.39
2025/03/04,2025/03/01,SF FuneralFDC000000075B6250301,,126.5,,1866002.89
2025/03/04,2025/03/01,SF FuneralFDC000000075C1250301,,126.5,,1866129.39
2025/03/04,2025/03/01,SF FuneralFDC000000075CD250301,,126.5,,1866255.89
2025/03/04,2025/03/01,SF FuneralFDC000000075DQ250301,,126.5,,1866382.39
2025/03/04,2025/03/01,SF FuneralFDC000000075K0250301,,126.5,,1866508.89
2025/03/04,2025/03/01,SF FuneralFDC000000075NM250301,,126.5,,1866635.39
2025/03/04,2025/03/01,SF FuneralFDC000000075RS250301,,126.5,,1866761.89
2025/03/04,2025/03/01,SF FuneralFDC000000075VX250301,,126.5,,1866888.39
2025/03/04,2025/03/01,SF FuneralFDC000000075YY250301,,126.5,,1867014.89
2025/03/04,2025/03/01,SF FuneralFDC00000007638250301,,126.5,,1867141.39
2025/03/04,2025/03/01,SF FuneralFDC0000000763J250301,,126.5,,1867267.89
2025/03/04,2025/03/01,SF FuneralFDC000000076HM250301,,126.5,,1867394.39
2025/03/04,2025/03/01,SF FuneralFDC000000076NL250301,,126.5,,1867520.89
2025/03/04,2025/03/01,SF FuneralFDC000000076XR250301,,126.5,,1867647.39
2025/03/04,2025/03/01,SF FuneralFDC0000000779Z250301,,126.5,,1867773.89
2025/03/04,2025/03/01,SF FuneralFDC000000077TG250301,,126.5,,1867900.39
2025/03/04,2025/03/01,SF FuneralFDC000000077TK250301,,126.5,,1868026.89
2025/03/04,2025/03/01,SF FuneralFDC000000077VM250301,,126.5,,1868153.39
2025/03/04,2025/03/01,SF FuneralFDC0000000787D250301,,126.5,,1868279.89
2025/03/04,2025/03/01,SF FuneralFDC00000007889250301,,126.5,,1868406.39
2025/03/04,2025/03/01,SF FuneralFDC0000000788X250301,,126.5,,1868532.89
2025/03/04,2025/03/01,SF FuneralFDC000000078S5250301,,126.5,,1868659.39
2025/03/04,2025/03/01,SF FuneralFDC000000078VP250301,,126.5,,1868785.89
2025/03/04,2025/03/01,SF FuneralFDC000000078VV250301,,126.5,,1868912.39
2025/03/04,2025/03/01,SF FuneralFDC00000007DLS250301,,126.5,,1869038.89
2025/03/04,2025/03/01,SF FuneralFDC00000007FC9250301,,126.5,,1869165.39
2025/03/04,2025/03/01,SF FuneralFDC00000007FSJ250301,,220,,1869385.39
2025/03/04,2025/03/01,SF FuneralFDC00000007GKV250301,,126.5,,1869511.89
2025/03/04,2025/03/01,SF FuneralFDC00000007GP1250301,,126.5,,1869638.39
2025/03/04,2025/03/01,SF FuneralFDC00000007GTT250301,,126.5,,1869764.89
2025/03/04,2025/03/01,SF FuneralFDC00000007HND250301,,126.5,,1869891.39
2025/03/04,2025/03/01,SF FuneralFDC00000007HSV250301,,126.5,,1870017.89
2025/03/04,2025/03/01,SF FuneralFDC00000007J2C250301,,126.5,,1870144.39
2025/03/04,2025/03/01,SF FuneralFDC00000007JZT250301,,126.5,,1870270.89
2025/03/04,2025/03/01,SF FuneralF793515       250301,,126.5,,1870397.39
2025/03/04,2025/03/01,SF FuneralFDC00000007P1Z250301,,256.5,,1870653.89
2025/03/04,2025/03/01,SF FuneralFDC00000007P33250301,,126.5,,1870780.39
2025/03/04,2025/03/01,SF FuneralFDC00000007P6C250301,,126.5,,1870906.89
2025/03/04,2025/03/01,SF FuneralFDC00000007PKR250301,,126.5,,1871033.39
2025/03/04,2025/03/01,SF FuneralFDC00000007PMC250301,,126.5,,1871159.89
2025/03/04,2025/03/01,SF FuneralFDC00000007PR0250301,,126.5,,1871286.39
2025/03/04,2025/03/01,SF FuneralFDC00000007PSF250301,,220,,1871506.39
2025/03/04,2025/03/01,SF FuneralF793687       250301,,126.5,,1871632.89
2025/03/04,2025/03/01,SF FuneralF793696       250301,,126.5,,1871759.39
2025/03/04,2025/03/01,SF FuneralFDC00000007Q02250301,,126.5,,1871885.89
2025/03/04,2025/03/01,SF FuneralFDC00000007Q62250301,,126.5,,1872012.39
2025/03/04,2025/03/01,SF FuneralFDC00000007QFG250301,,126.5,,1872138.89
2025/03/04,2025/03/01,SF FuneralFDC00000007QHH250301,,126.5,,1872265.39
2025/03/04,2025/03/01,SF FuneralFDC00000007QLQ250301,,126.5,,1872391.89
2025/03/04,2025/03/01,SF FuneralF794057       250301,,126.5,,1872518.39
2025/03/04,2025/03/01,SF FuneralFDC00000007QZ1250301,,126.5,,1872644.89
2025/03/04,2025/03/01,SF FuneralF794079       250301,,126.5,,1872771.39
2025/03/04,2025/03/01,SF FuneralFDC00000007R9N250301,,126.5,,1872897.89
2025/03/04,2025/03/01,SF FuneralF794186       250301,,126.5,,1873024.39
2025/03/04,2025/03/01,SF FuneralFDC00000007RJT250301,,126.5,,1873150.89
2025/03/04,2025/03/01,SF FuneralFDC00000007RZB250301,,126.5,,1873277.39
2025/03/04,2025/03/01,SF FuneralF794483       250301,,126.5,,1873403.89
2025/03/04,2025/03/01,SF FuneralFDC00000007RZX250301,,126.5,,1873530.39
2025/03/04,2025/03/01,SF FuneralFDC00000007S05250301,,126.5,,1873656.89
2025/03/04,2025/03/01,SF FuneralFDC00000007S0P250301,,126.5,,1873783.39
2025/03/04,2025/03/01,SF FuneralFDC00000007S15250301,,126.5,,1873909.89
2025/03/04,2025/03/01,SF FuneralFDC00000007TWH250301,,126.5,,1874036.39
2025/03/04,2025/03/01,SF FuneralF795213       250301,,126.5,,1874162.89
2025/03/04,2025/03/01,SF FuneralFDC00000007V6Y250301,,126.5,,1874289.39
2025/03/04,2025/03/01,SF FuneralFDC00000007VC8250301,,126.5,,1874415.89
2025/03/04,2025/03/01,SF FuneralF795309       250301,,126.5,,1874542.39
2025/03/04,2025/03/01,SF FuneralFDC00000007VDG250301,,126.5,,1874668.89
2025/03/04,2025/03/01,SF FuneralFDC00000007VL1250301,,126.5,,1874795.39
2025/03/04,2025/03/01,SF FuneralFDC00000007VRJ250301,,126.5,,1874921.89
2025/03/04,2025/03/01,SF FuneralF795454       250301,,126.5,,1875048.39
2025/03/04,2025/03/01,SF FuneralFDC00000007W1G250301,,126.5,,1875174.89
2025/03/04,2025/03/01,SF FuneralFDC00000007WG1250301,,126.5,,1875301.39
2025/03/04,2025/03/01,SF FuneralFDC00000007WGR250301,,126.5,,1875427.89
2025/03/04,2025/03/01,SF FuneralFDC00000007XCN250301,,126.5,,1875554.39
2025/03/04,2025/03/01,SF FuneralF795984       250301,,126.5,,1875680.89
2025/03/04,2025/03/01,SF FuneralFDC00000007Y7R250301,,126.5,,1875807.39
2025/03/04,2025/03/01,SF FuneralFDC00000007ZDG250301,,126.5,,1875933.89
2025/03/04,2025/03/01,SF FuneralF797097       250301,,126.5,,1876060.39
2025/03/04,2025/03/01,SF FuneralFDC000000083DD250301,,126.5,,1876186.89
2025/03/04,2025/03/01,SF FuneralF797988       250301,,126.5,,1876313.39
2025/03/04,2025/03/01,SF FuneralF797987       250301,,126.5,,1876439.89
2025/03/04,2025/03/01,SF FuneralFDC000000083H0250301,,126.5,,1876566.39
2025/03/04,2025/03/01,SF FuneralF798070       250301,,126.5,,1876692.89
2025/03/04,2025/03/01,SF FuneralF798084       250301,,126.5,,1876819.39
2025/03/04,2025/03/01,SF FuneralF798080       250301,,126.5,,1876945.89
2025/03/04,2025/03/01,SF FuneralFDC000000083VT250301,,220,,1877165.89
2025/03/04,2025/03/01,SF FuneralF798250       250301,,126.5,,1877292.39
2025/03/04,2025/03/01,SF FuneralFDC000000084CJ250301,,126.5,,1877418.89
2025/03/04,2025/03/01,SF FuneralF798397       250301,,126.5,,1877545.39
2025/03/04,2025/03/01,SF FuneralFDC0000000858Q250301,,126.5,,1877671.89
2025/03/04,2025/03/01,SF FuneralFDC000000085GH250301,,126.5,,1877798.39
2025/03/04,2025/03/01,SF FuneralF798677       250301,,126.5,,1877924.89
2025/03/04,2025/03/01,SF FuneralF798780       250301,,126.5,,1878051.39
2025/03/04,2025/03/01,SF FuneralFDC000000086HM250301,,213.31,,1878264.7
2025/03/04,2025/03/01,SF FuneralFDC0000000874P250301,,126.5,,1878391.2
2025/03/04,2025/03/01,SF FuneralF799293       250301,,126.5,,1878517.7
2025/03/04,2025/03/01,SF FuneralF799362       250301,,126.5,,1878644.2
2025/03/04,2025/03/01,SF FuneralFDC000000087CT250301,,191.5,,1878835.7
2025/03/04,2025/03/01,SF FuneralF799473       250301,,126.5,,1878962.2
2025/03/04,2025/03/01,SF FuneralF799541       250301,,126.5,,1879088.7
2025/03/04,2025/03/01,SF FuneralF799577       250301,,126.5,,1879215.2
2025/03/04,2025/03/01,SF FuneralFDC000000088K3250301,,220,,1879435.2
2025/03/04,2025/03/01,SF FuneralFDC000000088K6250301,,126.5,,1879561.7
2025/03/04,2025/03/01,SF FuneralFDC000000088R5250301,,126.5,,1879688.2
2025/03/04,2025/03/01,SF FuneralF799877       250301,,126.5,,1879814.7
2025/03/04,2025/03/01,SF FuneralF799892       250301,,126.5,,1879941.2
2025/03/04,2025/03/01,SF FuneralF799995       250301,,126.5,,1880067.7
2025/03/04,2025/03/01,SF FuneralF800029       250301,,126.5,,1880194.2
2025/03/04,2025/03/01,SF FuneralFDC000000089HY250301,,126.5,,1880320.7
2025/03/04,2025/03/01,SF FuneralF800341       250301,,126.5,,1880447.2
2025/03/04,2025/03/01,SF FuneralF800420       250301,,126.5,,1880573.7
2025/03/04,2025/03/01,SF FuneralFDC00000008BHC250301,,126.5,,1880700.2
2025/03/04,2025/03/01,SF FuneralF800712       250301,,126.5,,1880826.7
2025/03/04,2025/03/01,SF FuneralF800740       250301,,126.5,,1880953.2
2025/03/04,2025/03/01,SF FuneralF800897       250301,,126.5,,1881079.7
2025/03/04,2025/03/01,SF FuneralF801206       250301,,126.5,,1881206.2
2025/03/04,2025/03/01,SF FuneralF801425       250301,,126.5,,1881332.7
2025/03/04,2025/03/01,SF FuneralFDC00000008KXM250301,,126.5,,1881459.2
2025/03/04,2025/03/01,SF FuneralF802647       250301,,126.5,,1881585.7
2025/03/04,2025/03/01,SF FuneralF802788       250301,,126.5,,1881712.2
2025/03/04,2025/03/01,SF FuneralF783433       250301,,126.5,,1881838.7
2025/03/04,2025/03/01,SF FuneralFDC00000008LJ6250301,,126.5,,1881965.2
2025/03/04,2025/03/01,SF FuneralFDC00000008LX8250301,,126.5,,1882091.7
2025/03/04,2025/03/01,SF FuneralFDC00000008M52250301,,126.5,,1882218.2
2025/03/04,2025/03/01,SF FuneralF803244       250301,,126.5,,1882344.7
2025/03/04,2025/03/01,SF FuneralF803247       250301,,126.5,,1882471.2
2025/03/04,2025/03/01,SF FuneralFDC00000008M9Q250301,,126.5,,1882597.7
2025/03/04,2025/03/01,SF FuneralFDC00000008MHV250301,,126.5,,1882724.2
2025/03/04,2025/03/01,SF FuneralF803332       250301,,126.5,,1882850.7
2025/03/04,2025/03/01,SF FuneralFDC00000008MZ2250301,,126.5,,1882977.2
2025/03/04,2025/03/01,SF FuneralF803536       250301,,126.5,,1883103.7
2025/03/04,2025/03/01,SF FuneralF803645       250301,,126.5,,1883230.2
2025/03/04,2025/03/01,SF FuneralF803720       250301,,126.5,,1883356.7
2025/03/04,2025/03/01,SF FuneralF803759       250301,,126.5,,1883483.2
2025/03/04,2025/03/01,SF FuneralFDC00000008NR9250301,,256.5,,1883739.7
2025/03/04,2025/03/01,SF FuneralF803813       250301,,126.5,,1883866.2
2025/03/04,2025/03/01,SF FuneralF803834       250301,,126.5,,1883992.7
2025/03/04,2025/03/01,SF FuneralF803927       250301,,126.5,,1884119.2
2025/03/04,2025/03/01,SF FuneralFDC00000008PH6250301,,126.5,,1884245.7
2025/03/04,2025/03/01,SF FuneralFDC00000008PW7250301,,126.5,,1884372.2
2025/03/04,2025/03/01,SF FuneralF804192       250301,,126.5,,1884498.7
2025/03/04,2025/03/01,SF FuneralFDC00000008Q46250301,,191.5,,1884690.2
2025/03/04,2025/03/01,SF FuneralFDC00000008QKP250301,,126.5,,1884816.7
2025/03/04,2025/03/01,SF FuneralF804347       250301,,126.5,,1884943.2
2025/03/04,2025/03/01,SF FuneralF804561       250301,,126.5,,1885069.7
2025/03/04,2025/03/01,SF FuneralF808094       250301,,126.5,,1885196.2
2025/03/04,2025/03/01,SF FuneralF808462       250301,,126.5,,1885322.7
2025/03/04,2025/03/01,SF FuneralF808469       250301,,126.5,,1885449.2
2025/03/04,2025/03/01,SF FuneralF808477       250301,,126.5,,1885575.7
2025/03/04,2025/03/01,SF FuneralF808482       250301,,126.5,,1885702.2
2025/03/04,2025/03/01,SF FuneralF798079       250301,,126.5,,1885828.7
2025/03/04,2025/03/01,SF FuneralF808569       250301,,126.5,,1885955.2
2025/03/04,2025/03/01,SF FuneralF809104       250301,,126.5,,1886081.7
2025/03/04,2025/03/01,SF FuneralF809138       250301,,126.5,,1886208.2
2025/03/04,2025/03/01,SF FuneralF809139       250301,,126.5,,1886334.7
2025/03/04,2025/03/01,SF FuneralF809238       250301,,126.5,,1886461.2
2025/03/04,2025/03/01,SF FuneralF809668       250301,,126.5,,1886587.7
2025/03/04,2025/03/01,SF FuneralF809688       250301,,126.5,,1886714.2
2025/03/04,2025/03/01,SF FuneralF809917       250301,,126.5,,1886840.7
2025/03/04,2025/03/01,SF FuneralFDC000000094MH250301,,126.5,,1886967.2
2025/03/04,2025/03/01,SF FuneralFDC000000096CF250301,,126.5,,1887093.7
2025/03/04,2025/03/01,SF FuneralF810691       250301,,126.5,,1887220.2
2025/03/04,2025/03/01,SF FuneralF810782       250301,,126.5,,1887346.7
2025/03/04,2025/03/01,SF FuneralF812113       250301,,126.5,,1887473.2
2025/03/04,2025/03/01,SF FuneralF812134       250301,,126.5,,1887599.7
2025/03/04,2025/03/01,SF FuneralF812207       250301,,126.5,,1887726.2
2025/03/04,2025/03/01,SF FuneralF812230       250301,,126.5,,1887852.7
2025/03/04,2025/03/01,SF FuneralF812405       250301,,126.5,,1887979.2
2025/03/04,2025/03/01,SF FuneralF812440       250301,,126.5,,1888105.7
2025/03/04,2025/03/01,SF FuneralF812442       250301,,126.5,,1888232.2
2025/03/04,2025/03/01,SF FuneralF812843       250301,,126.5,,1888358.7
2025/03/04,2025/03/01,SF FuneralF812972       250301,,126.5,,1888485.2
2025/03/04,2025/03/01,SF FuneralF813300       250301,,126.5,,1888611.7
2025/03/04,2025/03/01,SF FuneralF813341       250301,,126.5,,1888738.2
2025/03/04,2025/03/01,SF FuneralF813492       250301,,126.5,,1888864.7
2025/03/04,2025/03/01,SF FuneralF815486       250301,,126.5,,1888991.2
2025/03/04,2025/03/01,SF FuneralF815527       250301,,126.5,,1889117.7
2025/03/04,2025/03/01,SF FuneralF815637       250301,,126.5,,1889244.2
2025/03/04,2025/03/01,SF FuneralF793524       250301,,126.5,,1889370.7
2025/03/04,2025/03/01,SF FuneralF816406       250301,,126.5,,1889497.2
2025/03/04,2025/03/01,SF FuneralF816459       250301,,126.5,,1889623.7
2025/03/04,2025/03/01,SF FuneralF816461       250301,,126.5,,1889750.2
2025/03/04,2025/03/01,SF FuneralF816465       250301,,126.5,,1889876.7
2025/03/04,2025/03/01,SF FuneralF809249       250301,,191.5,,1890068.2
2025/03/04,2025/03/01,SF FuneralF816550       250301,,126.5,,1890194.7
2025/03/04,2025/03/01,SF FuneralF816558       250301,,126.5,,1890321.2
2025/03/04,2025/03/01,SF FuneralF816573       250301,,126.5,,1890447.7
2025/03/04,2025/03/01,SF FuneralF816673       250301,,126.5,,1890574.2
2025/03/04,2025/03/01,SF FuneralF816686       250301,,126.5,,1890700.7
2025/03/04,2025/03/01,SF FuneralF816751       250301,,126.5,,1890827.2
2025/03/04,2025/03/01,SF FuneralF816808       250301,,126.5,,1890953.7
2025/03/04,2025/03/01,SF FuneralF816806       250301,,126.5,,1891080.2
2025/03/04,2025/03/01,SF FuneralF816828       250301,,126.5,,1891206.7
2025/03/04,2025/03/01,SF FuneralF817074       250301,,126.5,,1891333.2
2025/03/04,2025/03/01,SF FuneralF817305       250301,,126.5,,1891459.7
2025/03/04,2025/03/01,SF FuneralF817337       250301,,126.5,,1891586.2
2025/03/04,2025/03/01,SF FuneralF818466       250301,,126.5,,1891712.7
2025/03/04,2025/03/01,SF FuneralF818967       250301,,126.5,,1891839.2
2025/03/04,2025/03/01,SF FuneralF819017       250301,,126.5,,1891965.7
2025/03/04,2025/03/01,SF FuneralF819221       250301,,126.5,,1892092.2
2025/03/04,2025/03/01,SF FuneralF820487       250301,,126.5,,1892218.7
2025/03/04,2025/03/01,SF FuneralF820591       250301,,126.5,,1892345.2
2025/03/04,2025/03/01,SF FuneralF820718       250301,,126.5,,1892471.7
2025/03/04,2025/03/01,SF FuneralF821470       250301,,126.5,,1892598.2
2025/03/04,2025/03/01,SF FuneralF821474       250301,,126.5,,1892724.7
2025/03/04,2025/03/01,SF FuneralF821592       250301,,126.5,,1892851.2
2025/03/04,2025/03/01,SF FuneralF821841       250301,,126.5,,1892977.7
2025/03/04,2025/03/01,SF FuneralF816467       250301,,126.5,,1893104.2
2025/03/04,2025/03/01,SF FuneralF822506       250301,,126.5,,1893230.7
2025/03/04,2025/03/01,SF FuneralF822766       250301,,126.5,,1893357.2
2025/03/04,2025/03/01,SF FuneralF822773       250301,,126.5,,1893483.7
2025/03/04,2025/03/01,SF FuneralF823097       250301,,126.5,,1893610.2
2025/03/04,2025/03/01,SF FuneralF823213       250301,,126.5,,1893736.7
2025/03/04,2025/03/01,SF FuneralF827586       250301,,126.5,,1893863.2
2025/03/04,2025/03/01,SF FuneralF827686       250301,,126.5,,1893989.7
2025/03/04,2025/03/01,SF FuneralF828028       250301,,126.5,,1894116.2
2025/03/04,2025/03/01,SF FuneralF828045       250301,,126.5,,1894242.7
2025/03/04,2025/03/01,SF FuneralF780970       250301,,126.5,,1894369.2
2025/03/04,2025/03/01,SF FuneralF828082       250301,,126.5,,1894495.7
2025/03/04,2025/03/01,SF FuneralF828107       250301,,126.5,,1894622.2
2025/03/04,2025/03/01,SF FuneralF828108       250301,,126.5,,1894748.7
2025/03/04,2025/03/01,SF FuneralF828119       250301,,126.5,,1894875.2
2025/03/04,2025/03/01,SF FuneralF828208       250301,,126.5,,1895001.7
2025/03/04,2025/03/01,SF FuneralF780830       250301,,126.5,,1895128.2
2025/03/04,2025/03/01,SF FuneralF828229       250301,,126.5,,1895254.7
2025/03/04,2025/03/01,SF FuneralF828242       250301,,126.5,,1895381.2
2025/03/04,2025/03/01,SF FuneralF828245       250301,,126.5,,1895507.7
2025/03/04,2025/03/01,SF FuneralF828252       250301,,126.5,,1895634.2
2025/03/04,2025/03/01,SF FuneralF828287       250301,,126.5,,1895760.7
2025/03/04,2025/03/01,SF FuneralF828335       250301,,126.5,,1895887.2
2025/03/04,2025/03/01,SF FuneralF828340       250301,,126.5,,1896013.7
2025/03/04,2025/03/01,SF FuneralF828433       250301,,126.5,,1896140.2
2025/03/04,2025/03/01,SF FuneralFDC0000000BPPL250301,,126.5,,1896266.7
2025/03/04,2025/03/01,SF FuneralF828478       250301,,126.5,,1896393.2
2025/03/04,2025/03/01,SF FuneralF828514       250301,,126.5,,1896519.7
2025/03/04,2025/03/01,SF FuneralF828527       250301,,126.5,,1896646.2
2025/03/04,2025/03/01,SF FuneralF828428       250301,,126.5,,1896772.7
2025/03/04,2025/03/01,SF FuneralF828577       250301,,126.5,,1896899.2
2025/03/04,2025/03/01,SF FuneralFDC0000000BPX3250301,,126.5,,1897025.7
2025/03/04,2025/03/01,SF FuneralF784083       250301,,126.5,,1897152.2
2025/03/04,2025/03/01,SF FuneralF828662       250301,,126.5,,1897278.7
2025/03/04,2025/03/01,SF FuneralF828698       250301,,126.5,,1897405.2
2025/03/04,2025/03/01,SF FuneralF828823       250301,,126.5,,1897531.7
2025/03/04,2025/03/01,SF FuneralF829048       250301,,126.5,,1897658.2
2025/03/04,2025/03/01,SF FuneralF829075       250301,,126.5,,1897784.7
2025/03/04,2025/03/01,SF FuneralF829476       250301,,126.5,,1897911.2
2025/03/04,2025/03/01,SF FuneralF829515       250301,,126.5,,1898037.7
2025/03/04,2025/03/01,SF FuneralF829545       250301,,126.5,,1898164.2
2025/03/04,2025/03/01,SF FuneralF829553       250301,,126.5,,1898290.7
2025/03/04,2025/03/01,SF FuneralF829835       250301,,126.5,,1898417.2
2025/03/04,2025/03/01,SF FuneralF829967       250301,,126.5,,1898543.7
2025/03/04,2025/03/01,SF FuneralF830239       250301,,126.5,,1898670.2
2025/03/04,2025/03/01,SF FuneralF830532       250301,,126.5,,1898796.7
2025/03/04,2025/03/01,SF FuneralF830570       250301,,126.5,,1898923.2
2025/03/04,2025/03/01,SF FuneralF830677       250301,,126.5,,1899049.7
2025/03/04,2025/03/01,SF FuneralF781024       250301,,126.5,,1899176.2
2025/03/04,2025/03/01,SF FuneralF830742       250301,,126.5,,1899302.7
2025/03/04,2025/03/01,SF FuneralF832041       250301,,126.5,,1899429.2
2025/03/04,2025/03/01,SF FuneralF832263       250301,,126.5,,1899555.7
2025/03/04,2025/03/01,SF FuneralF832272       250301,,126.5,,1899682.2
2025/03/04,2025/03/01,SF FuneralF832355       250301,,126.5,,1899808.7
2025/03/04,2025/03/01,SF FuneralF832366       250301,,126.5,,1899935.2
2025/03/04,2025/03/01,SF FuneralF832452       250301,,126.5,,1900061.7
2025/03/04,2025/03/01,SF FuneralF832542       250301,,126.5,,1900188.2
2025/03/04,2025/03/01,SF FuneralF832594       250301,,126.5,,1900314.7
2025/03/04,2025/03/01,SF FuneralF832805       250301,,126.5,,1900441.2
2025/03/04,2025/03/01,SF FuneralF832802       250301,,126.5,,1900567.7
2025/03/04,2025/03/01,SF FuneralF834888       250301,,126.5,,1900694.2
2025/03/04,2025/03/01,SF FuneralF834999       250301,,126.5,,1900820.7
2025/03/04,2025/03/01,SF FuneralF838784       250301,,126.5,,1900947.2
2025/03/04,2025/03/01,SF FuneralF841005       250301,,126.5,,1901073.7
2025/03/04,2025/03/01,SF FuneralF841396       250301,,126.5,,1901200.2
2025/03/04,2025/03/01,SF FuneralF841444       250301,,126.5,,1901326.7
2025/03/04,2025/03/01,SF FuneralF841419       250301,,126.5,,1901453.2
2025/03/04,2025/03/01,SF FuneralF841508       250301,,126.5,,1901579.7
2025/03/04,2025/03/01,SF FuneralF841603       250301,,126.5,,1901706.2
2025/03/04,2025/03/01,SF FuneralF841612       250301,,126.5,,1901832.7
2025/03/04,2025/03/01,SF FuneralF841657       250301,,126.5,,1901959.2
2025/03/04,2025/03/01,SF FuneralF841673       250301,,126.5,,1902085.7
2025/03/04,2025/03/01,SF FuneralF841684       250301,,126.5,,1902212.2
2025/03/04,2025/03/01,SF FuneralF841687       250301,,126.5,,1902338.7
2025/03/04,2025/03/01,SF FuneralF841912       250301,,126.5,,1902465.2
2025/03/04,2025/03/01,SF FuneralF841975       250301,,126.5,,1902591.7
2025/03/04,2025/03/01,SF FuneralF842119       250301,,126.5,,1902718.2
2025/03/04,2025/03/01,SF FuneralF842246       250301,,126.5,,1902844.7
2025/03/04,2025/03/01,SF FuneralF842304       250301,,126.5,,1902971.2
2025/03/04,2025/03/01,SF FuneralF842319       250301,,126.5,,1903097.7
2025/03/04,2025/03/01,SF FuneralF842616       250301,,126.5,,1903224.2
2025/03/04,2025/03/01,SF FuneralF842651       250301,,126.5,,1903350.7
2025/03/04,2025/03/01,SF FuneralF842740       250301,,126.5,,1903477.2
2025/03/04,2025/03/01,SF FuneralF992213       250301,,126.5,,1903603.7
2025/03/04,2025/03/01,SF FuneralF992237       250301,,126.5,,1903730.2
2025/03/04,2025/03/01,SF FuneralF992246       250301,,126.5,,1903856.7
2025/03/04,2025/03/01,SF FuneralF992261       250301,,126.5,,1903983.2
2025/03/04,2025/03/01,SF FuneralF992345       250301,,126.5,,1904109.7
2025/03/04,2025/03/01,SF FuneralF992954       250301,,126.5,,1904236.2
2025/03/04,2025/03/01,SF FuneralF1021003      250301,,126.5,,1904362.7
2025/03/04,2025/03/01,SF FuneralF1021280      250301,,126.5,,1904489.2
2025/03/04,2025/03/01,SF FuneralF1021294      250301,,126.5,,1904615.7
2025/03/04,2025/03/01,SF FuneralF1021302      250301,,126.5,,1904742.2
2025/03/04,2025/03/01,SF FuneralF1021313      250301,,126.5,,1904868.7
2025/03/04,2025/03/01,SF FuneralF1021318      250301,,126.5,,1904995.2
2025/03/04,2025/03/01,SF FuneralF1021346      250301,,126.5,,1905121.7
2025/03/04,2025/03/01,SF FuneralF1021388      250301,,126.5,,1905248.2
2025/03/04,2025/03/01,SF FuneralF1021441      250301,,126.5,,1905374.7
2025/03/04,2025/03/01,SF FuneralF1021439      250301,,126.5,,1905501.2
2025/03/04,2025/03/01,SF FuneralFDC0000000JVRB250301,,126.5,,1905627.7
2025/03/04,2025/03/01,SF FuneralF1021489      250301,,126.5,,1905754.2
2025/03/04,2025/03/01,SF FuneralF1021794      250302,,126.5,,1905880.7
2025/03/04,2025/03/01,SF FuneralF1021837      250301,,126.5,,1906007.2
2025/03/04,2025/03/01,SF FuneralF1021952      250301,,126.5,,1906133.7
2025/03/04,2025/03/01,SF FuneralFDC0000000JWZ2250301,,126.5,,1906260.2
2025/03/04,2025/03/01,SF FuneralF1022135      250301,,126.5,,1906386.7
2025/03/04,2025/03/01,SF FuneralF1050725      250301,,126.5,,1906513.2
2025/03/04,2025/03/01,SF FuneralFDC0000000K1KB250301,,126.5,,1906639.7
2025/03/04,2025/03/01,SF FuneralF1052445      250301,,126.5,,1906766.2
2025/03/04,2025/03/01,SF FuneralF1052517      250301,,126.5,,1906892.7
2025/03/04,2025/03/01,SF FuneralF1058615      250301,,126.5,,1907019.2
2025/03/04,2025/03/01,SF FuneralF1058631      250301,,126.5,,1907145.7
2025/03/04,2025/03/01,SF FuneralF1058649      250301,,126.5,,1907272.2
2025/03/04,2025/03/01,SF FuneralF1058679      250301,,126.5,,1907398.7
2025/03/04,2025/03/01,SF FuneralF1058683      250301,,126.5,,1907525.2
2025/03/04,2025/03/01,SF FuneralF1058732      250301,,126.5,,1907651.7
2025/03/04,2025/03/01,SF FuneralF1058747      250301,,126.5,,1907778.2
2025/03/04,2025/03/01,SF FuneralFDC0000000K9FC250301,,126.5,,1907904.7
2025/03/04,2025/03/01,SF FuneralF1058765      250301,,126.5,,1908031.2
2025/03/04,2025/03/01,SF FuneralF1058810      250301,,126.5,,1908157.7
2025/03/04,2025/03/01,SF FuneralF1058824      250301,,126.5,,1908284.2
2025/03/04,2025/03/01,SF FuneralF1058847      250301,,126.5,,1908410.7
2025/03/04,2025/03/01,SF FuneralF1058864      250301,,126.5,,1908537.2
2025/03/04,2025/03/01,SF FuneralF1058869      250301,,126.5,,1908663.7
2025/03/04,2025/03/01,SF FuneralF1059042      250301,,126.5,,1908790.2
2025/03/04,2025/03/01,SF FuneralFDC0000000KB1G250301,,126.5,,1908916.7
2025/03/04,2025/03/01,SF FuneralF1059411      250301,,126.5,,1909043.2
2025/03/04,2025/03/01,SF FuneralF1059419      250301,,126.5,,1909169.7
2025/03/04,2025/03/01,SF FuneralF1059468      250301,,126.5,,1909296.2
2025/03/04,2025/03/01,SF FuneralF1060093      250302,,126.5,,1909422.7
2025/03/04,2025/03/01,SF FuneralF1060096      250301,,126.5,,1909549.2
2025/03/04,2025/03/01,SF FuneralFDC0000000KKWS250301,,126.5,,1909675.7
2025/03/04,2025/03/01,SF FuneralF1061563      250301,,126.5,,1909802.2
2025/03/04,2025/03/01,SF FuneralFDC0000000KLD6250301,,126.5,,1909928.7
2025/03/04,2025/03/01,SF FuneralF1061760      250301,,126.5,,1910055.2
2025/03/04,2025/03/01,SF FuneralFDC0000000KNBG250301,,126.5,,1910181.7
2025/03/04,2025/03/01,SF FuneralFDC0000000KPQ0250301,,191.5,,1910373.2
2025/03/04,2025/03/01,SF FuneralF1062722      250301,,126.5,,1910499.7
2025/03/04,2025/03/01,SF FuneralF1065812      250301,,126.5,,1910626.2
2025/03/04,2025/03/01,SF FuneralF1066175      250301,,126.5,,1910752.7
2025/03/04,2025/03/01,SF FuneralF1066638      250301,,126.5,,1910879.2
2025/03/04,2025/03/01,SF FuneralF1066674      250301,,126.5,,1911005.7
2025/03/04,2025/03/01,SF FuneralF1066704      250301,,126.5,,1911132.2
2025/03/04,2025/03/01,SF FuneralF1066721      250301,,126.5,,1911258.7
2025/03/04,2025/03/01,SF FuneralF1068155      250301,,126.5,,1911385.2
2025/03/04,2025/03/01,SF FuneralF1068194      250301,,126.5,,1911511.7
2025/03/04,2025/03/01,SF FuneralF1074511      250301,,126.5,,1911638.2
2025/03/04,2025/03/01,SF FuneralF1074895      250301,,126.5,,1911764.7
2025/03/04,2025/03/01,SF FuneralF1074922      250301,,126.5,,1911891.2
2025/03/04,2025/03/01,SF FuneralF1074984      250301,,126.5,,1912017.7
2025/03/04,2025/03/01,SF FuneralF1075040      250301,,126.5,,1912144.2
2025/03/04,2025/03/01,SF FuneralFDC0000000LBVR250301,,126.5,,1912270.7
2025/03/04,2025/03/01,SF FuneralF1075047      250301,,126.5,,1912397.2
2025/03/04,2025/03/01,SF FuneralF1078201      250301,,126.5,,1912523.7
2025/03/04,2025/03/01,SF FuneralF1078322      250301,,126.5,,1912650.2
2025/03/04,2025/03/01,SF FuneralF1078344      250301,,126.5,,1912776.7
2025/03/04,2025/03/01,SF FuneralF1078371      250301,,126.5,,1912903.2
2025/03/04,2025/03/01,SF FuneralF1078379      250301,,126.5,,1913029.7
2025/03/04,2025/03/01,SF FuneralFDC0000000LFBG250301,,126.5,,1913156.2
2025/03/04,2025/03/01,SF FuneralF1078397      250301,,126.5,,1913282.7
2025/03/04,2025/03/01,SF FuneralF1078473      250301,,126.5,,1913409.2
2025/03/04,2025/03/01,SF FuneralF987824       250301,,126.5,,1913535.7
2025/03/04,2025/03/01,SF FuneralF1080237      250301,,126.5,,1913662.2
2025/03/04,2025/03/01,SF FuneralF1083867      250301,,126.5,,1913788.7
2025/03/04,2025/03/01,SF FuneralF1084396      250301,,126.5,,1913915.2
2025/03/04,2025/03/01,SF FuneralF1084439      250301,,126.5,,1914041.7
2025/03/04,2025/03/01,SF FuneralF1084440      250301,,126.5,,1914168.2
2025/03/04,2025/03/01,SF FuneralF1084468      250301,,126.5,,1914294.7
2025/03/04,2025/03/01,SF FuneralF1084495      250301,,126.5,,1914421.2
2025/03/04,2025/03/01,SF FuneralF1084535      250301,,126.5,,1914547.7
2025/03/04,2025/03/01,SF FuneralF1084561      250301,,126.5,,1914674.2
2025/03/04,2025/03/01,SF FuneralF1084562      250301,,126.5,,1914800.7
2025/03/04,2025/03/01,SF FuneralF1084578      250301,,126.5,,1914927.2
2025/03/04,2025/03/01,SF FuneralF1085230      250301,,126.5,,1915053.7
2025/03/04,2025/03/01,SF FuneralF1085353      250301,,126.5,,1915180.2
2025/03/04,2025/03/01,SF FuneralF1085449      250301,,126.5,,1915306.7
2025/03/04,2025/03/01,SF FuneralF1096652      250301,,126.5,,1915433.2
2025/03/04,2025/03/01,SF FuneralF1102906      250301,,126.5,,1915559.7
2025/03/04,2025/03/01,SF FuneralF1108850      250301,,126.5,,1915686.2
2025/03/04,2025/03/01,SF FuneralF1108851      250301,,126.5,,1915812.7
2025/03/04,2025/03/01,SF FuneralF1108904      250301,,126.5,,1915939.2
2025/03/04,2025/03/01,SF FuneralF1109642      250301,,126.5,,1916065.7
2025/03/04,2025/03/01,SF FuneralF1109948      250301,,126.5,,1916192.2
2025/03/04,2025/03/01,SF FuneralF1110013      250301,,126.5,,1916318.7
2025/03/04,2025/03/01,SF FuneralF986723       250301,,126.5,,1916445.2
2025/03/04,2025/03/01,SF FuneralF1113291      250301,,126.5,,1916571.7
2025/03/04,2025/03/01,SF FuneralF1113317      250301,,126.5,,1916698.2
2025/03/04,2025/03/01,SF FuneralF1113340      250301,,126.5,,1916824.7
2025/03/04,2025/03/01,SF FuneralF1113360      250301,,126.5,,1916951.2
2025/03/04,2025/03/01,SF FuneralF1113561      250301,,126.5,,1917077.7
2025/03/04,2025/03/01,SF FuneralF1113622      250301,,126.5,,1917204.2
2025/03/04,2025/03/01,SF FuneralFDC0000000N52Y250301,,191.5,,1917395.7
2025/03/04,2025/03/01,SF FuneralF1113775      250301,,126.5,,1917522.2
2025/03/04,2025/03/01,SF FuneralFDC0000000N5HL250301,,126.5,,1917648.7
2025/03/04,2025/03/01,SF FuneralF1113834      250301,,126.5,,1917775.2
2025/03/04,2025/03/01,SF FuneralF1113849      250301,,126.5,,1917901.7
2025/03/04,2025/03/01,SF FuneralF1113882      250301,,126.5,,1918028.2
2025/03/04,2025/03/01,SF FuneralF1113915      250301,,126.5,,1918154.7
2025/03/04,2025/03/01,SF FuneralF1114053      250301,,126.5,,1918281.2
2025/03/04,2025/03/01,SF FuneralFDC0000000N6DY250301,,126.5,,1918407.7
2025/03/04,2025/03/01,SF FuneralF1114215      250301,,126.5,,1918534.2
2025/03/04,2025/03/01,SF FuneralF1114599      250301,,126.5,,1918660.7
2025/03/04,2025/03/01,SF FuneralF1114668      250301,,126.5,,1918787.2
2025/03/04,2025/03/01,SF FuneralF1114711      250301,,126.5,,1918913.7
2025/03/04,2025/03/01,SF FuneralFDC0000000N9XQ250301,,126.5,,1919040.2
2025/03/04,2025/03/01,SF FuneralF1114878      250301,,126.5,,1919166.7
2025/03/04,2025/03/01,SF FuneralF1115158      250301,,126.5,,1919293.2
2025/03/04,2025/03/01,SF FuneralF1115195      250301,,126.5,,1919419.7
2025/03/04,2025/03/01,SF FuneralF1115770      250301,,126.5,,1919546.2
2025/03/04,2025/03/01,SF FuneralF1115807      250301,,126.5,,1919672.7
2025/03/04,2025/03/01,SF FuneralF1115910      250302,,126.5,,1919799.2
2025/03/04,2025/03/01,SF FuneralF1116073      250301,,126.5,,1919925.7
2025/03/04,2025/03/01,SF FuneralF1116909      250302,,126.5,,1920052.2
2025/03/04,2025/03/01,SF FuneralF1116915      250301,,126.5,,1920178.7
2025/03/04,2025/03/01,SF FuneralF1116937      250301,,126.5,,1920305.2
2025/03/04,2025/03/01,SF FuneralF1116949      250301,,126.5,,1920431.7
2025/03/04,2025/03/01,SF FuneralF1116952      250301,,126.5,,1920558.2
2025/03/04,2025/03/01,SF FuneralFDC0000000NJ3H250301,,126.5,,1920684.7
2025/03/04,2025/03/01,SF FuneralF1117130      250301,,126.5,,1920811.2
2025/03/04,2025/03/01,SF FuneralF1117140      250301,,126.5,,1920937.7
2025/03/04,2025/03/01,SF FuneralF1117191      250301,,126.5,,1921064.2
2025/03/04,2025/03/01,SF FuneralF1117201      250301,,126.5,,1921190.7
2025/03/04,2025/03/01,SF FuneralFDC0000000NJSK250301,,126.5,,1921317.2
2025/03/04,2025/03/01,SF FuneralF1117275      250301,,126.5,,1921443.7
2025/03/04,2025/03/01,SF FuneralFDC0000000NJV4250301,,126.5,,1921570.2
2025/03/04,2025/03/01,SF FuneralF1117331      250301,,126.5,,1921696.7
2025/03/04,2025/03/01,SF FuneralFDC0000000NJYP250301,,126.5,,1921823.2
2025/03/04,2025/03/01,SF FuneralF1117339      250301,,126.5,,1921949.7
2025/03/04,2025/03/01,SF FuneralF1117341      250301,,126.5,,1922076.2
2025/03/04,2025/03/01,SF FuneralF1117362      250301,,126.5,,1922202.7
2025/03/04,2025/03/01,SF FuneralF1117392      250301,,126.5,,1922329.2
2025/03/04,2025/03/01,SF FuneralF1117397      250301,,126.5,,1922455.7
2025/03/04,2025/03/01,SF FuneralF1117409      250301,,126.5,,1922582.2
2025/03/04,2025/03/01,SF FuneralF1117610      250301,,126.5,,1922708.7
2025/03/04,2025/03/01,SF FuneralF1117666      250301,,126.5,,1922835.2
2025/03/04,2025/03/01,SF FuneralF1117734      250301,,126.5,,1922961.7
2025/03/04,2025/03/01,SF FuneralF1117765      250301,,126.5,,1923088.2
2025/03/04,2025/03/01,SF FuneralF1117858      250301,,126.5,,1923214.7
2025/03/04,2025/03/01,SF FuneralFDC0000000NLLQ250301,,126.5,,1923341.2
2025/03/04,2025/03/01,SF FuneralF784270       250301,,126.5,,1923467.7
2025/03/04,2025/03/01,SF FuneralF1117999      250301,,126.5,,1923594.2
2025/03/04,2025/03/01,SF FuneralF1118074      250301,,126.5,,1923720.7
2025/03/04,2025/03/01,SF FuneralF1118270      250301,,126.5,,1923847.2
2025/03/04,2025/03/01,SF FuneralF1118279      250301,,126.5,,1923973.7
2025/03/04,2025/03/01,SF FuneralF1118282      250301,,126.5,,1924100.2
2025/03/04,2025/03/01,SF FuneralF1118309      250301,,126.5,,1924226.7
2025/03/04,2025/03/01,SF FuneralF1118521      250301,,126.5,,1924353.2
2025/03/04,2025/03/01,SF FuneralF1118834      250301,,126.5,,1924479.7
2025/03/04,2025/03/01,SF FuneralF1118862      250301,,126.5,,1924606.2
2025/03/04,2025/03/01,SF FuneralF1120167      250301,,126.5,,1924732.7
2025/03/04,2025/03/01,SF FuneralF1120186      250301,,126.5,,1924859.2
2025/03/04,2025/03/01,SF FuneralF1120377      250301,,126.5,,1924985.7
2025/03/04,2025/03/01,SF FuneralFDC0000000NZT1250302,,126.5,,1925112.2
2025/03/04,2025/03/01,SF FuneralF1121878      250301,,126.5,,1925238.7
2025/03/04,2025/03/01,SF FuneralF1121943      250301,,126.5,,1925365.2
2025/03/04,2025/03/01,SF FuneralF1066220      250301,,126.5,,1925491.7
2025/03/04,2025/03/01,SF FuneralF1121986      250301,,126.5,,1925618.2
2025/03/04,2025/03/01,SF FuneralF1121989      250301,,126.5,,1925744.7
2025/03/04,2025/03/01,SF FuneralF1122005      250301,,126.5,,1925871.2
2025/03/04,2025/03/01,SF FuneralF1122007      250301,,126.5,,1925997.7
2025/03/04,2025/03/01,SF FuneralF1122228      250301,,126.5,,1926124.2
2025/03/04,2025/03/01,SF FuneralF1122259      250301,,126.5,,1926250.7
2025/03/04,2025/03/01,SF FuneralF1122271      250301,,126.5,,1926377.2
2025/03/04,2025/03/01,SF FuneralF1117411      250301,,191.5,,1926568.7
2025/03/04,2025/03/01,SF FuneralFDC0000000P1CP250301,,126.5,,1926695.2
2025/03/04,2025/03/01,SF FuneralFDC0000000P1G2250301,,126.5,,1926821.7
2025/03/04,2025/03/01,SF FuneralF1122670      250301,,126.5,,1926948.2
2025/03/04,2025/03/01,SF FuneralF1122721      250301,,126.5,,1927074.7
2025/03/04,2025/03/01,SF FuneralF1122802      250301,,126.5,,1927201.2
2025/03/04,2025/03/01,SF FuneralF1122837      250301,,126.5,,1927327.7
2025/03/04,2025/03/01,SF FuneralF1122909      250301,,126.5,,1927454.2
2025/03/04,2025/03/01,SF FuneralF1122962      250301,,126.5,,1927580.7
2025/03/04,2025/03/01,SF FuneralFDC0000000P2ZP250301,,126.5,,1927707.2
2025/03/04,2025/03/01,SF FuneralF1122994      250301,,126.5,,1927833.7
2025/03/04,2025/03/01,SF FuneralF1123053      250301,,126.5,,1927960.2
2025/03/04,2025/03/01,SF FuneralF1123069      250301,,126.5,,1928086.7
2025/03/04,2025/03/01,SF FuneralF1123083      250301,,126.5,,1928213.2
2025/03/04,2025/03/01,SF FuneralF1123104      250301,,126.5,,1928339.7
2025/03/04,2025/03/01,SF FuneralF1123152      250301,,126.5,,1928466.2
2025/03/04,2025/03/01,SF FuneralF1123160      250301,,126.5,,1928592.7
2025/03/04,2025/03/01,SF FuneralF1123215      250301,,126.5,,1928719.2
2025/03/04,2025/03/01,SF FuneralF1123222      250301,,126.5,,1928845.7
2025/03/04,2025/03/01,SF FuneralF1123250      250301,,126.5,,1928972.2
2025/03/04,2025/03/01,SF FuneralF1123961      250301,,126.5,,1929098.7
2025/03/04,2025/03/01,SF FuneralF1123969      250301,,126.5,,1929225.2
2025/03/04,2025/03/01,SF FuneralF1124076      250301,,126.5,,1929351.7
2025/03/04,2025/03/01,SF FuneralF1124092      250301,,126.5,,1929478.2
2025/03/04,2025/03/01,SF FuneralF1124152      250301,,126.5,,1929604.7
2025/03/04,2025/03/01,SF FuneralF1124160      250301,,126.5,,1929731.2
2025/03/04,2025/03/01,SF FuneralF1124588      250301,,126.5,,1929857.7
2025/03/04,2025/03/01,SF FuneralF1125401      250301,,126.5,,1929984.2
2025/03/04,2025/03/01,SF FuneralF1125410      250301,,126.5,,1930110.7
2025/03/04,2025/03/01,SF FuneralF1125442      250301,,126.5,,1930237.2
2025/03/04,2025/03/01,SF FuneralF1125473      250301,,126.5,,1930363.7
2025/03/04,2025/03/01,SF FuneralF1125485      250301,,126.5,,1930490.2
2025/03/04,2025/03/01,SF FuneralF1125695      250301,,126.5,,1930616.7
2025/03/04,2025/03/01,SF FuneralF1125771      250301,,126.5,,1930743.2
2025/03/04,2025/03/01,SF FuneralFDC0000000PJ41250301,,126.5,,1930869.7
2025/03/04,2025/03/01,SF FuneralF1125849      250301,,126.5,,1930996.2
2025/03/04,2025/03/01,SF FuneralF1125856      250301,,126.5,,1931122.7
2025/03/04,2025/03/01,SF FuneralF1126022      250301,,126.5,,1931249.2
2025/03/04,2025/03/01,SF FuneralFDC0000000PK6F250301,,126.5,,1931375.7
2025/03/04,2025/03/01,SF FuneralF1126127      250301,,126.5,,1931502.2
2025/03/04,2025/03/01,SF FuneralF1126260      250301,,126.5,,1931628.7
2025/03/04,2025/03/01,SF FuneralF1126820      250301,,126.5,,1931755.2
2025/03/04,2025/03/01,SF FuneralFDC0000000PL7T250301,,126.5,,1931881.7
2025/03/04,2025/03/01,SF FuneralFDC0000000PL7W250301,,126.5,,1932008.2
2025/03/04,2025/03/01,SF FuneralF1126829      250301,,126.5,,1932134.7
2025/03/04,2025/03/01,SF FuneralF1126832      250301,,126.5,,1932261.2
2025/03/04,2025/03/01,SF FuneralF1126833      250301,,126.5,,1932387.7
2025/03/04,2025/03/01,SF FuneralF1126909      250301,,126.5,,1932514.2
2025/03/04,2025/03/01,SF FuneralF1126916      250301,,126.5,,1932640.7
2025/03/04,2025/03/01,SF FuneralFDC0000000PNDG250301,,126.5,,1932767.2
2025/03/04,2025/03/01,SF FuneralFDC0000000PNWN250301,,126.5,,1932893.7
2025/03/04,2025/03/01,SF FuneralF1127443      250301,,126.5,,1933020.2
2025/03/04,2025/03/01,SF FuneralF1127525      250301,,126.5,,1933146.7
2025/03/04,2025/03/01,SF FuneralF1127560      250301,,126.5,,1933273.2
2025/03/04,2025/03/01,SF FuneralF1127751      250301,,126.5,,1933399.7
2025/03/04,2025/03/01,SF FuneralF1127850      250301,,126.5,,1933526.2
2025/03/04,2025/03/01,SF FuneralF1127855      250301,,126.5,,1933652.7
2025/03/04,2025/03/01,SF FuneralFDC0000000PJVJ250301,,126.5,,1933779.2
2025/03/04,2025/03/01,SF FuneralF1126017      250301,,126.5,,1933905.7
2025/03/04,2025/03/01,SF FuneralF1126173      250301,,126.5,,1934032.2
2025/03/04,2025/03/01,SF FuneralF1126306      250301,,126.5,,1934158.7
2025/03/04,2025/03/01,SF FuneralF1127433      250301,,126.5,,1934285.2
2025/03/04,2025/03/01,SF FuneralF1127581      250301,,126.5,,1934411.7
2025/03/04,2025/03/01,SF FuneralF1127635      250301,,126.5,,1934538.2
2025/03/04,2025/03/01,SF FuneralF1127913      250301,,126.5,,1934664.7
2025/03/04,2025/03/01,SF FuneralF1128034      250301,,126.5,,1934791.2
2025/03/04,2025/03/01,SF FuneralF1128061      250301,,126.5,,1934917.7
2025/03/04,2025/03/01,SF FuneralF1128120      250301,,126.5,,1935044.2
2025/03/04,2025/03/01,SF FuneralF1128154      250301,,126.5,,1935170.7
2025/03/04,2025/03/01,SF FuneralF1108313      250301,,126.5,,1935297.2
2025/03/04,2025/03/01,SF FuneralF1128373      250301,,126.5,,1935423.7
2025/03/04,2025/03/01,SF FuneralF1128944      250301,,126.5,,1935550.2
2025/03/04,2025/03/01,SF FuneralF1129109      250301,,126.5,,1935676.7
2025/03/04,2025/03/01,SF FuneralF1129314      250301,,126.5,,1935803.2
2025/03/04,2025/03/01,SF FuneralF1129352      250301,,126.5,,1935929.7
2025/03/04,2025/03/01,SF FuneralF1129892      250301,,126.5,,1936056.2
2025/03/04,2025/03/01,SF FuneralF1131120      250301,,126.5,,1936182.7
2025/03/04,2025/03/01,SF FuneralF1131126      250301,,126.5,,1936309.2
2025/03/04,2025/03/01,SF FuneralF1108905      250301,,126.5,,1936435.7
2025/03/04,2025/03/01,SF FuneralF1131235      250302,,126.5,,1936562.2
2025/03/04,2025/03/01,SF FuneralF1131353      250301,,126.5,,1936688.7
2025/03/04,2025/03/01,SF FuneralF1131595      250301,,126.5,,1936815.2
2025/03/04,2025/03/01,SF FuneralF1131626      250301,,126.5,,1936941.7
2025/03/04,2025/03/01,SF FuneralF1131692      250301,,126.5,,1937068.2
2025/03/04,2025/03/01,SF FuneralF1131750      250301,,126.5,,1937194.7
2025/03/04,2025/03/01,SF FuneralF1131774      250301,,126.5,,1937321.2
2025/03/04,2025/03/01,SF FuneralF1132064      250301,,126.5,,1937447.7
2025/03/04,2025/03/01,SF FuneralF1132817      250301,,321.5,,1937769.2
2025/03/04,2025/03/03,SF FuneralFDC000000057W9250302,,126.5,,1937895.7
2025/03/04,2025/03/03,SF FuneralFDC000000057WN250302,,126.5,,1938022.2
2025/03/04,2025/03/03,SF FuneralF808792       250303,,126.5,,1938148.7
2025/03/04,2025/03/03,SF FuneralF843025       250301,,126.5,,1938275.2
2025/03/04,2025/03/03,SF FuneralF843093       250301,,126.5,,1938401.7
2025/03/04,2025/03/03,SF FuneralF843393       250301,,126.5,,1938528.2
2025/03/04,2025/03/03,SF FuneralF843519       250301,,126.5,,1938654.7
2025/03/04,2025/03/03,SF FuneralF786500       250301,,126.5,,1938781.2
2025/03/04,2025/03/03,SF FuneralF789277       250301,,256.5,,1939037.7
2025/03/04,2025/03/03,SF FuneralFDC0000000GW5V250301,,126.5,,1939164.2
2025/03/04,2025/03/03,SF FuneralF900711       250301,,126.5,,1939290.7
2025/03/04,2025/03/03,SF FuneralF900780       250301,,126.5,,1939417.2
2025/03/04,2025/03/03,SF FuneralF1059350      250303,,126.5,,1939543.7
2025/03/04,2025/03/03,SF FuneralF1119770      250303,,126.5,,1939670.2
2025/03/04,2025/03/03,SF FuneralF1124565      250303,,126.5,,1939796.7
2025/03/04,2025/03/03,SF FuneralF1129524      250303,,126.5,,1939923.2
2025/03/04,2025/03/04,SF FuneralFDC0000000HQB5250304,,31.63,,1939954.83
2025/03/04,2025/03/04,SF FuneralFDC0000000LFBD250304,,126.5,,1940081.33
2025/03/04,2025/03/04,SF FuneralF1078389      250304,,126.5,,1940207.83
2025/03/04,2025/03/02,SF FuneralFDC0000000BQXN250302,,126.5,,1940334.33
2025/03/04,2025/03/02,SF FuneralF832765       250302,,126.5,,1940460.83
2025/03/04,2025/02/28,SF FuneralFDC00000005Y5W250228,,126.5,,1940587.33
2025/03/04,2025/02/28,SF FuneralFDC000000067LX250228,,126.5,,1940713.83
2025/03/04,2025/02/28,SF FuneralFDC00000006GP9250228,,126.5,,1940840.33
2025/03/04,2025/02/28,SF FuneralFDC00000006R2F250228,,126.5,,1940966.83
2025/03/04,2025/02/28,SF FuneralFDC0000000736K250228,,126.5,,1941093.33
2025/03/04,2025/02/28,SF FuneralFDC000000076N2250228,,126.5,,1941219.83
2025/03/04,2025/02/28,SF FuneralFDC000000077SY250228,,126.5,,1941346.33
2025/03/04,2025/02/28,SF FuneralF796238       250228,,126.5,,1941472.83
2025/03/04,2025/02/28,SF FuneralF798312       250228,,126.5,,1941599.33
2025/03/04,2025/02/28,SF FuneralFDC000000094NC250228,,126.5,,1941725.83
2025/03/04,2025/02/28,SF FuneralF812228       250228,,126.5,,1941852.33
2025/03/04,2025/02/28,SF FuneralF834993       250228,,126.5,,1941978.83
2025/03/04,2025/02/28,SF FuneralF901095       250301,,126.5,,1942105.33
2025/03/04,2025/02/28,SF FuneralF901189       250301,,126.5,,1942231.83
2025/03/04,2025/02/28,SF FuneralF901400       250301,,126.5,,1942358.33
2025/03/04,2025/02/28,SF FuneralF980932       250301,,126.5,,1942484.83
2025/03/04,2025/02/28,SF FuneralF980943       250301,,126.5,,1942611.33
2025/03/04,2025/02/28,SF FuneralF980942       250301,,126.5,,1942737.83
2025/03/04,2025/02/28,SF FuneralFDC0000000H9WB250301,,126.5,,1942864.33
2025/03/04,2025/02/28,SF FuneralF986701       250301,,126.5,,1942990.83
2025/03/04,2025/02/28,SF FuneralFDC0000000HLPG250301,,126.5,,1943117.33
2025/03/04,2025/02/28,SF FuneralF987482       250301,,126.5,,1943243.83
2025/03/04,2025/02/28,SF FuneralF987598       250228,,126.5,,1943370.33
2025/03/04,2025/02/28,SF FuneralF987615       250301,,126.5,,1943496.83
2025/03/04,2025/02/28,SF FuneralF988095       250301,,126.5,,1943623.33
2025/03/04,2025/02/28,SF FuneralF988105       250301,,126.5,,1943749.83
2025/03/04,2025/02/28,SF FuneralF988161       250301,,126.5,,1943876.33
2025/03/04,2025/02/28,SF FuneralFDC0000000HVTY250301,,126.5,,1944002.83
2025/03/04,2025/02/28,SF FuneralF841564       250301,,126.5,,1944129.33
2025/03/04,2025/02/28,SF FuneralF812243       250301,,126.5,,1944255.83
2025/03/04,2025/02/28,SF FuneralF988558       250301,,126.5,,1944382.33
2025/03/04,2025/02/28,SF FuneralF989195       250301,,126.5,,1944508.83
2025/03/04,2025/02/28,SF FuneralF989241       250301,,126.5,,1944635.33
2025/03/04,2025/02/28,SF FuneralF989454       250301,,126.5,,1944761.83
2025/03/04,2025/02/28,SF FuneralF989461       250301,,126.5,,1944888.33
2025/03/04,2025/02/28,SF FuneralF990632       250301,,126.5,,1945014.83
2025/03/04,2025/02/28,SF FuneralF992486       250228,,126.5,,1945141.33
2025/03/04,2025/02/28,SF FuneralF993446       250228,,126.5,,1945267.83
2025/03/04,2025/02/28,SF FuneralF987893       250228,,126.5,,1945394.33
2025/03/04,2025/02/28,SF FuneralF1074886      250228,,126.5,,1945520.83
2025/03/04,2025/02/28,SF FuneralF1084366      250228,,126.5,,1945647.33
2025/03/04,2025/02/28,SF FuneralF1094335      250228,,126.5,,1945773.83
2025/03/04,2025/02/28,SF FuneralF1113744      250228,,126.5,,1945900.33
2025/03/04,2025/02/28,SF FuneralF1121996      250228,,126.5,,1946026.83
2025/03/04,2025/02/28,SF FuneralF1122600      250228,,126.5,,1946153.33
2025/03/04,2025/02/28,SF FuneralF1125148      250228,,126.5,,1946279.83
2025/03/04,2025/02/25,SF FuneralF1110299      250225,,31.63,,1946311.46
2025/03/04,2025/02/27,SF FuneralFDC00000007Q2V250227,,126.5,,1946437.96
2025/03/04,2025/02/27,SF FuneralF809451       250227,,126.5,,1946564.46
2025/03/04,2025/02/27,SF FuneralF1078860      250227,,126.5,,1946690.96
2025/03/04,2025/02/28,SF FuneralFDC00000002WQ5250228,,220,,1946910.96
2025/03/04,2025/02/28,SF FuneralFDC00000005MVX250228,,126.5,,1947037.46
2025/03/04,2025/02/28,SF FuneralFDC000000067TL250228,,126.5,,1947163.96
2025/03/04,2025/02/28,SF FuneralFDC000000069ZV250228,,126.5,,1947290.46
2025/03/04,2025/02/28,SF FuneralFDC00000006BXT250228,,126.5,,1947416.96
2025/03/04,2025/02/28,SF FuneralFDC00000006CLY250228,,126.5,,1947543.46
2025/03/04,2025/02/28,SF FuneralFDC00000006GT4250228,,126.5,,1947669.96
2025/03/04,2025/02/28,SF FuneralFDC00000006JQD250228,,126.5,,1947796.46
2025/03/04,2025/02/28,SF FuneralFDC00000006TXT250228,,126.5,,1947922.96
2025/03/04,2025/02/28,SF FuneralFDC000000078RB250228,,126.5,,1948049.46
2025/03/04,2025/02/28,SF FuneralFDC00000007H64250228,,343.31,,1948392.77
2025/03/04,2025/02/28,SF FuneralFDC00000007ZPC250228,,126.5,,1948519.27
2025/03/04,2025/02/28,SF FuneralF798737       250228,,126.5,,1948645.77
2025/03/04,2025/02/28,SF FuneralF810917       250228,,126.5,,1948772.27
2025/03/04,2025/02/28,SF FuneralF812317       250228,,126.5,,1948898.77
2025/03/04,2025/02/28,SF FuneralFDC0000000BD9R250228,,126.5,,1949025.27
2025/03/04,2025/02/28,SF FuneralF834085       250228,,126.5,,1949151.77
2025/03/04,2025/02/28,SF FuneralF838802       250228,,126.5,,1949278.27
2025/03/04,2025/02/28,SF FuneralF900866       250301,,126.5,,1949404.77
2025/03/04,2025/02/28,SF FuneralF840974       250301,,256.5,,1949661.27
2025/03/04,2025/02/28,SF FuneralFDC0000000HFBF250301,,126.5,,1949787.77
2025/03/04,2025/02/28,SF FuneralF987573       250301,,126.5,,1949914.27
2025/03/04,2025/02/28,SF FuneralF987579       250301,,126.5,,1950040.77
2025/03/04,2025/02/28,SF FuneralF988081       250301,,126.5,,1950167.27
2025/03/04,2025/02/28,SF FuneralF988228       250301,,126.5,,1950293.77
2025/03/04,2025/02/28,SF FuneralF988372       250301,,126.5,,1950420.27
2025/03/04,2025/02/28,SF FuneralF988514       250301,,126.5,,1950546.77
2025/03/04,2025/02/28,SF FuneralF988559       250301,,126.5,,1950673.27
2025/03/04,2025/02/28,SF FuneralFDC0000000HXCP250301,,126.5,,1950799.77
2025/03/04,2025/02/28,SF FuneralF989263       250301,,126.5,,1950926.27
2025/03/04,2025/02/28,SF FuneralF989553       250228,,126.5,,1951052.77
2025/03/04,2025/02/28,SF FuneralF989775       250301,,126.5,,1951179.27
2025/03/04,2025/02/28,SF FuneralF989976       250301,,126.5,,1951305.77
2025/03/04,2025/02/28,SF FuneralF991159       250301,,126.5,,1951432.27
2025/03/04,2025/02/28,SF FuneralF1021641      250228,,126.5,,1951558.77
2025/03/04,2025/02/28,SF FuneralF1113156      250228,,126.5,,1951685.27
2025/03/04,2025/02/28,SF FuneralF1125931      250228,,126.5,,1951811.77
2025/03/04,2025/02/28,SF FuneralF1125947      250228,,126.5,,1951938.27
2025/03/04,2025/02/28,SF FuneralF1127860      250228,,126.5,,1952064.77
2025/03/04,2025/02/28,SF FuneralFDC0000000PZ6P250228,,126.5,,1952191.27
2025/03/04,2025/03/01,SF FuneralFDC00000002VJX250301,,220,,1952411.27
2025/03/04,2025/03/01,SF FuneralFDC00000002VQ1250301,,220,,1952631.27
2025/03/04,2025/03/01,SF FuneralFDC00000002WGN250301,,220,,1952851.27
2025/03/04,2025/03/01,SF FuneralFDC000000033B9250301,,220,,1953071.27
2025/03/04,2025/03/01,SF FuneralFDC000000033D3250301,,220,,1953291.27
2025/03/04,2025/03/01,SF FuneralFDC00000003F0W250301,,220,,1953511.27
2025/03/04,2025/03/01,SF FuneralFDC00000003F71250301,,220,,1953731.27
2025/03/04,2025/03/01,SF FuneralFDC00000003KHB250301,,220,,1953951.27
2025/03/04,2025/03/01,SF FuneralFDC000000047DZ250301,,220,,1954171.27
2025/03/04,2025/03/01,SF FuneralFDC00000004XLV250301,,220,,1954391.27
2025/03/04,2025/03/01,SF FuneralFDC000000058HS250301,,126.5,,1954517.77
2025/03/04,2025/03/01,SF FuneralFDC00000005C15250301,,126.5,,1954644.27
2025/03/04,2025/03/01,SF FuneralFDC00000005H42250301,,126.5,,1954770.77
2025/03/04,2025/03/01,SF FuneralFDC00000005MDQ250301,,126.5,,1954897.27
2025/03/04,2025/03/01,SF FuneralFDC00000005MMV250301,,126.5,,1955023.77
2025/03/04,2025/03/01,SF FuneralFDC00000005NBT250301,,126.5,,1955150.27
2025/03/04,2025/03/01,SF FuneralFDC00000005TB4250301,,126.5,,1955276.77
2025/03/04,2025/03/01,SF FuneralFDC00000005X66250301,,220,,1955496.77
2025/03/04,2025/03/01,SF FuneralFDC000000067MD250301,,126.5,,1955623.27
2025/03/04,2025/03/01,SF FuneralFDC000000067QG250301,,126.5,,1955749.77
2025/03/04,2025/03/01,SF FuneralFDC000000067TK250301,,126.5,,1955876.27
2025/03/04,2025/03/01,SF FuneralFDC0000000681L250301,,126.5,,1956002.77
2025/03/04,2025/03/01,SF FuneralFDC000000068D3250301,,126.5,,1956129.27
2025/03/04,2025/03/01,SF FuneralFDC000000067DZ250301,,126.5,,1956255.77
2025/03/04,2025/03/01,SF FuneralFDC000000067RQ250301,,126.5,,1956382.27
2025/03/04,2025/03/01,SF FuneralFDC0000000681F250301,,126.5,,1956508.77
2025/03/04,2025/03/01,SF FuneralFDC000000069N3250301,,126.5,,1956635.27
2025/03/04,2025/03/01,SF FuneralFDC00000006BDT250301,,126.5,,1956761.77
2025/03/04,2025/03/01,SF FuneralFDC00000006BJ6250301,,126.5,,1956888.27
2025/03/04,2025/03/01,SF FuneralFDC00000006BKH250301,,126.5,,1957014.77
2025/03/04,2025/03/01,SF FuneralFDC00000006BKY250301,,126.5,,1957141.27
2025/03/04,2025/03/01,SF FuneralFDC00000006BN6250301,,126.5,,1957267.77
2025/03/04,2025/03/01,SF FuneralFDC00000006BRH250301,,126.5,,1957394.27
2025/03/04,2025/03/01,SF FuneralFDC00000006CCC250301,,126.5,,1957520.77
2025/03/04,2025/03/01,SF FuneralFDC00000006DM4250301,,126.5,,1957647.27
2025/03/04,2025/03/01,SF FuneralFDC00000006F6S250301,,126.5,,1957773.77
2025/03/04,2025/03/01,SF FuneralFDC00000006F9L250301,,126.5,,1957900.27
2025/03/04,2025/03/01,SF FuneralFDC00000006G15250301,,126.5,,1958026.77
2025/03/04,2025/03/01,SF FuneralFDC00000006GRC250301,,126.5,,1958153.27
2025/03/04,2025/03/01,SF FuneralFDC00000006GSG250301,,126.5,,1958279.77
2025/03/04,2025/03/01,SF FuneralFDC00000006GTS250301,,126.5,,1958406.27
2025/03/04,2025/03/01,SF FuneralFDC00000006GTV250301,,126.5,,1958532.77
2025/03/04,2025/03/01,SF FuneralFDC00000006HLP250301,,126.5,,1958659.27
2025/03/04,2025/03/01,SF FuneralFDC00000006J30250301,,126.5,,1958785.77
2025/03/04,2025/03/01,SF FuneralFDC000000069ZF250301,,126.5,,1958912.27
2025/03/04,2025/03/01,SF FuneralFDC00000006JSY250301,,126.5,,1959038.77
2025/03/04,2025/03/01,SF FuneralFDC00000006KHK250301,,126.5,,1959165.27
2025/03/04,2025/03/01,SF FuneralFDC00000006KS5250301,,126.5,,1959291.77
2025/03/04,2025/03/01,SF FuneralFDC00000006L0V250301,,126.5,,1959418.27
2025/03/04,2025/03/01,SF FuneralFDC00000006MCS250301,,126.5,,1959544.77
2025/03/04,2025/03/01,SF FuneralFDC00000006RQR250301,,220,,1959764.77
2025/03/04,2025/03/01,SF FuneralFDC00000006RXD250301,,126.5,,1959891.27
2025/03/04,2025/03/01,SF FuneralFDC00000006TQX250301,,126.5,,1960017.77
2025/03/04,2025/03/01,SF FuneralFDC00000006J9P250301,,126.5,,1960144.27
2025/03/04,2025/03/01,SF FuneralFDC00000006KHF250301,,126.5,,1960270.77
2025/03/04,2025/03/01,SF FuneralFDC00000006XK9250301,,126.5,,1960397.27
2025/03/04,2025/03/01,SF FuneralFDC00000006Y9Z250301,,126.5,,1960523.77
2025/03/04,2025/03/01,SF FuneralFDC00000006Z19250301,,126.5,,1960650.27
2025/03/04,2025/03/01,SF FuneralFDC00000007368250301,,126.5,,1960776.77
2025/03/04,2025/03/01,SF FuneralFDC000000073VZ250301,,126.5,,1960903.27
2025/03/04,2025/03/01,SF FuneralFDC0000000746T250301,,126.5,,1961029.77
2025/03/04,2025/03/01,SF FuneralFDC000000074KR250301,,126.5,,1961156.27
2025/03/04,2025/03/01,SF FuneralFDC000000074TB250301,,126.5,,1961282.77
2025/03/04,2025/03/01,SF FuneralFDC00000007590250301,,126.5,,1961409.27
2025/03/04,2025/03/01,SF FuneralFDC0000000759K250301,,126.5,,1961535.77
2025/03/04,2025/03/01,SF FuneralFDC000000075J7250301,,126.5,,1961662.27
2025/03/04,2025/03/01,SF FuneralFDC000000076H8250301,,126.5,,1961788.77
2025/03/04,2025/03/01,SF FuneralFDC000000076PN250301,,126.5,,1961915.27
2025/03/04,2025/03/01,SF FuneralFDC000000076QW250301,,126.5,,1962041.77
2025/03/04,2025/03/01,SF FuneralFDC000000077RR250301,,126.5,,1962168.27
2025/03/04,2025/03/01,SF FuneralFDC00000007878250301,,126.5,,1962294.77
2025/03/04,2025/03/01,SF FuneralFDC0000000799C250301,,126.5,,1962421.27
2025/03/04,2025/03/01,SF FuneralFDC000000079HK250301,,126.5,,1962547.77
2025/03/04,2025/03/01,SF FuneralFDC00000007BLJ250301,,126.5,,1962674.27
2025/03/04,2025/03/01,SF FuneralFDC00000007C9H250301,,126.5,,1962800.77
2025/03/04,2025/03/01,SF FuneralFDC00000007DDH250301,,126.5,,1962927.27
2025/03/04,2025/03/01,SF FuneralFDC00000007FCV250301,,126.5,,1963053.77
2025/03/04,2025/03/01,SF FuneralFDC00000007FQ5250301,,126.5,,1963180.27
2025/03/04,2025/03/01,SF FuneralFDC00000007FY3250301,,126.5,,1963306.77
2025/03/04,2025/03/01,SF FuneralFDC00000007NRN250301,,126.5,,1963433.27
2025/03/04,2025/03/01,SF FuneralF793670       250301,,126.5,,1963559.77
2025/03/04,2025/03/01,SF FuneralFDC00000007PVN250301,,126.5,,1963686.27
2025/03/04,2025/03/01,SF FuneralFDC00000007PXR250301,,126.5,,1963812.77
2025/03/04,2025/03/01,SF FuneralFDC00000007QJ9250301,,126.5,,1963939.27
2025/03/04,2025/03/01,SF FuneralFDC00000007QKC250301,,126.5,,1964065.77
2025/03/04,2025/03/01,SF FuneralFDC00000007QNF250301,,220,,1964285.77
2025/03/04,2025/03/01,SF FuneralFDC00000007R49250301,,126.5,,1964412.27
2025/03/04,2025/03/01,SF FuneralF794127       250301,,126.5,,1964538.77
2025/03/04,2025/03/01,SF FuneralFDC00000007RJJ250301,,126.5,,1964665.27
2025/03/04,2025/03/01,SF FuneralFDC00000007RPX250301,,126.5,,1964791.77
2025/03/04,2025/03/01,SF FuneralFDC00000007S1V250301,,126.5,,1964918.27
2025/03/04,2025/03/01,SF FuneralFDC00000007T2F250301,,126.5,,1965044.77
2025/03/04,2025/03/01,SF FuneralFDC00000007T7R250301,,126.5,,1965171.27
2025/03/04,2025/03/01,SF FuneralFDC00000007397250301,,126.5,,1965297.77
2025/03/04,2025/03/01,SF FuneralFDC000000076PL250301,,126.5,,1965424.27
2025/03/04,2025/03/01,SF FuneralFDC000000078Q6250301,,126.5,,1965550.77
2025/03/04,2025/03/01,SF FuneralFDC00000007DR3250301,,126.5,,1965677.27
2025/03/04,2025/03/01,SF FuneralFDC00000007TJS250301,,220,,1965897.27
2025/03/04,2025/03/01,SF FuneralF795059       250301,,126.5,,1966023.77
2025/03/04,2025/03/01,SF FuneralF795659       250301,,126.5,,1966150.27
2025/03/04,2025/03/01,SF FuneralFDC00000007WP1250301,,126.5,,1966276.77
2025/03/04,2025/03/01,SF FuneralFDC00000007Z00250301,,126.5,,1966403.27
2025/03/04,2025/03/01,SF FuneralFDC00000007Z9H250301,,126.5,,1966529.77
2025/03/04,2025/03/01,SF FuneralF796829       250301,,126.5,,1966656.27
2025/03/04,2025/03/01,SF FuneralF797949       250301,,126.5,,1966782.77
2025/03/04,2025/03/01,SF FuneralFDC000000083FW250301,,126.5,,1966909.27
2025/03/04,2025/03/01,SF FuneralFDC000000083RQ250301,,126.5,,1967035.77
2025/03/04,2025/03/01,SF FuneralF798268       250301,,126.5,,1967162.27
2025/03/04,2025/03/01,SF FuneralF798673       250301,,126.5,,1967288.77
2025/03/04,2025/03/01,SF FuneralF798709       250301,,126.5,,1967415.27
2025/03/04,2025/03/01,SF FuneralF799226       250301,,126.5,,1967541.77
2025/03/04,2025/03/01,SF FuneralFDC000000088D1250301,,126.5,,1967668.27
2025/03/04,2025/03/01,SF FuneralF800040       250301,,126.5,,1967794.77
2025/03/04,2025/03/01,SF FuneralF800841       250301,,126.5,,1967921.27
2025/03/04,2025/03/01,SF FuneralF800898       250301,,126.5,,1968047.77
2025/03/04,2025/03/01,SF FuneralFDC00000008FHW250301,,126.5,,1968174.27
2025/03/04,2025/03/01,SF FuneralFDC00000008FJF250301,,126.5,,1968300.77
2025/03/04,2025/03/01,SF FuneralF801279       250301,,126.5,,1968427.27
2025/03/04,2025/03/01,SF FuneralF801564       250301,,126.5,,1968553.77
2025/03/04,2025/03/01,SF FuneralF801687       250301,,126.5,,1968680.27
2025/03/04,2025/03/01,SF FuneralF802408       250301,,126.5,,1968806.77
2025/03/04,2025/03/01,SF FuneralF804211       250301,,126.5,,1968933.27
2025/03/04,2025/03/01,SF FuneralF805048       250301,,126.5,,1969059.77
2025/03/04,2025/03/01,SF FuneralF805555       250301,,126.5,,1969186.27
2025/03/04,2025/03/01,SF FuneralF808524       250301,,126.5,,1969312.77
2025/03/04,2025/03/01,SF FuneralF808554       250301,,126.5,,1969439.27
2025/03/04,2025/03/01,SF FuneralF808576       250301,,126.5,,1969565.77
2025/03/04,2025/03/01,SF FuneralF808720       250301,,126.5,,1969692.27
2025/03/04,2025/03/01,SF FuneralF808750       250301,,126.5,,1969818.77
2025/03/04,2025/03/01,SF FuneralF808892       250301,,126.5,,1969945.27
2025/03/04,2025/03/01,SF FuneralF809312       250301,,126.5,,1970071.77
2025/03/04,2025/03/01,SF FuneralF809478       250301,,126.5,,1970198.27
2025/03/04,2025/03/01,SF FuneralF809677       250301,,126.5,,1970324.77
2025/03/04,2025/03/01,SF FuneralF809704       250301,,126.5,,1970451.27
2025/03/04,2025/03/01,SF FuneralF809882       250301,,126.5,,1970577.77
2025/03/04,2025/03/01,SF FuneralF794621       250301,,220,,1970797.77
2025/03/04,2025/03/01,SF FuneralF810465       250301,,126.5,,1970924.27
2025/03/04,2025/03/01,SF FuneralF810747       250301,,126.5,,1971050.77
2025/03/04,2025/03/01,SF FuneralF813100       250301,,126.5,,1971177.27
2025/03/04,2025/03/01,SF FuneralF813167       250301,,126.5,,1971303.77
2025/03/04,2025/03/01,SF FuneralF813622       250301,,126.5,,1971430.27
2025/03/04,2025/03/01,SF FuneralF813764       250301,,126.5,,1971556.77
2025/03/04,2025/03/01,SF FuneralF813774       250301,,126.5,,1971683.27
2025/03/04,2025/03/01,SF FuneralF813902       250301,,126.5,,1971809.77
2025/03/04,2025/03/01,SF FuneralF815666       250301,,126.5,,1971936.27
2025/03/04,2025/03/01,SF FuneralFDC00000009W3B250301,,126.5,,1972062.77
2025/03/04,2025/03/01,SF FuneralF816424       250301,,126.5,,1972189.27
2025/03/04,2025/03/01,SF FuneralF816527       250301,,126.5,,1972315.77
2025/03/04,2025/03/01,SF FuneralF816814       250301,,126.5,,1972442.27
2025/03/04,2025/03/01,SF FuneralF816945       250301,,126.5,,1972568.77
2025/03/04,2025/03/01,SF FuneralF817405       250301,,126.5,,1972695.27
2025/03/04,2025/03/01,SF FuneralF817500       250301,,126.5,,1972821.77
2025/03/04,2025/03/01,SF FuneralF818317       250301,,126.5,,1972948.27
2025/03/04,2025/03/01,SF FuneralF818524       250301,,126.5,,1973074.77
2025/03/04,2025/03/01,SF FuneralF818852       250301,,126.5,,1973201.27
2025/03/04,2025/03/01,SF FuneralF818982       250301,,126.5,,1973327.77
2025/03/04,2025/03/01,SF FuneralF820384       250301,,126.5,,1973454.27
2025/03/04,2025/03/01,SF FuneralF820447       250301,,126.5,,1973580.77
2025/03/04,2025/03/01,SF FuneralF820831       250301,,126.5,,1973707.27
2025/03/04,2025/03/01,SF FuneralF821100       250301,,126.5,,1973833.77
2025/03/04,2025/03/01,SF FuneralFDC0000000B99B250301,,126.5,,1973960.27
2025/03/04,2025/03/01,SF FuneralFDC0000000B9Y8250301,,126.5,,1974086.77
2025/03/04,2025/03/01,SF FuneralF821461       250301,,213.31,,1974300.08
2025/03/04,2025/03/01,SF FuneralF821613       250301,,126.5,,1974426.58
2025/03/04,2025/03/01,SF FuneralF827716       250301,,126.5,,1974553.08
2025/03/04,2025/03/01,SF FuneralF827850       250301,,126.5,,1974679.58
2025/03/04,2025/03/01,SF FuneralF828016       250301,,126.5,,1974806.08
2025/03/04,2025/03/01,SF FuneralF828019       250301,,126.5,,1974932.58
2025/03/04,2025/03/01,SF FuneralF828071       250301,,126.5,,1975059.08
2025/03/04,2025/03/01,SF FuneralF828112       250301,,126.5,,1975185.58
2025/03/04,2025/03/01,SF FuneralF828184       250301,,126.5,,1975312.08
2025/03/04,2025/03/01,SF FuneralF828207       250301,,126.5,,1975438.58
2025/03/04,2025/03/01,SF FuneralF828259       250301,,126.5,,1975565.08
2025/03/04,2025/03/01,SF FuneralF828893       250301,,126.5,,1975691.58
2025/03/04,2025/03/01,SF FuneralF829034       250301,,126.5,,1975818.08
2025/03/04,2025/03/01,SF FuneralF829077       250301,,126.5,,1975944.58
2025/03/04,2025/03/01,SF FuneralF829789       250301,,126.5,,1976071.08
2025/03/04,2025/03/01,SF FuneralF829886       250301,,126.5,,1976197.58
2025/03/04,2025/03/01,SF FuneralF830585       250301,,126.5,,1976324.08
2025/03/04,2025/03/01,SF FuneralF830876       250301,,126.5,,1976450.58
2025/03/04,2025/03/01,SF FuneralF831104       250301,,126.5,,1976577.08
2025/03/04,2025/03/01,SF FuneralF832052       250301,,126.5,,1976703.58
2025/03/04,2025/03/01,SF FuneralF832244       250301,,126.5,,1976830.08
2025/03/04,2025/03/01,SF FuneralF832964       250301,,126.5,,1976956.58
2025/03/04,2025/03/01,SF FuneralF833096       250301,,126.5,,1977083.08
2025/03/04,2025/03/01,SF FuneralF833102       250301,,126.5,,1977209.58
2025/03/04,2025/03/01,SF FuneralF833128       250301,,126.5,,1977336.08
2025/03/04,2025/03/01,SF FuneralF833240       250301,,126.5,,1977462.58
2025/03/04,2025/03/01,SF FuneralF833426       250301,,126.5,,1977589.08
2025/03/04,2025/03/01,SF FuneralF834187       250301,,126.5,,1977715.58
2025/03/04,2025/03/01,SF FuneralF834745       250301,,126.5,,1977842.08
2025/03/04,2025/03/01,SF FuneralF834936       250301,,126.5,,1977968.58
2025/03/04,2025/03/01,SF FuneralF841427       250301,,126.5,,1978095.08
2025/03/04,2025/03/01,SF FuneralF841437       250301,,126.5,,1978221.58
2025/03/04,2025/03/01,SF FuneralF841489       250301,,126.5,,1978348.08
2025/03/04,2025/03/01,SF FuneralF841532       250301,,126.5,,1978474.58
2025/03/04,2025/03/01,SF FuneralF841942       250301,,126.5,,1978601.08
2025/03/04,2025/03/01,SF FuneralF842044       250301,,126.5,,1978727.58
2025/03/04,2025/03/01,SF FuneralF842444       250301,,126.5,,1978854.08
2025/03/04,2025/03/01,SF FuneralF842519       250301,,126.5,,1978980.58
2025/03/04,2025/03/01,SF FuneralF842695       250301,,126.5,,1979107.08
2025/03/04,2025/03/01,SF FuneralF842766       250301,,126.5,,1979233.58
2025/03/04,2025/03/01,SF FuneralF992305       250301,,126.5,,1979360.08
2025/03/04,2025/03/01,SF FuneralF992362       250301,,126.5,,1979486.58
2025/03/04,2025/03/01,SF FuneralFDC0000000J8XY250301,,126.5,,1979613.08
2025/03/04,2025/03/01,SF FuneralF992488       250301,,126.5,,1979739.58
2025/03/04,2025/03/01,SF FuneralF992732       250301,,126.5,,1979866.08
2025/03/04,2025/03/01,SF FuneralF993035       250301,,126.5,,1979992.58
2025/03/04,2025/03/01,SF FuneralF993212       250301,,126.5,,1980119.08
2025/03/04,2025/03/01,SF FuneralF993215       250301,,126.5,,1980245.58
2025/03/04,2025/03/01,SF FuneralF1021223      250301,,126.5,,1980372.08
2025/03/04,2025/03/01,SF FuneralF1021275      250301,,126.5,,1980498.58
2025/03/04,2025/03/01,SF FuneralF1021431      250301,,126.5,,1980625.08
2025/03/04,2025/03/01,SF FuneralF1021516      250301,,126.5,,1980751.58
2025/03/04,2025/03/01,SF FuneralF1021760      250301,,126.5,,1980878.08
2025/03/04,2025/03/01,SF FuneralF1021767      250301,,126.5,,1981004.58
2025/03/04,2025/03/01,SF FuneralF1022018      250301,,126.5,,1981131.08
2025/03/04,2025/03/01,SF FuneralF1050754      250301,,126.5,,1981257.58
2025/03/04,2025/03/01,SF FuneralF1052041      250301,,126.5,,1981384.08
2025/03/04,2025/03/01,SF FuneralFDC0000000K0YD250301,,126.5,,1981510.58
2025/03/04,2025/03/01,SF FuneralF1052147      250301,,126.5,,1981637.08
2025/03/04,2025/03/01,SF FuneralF1052508      250301,,126.5,,1981763.58
2025/03/04,2025/03/01,SF FuneralF1052747      250301,,126.5,,1981890.08
2025/03/04,2025/03/01,SF FuneralF1058669      250301,,126.5,,1982016.58
2025/03/04,2025/03/01,SF FuneralF1060242      250301,,126.5,,1982143.08
2025/03/04,2025/03/01,SF FuneralFDC0000000KLR7250301,,126.5,,1982269.58
2025/03/04,2025/03/01,SF FuneralF1061685      250301,,126.5,,1982396.08
2025/03/04,2025/03/01,SF FuneralF1061705      250301,,126.5,,1982522.58
2025/03/04,2025/03/01,SF FuneralF1066353      250301,,126.5,,1982649.08
2025/03/04,2025/03/01,SF FuneralF1066410      250301,,126.5,,1982775.58
2025/03/04,2025/03/01,SF FuneralF1066418      250301,,126.5,,1982902.08
2025/03/04,2025/03/01,SF FuneralF1066716      250301,,126.5,,1983028.58
2025/03/04,2025/03/01,SF FuneralF1072710      250301,,126.5,,1983155.08
2025/03/04,2025/03/01,SF FuneralF1072866      250301,,126.5,,1983281.58
2025/03/04,2025/03/01,SF FuneralF1073201      250301,,126.5,,1983408.08
2025/03/04,2025/03/01,SF FuneralF1075045      250301,,126.5,,1983534.58
2025/03/04,2025/03/01,SF FuneralF1075125      250301,,126.5,,1983661.08
2025/03/04,2025/03/01,SF FuneralF1075236      250301,,126.5,,1983787.58
2025/03/04,2025/03/01,SF FuneralF1078246      250301,,126.5,,1983914.08
2025/03/04,2025/03/01,SF FuneralF1078386      250301,,126.5,,1984040.58
2025/03/04,2025/03/01,SF FuneralF1078615      250301,,126.5,,1984167.08
2025/03/04,2025/03/01,SF FuneralF1078964      250301,,126.5,,1984293.58
2025/03/04,2025/03/01,SF FuneralFDC0000000LM0M250301,,126.5,,1984420.08
2025/03/04,2025/03/01,SF FuneralFDC0000000LNNV250301,,126.5,,1984546.58
2025/03/04,2025/03/01,SF FuneralF1021257      250301,,126.5,,1984673.08
2025/03/04,2025/03/01,SF FuneralF1084033      250301,,126.5,,1984799.58
2025/03/04,2025/03/01,SF FuneralF1084333      250301,,126.5,,1984926.08
2025/03/04,2025/03/01,SF FuneralF1084394      250301,,126.5,,1985052.58
2025/03/04,2025/03/01,SF FuneralF1084657      250301,,126.5,,1985179.08
2025/03/04,2025/03/01,SF FuneralF1084875      250301,,126.5,,1985305.58
2025/03/04,2025/03/01,SF FuneralF1103729      250301,,126.5,,1985432.08
2025/03/04,2025/03/01,SF FuneralF1103949      250301,,126.5,,1985558.58
2025/03/04,2025/03/01,SF FuneralF1104064      250301,,126.5,,1985685.08
2025/03/04,2025/03/01,SF FuneralF1108778      250301,,126.5,,1985811.58
2025/03/04,2025/03/01,SF FuneralFDC0000000MJFF250301,,126.5,,1985938.08
2025/03/04,2025/03/01,SF FuneralFDC0000000MJSQ250301,,220,,1986158.08
2025/03/04,2025/03/01,SF FuneralF1109831      250301,,126.5,,1986284.58
2025/03/04,2025/03/01,SF FuneralF1110353      250301,,126.5,,1986411.08
2025/03/04,2025/03/01,SF FuneralF820617       250301,,126.5,,1986537.58
2025/03/04,2025/03/01,SF FuneralFDC0000000N388250301,,126.5,,1986664.08
2025/03/04,2025/03/01,SF FuneralFDC0000000N38C250301,,126.5,,1986790.58
2025/03/04,2025/03/01,SF FuneralF1113613      250301,,126.5,,1986917.08
2025/03/04,2025/03/01,SF FuneralF1113827      250301,,126.5,,1987043.58
2025/03/04,2025/03/01,SF FuneralF1113835      250301,,126.5,,1987170.08
2025/03/04,2025/03/01,SF FuneralF1114049      250301,,126.5,,1987296.58
2025/03/04,2025/03/01,SF FuneralF1114271      250301,,126.5,,1987423.08
2025/03/04,2025/03/01,SF FuneralF1114598      250301,,126.5,,1987549.58
2025/03/04,2025/03/01,SF FuneralF1114625      250301,,126.5,,1987676.08
2025/03/04,2025/03/01,SF FuneralF1115145      250301,,126.5,,1987802.58
2025/03/04,2025/03/01,SF FuneralF1116933      250301,,126.5,,1987929.08
2025/03/04,2025/03/01,SF FuneralF1116943      250302,,126.5,,1988055.58
2025/03/04,2025/03/01,SF FuneralF1116955      250301,,126.5,,1988182.08
2025/03/04,2025/03/01,SF FuneralF1117142      250301,,126.5,,1988308.58
2025/03/04,2025/03/01,SF FuneralF1117301      250302,,126.5,,1988435.08
2025/03/04,2025/03/01,SF FuneralF1117869      250301,,126.5,,1988561.58
2025/03/04,2025/03/01,SF FuneralF1117997      250301,,126.5,,1988688.08
2025/03/04,2025/03/01,SF FuneralF1118066      250301,,126.5,,1988814.58
2025/03/04,2025/03/01,SF FuneralF1118415      250301,,126.5,,1988941.08
2025/03/04,2025/03/01,SF FuneralF1118907      250301,,126.5,,1989067.58
2025/03/04,2025/03/01,SF FuneralF1119879      250301,,126.5,,1989194.08
2025/03/04,2025/03/01,SF FuneralF1121893      250301,,126.5,,1989320.58
2025/03/04,2025/03/01,SF FuneralF1121912      250301,,126.5,,1989447.08
2025/03/04,2025/03/01,SF FuneralF1122213      250301,,126.5,,1989573.58
2025/03/04,2025/03/01,SF FuneralF1122225      250301,,126.5,,1989700.08
2025/03/04,2025/03/01,SF FuneralF1122234      250301,,126.5,,1989826.58
2025/03/04,2025/03/01,SF FuneralF1122623      250301,,126.5,,1989953.08
2025/03/04,2025/03/01,SF FuneralF1122671      250301,,126.5,,1990079.58
2025/03/04,2025/03/01,SF FuneralF1122801      250301,,126.5,,1990206.08
2025/03/04,2025/03/01,SF FuneralF1122861      250301,,126.5,,1990332.58
2025/03/04,2025/03/01,SF FuneralF1122990      250301,,126.5,,1990459.08
2025/03/04,2025/03/01,SF FuneralF1123289      250301,,126.5,,1990585.58
2025/03/04,2025/03/01,SF FuneralF1123462      250301,,126.5,,1990712.08
2025/03/04,2025/03/01,SF FuneralF1124062      250301,,126.5,,1990838.58
2025/03/04,2025/03/01,SF FuneralF1125280      250301,,126.5,,1990965.08
2025/03/04,2025/03/01,SF FuneralF1125422      250301,,126.5,,1991091.58
2025/03/04,2025/03/01,SF FuneralF1125463      250301,,126.5,,1991218.08
2025/03/04,2025/03/01,SF FuneralF1125499      250301,,126.5,,1991344.58
2025/03/04,2025/03/01,SF FuneralF1052159      250301,,126.5,,1991471.08
2025/03/04,2025/03/01,SF FuneralFDC0000000PKGF250301,,213.31,,1991684.39
2025/03/04,2025/03/01,SF FuneralF1127398      250301,,126.5,,1991810.89
2025/03/04,2025/03/01,SF FuneralF1127400      250301,,126.5,,1991937.39
2025/03/04,2025/03/01,SF FuneralF1127645      250301,,126.5,,1992063.89
2025/03/04,2025/03/01,SF FuneralF1127938      250301,,126.5,,1992190.39
2025/03/04,2025/03/01,SF FuneralF1127992      250301,,126.5,,1992316.89
2025/03/04,2025/03/01,SF FuneralF1128004      250301,,126.5,,1992443.39
2025/03/04,2025/03/01,SF FuneralF1128137      250301,,126.5,,1992569.89
2025/03/04,2025/03/01,SF FuneralF1128186      250301,,126.5,,1992696.39
2025/03/04,2025/03/01,SF FuneralF1129162      250301,,126.5,,1992822.89
2025/03/04,2025/03/01,SF FuneralF1129319      250301,,126.5,,1992949.39
2025/03/04,2025/03/01,SF FuneralF1131207      250301,,126.5,,1993075.89
2025/03/04,2025/03/01,SF FuneralF1131478      250301,,126.5,,1993202.39
2025/03/04,2025/03/01,SF FuneralF1131488      250301,,126.5,,1993328.89
2025/03/04,2025/03/01,SF FuneralF1131508      250301,,126.5,,1993455.39
2025/03/04,2025/03/01,SF FuneralFDC0000000Q5P4250301,,126.5,,1993581.89
2025/03/04,2025/03/01,SF FuneralF1131704      250301,,126.5,,1993708.39
2025/03/04,2025/03/01,SF FuneralF1131734      250301,,126.5,,1993834.89
2025/03/04,2025/03/01,SF FuneralF1131839      250301,,126.5,,1993961.39
2025/03/04,2025/03/01,SF FuneralFDC0000000Q85V250301,,126.5,,1994087.89
2025/03/04,2025/03/03,SF FuneralF802942       250302,,126.5,,1994214.39
2025/03/04,2025/03/02,SF FuneralF828062       250302,,126.5,,1994340.89
2025/03/04,2025/03/03,SF FuneralF832528       250303,,126.5,,1994467.39
2025/03/04,2025/03/02,SF FuneralF832557       250302,,126.5,,1994593.89
2025/03/04,2025/03/03,SF FuneralF843397       250301,,126.5,,1994720.39
2025/03/04,2025/03/03,SF FuneralF900689       250301,,126.5,,1994846.89
2025/03/04,2025/03/03,SF FuneralF900733       250301,,126.5,,1994973.39
2025/03/04,2025/03/03,SF FuneralF900740       250301,,126.5,,1995099.89
2025/03/04,2025/03/03,SF FuneralF993884       250303,,126.5,,1995226.39
2025/03/04,2025/03/03,SF FuneralF1061660      250303,,126.5,,1995352.89
2025/03/04,2025/03/03,SF FuneralF1125880      250303,,126.5,,1995479.39
2025/03/04,2025/03/03,SF FuneralF1126015      250303,,126.5,,1995605.89
2025/03/04,2025/03/03,SF FuneralF1126184      250303,,126.5,,1995732.39
2025/03/04,2025/03/04,SF FuneralFDC00000006WKK250304,,31.63,,1995764.02
2025/03/04,2025/03/04,SF FuneralFDC00000007BRR250304,,126.5,,1995890.52
2025/03/04,2025/03/04,SF FuneralFDC00000007CJF250304,,63.25,,1995953.77
2025/03/04,2025/03/04,SF FuneralF816802       250304,,31.63,,1995985.4
2025/03/04,2025/03/04,SF FuneralF831106       250304,,31.63,,1996017.03
2025/03/04,2025/03/04,SF FuneralF1052659      250304,,31.63,,1996048.66
2025/03/04,2025/03/04,SF FuneralF1068029      250304,,31.63,,1996080.29
2025/03/04,2025/03/04,SF FuneralF1110299      250304,,31.63,,1996111.92
2025/03/04,2025/03/04,SF FuneralF1115749      250304,,31.63,,1996143.55
2025/03/04,2025/03/04,SF FuneralF1123395      250304,,63.25,,1996206.8
2025/03/04,2025/03/04,SF FuneralF1127411      250304,,126.5,,1996333.3
2025/03/04,2025/03/04,SF FuneralF1129103      250304,,31.63,,1996364.93
2025/03/04,2025/03/04,SF FuneralFDC0000000595N250304,,31.62,,1996396.55
2025/03/04,2025/03/04,SF FuneralFDC00000006L9F250304,,31.63,,1996428.18
2025/03/04,2025/03/04,SF FuneralF811733       250304,,31.63,,1996459.81
2025/03/04,2025/03/04,SF FuneralF813503       250304,,31.63,,1996491.44
2025/03/04,2025/03/04,SF FuneralF828892       250304,,63.25,,1996554.69
2025/03/04,2025/03/04,SF FuneralFDC0000000JRTR250304,,63.25,,1996617.94
2025/03/04,2025/03/04,SF FuneralF1022115      250304,,31.63,,1996649.57
2025/03/04,2025/03/04,SF FuneralF1110796      250304,,31.63,,1996681.2
2025/03/04,2025/03/04,SF FuneralF1118848      250304,,31.63,,1996712.83
2025/03/04,2025/03/04,SF FuneralF1123172      250304,,31.63,,1996744.46
2025/03/04,2025/02/27,SF FuneralFDC00000007QTL250227,,126.5,,1996870.96
2025/03/04,2025/02/27,SF FuneralFDC0000000HXW8250227,,126.5,,1996997.46
2025/03/04,2025/03/01,SF FuneralFDC00000002VCM250301,,220,,1997217.46
2025/03/04,2025/03/01,SF FuneralFDC00000002VKC250301,,220,,1997437.46
2025/03/04,2025/03/01,SF FuneralFDC00000002VYW250301,,220,,1997657.46
2025/03/04,2025/03/01,SF FuneralFDC00000004G93250301,,220,,1997877.46
2025/03/04,2025/03/01,SF FuneralFDC000000058N7250301,,126.5,,1998003.96
2025/03/04,2025/03/01,SF FuneralFDC00000005F2D250301,,126.5,,1998130.46
2025/03/04,2025/03/01,SF FuneralFDC00000005HYC250301,,220,,1998350.46
2025/03/04,2025/03/01,SF FuneralFDC00000005LYP250301,,220,,1998570.46
2025/03/04,2025/03/01,SF FuneralFDC00000005Z94250301,,126.5,,1998696.96
2025/03/04,2025/03/01,SF FuneralFDC000000063NT250301,,126.5,,1998823.46
2025/03/04,2025/03/01,SF FuneralFDC0000000680H250301,,126.5,,1998949.96
2025/03/04,2025/03/01,SF FuneralFDC0000000683X250301,,126.5,,1999076.46
2025/03/04,2025/03/01,SF FuneralFDC0000000688X250301,,126.5,,1999202.96
2025/03/04,2025/03/01,SF FuneralFDC00000006897250301,,126.5,,1999329.46
2025/03/04,2025/03/01,SF FuneralFDC0000000697M250301,,126.5,,1999455.96
2025/03/04,2025/03/01,SF FuneralFDC000000069Y7250301,,126.5,,1999582.46
2025/03/04,2025/03/01,SF FuneralFDC00000006BFB250301,,126.5,,1999708.96
2025/03/04,2025/03/01,SF FuneralFDC00000006BNH250301,,126.5,,1999835.46
2025/03/04,2025/03/01,SF FuneralFDC00000006BQX250301,,126.5,,1999961.96
2025/03/04,2025/03/01,SF FuneralFDC00000006CFT250301,,126.5,,2000088.46
2025/03/04,2025/03/01,SF FuneralFDC00000006DRL250301,,126.5,,2000214.96
2025/03/04,2025/03/01,SF FuneralFDC00000006F5R250301,,126.5,,2000341.46
2025/03/04,2025/03/01,SF FuneralFDC00000006FVH250301,,126.5,,2000467.96
2025/03/04,2025/03/01,SF FuneralFDC00000006FXN250301,,126.5,,2000594.46
2025/03/04,2025/03/01,SF FuneralFDC00000006GPH250301,,126.5,,2000720.96
2025/03/04,2025/03/01,SF FuneralFDC00000006GVN250301,,126.5,,2000847.46
2025/03/04,2025/03/01,SF FuneralFDC00000006H70250301,,126.5,,2000973.96
2025/03/04,2025/03/01,SF FuneralFDC00000006KH0250301,,126.5,,2001100.46
2025/03/04,2025/03/01,SF FuneralFDC00000006LYX250301,,126.5,,2001226.96
2025/03/04,2025/03/01,SF FuneralFDC00000006NVV250301,,126.5,,2001353.46
2025/03/04,2025/03/01,SF FuneralFDC00000006PSN250301,,126.5,,2001479.96
2025/03/04,2025/03/01,SF FuneralFDC00000006RYM250301,,126.5,,2001606.46
2025/03/04,2025/03/01,SF FuneralFDC00000006S94250301,,126.5,,2001732.96
2025/03/04,2025/03/01,SF FuneralFDC00000006ZYP250301,,126.5,,2001859.46
2025/03/04,2025/03/01,SF FuneralFDC0000000712R250301,,126.5,,2001985.96
2025/03/04,2025/03/01,SF FuneralFDC000000073Q5250301,,126.5,,2002112.46
2025/03/04,2025/03/01,SF FuneralFDC0000000746Z250301,,126.5,,2002238.96
2025/03/04,2025/03/01,SF FuneralFDC000000074ZK250301,,126.5,,2002365.46
2025/03/04,2025/03/01,SF FuneralFDC00000007578250301,,126.5,,2002491.96
2025/03/04,2025/03/01,SF FuneralFDC000000075FJ250301,,126.5,,2002618.46
2025/03/04,2025/03/01,SF FuneralFDC000000076MN250301,,126.5,,2002744.96
2025/03/04,2025/03/01,SF FuneralFDC00000007B6S250301,,126.5,,2002871.46
2025/03/04,2025/03/01,SF FuneralFDC00000007CG3250301,,126.5,,2002997.96
2025/03/04,2025/03/01,SF FuneralFDC00000007DMX250301,,220,,2003217.96
2025/03/04,2025/03/01,SF FuneralFDC00000007DRC250301,,126.5,,2003344.46
2025/03/04,2025/03/01,SF FuneralFDC00000007F7V250301,,126.5,,2003470.96
2025/03/04,2025/03/01,SF FuneralFDC00000007FR6250301,,126.5,,2003597.46
2025/03/04,2025/03/01,SF FuneralFDC00000007P25250301,,126.5,,2003723.96
2025/03/04,2025/03/01,SF FuneralFDC00000007P2H250301,,126.5,,2003850.46
2025/03/04,2025/03/01,SF FuneralFDC00000007PW2250301,,126.5,,2003976.96
2025/03/04,2025/03/01,SF FuneralFDC00000007QG6250301,,126.5,,2004103.46
2025/03/04,2025/03/01,SF FuneralF793932       250301,,126.5,,2004229.96
2025/03/04,2025/03/01,SF FuneralFDC00000007QMY250301,,126.5,,2004356.46
2025/03/04,2025/03/01,SF FuneralFDC00000007RG9250301,,126.5,,2004482.96
2025/03/04,2025/03/01,SF FuneralFDC00000007S2G250301,,126.5,,2004609.46
2025/03/04,2025/03/01,SF FuneralF794675       250301,,126.5,,2004735.96
2025/03/04,2025/03/01,SF FuneralFDC00000007SXX250301,,126.5,,2004862.46
2025/03/04,2025/03/01,SF FuneralF794882       250301,,126.5,,2004988.96
2025/03/04,2025/03/01,SF FuneralFDC00000007TKR250301,,126.5,,2005115.46
2025/03/04,2025/03/01,SF FuneralFDC00000007WYG250301,,126.5,,2005241.96
2025/03/04,2025/03/01,SF FuneralFDC00000007ZD0250301,,126.5,,2005368.46
2025/03/04,2025/03/01,SF FuneralFDC000000083H6250301,,126.5,,2005494.96
2025/03/04,2025/03/01,SF FuneralF798031       250301,,126.5,,2005621.46
2025/03/04,2025/03/01,SF FuneralF798034       250301,,126.5,,2005747.96
2025/03/04,2025/03/01,SF FuneralF798189       250301,,126.5,,2005874.46
2025/03/04,2025/03/01,SF FuneralF798267       250301,,126.5,,2006000.96
2025/03/04,2025/03/01,SF FuneralFDC000000084X4250301,,126.5,,2006127.46
2025/03/04,2025/03/01,SF FuneralF798788       250301,,126.5,,2006253.96
2025/03/04,2025/03/01,SF FuneralF799195       250301,,126.5,,2006380.46
2025/03/04,2025/03/01,SF FuneralFDC000000086YL250301,,256.5,,2006636.96
2025/03/04,2025/03/01,SF FuneralF799361       250301,,126.5,,2006763.46
2025/03/04,2025/03/01,SF FuneralF799379       250301,,126.5,,2006889.96
2025/03/04,2025/03/01,SF FuneralFDC000000087D8250301,,126.5,,2007016.46
2025/03/04,2025/03/01,SF FuneralFDC000000089VT250301,,126.5,,2007142.96
2025/03/04,2025/03/01,SF FuneralF802198       250301,,126.5,,2007269.46
2025/03/04,2025/03/01,SF FuneralF789710       250301,,126.5,,2007395.96
2025/03/04,2025/03/01,SF FuneralF802610       250301,,126.5,,2007522.46
2025/03/04,2025/03/01,SF FuneralF802826       250301,,126.5,,2007648.96
2025/03/04,2025/03/01,SF FuneralF802844       250301,,126.5,,2007775.46
2025/03/04,2025/03/01,SF FuneralF784219       250301,,126.5,,2007901.96
2025/03/04,2025/03/01,SF FuneralF804039       250301,,126.5,,2008028.46
2025/03/04,2025/03/01,SF FuneralF804537       250301,,126.5,,2008154.96
2025/03/04,2025/03/01,SF FuneralF786912       250301,,126.5,,2008281.46
2025/03/04,2025/03/01,SF FuneralF805817       250301,,126.5,,2008407.96
2025/03/04,2025/03/01,SF FuneralFDC00000008ZBR250301,,191.5,,2008599.46
2025/03/04,2025/03/01,SF FuneralF804271       250301,,126.5,,2008725.96
2025/03/04,2025/03/01,SF FuneralF808855       250301,,126.5,,2008852.46
2025/03/04,2025/03/01,SF FuneralF809022       250301,,126.5,,2008978.96
2025/03/04,2025/03/01,SF FuneralF809160       250301,,126.5,,2009105.46
2025/03/04,2025/03/01,SF FuneralF810288       250301,,126.5,,2009231.96
2025/03/04,2025/03/01,SF FuneralF810793       250301,,126.5,,2009358.46
2025/03/04,2025/03/01,SF FuneralF812102       250301,,126.5,,2009484.96
2025/03/04,2025/03/01,SF FuneralF812177       250301,,126.5,,2009611.46
2025/03/04,2025/03/01,SF FuneralF813009       250301,,126.5,,2009737.96
2025/03/04,2025/03/01,SF FuneralF813058       250301,,126.5,,2009864.46
2025/03/04,2025/03/01,SF FuneralFDC00000009GML250301,,126.5,,2009990.96
2025/03/04,2025/03/01,SF FuneralF813085       250301,,126.5,,2010117.46
2025/03/04,2025/03/01,SF FuneralFDC00000009JFJ250301,,126.5,,2010243.96
2025/03/04,2025/03/01,SF FuneralFDC00000009KM3250301,,126.5,,2010370.46
2025/03/04,2025/03/01,SF FuneralF814343       250301,,126.5,,2010496.96
2025/03/04,2025/03/01,SF FuneralF816679       250301,,126.5,,2010623.46
2025/03/04,2025/03/01,SF FuneralFDC00000009WXB250301,,126.5,,2010749.96
2025/03/04,2025/03/01,SF FuneralF816912       250301,,126.5,,2010876.46
2025/03/04,2025/03/01,SF FuneralF816956       250301,,126.5,,2011002.96
2025/03/04,2025/03/01,SF FuneralF817195       250301,,126.5,,2011129.46
2025/03/04,2025/03/01,SF FuneralF817220       250301,,126.5,,2011255.96
2025/03/04,2025/03/01,SF FuneralF817255       250301,,126.5,,2011382.46
2025/03/04,2025/03/01,SF FuneralF817431       250301,,126.5,,2011508.96
2025/03/04,2025/03/01,SF FuneralF817523       250301,,126.5,,2011635.46
2025/03/04,2025/03/01,SF FuneralF817762       250301,,126.5,,2011761.96
2025/03/04,2025/03/01,SF FuneralF817795       250301,,126.5,,2011888.46
2025/03/04,2025/03/01,SF FuneralF818082       250301,,126.5,,2012014.96
2025/03/04,2025/03/01,SF FuneralF820352       250301,,126.5,,2012141.46
2025/03/04,2025/03/01,SF FuneralF820369       250301,,126.5,,2012267.96
2025/03/04,2025/03/01,SF FuneralF812538       250301,,126.5,,2012394.46
2025/03/04,2025/03/01,SF FuneralF820579       250301,,126.5,,2012520.96
2025/03/04,2025/03/01,SF FuneralF820639       250301,,126.5,,2012647.46
2025/03/04,2025/03/01,SF FuneralF820758       250301,,126.5,,2012773.96
2025/03/04,2025/03/01,SF FuneralF821192       250301,,126.5,,2012900.46
2025/03/04,2025/03/01,SF FuneralF821523       250301,,126.5,,2013026.96
2025/03/04,2025/03/01,SF FuneralF821558       250301,,126.5,,2013153.46
2025/03/04,2025/03/01,SF FuneralF796028       250301,,126.5,,2013279.96
2025/03/04,2025/03/01,SF FuneralF822681       250301,,126.5,,2013406.46
2025/03/04,2025/03/01,SF FuneralFDC0000000BM1F250301,,126.5,,2013532.96
2025/03/04,2025/03/01,SF FuneralF827926       250301,,126.5,,2013659.46
2025/03/04,2025/03/01,SF FuneralF828015       250301,,126.5,,2013785.96
2025/03/04,2025/03/01,SF FuneralF828030       250301,,126.5,,2013912.46
2025/03/04,2025/03/01,SF FuneralFDC0000000BNVM250301,,126.5,,2014038.96
2025/03/04,2025/03/01,SF FuneralF828133       250301,,126.5,,2014165.46
2025/03/04,2025/03/01,SF FuneralF788407       250301,,126.5,,2014291.96
2025/03/04,2025/03/01,SF FuneralF828343       250301,,126.5,,2014418.46
2025/03/04,2025/03/01,SF FuneralF828345       250301,,126.5,,2014544.96
2025/03/04,2025/03/01,SF FuneralF828369       250301,,126.5,,2014671.46
2025/03/04,2025/03/01,SF FuneralFDC0000000BPJF250301,,126.5,,2014797.96
2025/03/04,2025/03/01,SF FuneralF828375       250301,,126.5,,2014924.46
2025/03/04,2025/03/01,SF FuneralF828389       250301,,126.5,,2015050.96
2025/03/04,2025/03/01,SF FuneralF828549       250301,,126.5,,2015177.46
2025/03/04,2025/03/01,SF FuneralF815209       250301,,126.5,,2015303.96
2025/03/04,2025/03/01,SF FuneralF828705       250301,,126.5,,2015430.46
2025/03/04,2025/03/01,SF FuneralF828734       250301,,126.5,,2015556.96
2025/03/04,2025/03/01,SF FuneralF828744       250301,,126.5,,2015683.46
2025/03/04,2025/03/01,SF FuneralF828746       250301,,126.5,,2015809.96
2025/03/04,2025/03/01,SF FuneralF828783       250301,,126.5,,2015936.46
2025/03/04,2025/03/01,SF FuneralF829073       250301,,126.5,,2016062.96
2025/03/04,2025/03/01,SF FuneralF829572       250301,,126.5,,2016189.46
2025/03/04,2025/03/01,SF FuneralF829662       250301,,126.5,,2016315.96
2025/03/04,2025/03/01,SF FuneralF829669       250301,,126.5,,2016442.46
2025/03/04,2025/03/01,SF FuneralF830032       250301,,126.5,,2016568.96
2025/03/04,2025/03/01,SF FuneralF830399       250301,,126.5,,2016695.46
2025/03/04,2025/03/01,SF FuneralF830559       250301,,126.5,,2016821.96
2025/03/04,2025/03/01,SF FuneralF830681       250301,,126.5,,2016948.46
2025/03/04,2025/03/01,SF FuneralF830686       250301,,126.5,,2017074.96
2025/03/04,2025/03/01,SF FuneralF831863       250301,,126.5,,2017201.46
2025/03/04,2025/03/01,SF FuneralF832016       250301,,126.5,,2017327.96
2025/03/04,2025/03/01,SF FuneralF832448       250301,,126.5,,2017454.46
2025/03/04,2025/03/01,SF FuneralF832536       250301,,126.5,,2017580.96
2025/03/04,2025/03/01,SF FuneralF832664       250301,,126.5,,2017707.46
2025/03/04,2025/03/01,SF FuneralF833260       250301,,126.5,,2017833.96
2025/03/04,2025/03/01,SF FuneralF834605       250301,,126.5,,2017960.46
2025/03/04,2025/03/01,SF FuneralF834657       250301,,126.5,,2018086.96
2025/03/04,2025/03/01,SF FuneralF841402       250301,,126.5,,2018213.46
2025/03/04,2025/03/01,SF FuneralF841428       250301,,126.5,,2018339.96
2025/03/04,2025/03/01,SF FuneralF841433       250301,,126.5,,2018466.46
2025/03/04,2025/03/01,SF FuneralF841624       250301,,126.5,,2018592.96
2025/03/04,2025/03/01,SF FuneralF841824       250301,,126.5,,2018719.46
2025/03/04,2025/03/01,SF FuneralF842015       250301,,126.5,,2018845.96
2025/03/04,2025/03/01,SF FuneralF842120       250301,,126.5,,2018972.46
2025/03/04,2025/03/01,SF FuneralF842175       250301,,126.5,,2019098.96
2025/03/04,2025/03/01,SF FuneralF842271       250301,,126.5,,2019225.46
2025/03/04,2025/03/01,SF FuneralF842268       250301,,126.5,,2019351.96
2025/03/04,2025/03/01,SF FuneralF842292       250301,,126.5,,2019478.46
2025/03/04,2025/03/01,SF FuneralF842325       250301,,126.5,,2019604.96
2025/03/04,2025/03/01,SF FuneralF842673       250301,,126.5,,2019731.46
2025/03/04,2025/03/01,SF FuneralF842738       250301,,126.5,,2019857.96
2025/03/04,2025/03/01,SF FuneralF992276       250301,,126.5,,2019984.46
2025/03/04,2025/03/01,SF FuneralF992343       250301,,126.5,,2020110.96
2025/03/04,2025/03/01,SF FuneralF992349       250301,,126.5,,2020237.46
2025/03/04,2025/03/01,SF FuneralF992373       250301,,126.5,,2020363.96
2025/03/04,2025/03/01,SF FuneralF992455       250301,,126.5,,2020490.46
2025/03/04,2025/03/01,SF FuneralF992754       250301,,126.5,,2020616.96
2025/03/04,2025/03/01,SF FuneralF993306       250301,,126.5,,2020743.46
2025/03/04,2025/03/01,SF FuneralFDC0000000JD0W250301,,126.5,,2020869.96
2025/03/04,2025/03/01,SF FuneralF994043       250301,,126.5,,2020996.46
2025/03/04,2025/03/01,SF FuneralF793647       250301,,191.5,,2021187.96
2025/03/04,2025/03/01,SF FuneralF1017067      250301,,126.5,,2021314.46
2025/03/04,2025/03/01,SF FuneralF1021314      250301,,126.5,,2021440.96
2025/03/04,2025/03/01,SF FuneralF1021556      250301,,126.5,,2021567.46
2025/03/04,2025/03/01,SF FuneralFDC0000000JW3W250301,,126.5,,2021693.96
2025/03/04,2025/03/01,SF FuneralF1021621      250301,,126.5,,2021820.46
2025/03/04,2025/03/01,SF FuneralF1021712      250301,,126.5,,2021946.96
2025/03/04,2025/03/01,SF FuneralF1021805      250301,,126.5,,2022073.46
2025/03/04,2025/03/01,SF FuneralF1022202      250301,,126.5,,2022199.96
2025/03/04,2025/03/01,SF FuneralF1033553      250301,,126.5,,2022326.46
2025/03/04,2025/03/01,SF FuneralF1033677      250301,,126.5,,2022452.96
2025/03/04,2025/03/01,SF FuneralF1033710      250301,,126.5,,2022579.46
2025/03/04,2025/03/01,SF FuneralF1050857      250301,,126.5,,2022705.96
2025/03/04,2025/03/01,SF FuneralF1052434      250301,,126.5,,2022832.46
2025/03/04,2025/03/01,SF FuneralF1054961      250301,,126.5,,2022958.96
2025/03/04,2025/03/01,SF FuneralF1054996      250301,,126.5,,2023085.46
2025/03/04,2025/03/01,SF FuneralF1055101      250301,,126.5,,2023211.96
2025/03/04,2025/03/01,SF FuneralF1058690      250301,,126.5,,2023338.46
2025/03/04,2025/03/01,SF FuneralF1058731      250301,,126.5,,2023464.96
2025/03/04,2025/03/01,SF FuneralFDC0000000K9KF250301,,126.5,,2023591.46
2025/03/04,2025/03/01,SF FuneralF1058816      250301,,126.5,,2023717.96
2025/03/04,2025/03/01,SF FuneralF1059495      250301,,126.5,,2023844.46
2025/03/04,2025/03/01,SF FuneralF1060074      250301,,126.5,,2023970.96
2025/03/04,2025/03/01,SF FuneralF1060571      250301,,126.5,,2024097.46
2025/03/04,2025/03/01,SF FuneralF1060699      250301,,126.5,,2024223.96
2025/03/04,2025/03/01,SF FuneralF1060801      250301,,126.5,,2024350.46
2025/03/04,2025/03/01,SF FuneralF1065983      250301,,126.5,,2024476.96
2025/03/04,2025/03/01,SF FuneralF1066221      250301,,126.5,,2024603.46
2025/03/04,2025/03/01,SF FuneralF1066593      250301,,126.5,,2024729.96
2025/03/04,2025/03/01,SF FuneralF1066650      250301,,126.5,,2024856.46
2025/03/04,2025/03/01,SF FuneralF1066788      250301,,126.5,,2024982.96
2025/03/04,2025/03/01,SF FuneralF1072941      250301,,126.5,,2025109.46
2025/03/04,2025/03/01,SF FuneralF1073240      250301,,126.5,,2025235.96
2025/03/04,2025/03/01,SF FuneralF1075280      250301,,126.5,,2025362.46
2025/03/04,2025/03/01,SF FuneralF1078095      250301,,126.5,,2025488.96
2025/03/04,2025/03/01,SF FuneralF1078338      250301,,126.5,,2025615.46
2025/03/04,2025/03/01,SF FuneralF1078368      250301,,126.5,,2025741.96
2025/03/04,2025/03/01,SF FuneralF788384       250301,,126.5,,2025868.46
2025/03/04,2025/03/01,SF FuneralF1078680      250301,,126.5,,2025994.96
2025/03/04,2025/03/01,SF FuneralFDC0000000LJPF250301,,126.5,,2026121.46
2025/03/04,2025/03/01,SF FuneralF1079822      250301,,126.5,,2026247.96
2025/03/04,2025/03/01,SF FuneralF1084443      250301,,126.5,,2026374.46
2025/03/04,2025/03/01,SF FuneralF1085087      250301,,126.5,,2026500.96
2025/03/04,2025/03/01,SF FuneralF1085158      250301,,126.5,,2026627.46
2025/03/04,2025/03/01,SF FuneralF1085204      250301,,126.5,,2026753.96
2025/03/04,2025/03/01,SF FuneralF1085346      250301,,126.5,,2026880.46
2025/03/04,2025/03/01,SF FuneralF1102799      250302,,126.5,,2027006.96
2025/03/04,2025/03/01,SF FuneralF1103019      250301,,126.5,,2027133.46
2025/03/04,2025/03/01,SF FuneralF1108827      250301,,126.5,,2027259.96
2025/03/04,2025/03/01,SF FuneralF1109060      250301,,126.5,,2027386.46
2025/03/04,2025/03/01,SF FuneralF1109061      250301,,126.5,,2027512.96
2025/03/04,2025/03/01,SF FuneralF1109126      250302,,126.5,,2027639.46
2025/03/04,2025/03/01,SF FuneralF1109687      250301,,126.5,,2027765.96
2025/03/04,2025/03/01,SF FuneralF793753       250301,,191.5,,2027957.46
2025/03/04,2025/03/01,SF FuneralF1110042      250301,,126.5,,2028083.96
2025/03/04,2025/03/01,SF FuneralFDC0000000ML98250301,,126.5,,2028210.46
2025/03/04,2025/03/01,SF FuneralFDC0000000ML9H250301,,126.5,,2028336.96
2025/03/04,2025/03/01,SF FuneralFDC0000000MN56250301,,126.5,,2028463.46
2025/03/04,2025/03/01,SF FuneralFDC0000000MN5D250301,,126.5,,2028589.96
2025/03/04,2025/03/01,SF FuneralF1110522      250301,,126.5,,2028716.46
2025/03/04,2025/03/01,SF FuneralF1110795      250301,,126.5,,2028842.96
2025/03/04,2025/03/01,SF FuneralF1111359      250301,,126.5,,2028969.46
2025/03/04,2025/03/01,SF FuneralF804557       250301,,126.5,,2029095.96
2025/03/04,2025/03/01,SF FuneralF1112487      250301,,126.5,,2029222.46
2025/03/04,2025/03/01,SF FuneralF1113175      250302,,126.5,,2029348.96
2025/03/04,2025/03/01,SF FuneralF1113244      250301,,126.5,,2029475.46
2025/03/04,2025/03/01,SF FuneralF1113864      250301,,126.5,,2029601.96
2025/03/04,2025/03/01,SF FuneralFDC0000000N5V7250301,,126.5,,2029728.46
2025/03/04,2025/03/01,SF FuneralF1113959      250301,,126.5,,2029854.96
2025/03/04,2025/03/01,SF FuneralF1114496      250301,,126.5,,2029981.46
2025/03/04,2025/03/01,SF FuneralFDC0000000N99D250301,,126.5,,2030107.96
2025/03/04,2025/03/01,SF FuneralF1114845      250301,,126.5,,2030234.46
2025/03/04,2025/03/01,SF FuneralF1114868      250301,,126.5,,2030360.96
2025/03/04,2025/03/01,SF FuneralF1115155      250301,,126.5,,2030487.46
2025/03/04,2025/03/01,SF FuneralF1115857      250301,,126.5,,2030613.96
2025/03/04,2025/03/01,SF FuneralF1116902      250302,,126.5,,2030740.46
2025/03/04,2025/03/01,SF FuneralF1116907      250301,,126.5,,2030866.96
2025/03/04,2025/03/01,SF FuneralF1116951      250301,,126.5,,2030993.46
2025/03/04,2025/03/01,SF FuneralF1117049      250301,,126.5,,2031119.96
2025/03/04,2025/03/01,SF FuneralF1117147      250301,,126.5,,2031246.46
2025/03/04,2025/03/01,SF FuneralF1117263      250301,,126.5,,2031372.96
2025/03/04,2025/03/01,SF FuneralF1117366      250301,,126.5,,2031499.46
2025/03/04,2025/03/01,SF FuneralF1117870      250301,,126.5,,2031625.96
2025/03/04,2025/03/01,SF FuneralF1118124      250301,,126.5,,2031752.46
2025/03/04,2025/03/01,SF FuneralF1118278      250301,,126.5,,2031878.96
2025/03/04,2025/03/01,SF FuneralF1118353      250301,,126.5,,2032005.46
2025/03/04,2025/03/01,SF FuneralF1118550      250301,,126.5,,2032131.96
2025/03/04,2025/03/01,SF FuneralF1118772      250301,,126.5,,2032258.46
2025/03/04,2025/03/01,SF FuneralF1118806      250301,,126.5,,2032384.96
2025/03/04,2025/03/01,SF FuneralF1118838      250301,,126.5,,2032511.46
2025/03/04,2025/03/01,SF FuneralF1119078      250301,,126.5,,2032637.96
2025/03/04,2025/03/01,SF FuneralF1120222      250301,,126.5,,2032764.46
2025/03/04,2025/03/01,SF FuneralF1121914      250301,,126.5,,2032890.96
2025/03/04,2025/03/01,SF FuneralF1122065      250301,,126.5,,2033017.46
2025/03/04,2025/03/01,SF FuneralF1122740      250301,,126.5,,2033143.96
2025/03/04,2025/03/01,SF FuneralF1122823      250301,,126.5,,2033270.46
2025/03/04,2025/03/01,SF FuneralF1123059      250301,,126.5,,2033396.96
2025/03/04,2025/03/01,SF FuneralFDC0000000P3JW250301,,126.5,,2033523.46
2025/03/04,2025/03/01,SF FuneralF1123252      250301,,126.5,,2033649.96
2025/03/04,2025/03/01,SF FuneralF1123978      250301,,126.5,,2033776.46
2025/03/04,2025/03/01,SF FuneralF1124158      250301,,126.5,,2033902.96
2025/03/04,2025/03/01,SF FuneralF1124539      250301,,126.5,,2034029.46
2025/03/04,2025/03/01,SF FuneralFDC0000000PGJD250301,,126.5,,2034155.96
2025/03/04,2025/03/01,SF FuneralF900641       250301,,126.5,,2034282.46
2025/03/04,2025/03/01,SF FuneralF1125449      250301,,126.5,,2034408.96
2025/03/04,2025/03/01,SF FuneralFDC0000000PHKN250301,,126.5,,2034535.46
2025/03/04,2025/03/01,SF FuneralFDC00000005BSR250301,,126.5,,2034661.96
2025/03/04,2025/02/28,SF FuneralFDC0000000HGD3250301,,126.5,,2034788.46
2025/03/04,2025/03/01,SF FuneralFDC0000000NM53250301,,126.5,,2034914.96
2025/03/04,2025/03/01,SF FuneralFDC0000000NMY3250301,,126.5,,2035041.46
2025/03/04,2025/03/01,SF FuneralFDC0000000PKF7250301,,126.5,,2035167.96
2025/03/04,2025/03/01,SF FuneralFDC0000000Q7GP250301,,126.5,,2035294.46
2025/03/04,2025/03/01,SF FuneralFDC00000002RF1250301,,220,,2035514.46
2025/03/04,2025/03/01,SF FuneralFDC00000002V49250301,,220,,2035734.46
2025/03/04,2025/03/01,SF FuneralFDC00000002V8X250301,,220,,2035954.46
2025/03/04,2025/03/01,SF FuneralFDC00000002VW6250301,,220,,2036174.46
2025/03/04,2025/03/01,SF FuneralFDC00000002VZ6250301,,220,,2036394.46
2025/03/04,2025/03/01,SF FuneralFDC00000002WTM250301,,220,,2036614.46
2025/03/04,2025/03/01,SF FuneralFDC00000002WW3250301,,220,,2036834.46
2025/03/04,2025/03/01,SF FuneralFDC00000002X65250301,,220,,2037054.46
2025/03/04,2025/03/01,SF FuneralFDC00000002XDL250301,,220,,2037274.46
2025/03/04,2025/03/01,SF FuneralFDC000000032YT250301,,220,,2037494.46
2025/03/04,2025/03/01,SF FuneralFDC0000000334T250301,,220,,2037714.46
2025/03/04,2025/03/01,SF FuneralFDC000000033FH250301,,220,,2037934.46
2025/03/04,2025/03/01,SF FuneralFDC000000033R6250301,,220,,2038154.46
2025/03/04,2025/03/01,SF FuneralFDC000000034R2250301,,220,,2038374.46
2025/03/04,2025/03/01,SF FuneralFDC0000000378C250301,,220,,2038594.46
2025/03/04,2025/03/01,SF FuneralFDC00000003F03250301,,220,,2038814.46
2025/03/04,2025/03/01,SF FuneralFDC000000057WZ250301,,220,,2039034.46
2025/03/04,2025/03/01,SF FuneralFDC00000005BTX250301,,220,,2039254.46
2025/03/04,2025/03/01,SF FuneralFDC00000005G6L250301,,126.5,,2039380.96
2025/03/04,2025/03/01,SF FuneralFDC00000005H9Q250301,,126.5,,2039507.46
2025/03/04,2025/03/01,SF FuneralFDC00000005M6V250301,,126.5,,2039633.96
2025/03/04,2025/03/01,SF FuneralFDC00000005N09250301,,126.5,,2039760.46
2025/03/04,2025/03/01,SF FuneralFDC00000005NG6250301,,126.5,,2039886.96
2025/03/04,2025/03/01,SF FuneralFDC00000005PRL250301,,126.5,,2040013.46
2025/03/04,2025/03/01,SF FuneralFDC00000005XYJ250301,,126.5,,2040139.96
2025/03/04,2025/03/01,SF FuneralFDC000000067Y6250301,,126.5,,2040266.46
2025/03/04,2025/03/01,SF FuneralFDC00000006844250301,,126.5,,2040392.96
2025/03/04,2025/03/01,SF FuneralFDC000000068QQ250301,,126.5,,2040519.46
2025/03/04,2025/03/01,SF FuneralFDC0000000693P250301,,126.5,,2040645.96
2025/03/04,2025/03/01,SF FuneralFDC00000006B7L250301,,126.5,,2040772.46
2025/03/04,2025/03/01,SF FuneralFDC00000006CT7250301,,126.5,,2040898.96
2025/03/04,2025/03/01,SF FuneralFDC00000006F0Z250301,,126.5,,2041025.46
2025/03/04,2025/03/01,SF FuneralFDC00000006FLL250301,,126.5,,2041151.96
2025/03/04,2025/03/01,SF FuneralFDC00000006FNV250301,,126.5,,2041278.46
2025/03/04,2025/03/01,SF FuneralFDC00000006FRB250301,,126.5,,2041404.96
2025/03/04,2025/03/01,SF FuneralFDC00000006GDH250301,,126.5,,2041531.46
2025/03/04,2025/03/01,SF FuneralFDC00000006GKD250301,,191.5,,2041722.96
2025/03/04,2025/03/01,SF FuneralFDC00000006GNC250301,,126.5,,2041849.46
2025/03/04,2025/03/01,SF FuneralFDC00000006JQJ250301,,126.5,,2041975.96
2025/03/04,2025/03/01,SF FuneralFDC00000006JQW250301,,126.5,,2042102.46
2025/03/04,2025/03/01,SF FuneralFDC00000006JVV250301,,126.5,,2042228.96
2025/03/04,2025/03/01,SF FuneralFDC00000006JW6250301,,126.5,,2042355.46
2025/03/04,2025/03/01,SF FuneralFDC00000006K2K250301,,126.5,,2042481.96
2025/03/04,2025/03/01,SF FuneralFDC00000006KQ2250301,,126.5,,2042608.46
2025/03/04,2025/03/01,SF FuneralFDC00000006LKT250301,,126.5,,2042734.96
2025/03/04,2025/03/01,SF FuneralFDC00000006M1B250301,,126.5,,2042861.46
2025/03/04,2025/03/01,SF FuneralFDC00000006M6P250301,,126.5,,2042987.96
2025/03/04,2025/03/01,SF FuneralFDC00000006PHG250301,,126.5,,2043114.46
2025/03/04,2025/03/01,SF FuneralFDC00000006S7X250301,,126.5,,2043240.96
2025/03/04,2025/03/01,SF FuneralFDC00000006WZ6250301,,126.5,,2043367.46
2025/03/04,2025/03/01,SF FuneralFDC00000006XN2250301,,126.5,,2043493.96
2025/03/04,2025/03/01,SF FuneralFDC0000000723V250301,,126.5,,2043620.46
2025/03/04,2025/03/01,SF FuneralFDC000000073CY250301,,126.5,,2043746.96
2025/03/04,2025/03/01,SF FuneralFDC000000073F7250301,,126.5,,2043873.46
2025/03/04,2025/03/01,SF FuneralFDC000000073N7250301,,126.5,,2043999.96
2025/03/04,2025/03/01,SF FuneralFDC0000000743Y250301,,126.5,,2044126.46
2025/03/04,2025/03/01,SF FuneralFDC0000000757H250301,,126.5,,2044252.96
2025/03/04,2025/03/01,SF FuneralFDC0000000758Q250301,,126.5,,2044379.46
2025/03/04,2025/03/01,SF FuneralFDC000000075KH250301,,126.5,,2044505.96
2025/03/04,2025/03/01,SF FuneralFDC000000075P7250301,,126.5,,2044632.46
2025/03/04,2025/03/01,SF FuneralFDC000000075Y1250301,,126.5,,2044758.96
2025/03/04,2025/03/01,SF FuneralFDC000000076LB250301,,126.5,,2044885.46
2025/03/04,2025/03/01,SF FuneralFDC000000076MD250301,,126.5,,2045011.96
2025/03/04,2025/03/01,SF FuneralFDC0000000773X250301,,126.5,,2045138.46
2025/03/04,2025/03/01,SF FuneralFDC00000007811250301,,126.5,,2045264.96
2025/03/04,2025/03/01,SF FuneralFDC00000007872250301,,126.5,,2045391.46
2025/03/04,2025/03/01,SF FuneralFDC000000078D7250301,,126.5,,2045517.96
2025/03/04,2025/03/01,SF FuneralFDC000000078VG250301,,220,,2045737.96
2025/03/04,2025/03/01,SF FuneralFDC00000007BG1250301,,126.5,,2045864.46
2025/03/04,2025/03/01,SF FuneralFDC00000007DTT250301,,126.5,,2045990.96
2025/03/04,2025/03/01,SF FuneralFDC00000007DWN250301,,220,,2046210.96
2025/03/04,2025/03/01,SF FuneralFDC00000007DYY250301,,126.5,,2046337.46
2025/03/04,2025/03/01,SF FuneralFDC00000007QQK250301,,126.5,,2046463.96
2025/03/04,2025/03/01,SF FuneralF793977       250301,,126.5,,2046590.46
2025/03/04,2025/03/01,SF FuneralFDC00000007R50250301,,126.5,,2046716.96
2025/03/04,2025/03/01,SF FuneralFDC00000007R83250301,,126.5,,2046843.46
2025/03/04,2025/03/01,SF FuneralFDC00000007RP5250301,,126.5,,2046969.96
2025/03/04,2025/03/01,SF FuneralF794669       250301,,126.5,,2047096.46
2025/03/04,2025/03/01,SF FuneralF795467       250301,,126.5,,2047222.96
2025/03/04,2025/03/01,SF FuneralF795530       250301,,126.5,,2047349.46
2025/03/04,2025/03/01,SF FuneralFDC00000007WGB250301,,126.5,,2047475.96
2025/03/04,2025/03/01,SF FuneralFDC00000007WJM250301,,126.5,,2047602.46
2025/03/04,2025/03/01,SF FuneralFDC00000007X0L250301,,126.5,,2047728.96
2025/03/04,2025/03/01,SF FuneralFDC00000007X32250301,,126.5,,2047855.46
2025/03/04,2025/03/01,SF FuneralFDC00000007XG1250301,,126.5,,2047981.96
2025/03/04,2025/03/01,SF FuneralFDC00000007XYM250301,,126.5,,2048108.46
2025/03/04,2025/03/01,SF FuneralFDC00000007YQ6250301,,126.5,,2048234.96
2025/03/04,2025/03/01,SF FuneralFDC00000007YR1250301,,126.5,,2048361.46
2025/03/04,2025/03/01,SF FuneralFDC00000007Z6H250301,,126.5,,2048487.96
2025/03/04,2025/03/01,SF FuneralFDC000000080NF250301,,126.5,,2048614.46
2025/03/04,2025/03/01,SF FuneralF798048       250301,,126.5,,2048740.96
2025/03/04,2025/03/01,SF FuneralF798093       250301,,126.5,,2048867.46
2025/03/04,2025/03/01,SF FuneralF798104       250301,,126.5,,2048993.96
2025/03/04,2025/03/01,SF FuneralF798108       250301,,126.5,,2049120.46
2025/03/04,2025/03/01,SF FuneralF798149       250301,,126.5,,2049246.96
2025/03/04,2025/03/01,SF FuneralFDC000000084D0250301,,126.5,,2049373.46
2025/03/04,2025/03/01,SF FuneralF798355       250301,,126.5,,2049499.96
2025/03/04,2025/03/01,SF FuneralFDC000000084P7250301,,126.5,,2049626.46
2025/03/04,2025/03/01,SF FuneralFDC000000085FB250301,,126.5,,2049752.96
2025/03/04,2025/03/01,SF FuneralFDC000000085FJ250301,,126.5,,2049879.46
2025/03/04,2025/03/01,SF FuneralFDC000000085V2250301,,126.5,,2050005.96
2025/03/04,2025/03/01,SF FuneralFDC000000085V6250301,,126.5,,2050132.46
2025/03/04,2025/03/01,SF FuneralF798762       250301,,126.5,,2050258.96
2025/03/04,2025/03/01,SF FuneralF798822       250301,,126.5,,2050385.46
2025/03/04,2025/03/01,SF FuneralF798946       250301,,126.5,,2050511.96
2025/03/04,2025/03/01,SF FuneralF799397       250301,,126.5,,2050638.46
2025/03/04,2025/03/01,SF FuneralFDC000000087RN250301,,126.5,,2050764.96
2025/03/04,2025/03/01,SF FuneralF800526       250301,,126.5,,2050891.46
2025/03/04,2025/03/01,SF FuneralF800588       250301,,126.5,,2051017.96
2025/03/04,2025/03/01,SF FuneralFDC00000008FQ3250301,,126.5,,2051144.46
2025/03/04,2025/03/01,SF FuneralF802576       250301,,126.5,,2051270.96
2025/03/04,2025/03/01,SF FuneralF802594       250301,,126.5,,2051397.46
2025/03/04,2025/03/01,SF FuneralF802705       250301,,126.5,,2051523.96
2025/03/04,2025/03/01,SF FuneralF802764       250301,,126.5,,2051650.46
2025/03/04,2025/03/01,SF FuneralFDC00000008LKC250301,,126.5,,2051776.96
2025/03/04,2025/03/01,SF FuneralF802922       250301,,126.5,,2051903.46
2025/03/04,2025/03/01,SF FuneralF802972       250301,,126.5,,2052029.96
2025/03/04,2025/03/01,SF FuneralF803756       250301,,126.5,,2052156.46
2025/03/04,2025/03/01,SF FuneralF804109       250301,,126.5,,2052282.96
2025/03/04,2025/03/01,SF FuneralF805513       250301,,126.5,,2052409.46
2025/03/04,2025/03/01,SF FuneralF805652       250301,,126.5,,2052535.96
2025/03/04,2025/03/01,SF FuneralF808004       250301,,126.5,,2052662.46
2025/03/04,2025/03/01,SF FuneralF808175       250301,,126.5,,2052788.96
2025/03/04,2025/03/01,SF FuneralF808434       250301,,126.5,,2052915.46
2025/03/04,2025/03/01,SF FuneralF808573       250301,,126.5,,2053041.96
2025/03/04,2025/03/01,SF FuneralF808636       250301,,126.5,,2053168.46
2025/03/04,2025/03/01,SF FuneralF808835       250301,,126.5,,2053294.96
2025/03/04,2025/03/01,SF FuneralF809339       250301,,126.5,,2053421.46
2025/03/04,2025/03/01,SF FuneralF809768       250301,,126.5,,2053547.96
2025/03/04,2025/03/01,SF FuneralF810209       250301,,126.5,,2053674.46
2025/03/04,2025/03/01,SF FuneralF810741       250301,,126.5,,2053800.96
2025/03/04,2025/03/01,SF FuneralF810856       250301,,126.5,,2053927.46
2025/03/04,2025/03/01,SF FuneralF811040       250301,,126.5,,2054053.96
2025/03/04,2025/03/01,SF FuneralF787192       250301,,126.5,,2054180.46
2025/03/04,2025/03/01,SF FuneralF811381       250301,,126.5,,2054306.96
2025/03/04,2025/03/01,SF FuneralF812251       250301,,126.5,,2054433.46
2025/03/04,2025/03/01,SF FuneralF812396       250301,,126.5,,2054559.96
2025/03/04,2025/03/01,SF FuneralF812457       250301,,126.5,,2054686.46
2025/03/04,2025/03/01,SF FuneralF812489       250301,,126.5,,2054812.96
2025/03/04,2025/03/01,SF FuneralF812542       250301,,126.5,,2054939.46
2025/03/04,2025/03/01,SF FuneralF812561       250301,,126.5,,2055065.96
2025/03/04,2025/03/01,SF FuneralF812611       250301,,126.5,,2055192.46
2025/03/04,2025/03/01,SF FuneralF812727       250301,,126.5,,2055318.96
2025/03/04,2025/03/01,SF FuneralF813305       250301,,126.5,,2055445.46
2025/03/04,2025/03/01,SF FuneralF813440       250301,,126.5,,2055571.96
2025/03/04,2025/03/01,SF FuneralF813919       250301,,126.5,,2055698.46
2025/03/04,2025/03/01,SF FuneralF815659       250301,,126.5,,2055824.96
2025/03/04,2025/03/01,SF FuneralF816419       250301,,126.5,,2055951.46
2025/03/04,2025/03/01,SF FuneralF816640       250301,,126.5,,2056077.96
2025/03/04,2025/03/01,SF FuneralF781116       250301,,126.5,,2056204.46
2025/03/04,2025/03/01,SF FuneralF816769       250301,,126.5,,2056330.96
2025/03/04,2025/03/01,SF FuneralF816785       250301,,126.5,,2056457.46
2025/03/04,2025/03/01,SF FuneralF816792       250301,,126.5,,2056583.96
2025/03/04,2025/03/01,SF FuneralF816950       250301,,126.5,,2056710.46
2025/03/04,2025/03/01,SF FuneralF812236       250301,,126.5,,2056836.96
2025/03/04,2025/03/01,SF FuneralF817148       250301,,126.5,,2056963.46
2025/03/04,2025/03/01,SF FuneralF817187       250301,,126.5,,2057089.96
2025/03/04,2025/03/01,SF FuneralF817211       250301,,126.5,,2057216.46
2025/03/04,2025/03/01,SF FuneralF817221       250301,,126.5,,2057342.96
2025/03/04,2025/03/01,SF FuneralF817561       250301,,126.5,,2057469.46
2025/03/04,2025/03/01,SF FuneralF819163       250301,,126.5,,2057595.96
2025/03/04,2025/03/01,SF FuneralF819728       250301,,126.5,,2057722.46
2025/03/04,2025/03/01,SF FuneralF820640       250301,,126.5,,2057848.96
2025/03/04,2025/03/01,SF FuneralF820656       250301,,126.5,,2057975.46
2025/03/04,2025/03/01,SF FuneralF820738       250301,,126.5,,2058101.96
2025/03/04,2025/03/01,SF FuneralF820779       250301,,126.5,,2058228.46
2025/03/04,2025/03/01,SF FuneralF820843       250301,,126.5,,2058354.96
2025/03/04,2025/03/01,SF FuneralF821016       250301,,126.5,,2058481.46
2025/03/04,2025/03/01,SF FuneralF821074       250301,,126.5,,2058607.96
2025/03/04,2025/03/01,SF FuneralF821128       250301,,126.5,,2058734.46
2025/03/04,2025/03/01,SF FuneralFDC0000000B9N7250301,,126.5,,2058860.96
2025/03/04,2025/03/01,SF FuneralFDC0000000BB12250301,,126.5,,2058987.46
2025/03/04,2025/03/01,SF FuneralF821519       250301,,126.5,,2059113.96
2025/03/04,2025/03/01,SF FuneralF821625       250301,,126.5,,2059240.46
2025/03/04,2025/03/01,SF FuneralF821989       250301,,126.5,,2059366.96
2025/03/04,2025/03/01,SF FuneralF822137       250301,,126.5,,2059493.46
2025/03/04,2025/03/01,SF FuneralF822290       250301,,126.5,,2059619.96
2025/03/04,2025/03/01,SF FuneralF823427       250301,,126.5,,2059746.46
2025/03/04,2025/03/01,SF FuneralF828080       250301,,126.5,,2059872.96
2025/03/04,2025/03/01,SF FuneralFDC0000000BP12250301,,126.5,,2059999.46
2025/03/04,2025/03/01,SF FuneralF828192       250301,,126.5,,2060125.96
2025/03/04,2025/03/01,SF FuneralF828220       250301,,126.5,,2060252.46
2025/03/04,2025/03/01,SF FuneralF828390       250301,,126.5,,2060378.96
2025/03/04,2025/03/01,SF FuneralF828423       250301,,126.5,,2060505.46
2025/03/04,2025/03/01,SF FuneralF821326       250301,,126.5,,2060631.96
2025/03/04,2025/03/01,SF FuneralF828470       250301,,126.5,,2060758.46
2025/03/04,2025/03/01,SF FuneralF828491       250301,,126.5,,2060884.96
2025/03/04,2025/03/01,SF FuneralF828720       250301,,126.5,,2061011.46
2025/03/04,2025/03/01,SF FuneralF829645       250301,,126.5,,2061137.96
2025/03/04,2025/03/01,SF FuneralF829748       250301,,126.5,,2061264.46
2025/03/04,2025/03/01,SF FuneralF830040       250301,,126.5,,2061390.96
2025/03/04,2025/03/01,SF FuneralF830077       250301,,126.5,,2061517.46
2025/03/04,2025/03/01,SF FuneralF830735       250301,,126.5,,2061643.96
2025/03/04,2025/03/01,SF FuneralF832126       250301,,126.5,,2061770.46
2025/03/04,2025/03/01,SF FuneralF832278       250301,,126.5,,2061896.96
2025/03/04,2025/03/01,SF FuneralF832311       250301,,126.5,,2062023.46
2025/03/04,2025/03/01,SF FuneralF832312       250301,,126.5,,2062149.96
2025/03/04,2025/03/01,SF FuneralF832315       250301,,126.5,,2062276.46
2025/03/04,2025/03/01,SF FuneralF832385       250301,,191.5,,2062467.96
2025/03/04,2025/03/01,SF FuneralF832396       250301,,126.5,,2062594.46
2025/03/04,2025/03/01,SF FuneralF832442       250301,,126.5,,2062720.96
2025/03/04,2025/03/01,SF FuneralF832464       250301,,126.5,,2062847.46
2025/03/04,2025/03/01,SF FuneralF832496       250301,,126.5,,2062973.96
2025/03/04,2025/03/01,SF FuneralF832529       250301,,126.5,,2063100.46
2025/03/04,2025/03/01,SF FuneralF832624       250301,,126.5,,2063226.96
2025/03/04,2025/03/01,SF FuneralF832702       250301,,126.5,,2063353.46
2025/03/04,2025/03/01,SF FuneralF785655       250301,,126.5,,2063479.96
2025/03/04,2025/03/01,SF FuneralFDC0000000CQVZ250301,,126.5,,2063606.46
2025/03/04,2025/03/01,SF FuneralF833547       250301,,126.5,,2063732.96
2025/03/04,2025/03/01,SF FuneralF833759       250301,,126.5,,2063859.46
2025/03/04,2025/03/01,SF FuneralF834234       250301,,126.5,,2063985.96
2025/03/04,2025/03/01,SF FuneralF834771       250301,,126.5,,2064112.46
2025/03/04,2025/03/01,SF FuneralF841568       250301,,126.5,,2064238.96
2025/03/04,2025/03/01,SF FuneralF841807       250301,,126.5,,2064365.46
2025/03/04,2025/03/01,SF FuneralF841861       250301,,126.5,,2064491.96
2025/03/04,2025/03/01,SF FuneralF841954       250301,,126.5,,2064618.46
2025/03/04,2025/03/01,SF FuneralF842263       250301,,126.5,,2064744.96
2025/03/04,2025/03/01,SF FuneralF842506       250301,,126.5,,2064871.46
2025/03/04,2025/03/01,SF FuneralF842551       250301,,126.5,,2064997.96
2025/03/04,2025/03/01,SF FuneralF992240       250301,,126.5,,2065124.46
2025/03/04,2025/03/01,SF FuneralF992461       250301,,126.5,,2065250.96
2025/03/04,2025/03/01,SF FuneralF992611       250301,,126.5,,2065377.46
2025/03/04,2025/03/01,SF FuneralF992766       250301,,126.5,,2065503.96
2025/03/04,2025/03/01,SF FuneralF992808       250301,,126.5,,2065630.46
2025/03/04,2025/03/01,SF FuneralF789986       250301,,191.5,,2065821.96
2025/03/04,2025/03/01,SF FuneralF993067       250301,,126.5,,2065948.46
2025/03/04,2025/03/01,SF FuneralF993547       250301,,126.5,,2066074.96
2025/03/04,2025/03/01,SF FuneralF993612       250302,,126.5,,2066201.46
2025/03/04,2025/03/01,SF FuneralF1010506      250301,,126.5,,2066327.96
2025/03/04,2025/03/01,SF FuneralF1017048      250301,,126.5,,2066454.46
2025/03/04,2025/03/01,SF FuneralF1017563      250301,,126.5,,2066580.96
2025/03/04,2025/03/01,SF FuneralFDC0000000JMST250301,,126.5,,2066707.46
2025/03/04,2025/03/01,SF FuneralF1021700      250301,,126.5,,2066833.96
2025/03/04,2025/03/01,SF FuneralF1021513      250301,,126.5,,2066960.46
2025/03/04,2025/03/01,SF FuneralF1021976      250301,,126.5,,2067086.96
2025/03/04,2025/03/01,SF FuneralF789313       250301,,126.5,,2067213.46
2025/03/04,2025/03/01,SF FuneralF1022155      250301,,126.5,,2067339.96
2025/03/04,2025/03/01,SF FuneralF1022195      250301,,126.5,,2067466.46
2025/03/04,2025/03/01,SF FuneralF1022213      250301,,126.5,,2067592.96
2025/03/04,2025/03/01,SF FuneralF1051771      250301,,126.5,,2067719.46
2025/03/04,2025/03/01,SF FuneralF1055255      250301,,126.5,,2067845.96
2025/03/04,2025/03/01,SF FuneralF1058646      250301,,126.5,,2067972.46
2025/03/04,2025/03/01,SF FuneralF1058674      250301,,126.5,,2068098.96
2025/03/04,2025/03/01,SF FuneralF1058695      250301,,126.5,,2068225.46
2025/03/04,2025/03/01,SF FuneralF1058844      250301,,126.5,,2068351.96
2025/03/04,2025/03/01,SF FuneralF1058870      250301,,126.5,,2068478.46
2025/03/04,2025/03/01,SF FuneralF1059828      250301,,126.5,,2068604.96
2025/03/04,2025/03/01,SF FuneralF1060324      250301,,126.5,,2068731.46
2025/03/04,2025/03/01,SF FuneralFDC0000000KH1N250301,,126.5,,2068857.96
2025/03/04,2025/03/01,SF FuneralF1060790      250301,,126.5,,2068984.46
2025/03/04,2025/03/01,SF FuneralF1060786      250301,,126.5,,2069110.96
2025/03/04,2025/03/01,SF FuneralF1060908      250301,,126.5,,2069237.46
2025/03/04,2025/03/01,SF FuneralF1060911      250301,,126.5,,2069363.96
2025/03/04,2025/03/01,SF FuneralF1061807      250301,,126.5,,2069490.46
2025/03/04,2025/03/01,SF FuneralF1061829      250301,,126.5,,2069616.96
2025/03/04,2025/03/01,SF FuneralF1066132      250301,,126.5,,2069743.46
2025/03/04,2025/03/01,SF FuneralF1066198      250301,,126.5,,2069869.96
2025/03/04,2025/03/01,SF FuneralF1066514      250301,,126.5,,2069996.46
2025/03/04,2025/03/01,SF FuneralF1066626      250301,,126.5,,2070122.96
2025/03/04,2025/03/01,SF FuneralF1066752      250301,,126.5,,2070249.46
2025/03/04,2025/03/01,SF FuneralF1067886      250301,,126.5,,2070375.96
2025/03/04,2025/03/01,SF FuneralF1068040      250301,,126.5,,2070502.46
2025/03/04,2025/03/01,SF FuneralF1068098      250301,,126.5,,2070628.96
2025/03/04,2025/03/01,SF FuneralFDC0000000L010250301,,126.5,,2070755.46
2025/03/04,2025/03/01,SF FuneralF1072712      250301,,126.5,,2070881.96
2025/03/04,2025/03/01,SF FuneralF1073364      250301,,126.5,,2071008.46
2025/03/04,2025/03/01,SF FuneralF1075044      250301,,126.5,,2071134.96
2025/03/04,2025/03/01,SF FuneralF1075231      250301,,126.5,,2071261.46
2025/03/04,2025/03/01,SF FuneralF1075269      250301,,126.5,,2071387.96
2025/03/04,2025/03/01,SF FuneralF1075321      250301,,126.5,,2071514.46
2025/03/04,2025/03/01,SF FuneralF1078231      250301,,126.5,,2071640.96
2025/03/04,2025/03/01,SF FuneralF1078569      250301,,126.5,,2071767.46
2025/03/04,2025/03/01,SF FuneralF1078661      250301,,126.5,,2071893.96
2025/03/04,2025/03/01,SF FuneralF1079116      250301,,126.5,,2072020.46
2025/03/04,2025/03/01,SF FuneralF1080163      250301,,126.5,,2072146.96
2025/03/04,2025/03/01,SF FuneralF1084025      250301,,126.5,,2072273.46
2025/03/04,2025/03/01,SF FuneralF1084373      250301,,126.5,,2072399.96
2025/03/04,2025/03/01,SF FuneralF1084430      250301,,126.5,,2072526.46
2025/03/04,2025/03/01,SF FuneralF1084589      250301,,126.5,,2072652.96
2025/03/04,2025/03/01,SF FuneralF1085038      250301,,126.5,,2072779.46
2025/03/04,2025/03/01,SF FuneralF1085049      250301,,126.5,,2072905.96
2025/03/04,2025/03/01,SF FuneralF1085190      250301,,126.5,,2073032.46
2025/03/04,2025/03/01,SF FuneralF1088482      250301,,126.5,,2073158.96
2025/03/04,2025/03/01,SF FuneralF1103560      250301,,126.5,,2073285.46
2025/03/04,2025/03/01,SF FuneralF1103740      250301,,126.5,,2073411.96
2025/03/04,2025/03/01,SF FuneralF1103836      250301,,126.5,,2073538.46
2025/03/04,2025/03/01,SF FuneralF1108314      250301,,126.5,,2073664.96
2025/03/04,2025/03/01,SF FuneralF1108998      250301,,126.5,,2073791.46
2025/03/04,2025/03/01,SF FuneralF1109027      250301,,126.5,,2073917.96
2025/03/04,2025/03/01,SF FuneralF1109091      250301,,126.5,,2074044.46
2025/03/04,2025/03/01,SF FuneralF1109141      250301,,126.5,,2074170.96
2025/03/04,2025/03/01,SF FuneralF1109688      250301,,126.5,,2074297.46
2025/03/04,2025/03/01,SF FuneralF1110173      250301,,126.5,,2074423.96
2025/03/04,2025/03/01,SF FuneralF1110402      250301,,126.5,,2074550.46
2025/03/04,2025/03/01,SF FuneralF1110464      250301,,126.5,,2074676.96
2025/03/04,2025/03/01,SF FuneralF1111530      250301,,126.5,,2074803.46
2025/03/04,2025/03/01,SF FuneralF1113318      250301,,126.5,,2074929.96
2025/03/04,2025/03/01,SF FuneralF1113325      250301,,126.5,,2075056.46
2025/03/04,2025/03/01,SF FuneralF1113645      250301,,126.5,,2075182.96
2025/03/04,2025/03/01,SF FuneralF1113731      250302,,126.5,,2075309.46
2025/03/04,2025/03/01,SF FuneralF1113795      250301,,126.5,,2075435.96
2025/03/04,2025/03/01,SF FuneralF1113908      250301,,126.5,,2075562.46
2025/03/04,2025/03/01,SF FuneralF1114612      250301,,126.5,,2075688.96
2025/03/04,2025/03/01,SF FuneralF1115110      250301,,126.5,,2075815.46
2025/03/04,2025/03/01,SF FuneralF1115751      250301,,126.5,,2075941.96
2025/03/04,2025/03/01,SF FuneralF1115860      250301,,126.5,,2076068.46
2025/03/04,2025/03/01,SF FuneralF1115954      250301,,126.5,,2076194.96
2025/03/04,2025/03/01,SF FuneralF1116946      250301,,126.5,,2076321.46
2025/03/04,2025/03/01,SF FuneralF1117190      250301,,126.5,,2076447.96
2025/03/04,2025/03/01,SF FuneralF1117675      250301,,126.5,,2076574.46
2025/03/04,2025/03/01,SF FuneralF808468       250301,,126.5,,2076700.96
2025/03/04,2025/03/01,SF FuneralF1120687      250301,,126.5,,2076827.46
2025/03/04,2025/03/01,SF FuneralF1120834      250301,,126.5,,2076953.96
2025/03/04,2025/03/01,SF FuneralF1121935      250301,,126.5,,2077080.46
2025/03/04,2025/03/01,SF FuneralF1121934      250301,,126.5,,2077206.96
2025/03/04,2025/03/01,SF FuneralF1122013      250301,,126.5,,2077333.46
2025/03/04,2025/03/01,SF FuneralF1122226      250301,,126.5,,2077459.96
2025/03/04,2025/03/01,SF FuneralF1122572      250301,,126.5,,2077586.46
2025/03/04,2025/03/01,SF FuneralF1122657      250301,,126.5,,2077712.96
2025/03/04,2025/03/01,SF FuneralF1122659      250301,,126.5,,2077839.46
2025/03/04,2025/03/01,SF FuneralF1122722      250301,,126.5,,2077965.96
2025/03/04,2025/03/01,SF FuneralF1123044      250301,,126.5,,2078092.46
2025/03/04,2025/03/01,SF FuneralF1123067      250301,,126.5,,2078218.96
2025/03/04,2025/03/01,SF FuneralFDC0000000P3HW250301,,126.5,,2078345.46
2025/03/04,2025/03/01,SF FuneralF1123155      250301,,126.5,,2078471.96
2025/03/04,2025/03/01,SF FuneralF1124350      250301,,126.5,,2078598.46
2025/03/04,2025/03/01,SF FuneralF1124612      250301,,126.5,,2078724.96
2025/03/04,2025/03/01,SF FuneralF1125451      250301,,126.5,,2078851.46
2025/03/04,2025/03/01,SF FuneralFDC0000000PHWV250301,,126.5,,2078977.96
2025/03/04,2025/03/01,SF FuneralF1125950      250301,,126.5,,2079104.46
2025/03/04,2025/03/01,SF FuneralFDC0000000PJS4250301,,126.5,,2079230.96
2025/03/04,2025/03/01,SF FuneralF988463       250301,,126.5,,2079357.46
2025/03/04,2025/03/01,SF FuneralF1127344      250301,,126.5,,2079483.96
2025/03/04,2025/03/01,SF FuneralF1127361      250301,,126.5,,2079610.46
2025/03/04,2025/03/01,SF FuneralF1127858      250301,,126.5,,2079736.96
2025/03/04,2025/03/01,SF FuneralF1127894      250301,,126.5,,2079863.46
2025/03/04,2025/03/01,SF FuneralF1127916      250301,,126.5,,2079989.96
2025/03/04,2025/03/01,SF FuneralF1128185      250301,,126.5,,2080116.46
2025/03/04,2025/03/01,SF FuneralF1128326      250301,,126.5,,2080242.96
2025/03/04,2025/03/01,SF FuneralF1128969      250301,,126.5,,2080369.46
2025/03/04,2025/03/01,SF FuneralF1129092      250301,,126.5,,2080495.96
2025/03/04,2025/03/01,SF FuneralF1129154      250301,,126.5,,2080622.46
2025/03/04,2025/03/01,SF FuneralF1129219      250301,,126.5,,2080748.96
2025/03/04,2025/03/01,SF FuneralFDC0000000PYZT250301,,126.5,,2080875.46
2025/03/04,2025/03/01,SF FuneralF1129445      250301,,126.5,,2081001.96
2025/03/04,2025/03/01,SF FuneralF1131141      250301,,126.5,,2081128.46
2025/03/04,2025/03/01,SF FuneralF1131223      250301,,126.5,,2081254.96
2025/03/04,2025/03/01,SF FuneralFDC0000000Q4W1250302,,126.5,,2081381.46
2025/03/04,2025/03/01,SF FuneralF1131312      250302,,126.5,,2081507.96
2025/03/04,2025/03/01,SF FuneralF1131649      250301,,126.5,,2081634.46
2025/03/04,2025/03/01,SF FuneralF1131895      250301,,126.5,,2081760.96
2025/03/04,2025/03/01,SF FuneralF1132094      250301,,126.5,,2081887.46
2025/03/04,2025/03/01,SF FuneralF1118537      250301,,126.5,,2082013.96
2025/03/04,2025/03/01,SF FuneralF1132257      250301,,126.5,,2082140.46
2025/03/04,2025/03/01,SF FuneralF1132355      250301,,126.5,,2082266.96
2025/03/04,2025/03/01,SF FuneralF1132362      250301,,126.5,,2082393.46
2025/03/04,2025/03/01,SF FuneralF1132431      250301,,126.5,,2082519.96
2025/03/04,2025/03/03,SF FuneralF808696       250302,,126.5,,2082646.46
2025/03/04,2025/03/03,SF FuneralF808733       250302,,126.5,,2082772.96
2025/03/04,2025/03/03,SF FuneralFDC0000000934R250303,,191.5,,2082964.46
2025/03/04,2025/03/03,SF FuneralF812500       250302,,126.5,,2083090.96
2025/03/04,2025/03/03,SF FuneralF812666       250303,,126.5,,2083217.46
2025/03/04,2025/03/03,SF FuneralF822955       250302,,126.5,,2083343.96
2025/03/04,2025/03/03,SF FuneralF842965       250301,,126.5,,2083470.46
2025/03/04,2025/03/03,SF FuneralF842984       250301,,126.5,,2083596.96
2025/03/04,2025/03/03,SF FuneralF900531       250301,,126.5,,2083723.46
2025/03/04,2025/03/03,SF FuneralF900569       250301,,126.5,,2083849.96
2025/03/04,2025/03/03,SF FuneralF987942       250303,,126.5,,2083976.46
2025/03/04,2025/03/03,SF FuneralF1066729      250303,,126.5,,2084102.96
2025/03/04,2025/03/03,SF FuneralF1078472      250303,,126.5,,2084229.46
2025/03/04,2025/03/03,SF FuneralF1122021      250303,,126.5,,2084355.96
2025/03/04,2025/03/03,SF FuneralF1125683      250303,,126.5,,2084482.46
2025/03/04,2025/03/03,SF FuneralF1126140      250303,,126.5,,2084608.96
2025/03/04,2025/02/24,SF FuneralFDC0000000350C250223,,220,,2084828.96
2025/03/04,2025/02/24,SF FuneralF830051       250224,,63.25,,2084892.21
2025/03/04,2025/02/25,SF FuneralFDC00000007ZTL250225,,126.5,,2085018.71
2025/03/04,2025/02/26,SF FuneralF793899       250226,,126.5,,2085145.21
2025/03/04,2025/02/27,SF FuneralFDC00000006QNF250227,,126.5,,2085271.71
2025/03/04,2025/02/28,SF FuneralFDC000000034D9250228,,220,,2085491.71
2025/03/04,2025/02/28,SF FuneralFDC00000006FDH250228,,126.5,,2085618.21
2025/03/04,2025/02/28,SF FuneralFDC00000006L3F250228,,126.5,,2085744.71
2025/03/04,2025/02/28,SF FuneralF809340       250228,,126.5,,2085871.21
2025/03/04,2025/02/28,SF FuneralF827906       250228,,126.5,,2085997.71
2025/03/04,2025/02/28,SF FuneralFDC0000000BVMV250228,,126.5,,2086124.21
2025/03/04,2025/02/28,SF FuneralF832974       250228,,126.5,,2086250.71
2025/03/04,2025/02/28,SF FuneralF840849       250228,,126.5,,2086377.21
2025/03/04,2025/02/28,SF FuneralF841461       250228,,126.5,,2086503.71
2025/03/04,2025/02/28,SF FuneralF900902       250301,,126.5,,2086630.21
2025/03/04,2025/02/28,SF FuneralF901080       250301,,126.5,,2086756.71
2025/03/04,2025/02/28,SF FuneralF901085       250301,,126.5,,2086883.21
2025/03/04,2025/02/28,SF FuneralF901183       250301,,126.5,,2087009.71
2025/03/04,2025/02/28,SF FuneralF901240       250301,,126.5,,2087136.21
2025/03/04,2025/02/28,SF FuneralF981616       250301,,126.5,,2087262.71
2025/03/04,2025/02/28,SF FuneralF777476       250301,,191.5,,2087454.21
2025/03/04,2025/02/28,SF FuneralF987076       250301,,126.5,,2087580.71
2025/03/04,2025/02/28,SF FuneralF987612       250301,,126.5,,2087707.21
2025/03/04,2025/02/28,SF FuneralF987680       250301,,126.5,,2087833.71
2025/03/04,2025/02/28,SF FuneralF987688       250228,,126.5,,2087960.21
2025/03/04,2025/02/28,SF FuneralF987735       250301,,126.5,,2088086.71
2025/03/04,2025/02/28,SF FuneralF987837       250301,,126.5,,2088213.21
2025/03/04,2025/02/28,SF FuneralF987944       250301,,126.5,,2088339.71
2025/03/04,2025/02/28,SF FuneralF988063       250301,,126.5,,2088466.21
2025/03/04,2025/02/28,SF FuneralF988078       250301,,126.5,,2088592.71
2025/03/04,2025/02/28,SF FuneralF988732       250301,,126.5,,2088719.21
2025/03/04,2025/02/28,SF FuneralF988970       250301,,126.5,,2088845.71
2025/03/04,2025/02/28,SF FuneralF988972       250301,,126.5,,2088972.21
2025/03/04,2025/02/28,SF FuneralF989123       250301,,126.5,,2089098.71
2025/03/04,2025/02/28,SF FuneralF989603       250301,,126.5,,2089225.21
2025/03/04,2025/02/28,SF FuneralF989697       250301,,126.5,,2089351.71
2025/03/04,2025/02/28,SF FuneralF990100       250301,,126.5,,2089478.21
2025/03/04,2025/02/28,SF FuneralF993572       250228,,31.63,,2089509.84
2025/03/04,2025/02/28,SF FuneralF1021663      250228,,126.5,,2089636.34
2025/03/04,2025/02/28,SF FuneralF1104078      250228,,126.5,,2089762.84
2025/03/04,2025/02/28,SF FuneralF1128182      250228,,126.5,,2089889.34
2025/03/04,2025/02/28,Rev SF FuneralFDC0000000NNGY250228,,-31.63,,2089857.71
2025/03/04,2025/02/11,Rev SF FuneralFDC0000000NRQK250211,,-31.63,,2089826.08
2025/03/04,2025/02/18,Rev SF FuneralFDC0000000NRQK250218,,-31.63,,2089794.45
2025/03/04,2025/03/04,Rev SF FuneralFDC0000000N8G1250304,,-31.63,,2089762.82
2025/03/04,2025/02/28,Rev SF FuneralFDC0000000K7CQ250228,,-31.63,,2089731.19
2025/03/04,2025/02/25,Rev SF FuneralFDC0000000NRQK250225,,-31.63,,2089699.56
2025/03/04,2025/02/21,Rev SF FuneralFDC0000000K474250221,,-126.5,,2089573.06
2025/03/04,2025/02/28,Rev SF FuneralFDC0000000L90R250228,,-126.5,,2089446.56
2025/03/04,2025/02/24,Rev SF FuneralFDC0000000FGX6250222,,-126.5,,2089320.06
2025/03/04,2025/03/04,SF FuneralF990255       250304,,31.63,,2089351.69
2025/03/04,2025/03/04,RTC-SFTAV2022756550,,220,,2089571.69
2025/03/04,2025/02/26,SF FuneralF993486       250226,,126.5,,2089698.19
2025/03/04,2025/03/01,SF FuneralF821521       250301,,126.5,,2089824.69
2025/03/04,2025/03/03,SF FuneralFDC0000000N6CD250303,,126.5,,2089951.19
2025/03/04,2025/03/03,SF FuneralF1129035      250303,,126.5,,2090077.69
2025/03/04,2025/03/04,SF FuneralF802295       250304,,31.63,,2090109.32
2025/03/04,2025/03/04,SF FuneralF993719       250304,,31.63,,2090140.95
2025/03/04,2025/03/04,SF FuneralFDC0000000JHBW250304,,31.63,,2090172.58
2025/03/04,2025/02/25,SF FuneralF1080371      250225,,63.25,,2090235.83
2025/03/04,2025/02/27,SF FuneralFDC00000005V46250227,,126.5,,2090362.33
2025/03/04,2025/02/27,SF FuneralFDC0000000JVB4250227,,126.5,,2090488.83
2025/03/04,2025/02/28,SF FuneralFDC00000005KKX250228,,126.5,,2090615.33
2025/03/04,2025/02/28,SF FuneralF803166       250228,,126.5,,2090741.83
2025/03/04,2025/02/28,SF FuneralFDC0000000HTZ4250228,,126.5,,2090868.33
2025/03/04,2025/02/28,SF FuneralF1058609      250228,,126.5,,2090994.83
2025/03/04,2025/02/28,SF FuneralFDC0000000MLM7250228,,126.5,,2091121.33
2025/03/04,2025/02/28,SF FuneralFDC0000000MLMG250228,,126.5,,2091247.83
2025/03/04,2025/03/01,SF FuneralF1118722      250301,,126.5,,2091374.33
2025/03/04,2025/03/01,SF FuneralFDC0000000PV3T250302,,126.5,,2091500.83
2025/03/04,2025/03/03,SF FuneralF1131720      250303,,126.5,,2091627.33
2025/03/04,2025/03/04,SF FuneralFDC00000006S4K250304,,126.5,,2091753.83
2025/03/04,2025/03/04,SF FuneralFDC00000008JV9250304,,63.25,,2091817.08
2025/03/04,2025/03/04,SF FuneralFDC00000008JVC250304,,63.25,,2091880.33
2025/03/04,2025/02/27,Rev SF FuneralFDC0000000F60P250227,,-126.5,,2091753.83
2025/03/04,2025/02/25,Rev SF FuneralFDC00000008HK9250225,,-126.5,,2091627.33
2025/03/04,2025/02/27,SF FuneralFDC00000007893250227,,126.5,,2091753.83
2025/03/04,2025/02/27,SF FuneralF803563       250227,,126.5,,2091880.33
2025/03/04,2025/02/27,SF FuneralF842213       250227,,126.5,,2092006.83
2025/03/04,2025/02/28,SF FuneralFDC000000039Y2250228,,220,,2092226.83
2025/03/04,2025/02/28,SF FuneralF1017246      250228,,126.5,,2092353.33
2025/03/04,2025/03/01,SF FuneralFDC000000078B2250301,,126.5,,2092479.83
2025/03/04,2025/03/01,SF FuneralFDC0000000KXTD250301,,126.5,,2092606.33
2025/03/04,2025/03/01,SF FuneralF1073205      250301,,126.5,,2092732.83
2025/03/04,2025/03/01,SF FuneralF1084572      250301,,126.5,,2092859.33
2025/03/04,2025/03/03,SF FuneralFDC00000007JPM250302,,63.25,,2092922.58
2025/03/04,2025/03/04,SF FuneralF821359       250304,,63.25,,2092985.83
2025/03/04,2025/03/04,SF FuneralF834784       250304,,31.63,,2093017.46
2025/03/04,2025/03/04,SF FuneralF981838       250304,,31.63,,2093049.09
2025/03/04,2025/03/04,SF FuneralF992943       250304,,63.25,,2093112.34
2025/03/04,2025/02/01,Rev SF FuneralFDC0000000MN6J250201,,-126.5,,2092985.84
2025/03/04,2025/03/01,Rev SF FuneralFDC0000000P6LN250301,,-126.5,,2092859.34
2025/03/04,2025/02/01,Rev SF FuneralFDC0000000P6LN250201,,-126.5,,2092732.84
2025/03/04,2025/03/01,Rev SF FuneralFDC0000000MN6J250301,,-126.5,,2092606.34
2025/03/04,2025/03/04,SF FuneralFDC0000000BBZY250304,,126.5,,2092732.84
2025/03/04,2025/03/04,SF FuneralF822587       250304,,31.63,,2092764.47
2025/03/04,2025/03/04,SF FuneralF901250       250304,,63.25,,2092827.72
2025/03/04,2025/03/04,SF FuneralF990180       250304,,31.63,,2092859.35
2025/03/04,2025/03/04,SF FuneralF1084859      250304,,31.63,,2092890.98
2025/03/04,2025/03/04,SF FuneralF1111603      250304,,31.63,,2092922.61
2025/03/04,2025/03/04,Fee-Teller Transactions,,-11.91,,2092910.7
2025/03/04,2025/03/04,Dep-Cash-SFTAP2023802672,,126.5,11.91,2093037.2
2025/03/04,2025/02/27,SF FuneralFDC00000009LFL250227,,126.5,,2093163.7
2025/03/04,2025/02/28,SF FuneralFDC0000000J3GP250228,,126.5,,2093290.2
2025/03/04,2025/03/01,SF FuneralFDC000000072QS250301,,126.5,,2093416.7
2025/03/04,2025/03/01,SF FuneralF832598       250301,,126.5,,2093543.2
2025/03/04,2025/03/01,SF FuneralF1021492      250301,,126.5,,2093669.7
2025/03/04,2025/03/01,SF FuneralF1109066      250301,,126.5,,2093796.2
2025/03/04,2025/03/01,SF FuneralFDC0000000PKN5250301,,126.5,,2093922.7
2025/03/04,2025/03/01,SF FuneralF1128007      250301,,126.5,,2094049.2
2025/03/04,2025/03/04,SF FuneralF798485       250304,,31.63,,2094080.83
2025/03/04,2025/03/04,SF FuneralF1080249      250304,,31.63,,2094112.46
2025/03/04,2025/03/04,SF FuneralF1110117      250304,,31.63,,2094144.09
2025/03/04,2025/02/28,SF FuneralFDC000000070FN250228,,126.5,,2094270.59
2025/03/04,2025/03/01,SF FuneralFDC0000000NLY9250301,,31.63,,2094302.22
2025/03/04,2025/03/01,SF FuneralF1117993      250301,,31.63,,2094333.85
2025/03/04,2025/02/24,SF FuneralFDC00000006YYC250224,,126.5,,2094460.35
2025/03/04,2025/02/24,SF FuneralF819654       250224,,126.5,,2094586.85
2025/03/04,2025/02/25,SF FuneralF1113205      250225,,126.5,,2094713.35
2025/03/04,2025/02/28,SF FuneralF990429       250228,,126.5,,2094839.85
2025/03/04,2025/02/28,SF FuneralF1060979      250228,,126.5,,2094966.35
2025/03/04,2025/02/28,SF FuneralF1109851      250228,,126.5,,2095092.85
2025/03/04,2025/03/03,SF FuneralF844352       250301,,126.5,,2095219.35
2025/03/04,2025/03/04,SF FuneralFDC000000086B2250304,,31.63,,2095250.98
2025/03/04,2025/03/04,SF FuneralF1127346      250304,,31.63,,2095282.61
2025/03/04,2025/02/01,Rev SF FuneralFDC0000000PL99250201,,-126.5,,2095156.11
2025/03/04,2025/02/28,Rev SF FuneralFDC0000000HYQ5250228,,-126.5,,2095029.61
2025/03/04,2025/02/28,Rev SF FuneralFDC0000000NY14250228,,-126.5,,2094903.11
2025/03/04,2025/02/28,Rev SF FuneralFDC00000007CLH250228,,-126.5,,2094776.61
2025/03/04,2025/03/01,Rev SF FuneralFDC0000000PL99250301,,-126.5,,2094650.11
2025/03/04,2025/02/28,Rev SF FuneralFDC00000007CLK250228,,-126.5,,2094523.61
2025/03/04,2025/02/28,Rev SF FuneralFDC0000000J3GP250228,,-126.5,,2094397.11
2025/03/04,2025/02/28,Rev SF FuneralFDC0000000KS13250228,,-126.5,,2094270.61
2025/03/04,2025/01/24,Rev SF FuneralFDC0000000PSD4250128,,-126.5,,2094144.11
2025/03/04,2025/03/01,Rev SF FuneralFDC00000006M99250301,,-126.5,,2094017.61
2025/03/04,2025/01/24,Rev SF FuneralFDC0000000P186250126,,-126.5,,2093891.11
2025/03/04,2024/12/11,Rev SF FuneralF831684       241222,,-126.5,,2093764.61
2025/03/04,2025/02/27,Rev SF FuneralFDC000000069ZD250227,,-126.5,,2093638.11
2025/03/04,2025/03/01,Rev SF FuneralFDC00000009LQN250301,,-126.5,,2093511.61
2025/03/04,2025/03/01,Rev SF FuneralFDC0000000PZLM250301,,-126.5,,2093385.11
2025/03/04,2025/03/04,Rev SF FuneralFDC00000006S4K250304,,-126.5,,2093258.61
2025/03/04,2025/02/01,Rev SF FuneralFDC0000000PZLM250201,,-126.5,,2093132.11
2025/03/04,2025/03/01,Rev SF FuneralFDC000000033XY250301,,-220,,2092912.11
2025/03/04,2025/01/24,Rev SF FuneralF1020935      250127,,-126.5,,2092785.61
2025/03/04,2025/02/24,Rev SF FuneralFDC0000000HZN0250224,,-63.25,,2092722.36
2025/03/04,2025/02/28,Rev SF FuneralFDC0000000PSD4250228,,-126.5,,2092595.86
2025/03/04,2025/02/22,Rev SF FuneralFDC0000000Q3LH250222,,-126.5,,2092469.36
2025/03/04,2025/01/30,Rev SF FuneralFDC0000000P0J8250130,,-126.5,,2092342.86
2025/03/04,2025/03/01,Rev SF FuneralFDC0000000D0HF250301,,-126.5,,2092216.36
2025/03/04,2025/02/01,Rev SF FuneralFDC000000033XY250201,,-220,,2091996.36
2025/03/04,2025/02/04,Rev SF FuneralFDC00000007YZB250204,,-31.63,,2091964.73
2025/03/04,2025/02/11,Rev SF FuneralFDC00000007YZB250211,,-31.63,,2091933.1
2025/03/04,2025/03/04,Rev SF FuneralFDC0000000JHBW250304,,-31.63,,2091901.47
2025/03/04,2025/02/25,Rev SF FuneralFDC00000007YZB250225,,-31.63,,2091869.84
2025/03/04,2025/03/04,Rev SF FuneralFDC0000000HN9N250304,,-31.63,,2091838.21
2025/03/04,2025/02/18,Rev SF FuneralFDC00000007YZB250218,,-31.63,,2091806.58
2025/03/04,2025/03/04,Rev SF FuneralFDC00000005PFJ250304,,-31.63,,2091774.95
2025/03/04,2025/03/04,Rev SF FuneralFDC00000007YZB250304,,-31.63,,2091743.32
2025/03/04,2025/02/28,SF FuneralF901526       250301,,126.5,,2091869.82
2025/03/04,2025/03/01,SF FuneralFDC00000008ZPZ250301,,126.5,,2091996.32
2025/03/04,2025/03/01,SF FuneralF810830       250301,,126.5,,2092122.82
2025/03/04,2025/02/26,SF FuneralF841298       250226,,126.5,,2092249.32
2025/03/04,2025/03/03,SF FuneralF1126202      250303,,126.5,,2092375.82
2025/03/04,2025/02/27,SF FuneralF1109616      250227,,126.5,,2092502.32
2025/03/04,2025/03/04,SF FuneralF1131796      250304,,31.63,,2092533.95
2025/03/04,2025/03/01,SF FuneralF1130872      250301,,126.5,,2092660.45
2025/03/04,2025/03/04,EFT-EFT DEBIT TRANSFERS 061331,,57860,,2150520.45
2025/03/04,2025/03/04,Fee-ACB Debit Order,,-19.5,,2150500.95
2025/03/04,2025/03/04,EFTNP-NUPAY  33560/250303,,-84426.84,19.5,2066074.11
2025/03/05,2025/02/28,SF FuneralFDC0000000338L250228,,220,,2066294.11
2025/03/05,2025/02/28,SF FuneralFDC0000000341Z250228,,220,,2066514.11
2025/03/05,2025/02/28,SF FuneralFDC00000005XML250228,,126.5,,2066640.61
2025/03/05,2025/02/28,SF FuneralFDC00000006B89250228,,126.5,,2066767.11
2025/03/05,2025/02/28,SF FuneralFDC000000075GX250228,,126.5,,2066893.61
2025/03/05,2025/02/28,SF FuneralFDC00000007857250228,,126.5,,2067020.11
2025/03/05,2025/02/28,SF FuneralFDC00000007859250228,,126.5,,2067146.61
2025/03/05,2025/02/28,SF FuneralFDC00000007QZX250228,,126.5,,2067273.11
2025/03/05,2025/02/28,SF FuneralF832889       250228,,126.5,,2067399.61
2025/03/05,2025/02/28,SF FuneralF817468       250228,,126.5,,2067526.11
2025/03/05,2025/02/28,SF FuneralF817546       250228,,126.5,,2067652.61
2025/03/05,2025/02/28,SF FuneralFDC0000000DXTJ250228,,126.5,,2067779.11
2025/03/05,2025/02/28,SF FuneralF980439       250228,,126.5,,2067905.61
2025/03/05,2025/02/28,SF FuneralFDC0000000HFLZ250301,,126.5,,2068032.11
2025/03/05,2025/02/28,SF FuneralF981551       250301,,126.5,,2068158.61
2025/03/05,2025/02/28,SF FuneralF987695       250301,,126.5,,2068285.11
2025/03/05,2025/02/28,SF FuneralF987762       250301,,126.5,,2068411.61
2025/03/05,2025/02/28,SF FuneralF987890       250301,,126.5,,2068538.11
2025/03/05,2025/02/28,SF FuneralF988467       250301,,126.5,,2068664.61
2025/03/05,2025/03/01,SF FuneralFDC00000005N57250301,,126.5,,2068791.11
2025/03/05,2025/03/01,SF FuneralFDC00000005RSX250301,,220,,2069011.11
2025/03/05,2025/03/01,SF FuneralFDC000000069MT250301,,126.5,,2069137.61
2025/03/05,2025/03/01,SF FuneralFDC00000006GK2250301,,126.5,,2069264.11
2025/03/05,2025/03/01,SF FuneralFDC00000006H2C250301,,126.5,,2069390.61
2025/03/05,2025/03/01,SF FuneralFDC00000006JVF250301,,126.5,,2069517.11
2025/03/05,2025/03/01,SF FuneralFDC00000006JVM250301,,126.5,,2069643.61
2025/03/05,2025/03/01,SF FuneralFDC00000006KB9250301,,126.5,,2069770.11
2025/03/05,2025/03/01,SF FuneralFDC00000006MBT250301,,126.5,,2069896.61
2025/03/05,2025/03/01,SF FuneralFDC00000006QQS250301,,126.5,,2070023.11
2025/03/05,2025/03/01,SF FuneralFDC00000006XNJ250301,,126.5,,2070149.61
2025/03/05,2025/03/01,SF FuneralFDC000000072GT250301,,126.5,,2070276.11
2025/03/05,2025/03/01,SF FuneralFDC0000000730C250301,,126.5,,2070402.61
2025/03/05,2025/03/01,SF FuneralFDC000000074RT250301,,126.5,,2070529.11
2025/03/05,2025/03/01,SF FuneralFDC0000000797Y250301,,126.5,,2070655.61
2025/03/05,2025/03/01,SF FuneralFDC00000007FCP250301,,126.5,,2070782.11
2025/03/05,2025/03/01,SF FuneralFDC00000007H2S250301,,220,,2071002.11
2025/03/05,2025/03/01,SF FuneralFDC00000007QBR250301,,126.5,,2071128.61
2025/03/05,2025/03/01,SF FuneralFDC00000007QKS250301,,126.5,,2071255.11
2025/03/05,2025/03/01,SF FuneralF793929       250301,,126.5,,2071381.61
2025/03/05,2025/03/01,SF FuneralF793935       250301,,126.5,,2071508.11
2025/03/05,2025/03/01,SF FuneralFDC00000007R1W250301,,126.5,,2071634.61
2025/03/05,2025/03/01,SF FuneralFDC00000007SBL250301,,126.5,,2071761.11
2025/03/05,2025/03/01,SF FuneralFDC00000007T9M250301,,126.5,,2071887.61
2025/03/05,2025/03/01,SF FuneralFDC00000007YHX250301,,126.5,,2072014.11
2025/03/05,2025/03/01,SF FuneralFDC000000084VD250301,,126.5,,2072140.61
2025/03/05,2025/03/01,SF FuneralFDC000000085S3250301,,126.5,,2072267.11
2025/03/05,2025/03/01,SF FuneralFDC0000000877D250301,,126.5,,2072393.61
2025/03/05,2025/03/01,SF FuneralFDC0000000879X250301,,126.5,,2072520.11
2025/03/05,2025/03/01,SF FuneralF801891       250301,,126.5,,2072646.61
2025/03/05,2025/03/01,SF FuneralF803608       250301,,126.5,,2072773.11
2025/03/05,2025/03/01,SF FuneralF803749       250301,,126.5,,2072899.61
2025/03/05,2025/03/01,SF FuneralF808745       250301,,126.5,,2073026.11
2025/03/05,2025/03/01,SF FuneralF808769       250301,,126.5,,2073152.61
2025/03/05,2025/03/01,SF FuneralF808940       250301,,126.5,,2073279.11
2025/03/05,2025/03/01,SF FuneralF808962       250301,,126.5,,2073405.61
2025/03/05,2025/03/01,SF FuneralF809000       250301,,126.5,,2073532.11
2025/03/05,2025/03/01,SF FuneralF809095       250301,,126.5,,2073658.61
2025/03/05,2025/03/01,SF FuneralFDC000000092PD250301,,126.5,,2073785.11
2025/03/05,2025/03/01,SF FuneralF809684       250301,,126.5,,2073911.61
2025/03/05,2025/03/01,SF FuneralF809959       250301,,126.5,,2074038.11
2025/03/05,2025/03/01,SF FuneralF810895       250301,,126.5,,2074164.61
2025/03/05,2025/03/01,SF FuneralF812643       250301,,126.5,,2074291.11
2025/03/05,2025/03/01,SF FuneralF812690       250301,,126.5,,2074417.61
2025/03/05,2025/03/01,SF FuneralF812866       250301,,126.5,,2074544.11
2025/03/05,2025/03/01,SF FuneralF814923       250301,,126.5,,2074670.61
2025/03/05,2025/03/01,SF FuneralF816856       250301,,126.5,,2074797.11
2025/03/05,2025/03/01,SF FuneralF816929       250301,,126.5,,2074923.61
2025/03/05,2025/03/01,SF FuneralF817290       250301,,126.5,,2075050.11
2025/03/05,2025/03/01,SF FuneralF817901       250301,,126.5,,2075176.61
2025/03/05,2025/03/01,SF FuneralF818895       250301,,126.5,,2075303.11
2025/03/05,2025/03/01,SF FuneralF820923       250301,,126.5,,2075429.61
2025/03/05,2025/03/01,SF FuneralF821929       250301,,126.5,,2075556.11
2025/03/05,2025/03/01,SF FuneralF828382       250301,,126.5,,2075682.61
2025/03/05,2025/03/01,SF FuneralF828576       250301,,126.5,,2075809.11
2025/03/05,2025/03/01,SF FuneralF829024       250301,,126.5,,2075935.61
2025/03/05,2025/03/01,SF FuneralF829650       250301,,126.5,,2076062.11
2025/03/05,2025/03/01,SF FuneralF832415       250301,,126.5,,2076188.61
2025/03/05,2025/03/01,SF FuneralF832433       250301,,126.5,,2076315.11
2025/03/05,2025/03/01,SF FuneralFDC0000000CKL3250301,,191.5,,2076506.61
2025/03/05,2025/03/01,SF FuneralFDC0000000CS5X250301,,126.5,,2076633.11
2025/03/05,2025/03/01,SF FuneralF833383       250301,,126.5,,2076759.61
2025/03/05,2025/03/01,SF FuneralFDC0000000CXVK250301,,126.5,,2076886.11
2025/03/05,2025/03/01,SF FuneralF838810       250301,,126.5,,2077012.61
2025/03/05,2025/03/01,SF FuneralF841719       250301,,126.5,,2077139.11
2025/03/05,2025/03/01,SF FuneralF842584       250301,,126.5,,2077265.61
2025/03/05,2025/03/01,SF FuneralFDC0000000F6NW250301,,126.5,,2077392.11
2025/03/05,2025/03/01,SF FuneralFDC0000000F6W1250301,,126.5,,2077518.61
2025/03/05,2025/03/01,SF FuneralF842589       250301,,126.5,,2077645.11
2025/03/05,2025/03/01,SF FuneralF1017101      250301,,126.5,,2077771.61
2025/03/05,2025/03/01,SF FuneralF1017732      250301,,126.5,,2077898.11
2025/03/05,2025/03/01,SF FuneralF1021702      250301,,126.5,,2078024.61
2025/03/05,2025/03/01,SF FuneralF1021708      250301,,126.5,,2078151.11
2025/03/05,2025/03/01,SF FuneralFDC0000000JWQ5250301,,126.5,,2078277.61
2025/03/05,2025/03/01,SF FuneralF1022122      250301,,126.5,,2078404.11
2025/03/05,2025/03/01,SF FuneralF1034024      250301,,126.5,,2078530.61
2025/03/05,2025/03/01,SF FuneralF1021862      250301,,126.5,,2078657.11
2025/03/05,2025/03/01,SF FuneralF1058856      250302,,126.5,,2078783.61
2025/03/05,2025/03/01,SF FuneralF1066262      250301,,126.5,,2078910.11
2025/03/05,2025/03/01,SF FuneralF1066434      250301,,126.5,,2079036.61
2025/03/05,2025/03/01,SF FuneralF1073239      250301,,126.5,,2079163.11
2025/03/05,2025/03/01,SF FuneralF1073802      250301,,126.5,,2079289.61
2025/03/05,2025/03/01,SF FuneralF1079121      250301,,126.5,,2079416.11
2025/03/05,2025/03/01,SF FuneralF1084953      250301,,126.5,,2079542.61
2025/03/05,2025/03/01,SF FuneralF1085024      250301,,126.5,,2079669.11
2025/03/05,2025/03/01,SF FuneralF1109001      250301,,126.5,,2079795.61
2025/03/05,2025/03/01,SF FuneralF1109092      250301,,126.5,,2079922.11
2025/03/05,2025/03/01,SF FuneralFDC0000000MKQZ250301,,126.5,,2080048.61
2025/03/05,2025/03/01,SF FuneralF1109946      250302,,126.5,,2080175.11
2025/03/05,2025/03/01,SF FuneralF1110233      250301,,126.5,,2080301.61
2025/03/05,2025/03/01,SF FuneralF1110385      250301,,126.5,,2080428.11
2025/03/05,2025/03/01,SF FuneralF1113836      250301,,126.5,,2080554.61
2025/03/05,2025/03/01,SF FuneralF1113927      250301,,126.5,,2080681.11
2025/03/05,2025/03/01,SF FuneralF1114050      250301,,126.5,,2080807.61
2025/03/05,2025/03/01,SF FuneralF1114164      250301,,126.5,,2080934.11
2025/03/05,2025/03/01,SF FuneralF1114682      250301,,126.5,,2081060.61
2025/03/05,2025/03/01,SF FuneralF1117732      250301,,126.5,,2081187.11
2025/03/05,2025/03/01,SF FuneralF1117862      250302,,126.5,,2081313.61
2025/03/05,2025/03/01,SF FuneralF1119882      250301,,126.5,,2081440.11
2025/03/05,2025/03/01,SF FuneralFDC0000000P18J250301,,126.5,,2081566.61
2025/03/05,2025/03/01,SF FuneralF1122831      250301,,126.5,,2081693.11
2025/03/05,2025/03/01,SF FuneralF1122851      250301,,126.5,,2081819.61
2025/03/05,2025/03/01,SF FuneralF1122853      250301,,126.5,,2081946.11
2025/03/05,2025/03/01,SF FuneralFDC0000000P3B8250301,,126.5,,2082072.61
2025/03/05,2025/03/01,SF FuneralF1123066      250301,,126.5,,2082199.11
2025/03/05,2025/03/01,SF FuneralF1123114      250301,,126.5,,2082325.61
2025/03/05,2025/03/01,SF FuneralFDC0000000P3SR250301,,126.5,,2082452.11
2025/03/05,2025/03/01,SF FuneralF1123177      250301,,126.5,,2082578.61
2025/03/05,2025/03/01,SF FuneralF1124099      250301,,126.5,,2082705.11
2025/03/05,2025/03/01,SF FuneralFDC0000000P7G5250301,,126.5,,2082831.61
2025/03/05,2025/03/01,SF FuneralFDC0000000P7HD250301,,126.5,,2082958.11
2025/03/05,2025/03/01,SF FuneralF1128191      250301,,126.5,,2083084.61
2025/03/05,2025/03/01,SF FuneralF1128227      250302,,126.5,,2083211.11
2025/03/05,2025/03/01,SF FuneralF1128904      250301,,126.5,,2083337.61
2025/03/05,2025/03/01,SF FuneralF1129283      250301,,126.5,,2083464.11
2025/03/05,2025/03/01,SF FuneralFDC0000000PZ0P250301,,126.5,,2083590.61
2025/03/05,2025/03/01,SF FuneralF1130626      250301,,126.5,,2083717.11
2025/03/05,2025/03/01,SF FuneralF1131473      250302,,126.5,,2083843.61
2025/03/05,2025/03/01,SF FuneralF1132495      250301,,126.5,,2083970.11
2025/03/05,2025/03/01,SF FuneralF1132840      250301,,126.5,,2084096.61
2025/03/05,2025/03/04,SF FuneralF1125777      250304,,31.63,,2084128.24
2025/03/05,2025/02/27,SF FuneralFDC00000007SM6250227,,126.5,,2084254.74
2025/03/05,2025/03/03,SF FuneralFDC000000078NY250302,,126.5,,2084381.24
2025/03/05,2025/03/03,SF FuneralF812941       250302,,126.5,,2084507.74
2025/03/05,2025/03/03,SF FuneralF813154       250303,,126.5,,2084634.24
2025/03/05,2025/03/03,SF FuneralF843049       250301,,126.5,,2084760.74
2025/03/05,2025/03/03,SF FuneralF844172       250301,,126.5,,2084887.24
2025/03/05,2025/03/03,SF FuneralFDC0000000Q4S6250303,,126.5,,2085013.74
2025/03/05,2025/03/01,SF FuneralFDC00000005MWG250301,,31.63,,2085045.37
2025/03/05,2025/03/01,SF FuneralF1127843      250301,,31.63,,2085077
2025/03/05,2025/02/27,SF FuneralF1055314      250227,,126.5,,2085203.5
2025/03/05,2025/02/27,SF FuneralF1122867      250227,,126.5,,2085330
2025/03/05,2025/02/28,SF FuneralFDC00000008S9Q250228,,126.5,,2085456.5
2025/03/05,2025/02/28,SF FuneralF844293       250228,,126.5,,2085583
2025/03/05,2025/02/28,SF FuneralF1084158      250228,,126.5,,2085709.5
2025/03/05,2025/02/28,SF FuneralFDC0000000MV1C250228,,126.5,,2085836
2025/03/05,2025/03/01,SF FuneralF1016646      250302,,63.25,,2085899.25
2025/03/05,2025/03/04,SF FuneralFDC00000007J73250304,,63.25,,2085962.5
2025/03/05,2025/03/04,SF FuneralFDC0000000B379250304,,63.25,,2086025.75
2025/03/05,2025/03/03,SF FuneralFDC00000006RQ8250302,,31.63,,2086057.38
2025/03/05,2025/03/03,SF FuneralF1132295      250303,,31.63,,2086089.01
2025/03/05,2025/02/24,SF FuneralF825179       250224,,126.5,,2086215.51
2025/03/05,2025/02/25,SF FuneralFDC000000063FR250225,,126.5,,2086342.01
2025/03/05,2025/02/27,SF FuneralFDC0000000BQKQ250227,,126.5,,2086468.51
2025/03/05,2025/02/27,SF FuneralF831926       250227,,126.5,,2086595.01
2025/03/05,2025/02/27,SF FuneralF843818       250227,,126.5,,2086721.51
2025/03/05,2025/02/27,SF FuneralFDC0000000NR0L250227,,126.5,,2086848.01
2025/03/05,2025/02/28,SF FuneralFDC0000000L27Z250228,,191.5,,2087039.51
2025/03/05,2025/02/28,SF FuneralFDC0000000MKNW250228,,191.5,,2087231.01
2025/03/05,2025/03/01,SF FuneralFDC00000005XNC250301,,31.63,,2087262.64
2025/03/05,2025/03/01,SF FuneralF817935       250301,,126.5,,2087389.14
2025/03/05,2025/03/01,SF FuneralF1130776      250301,,31.63,,2087420.77
2025/03/05,2025/03/03,SF FuneralFDC00000005NYD250303,,63.25,,2087484.02
2025/03/05,2025/03/03,SF FuneralFDC000000070Z5250302,,31.63,,2087515.65
2025/03/05,2025/03/03,SF FuneralF1072928      250303,,31.63,,2087547.28
2025/03/05,2025/03/04,SF FuneralF814338       250304,,31.63,,2087578.91
2025/03/05,2025/03/04,SF FuneralF1059469      250304,,63.25,,2087642.16
2025/03/05,2025/03/04,SF FuneralF1072724      250304,,31.63,,2087673.79
2025/03/05,2025/03/04,SF FuneralF1123316      250304,,31.63,,2087705.42
2025/03/05,2025/03/01,SF FuneralFDC0000000Q9WZ250301,,126.5,,2087831.92
2025/03/05,2025/03/03,SF FuneralFDC00000002VR4250303,,220,,2088051.92
2025/03/05,2025/03/03,SF FuneralFDC000000033BP250302,,220,,2088271.92
2025/03/05,2025/03/03,SF FuneralFDC00000003KYJ250303,,220,,2088491.92
2025/03/05,2025/03/03,SF FuneralFDC00000003V13250302,,220,,2088711.92
2025/03/05,2025/03/03,SF FuneralFDC000000041PX250302,,220,,2088931.92
2025/03/05,2025/03/03,SF FuneralFDC00000004741250302,,220,,2089151.92
2025/03/05,2025/03/03,SF FuneralFDC00000006HBF250302,,126.5,,2089278.42
2025/03/05,2025/03/03,SF FuneralFDC00000006PG3250302,,256.5,,2089534.92
2025/03/05,2025/03/03,SF FuneralFDC00000007517250302,,126.5,,2089661.42
2025/03/05,2025/03/03,SF FuneralF810852       250302,,126.5,,2089787.92
2025/03/05,2025/03/03,SF FuneralFDC00000009DX2250302,,126.5,,2089914.42
2025/03/05,2025/03/03,SF FuneralF814262       250302,,126.5,,2090040.92
2025/03/05,2025/03/03,SF FuneralF842473       250302,,126.5,,2090167.42
2025/03/05,2025/03/03,SF FuneralF842940       250301,,126.5,,2090293.92
2025/03/05,2025/03/03,SF FuneralF1078902      250303,,126.5,,2090420.42
2025/03/05,2025/03/03,SF FuneralF793892       250303,,191.5,,2090611.92
2025/03/05,2025/03/04,SF FuneralF812901       250304,,126.5,,2090738.42
2025/03/05,2025/02/26,SF FuneralF793966       250226,,126.5,,2090864.92
2025/03/05,2025/02/26,SF FuneralFDC00000007XSC250226,,126.5,,2090991.42
2025/03/05,2025/02/27,SF FuneralFDC00000006JDZ250227,,126.5,,2091117.92
2025/03/05,2025/02/27,SF FuneralFDC00000007RB4250227,,126.5,,2091244.42
2025/03/05,2025/02/27,SF FuneralFDC00000007XMQ250227,,126.5,,2091370.92
2025/03/05,2025/02/28,SF FuneralFDC00000002Q6C250228,,220,,2091590.92
2025/03/05,2025/02/28,SF FuneralFDC00000002W6B250228,,220,,2091810.92
2025/03/05,2025/02/28,SF FuneralFDC0000000338C250228,,220,,2092030.92
2025/03/05,2025/02/28,SF FuneralFDC000000033B0250228,,220,,2092250.92
2025/03/05,2025/02/28,SF FuneralFDC000000035LF250228,,220,,2092470.92
2025/03/05,2025/02/28,SF FuneralFDC00000003B8W250228,,220,,2092690.92
2025/03/05,2025/02/28,SF FuneralFDC00000003B99250228,,220,,2092910.92
2025/03/05,2025/02/28,SF FuneralFDC00000003BYB250228,,220,,2093130.92
2025/03/05,2025/02/28,SF FuneralFDC00000003BYF250228,,220,,2093350.92
2025/03/05,2025/02/28,SF FuneralFDC00000003CQ8250228,,220,,2093570.92
2025/03/05,2025/02/28,SF FuneralFDC00000003TRJ250228,,220,,2093790.92
2025/03/05,2025/02/28,SF FuneralFDC000000040XR250228,,220,,2094010.92
2025/03/05,2025/02/28,SF FuneralFDC0000000415M250228,,220,,2094230.92
2025/03/05,2025/02/28,SF FuneralFDC000000041FZ250228,,220,,2094450.92
2025/03/05,2025/02/28,SF FuneralFDC000000043NF250228,,220,,2094670.92
2025/03/05,2025/02/28,SF FuneralFDC000000058Y5250228,,126.5,,2094797.42
2025/03/05,2025/02/28,SF FuneralFDC00000005LWF250228,,126.5,,2094923.92
2025/03/05,2025/02/28,SF FuneralFDC00000005LZ5250228,,126.5,,2095050.42
2025/03/05,2025/02/28,SF FuneralFDC00000005MJM250228,,126.5,,2095176.92
2025/03/05,2025/02/28,SF FuneralFDC00000005NXZ250228,,126.5,,2095303.42
2025/03/05,2025/02/28,SF FuneralFDC00000005SCC250228,,126.5,,2095429.92
2025/03/05,2025/02/28,SF FuneralFDC00000005SR2250228,,126.5,,2095556.42
2025/03/05,2025/02/28,SF FuneralFDC00000005V5C250228,,126.5,,2095682.92
2025/03/05,2025/02/28,SF FuneralFDC00000005XGS250228,,126.5,,2095809.42
2025/03/05,2025/02/28,SF FuneralFDC000000069WB250228,,126.5,,2095935.92
2025/03/05,2025/02/28,SF FuneralFDC00000006BJD250228,,126.5,,2096062.42
2025/03/05,2025/02/28,SF FuneralFDC00000006BL4250228,,126.5,,2096188.92
2025/03/05,2025/02/28,SF FuneralFDC00000006BYW250228,,126.5,,2096315.42
2025/03/05,2025/02/28,SF FuneralFDC00000006JHP250228,,126.5,,2096441.92
2025/03/05,2025/02/28,SF FuneralFDC00000006Q46250228,,126.5,,2096568.42
2025/03/05,2025/02/28,SF FuneralFDC00000007QMM250228,,126.5,,2096694.92
2025/03/05,2025/02/28,SF FuneralFDC00000007R3P250228,,126.5,,2096821.42
2025/03/05,2025/02/28,SF FuneralFDC000000084JZ250228,,126.5,,2096947.92
2025/03/05,2025/02/28,SF FuneralF803646       250228,,126.5,,2097074.42
2025/03/05,2025/02/28,SF FuneralF816643       250228,,126.5,,2097200.92
2025/03/05,2025/02/28,SF FuneralF901459       250301,,126.5,,2097327.42
2025/03/05,2025/02/28,SF FuneralF981138       250301,,126.5,,2097453.92
2025/03/05,2025/02/28,SF FuneralF784108       250301,,213.31,,2097667.23
2025/03/05,2025/02/28,SF FuneralF987784       250301,,126.5,,2097793.73
2025/03/05,2025/02/28,SF FuneralF989651       250301,,126.5,,2097920.23
2025/03/05,2025/02/28,SF FuneralF782668       250228,,256.5,,2098176.73
2025/03/05,2025/02/28,SF FuneralF1080342      250228,,126.5,,2098303.23
2025/03/05,2025/03/01,SF FuneralFDC00000002QXK250301,,220,,2098523.23
2025/03/05,2025/03/01,SF FuneralFDC00000002RB0250301,,220,,2098743.23
2025/03/05,2025/03/01,SF FuneralFDC00000002V0S250301,,220,,2098963.23
2025/03/05,2025/03/01,SF FuneralFDC00000002V11250301,,220,,2099183.23
2025/03/05,2025/03/01,SF FuneralFDC00000002V12250301,,220,,2099403.23
2025/03/05,2025/03/01,SF FuneralFDC00000002V2J250301,,220,,2099623.23
2025/03/05,2025/03/01,SF FuneralFDC00000002VHD250301,,220,,2099843.23
2025/03/05,2025/03/01,SF FuneralFDC00000002VP5250301,,220,,2100063.23
2025/03/05,2025/03/01,SF FuneralFDC00000002VR6250301,,220,,2100283.23
2025/03/05,2025/03/01,SF FuneralFDC00000002VVC250301,,220,,2100503.23
2025/03/05,2025/03/01,SF FuneralFDC00000002W26250301,,220,,2100723.23
2025/03/05,2025/03/01,SF FuneralFDC00000002W4Q250301,,220,,2100943.23
2025/03/05,2025/03/01,SF FuneralFDC00000002WPK250301,,220,,2101163.23
2025/03/05,2025/03/01,SF FuneralFDC00000002X4V250301,,220,,2101383.23
2025/03/05,2025/03/01,SF FuneralFDC00000002X9M250301,,220,,2101603.23
2025/03/05,2025/03/01,SF FuneralFDC00000002YDD250301,,220,,2101823.23
2025/03/05,2025/03/01,SF FuneralFDC00000002YV2250301,,220,,2102043.23
2025/03/05,2025/03/01,SF FuneralFDC000000031KH250301,,220,,2102263.23
2025/03/05,2025/03/01,SF FuneralFDC000000031Q6250301,,220,,2102483.23
2025/03/05,2025/03/01,SF FuneralFDC00000003363250301,,220,,2102703.23
2025/03/05,2025/03/01,SF FuneralFDC0000000337C250301,,220,,2102923.23
2025/03/05,2025/03/01,SF FuneralFDC0000000337R250301,,220,,2103143.23
2025/03/05,2025/03/01,SF FuneralFDC000000033D7250301,,220,,2103363.23
2025/03/05,2025/03/01,SF FuneralFDC000000033FC250301,,220,,2103583.23
2025/03/05,2025/03/01,SF FuneralFDC000000033GY250301,,220,,2103803.23
2025/03/05,2025/03/01,SF FuneralFDC000000033H3250301,,220,,2104023.23
2025/03/05,2025/03/01,SF FuneralFDC000000033KS250301,,220,,2104243.23
2025/03/05,2025/03/01,SF FuneralFDC000000033P9250301,,220,,2104463.23
2025/03/05,2025/03/01,SF FuneralFDC000000033RG250301,,220,,2104683.23
2025/03/05,2025/03/01,SF FuneralFDC00000003401250301,,220,,2104903.23
2025/03/05,2025/03/01,SF FuneralFDC00000003479250301,,220,,2105123.23
2025/03/05,2025/03/01,SF FuneralFDC000000034BY250301,,220,,2105343.23
2025/03/05,2025/03/01,SF FuneralFDC000000034PL250301,,220,,2105563.23
2025/03/05,2025/03/01,SF FuneralFDC000000034PN250301,,220,,2105783.23
2025/03/05,2025/03/01,SF FuneralFDC000000034R5250301,,220,,2106003.23
2025/03/05,2025/03/01,SF FuneralFDC000000037DS250301,,220,,2106223.23
2025/03/05,2025/03/01,SF FuneralFDC00000003DJ6250301,,220,,2106443.23
2025/03/05,2025/03/01,SF FuneralFDC00000003K85250301,,220,,2106663.23
2025/03/05,2025/03/01,SF FuneralFDC00000003M2S250301,,220,,2106883.23
2025/03/05,2025/03/01,SF FuneralFDC00000003SJP250301,,220,,2107103.23
2025/03/05,2025/03/01,SF FuneralFDC00000003TW0250301,,220,,2107323.23
2025/03/05,2025/03/01,SF FuneralFDC00000003VXG250301,,220,,2107543.23
2025/03/05,2025/03/01,SF FuneralFDC000000040WW250301,,220,,2107763.23
2025/03/05,2025/03/01,SF FuneralFDC0000000411V250301,,220,,2107983.23
2025/03/05,2025/03/01,SF FuneralFDC000000041RD250301,,220,,2108203.23
2025/03/05,2025/03/01,SF FuneralFDC000000041S9250301,,220,,2108423.23
2025/03/05,2025/03/01,SF FuneralFDC00000004321250301,,220,,2108643.23
2025/03/05,2025/03/01,SF FuneralFDC0000000455B250301,,220,,2108863.23
2025/03/05,2025/03/01,SF FuneralFDC00000004978250301,,220,,2109083.23
2025/03/05,2025/03/01,SF FuneralFDC00000004H3V250301,,220,,2109303.23
2025/03/05,2025/03/01,SF FuneralFDC00000004HXN250301,,220,,2109523.23
2025/03/05,2025/03/01,SF FuneralFDC000000057NB250301,,126.5,,2109649.73
2025/03/05,2025/03/01,SF FuneralFDC000000059GC250301,,126.5,,2109776.23
2025/03/05,2025/03/01,SF FuneralFDC00000005D42250301,,126.5,,2109902.73
2025/03/05,2025/03/01,SF FuneralFDC00000005D5Q250301,,126.5,,2110029.23
2025/03/05,2025/03/01,SF FuneralFDC00000005GGN250301,,126.5,,2110155.73
2025/03/05,2025/03/01,SF FuneralFDC00000005JBZ250301,,126.5,,2110282.23
2025/03/05,2025/03/01,SF FuneralFDC00000005MNG250301,,256.5,,2110538.73
2025/03/05,2025/03/01,SF FuneralFDC00000005PSC250301,,126.5,,2110665.23
2025/03/05,2025/03/01,SF FuneralFDC00000005Q2V250301,,126.5,,2110791.73
2025/03/05,2025/03/01,SF FuneralFDC00000005Q46250301,,126.5,,2110918.23
2025/03/05,2025/03/01,SF FuneralFDC00000005QBR250301,,126.5,,2111044.73
2025/03/05,2025/03/01,SF FuneralFDC00000005RWH250301,,220,,2111264.73
2025/03/05,2025/03/01,SF FuneralFDC00000005RZS250301,,126.5,,2111391.23
2025/03/05,2025/03/01,SF FuneralFDC00000005TS6250301,,126.5,,2111517.73
2025/03/05,2025/03/01,SF FuneralFDC00000005V30250301,,126.5,,2111644.23
2025/03/05,2025/03/01,SF FuneralFDC00000005VN4250301,,126.5,,2111770.73
2025/03/05,2025/03/01,SF FuneralFDC00000005VRF250301,,126.5,,2111897.23
2025/03/05,2025/03/01,SF FuneralFDC00000005X4G250301,,126.5,,2112023.73
2025/03/05,2025/03/01,SF FuneralFDC0000000696H250301,,126.5,,2112150.23
2025/03/05,2025/03/01,SF FuneralFDC000000069BZ250301,,126.5,,2112276.73
2025/03/05,2025/03/01,SF FuneralFDC000000069FR250301,,126.5,,2112403.23
2025/03/05,2025/03/01,SF FuneralFDC000000069XJ250301,,126.5,,2112529.73
2025/03/05,2025/03/01,SF FuneralFDC00000006B5L250301,,126.5,,2112656.23
2025/03/05,2025/03/01,SF FuneralFDC00000006B7V250301,,126.5,,2112782.73
2025/03/05,2025/03/01,SF FuneralFDC00000006B9K250301,,126.5,,2112909.23
2025/03/05,2025/03/01,SF FuneralFDC00000006BFT250301,,126.5,,2113035.73
2025/03/05,2025/03/01,SF FuneralFDC00000006BR9250301,,126.5,,2113162.23
2025/03/05,2025/03/01,SF FuneralFDC00000006BWD250301,,126.5,,2113288.73
2025/03/05,2025/03/01,SF FuneralFDC00000006C1Y250301,,126.5,,2113415.23
2025/03/05,2025/03/01,SF FuneralFDC00000006C59250301,,126.5,,2113541.73
2025/03/05,2025/03/01,SF FuneralFDC00000006C62250301,,126.5,,2113668.23
2025/03/05,2025/03/01,SF FuneralFDC00000006DBY250301,,126.5,,2113794.73
2025/03/05,2025/03/01,SF FuneralFDC00000006DDC250301,,256.5,,2114051.23
2025/03/05,2025/03/01,SF FuneralFDC00000006DJL250301,,126.5,,2114177.73
2025/03/05,2025/03/01,SF FuneralFDC00000006F3P250301,,126.5,,2114304.23
2025/03/05,2025/03/01,SF FuneralFDC00000006F84250301,,126.5,,2114430.73
2025/03/05,2025/03/01,SF FuneralFDC00000006FB0250301,,126.5,,2114557.23
2025/03/05,2025/03/01,SF FuneralFDC00000006FCH250301,,126.5,,2114683.73
2025/03/05,2025/03/01,SF FuneralFDC00000006GQ1250301,,126.5,,2114810.23
2025/03/05,2025/03/01,SF FuneralFDC00000006GS5250301,,126.5,,2114936.73
2025/03/05,2025/03/01,SF FuneralFDC00000006GT2250301,,126.5,,2115063.23
2025/03/05,2025/03/01,SF FuneralFDC00000006GV9250301,,126.5,,2115189.73
2025/03/05,2025/03/01,SF FuneralFDC00000006GZG250301,,126.5,,2115316.23
2025/03/05,2025/03/01,SF FuneralFDC00000006H1N250301,,126.5,,2115442.73
2025/03/05,2025/03/01,SF FuneralFDC00000006H5W250301,,126.5,,2115569.23
2025/03/05,2025/03/01,SF FuneralFDC00000006HH5250301,,126.5,,2115695.73
2025/03/05,2025/03/01,SF FuneralFDC00000006HL5250301,,126.5,,2115822.23
2025/03/05,2025/03/01,SF FuneralFDC00000006HLC250301,,126.5,,2115948.73
2025/03/05,2025/03/01,SF FuneralFDC00000006J0Q250301,,126.5,,2116075.23
2025/03/05,2025/03/01,SF FuneralFDC00000006J1P250301,,126.5,,2116201.73
2025/03/05,2025/03/01,SF FuneralFDC00000006K1H250301,,126.5,,2116328.23
2025/03/05,2025/03/01,SF FuneralFDC00000006K1L250301,,126.5,,2116454.73
2025/03/05,2025/03/01,SF FuneralFDC00000006KCZ250301,,126.5,,2116581.23
2025/03/05,2025/03/01,SF FuneralFDC00000006L4G250301,,126.5,,2116707.73
2025/03/05,2025/03/01,SF FuneralFDC00000006L6V250301,,126.5,,2116834.23
2025/03/05,2025/03/01,SF FuneralFDC00000006L8Y250301,,126.5,,2116960.73
2025/03/05,2025/03/01,SF FuneralFDC00000006LQ4250301,,126.5,,2117087.23
2025/03/05,2025/03/01,SF FuneralFDC00000006LXS250301,,126.5,,2117213.73
2025/03/05,2025/03/01,SF FuneralFDC00000006LY4250301,,126.5,,2117340.23
2025/03/05,2025/03/01,SF FuneralFDC00000006MJ4250301,,126.5,,2117466.73
2025/03/05,2025/03/01,SF FuneralFDC00000006MS2250301,,220,,2117686.73
2025/03/05,2025/03/01,SF FuneralFDC00000006NK1250301,,126.5,,2117813.23
2025/03/05,2025/03/01,SF FuneralFDC00000006NKF250301,,126.5,,2117939.73
2025/03/05,2025/03/01,SF FuneralFDC00000006S29250301,,126.5,,2118066.23
2025/03/05,2025/03/01,SF FuneralFDC00000006T59250301,,126.5,,2118192.73
2025/03/05,2025/03/01,SF FuneralFDC00000006T5F250301,,126.5,,2118319.23
2025/03/05,2025/03/01,SF FuneralFDC00000006VZJ250301,,126.5,,2118445.73
2025/03/05,2025/03/01,SF FuneralFDC00000006WPQ250301,,126.5,,2118572.23
2025/03/05,2025/03/01,SF FuneralFDC00000006WTM250301,,126.5,,2118698.73
2025/03/05,2025/03/01,SF FuneralFDC00000006X8L250301,,126.5,,2118825.23
2025/03/05,2025/03/01,SF FuneralFDC00000006XN9250301,,126.5,,2118951.73
2025/03/05,2025/03/01,SF FuneralFDC00000006XVM250301,,126.5,,2119078.23
2025/03/05,2025/03/01,SF FuneralFDC00000007193250301,,126.5,,2119204.73
2025/03/05,2025/03/01,SF FuneralFDC000000073PH250301,,126.5,,2119331.23
2025/03/05,2025/03/01,SF FuneralFDC0000000748P250301,,126.5,,2119457.73
2025/03/05,2025/03/01,SF FuneralFDC000000074C3250301,,126.5,,2119584.23
2025/03/05,2025/03/01,SF FuneralFDC000000074FF250301,,126.5,,2119710.73
2025/03/05,2025/03/01,SF FuneralFDC000000074PV250301,,126.5,,2119837.23
2025/03/05,2025/03/01,SF FuneralFDC000000074RG250301,,191.5,,2120028.73
2025/03/05,2025/03/01,SF FuneralFDC000000074SF250301,,126.5,,2120155.23
2025/03/05,2025/03/01,SF FuneralFDC000000074VJ250301,,126.5,,2120281.73
2025/03/05,2025/03/01,SF FuneralFDC0000000750P250301,,126.5,,2120408.23
2025/03/05,2025/03/01,SF FuneralFDC0000000754X250301,,126.5,,2120534.73
2025/03/05,2025/03/01,SF FuneralFDC00000007599250301,,126.5,,2120661.23
2025/03/05,2025/03/01,SF FuneralFDC000000075B1250301,,126.5,,2120787.73
2025/03/05,2025/03/01,SF FuneralFDC000000075DD250301,,126.5,,2120914.23
2025/03/05,2025/03/01,SF FuneralFDC000000075FP250301,,126.5,,2121040.73
2025/03/05,2025/03/01,SF FuneralFDC000000075H4250301,,126.5,,2121167.23
2025/03/05,2025/03/01,SF FuneralFDC000000075MV250301,,126.5,,2121293.73
2025/03/05,2025/03/01,SF FuneralFDC000000075Q9250301,,126.5,,2121420.23
2025/03/05,2025/03/01,SF FuneralFDC000000075R1250301,,126.5,,2121546.73
2025/03/05,2025/03/01,SF FuneralFDC000000075RB250301,,126.5,,2121673.23
2025/03/05,2025/03/01,SF FuneralFDC000000075TX250301,,126.5,,2121799.73
2025/03/05,2025/03/01,SF FuneralFDC000000075Y3250301,,126.5,,2121926.23
2025/03/05,2025/03/01,SF FuneralFDC000000076K3250301,,126.5,,2122052.73
2025/03/05,2025/03/01,SF FuneralFDC000000076YC250301,,126.5,,2122179.23
2025/03/05,2025/03/01,SF FuneralFDC000000077CX250301,,126.5,,2122305.73
2025/03/05,2025/03/01,SF FuneralFDC000000077VC250301,,126.5,,2122432.23
2025/03/05,2025/03/01,SF FuneralFDC0000000784P250301,,126.5,,2122558.73
2025/03/05,2025/03/01,SF FuneralFDC000000079H5250301,,126.5,,2122685.23
2025/03/05,2025/03/01,SF FuneralFDC000000079J6250301,,126.5,,2122811.73
2025/03/05,2025/03/01,SF FuneralFDC000000079JT250301,,126.5,,2122938.23
2025/03/05,2025/03/01,SF FuneralFDC000000079LY250301,,126.5,,2123064.73
2025/03/05,2025/03/01,SF FuneralFDC000000079S9250301,,126.5,,2123191.23
2025/03/05,2025/03/01,SF FuneralFDC000000079VD250301,,126.5,,2123317.73
2025/03/05,2025/03/01,SF FuneralFDC00000007B0N250301,,126.5,,2123444.23
2025/03/05,2025/03/01,SF FuneralFDC00000007BFG250301,,126.5,,2123570.73
2025/03/05,2025/03/01,SF FuneralFDC00000007BJ3250301,,126.5,,2123697.23
2025/03/05,2025/03/01,SF FuneralFDC00000007BSK250301,,220,,2123917.23
2025/03/05,2025/03/01,SF FuneralFDC00000007BV7250301,,126.5,,2124043.73
2025/03/05,2025/03/01,SF FuneralFDC00000007CZT250301,,126.5,,2124170.23
2025/03/05,2025/03/01,SF FuneralFDC00000007DB5250301,,126.5,,2124296.73
2025/03/05,2025/03/01,SF FuneralFDC00000007DCX250301,,126.5,,2124423.23
2025/03/05,2025/03/01,SF FuneralFDC00000007DCZ250301,,126.5,,2124549.73
2025/03/05,2025/03/01,SF FuneralFDC00000007F3Y250301,,220,,2124769.73
2025/03/05,2025/03/01,SF FuneralFDC00000007HQ5250301,,126.5,,2124896.23
2025/03/05,2025/03/01,SF FuneralFDC00000007HXV250301,,126.5,,2125022.73
2025/03/05,2025/03/01,SF FuneralFDC00000007KBZ250301,,126.5,,2125149.23
2025/03/05,2025/03/01,SF FuneralFDC00000007KMT250301,,126.5,,2125275.73
2025/03/05,2025/03/01,SF FuneralFDC00000007LYS250301,,126.5,,2125402.23
2025/03/05,2025/03/01,SF FuneralFDC00000007Q5S250301,,126.5,,2125528.73
2025/03/05,2025/03/01,SF FuneralF793825       250301,,126.5,,2125655.23
2025/03/05,2025/03/01,SF FuneralFDC00000007Q8G250301,,126.5,,2125781.73
2025/03/05,2025/03/01,SF FuneralFDC00000007QXX250301,,126.5,,2125908.23
2025/03/05,2025/03/01,SF FuneralFDC00000007R2G250301,,126.5,,2126034.73
2025/03/05,2025/03/01,SF FuneralFDC00000007R8B250301,,126.5,,2126161.23
2025/03/05,2025/03/01,SF FuneralFDC00000007R8F250301,,126.5,,2126287.73
2025/03/05,2025/03/01,SF FuneralFDC00000007RFT250301,,126.5,,2126414.23
2025/03/05,2025/03/01,SF FuneralFDC00000007RFV250301,,126.5,,2126540.73
2025/03/05,2025/03/01,SF FuneralFDC00000007RGG250301,,126.5,,2126667.23
2025/03/05,2025/03/01,SF FuneralFDC00000007RMK250301,,126.5,,2126793.73
2025/03/05,2025/03/01,SF FuneralFDC00000007RPY250301,,126.5,,2126920.23
2025/03/05,2025/03/01,SF FuneralFDC00000007SGT250301,,126.5,,2127046.73
2025/03/05,2025/03/01,SF FuneralFDC00000007TVX250301,,126.5,,2127173.23
2025/03/05,2025/03/01,SF FuneralFDC00000007VQQ250301,,126.5,,2127299.73
2025/03/05,2025/03/01,SF FuneralF795548       250301,,126.5,,2127426.23
2025/03/05,2025/03/01,SF FuneralFDC00000007XC2250301,,126.5,,2127552.73
2025/03/05,2025/03/01,SF FuneralFDC00000007ZGX250301,,126.5,,2127679.23
2025/03/05,2025/03/01,SF FuneralFDC0000000800G250301,,126.5,,2127805.73
2025/03/05,2025/03/01,SF FuneralFDC000000080GS250301,,126.5,,2127932.23
2025/03/05,2025/03/01,SF FuneralFDC000000080KN250301,,126.5,,2128058.73
2025/03/05,2025/03/01,SF FuneralFDC00000008229250301,,191.5,,2128250.23
2025/03/05,2025/03/01,SF FuneralFDC000000084GS250301,,126.5,,2128376.73
2025/03/05,2025/03/01,SF FuneralFDC000000085Q4250301,,126.5,,2128503.23
2025/03/05,2025/03/01,SF FuneralFDC000000085XR250301,,126.5,,2128629.73
2025/03/05,2025/03/01,SF FuneralF798769       250301,,126.5,,2128756.23
2025/03/05,2025/03/01,SF FuneralFDC00000008647250301,,126.5,,2128882.73
2025/03/05,2025/03/01,SF FuneralFDC000000086F3250301,,126.5,,2129009.23
2025/03/05,2025/03/01,SF FuneralF782386       250301,,191.5,,2129200.73
2025/03/05,2025/03/01,SF FuneralFDC000000087LY250301,,126.5,,2129327.23
2025/03/05,2025/03/01,SF FuneralF799522       250301,,126.5,,2129453.73
2025/03/05,2025/03/01,SF FuneralF799523       250301,,126.5,,2129580.23
2025/03/05,2025/03/01,SF FuneralFDC000000088WG250301,,126.5,,2129706.73
2025/03/05,2025/03/01,SF FuneralFDC000000089NV250301,,126.5,,2129833.23
2025/03/05,2025/03/01,SF FuneralF800779       250301,,126.5,,2129959.73
2025/03/05,2025/03/01,SF FuneralFDC00000008CMF250301,,256.5,,2130216.23
2025/03/05,2025/03/01,SF FuneralFDC00000008JB8250301,,126.5,,2130342.73
2025/03/05,2025/03/01,SF FuneralFDC00000008L8Y250301,,126.5,,2130469.23
2025/03/05,2025/03/01,SF FuneralF802839       250301,,126.5,,2130595.73
2025/03/05,2025/03/01,SF FuneralFDC00000008LFL250301,,126.5,,2130722.23
2025/03/05,2025/03/01,SF FuneralFDC00000008LY4250301,,126.5,,2130848.73
2025/03/05,2025/03/01,SF FuneralFDC00000008M0P250301,,126.5,,2130975.23
2025/03/05,2025/03/01,SF FuneralFDC00000008M1P250301,,126.5,,2131101.73
2025/03/05,2025/03/01,SF FuneralF803195       250301,,126.5,,2131228.23
2025/03/05,2025/03/01,SF FuneralF781930       250301,,256.5,,2131484.73
2025/03/05,2025/03/01,SF FuneralF803984       250301,,126.5,,2131611.23
2025/03/05,2025/03/01,SF FuneralF789872       250301,,126.5,,2131737.73
2025/03/05,2025/03/01,SF FuneralF804086       250301,,126.5,,2131864.23
2025/03/05,2025/03/01,SF FuneralF804107       250301,,126.5,,2131990.73
2025/03/05,2025/03/01,SF FuneralFDC00000008PY6250301,,126.5,,2132117.23
2025/03/05,2025/03/01,SF FuneralFDC00000008PY8250301,,126.5,,2132243.73
2025/03/05,2025/03/01,SF FuneralF805280       250301,,126.5,,2132370.23
2025/03/05,2025/03/01,SF FuneralFDC00000009100250301,,126.5,,2132496.73
2025/03/05,2025/03/01,SF FuneralF809226       250301,,126.5,,2132623.23
2025/03/05,2025/03/01,SF FuneralF809252       250301,,126.5,,2132749.73
2025/03/05,2025/03/01,SF FuneralF810253       250301,,126.5,,2132876.23
2025/03/05,2025/03/01,SF FuneralFDC000000097F5250301,,126.5,,2133002.73
2025/03/05,2025/03/01,SF FuneralF812606       250301,,126.5,,2133129.23
2025/03/05,2025/03/01,SF FuneralF812640       250301,,126.5,,2133255.73
2025/03/05,2025/03/01,SF FuneralFDC00000009FL9250301,,126.5,,2133382.23
2025/03/05,2025/03/01,SF FuneralF812742       250301,,126.5,,2133508.73
2025/03/05,2025/03/01,SF FuneralFDC00000009FQ8250301,,256.5,,2133765.23
2025/03/05,2025/03/01,SF FuneralF812757       250301,,126.5,,2133891.73
2025/03/05,2025/03/01,SF FuneralF812852       250301,,126.5,,2134018.23
2025/03/05,2025/03/01,SF FuneralF812862       250301,,126.5,,2134144.73
2025/03/05,2025/03/01,SF FuneralF812939       250301,,126.5,,2134271.23
2025/03/05,2025/03/01,SF FuneralF814097       250301,,126.5,,2134397.73
2025/03/05,2025/03/01,SF FuneralF814388       250301,,126.5,,2134524.23
2025/03/05,2025/03/01,SF FuneralFDC00000009MDJ250301,,126.5,,2134650.73
2025/03/05,2025/03/01,SF FuneralFDC00000009VPX250301,,126.5,,2134777.23
2025/03/05,2025/03/01,SF FuneralF816636       250301,,126.5,,2134903.73
2025/03/05,2025/03/01,SF FuneralF816646       250301,,126.5,,2135030.23
2025/03/05,2025/03/01,SF FuneralF816787       250301,,126.5,,2135156.73
2025/03/05,2025/03/01,SF FuneralF816934       250301,,126.5,,2135283.23
2025/03/05,2025/03/01,SF FuneralF817201       250301,,126.5,,2135409.73
2025/03/05,2025/03/01,SF FuneralF817382       250301,,126.5,,2135536.23
2025/03/05,2025/03/01,SF FuneralF817482       250301,,126.5,,2135662.73
2025/03/05,2025/03/01,SF FuneralF817740       250301,,126.5,,2135789.23
2025/03/05,2025/03/01,SF FuneralFDC00000009ZXC250301,,220,,2136009.23
2025/03/05,2025/03/01,SF FuneralF818295       250301,,126.5,,2136135.73
2025/03/05,2025/03/01,SF FuneralF820585       250301,,126.5,,2136262.23
2025/03/05,2025/03/01,SF FuneralF820596       250301,,126.5,,2136388.73
2025/03/05,2025/03/01,SF FuneralFDC0000000B863250301,,126.5,,2136515.23
2025/03/05,2025/03/01,SF FuneralF820628       250301,,126.5,,2136641.73
2025/03/05,2025/03/01,SF FuneralFDC0000000B8D7250301,,256.5,,2136898.23
2025/03/05,2025/03/01,SF FuneralF821842       250301,,126.5,,2137024.73
2025/03/05,2025/03/01,SF FuneralF822123       250301,,126.5,,2137151.23
2025/03/05,2025/03/01,SF FuneralF822151       250301,,126.5,,2137277.73
2025/03/05,2025/03/01,SF FuneralF823204       250301,,126.5,,2137404.23
2025/03/05,2025/03/01,SF FuneralF828235       250301,,126.5,,2137530.73
2025/03/05,2025/03/01,SF FuneralF828244       250301,,126.5,,2137657.23
2025/03/05,2025/03/01,SF FuneralF828247       250301,,126.5,,2137783.73
2025/03/05,2025/03/01,SF FuneralFDC0000000BP85250301,,126.5,,2137910.23
2025/03/05,2025/03/01,SF FuneralF828339       250301,,126.5,,2138036.73
2025/03/05,2025/03/01,SF FuneralF828417       250301,,126.5,,2138163.23
2025/03/05,2025/03/01,SF FuneralF828434       250301,,126.5,,2138289.73
2025/03/05,2025/03/01,SF FuneralF829614       250301,,126.5,,2138416.23
2025/03/05,2025/03/01,SF FuneralF830573       250301,,126.5,,2138542.73
2025/03/05,2025/03/01,SF FuneralF831562       250301,,126.5,,2138669.23
2025/03/05,2025/03/01,SF FuneralF832788       250301,,126.5,,2138795.73
2025/03/05,2025/03/01,SF FuneralF833129       250301,,126.5,,2138922.23
2025/03/05,2025/03/01,SF FuneralF833170       250301,,126.5,,2139048.73
2025/03/05,2025/03/01,SF FuneralFDC0000000CR3B250301,,126.5,,2139175.23
2025/03/05,2025/03/01,SF FuneralF834560       250301,,126.5,,2139301.73
2025/03/05,2025/03/01,SF FuneralFDC0000000DBYW250301,,191.5,,2139493.23
2025/03/05,2025/03/01,SF FuneralF841309       250301,,126.5,,2139619.73
2025/03/05,2025/03/01,SF FuneralF841478       250301,,126.5,,2139746.23
2025/03/05,2025/03/01,SF FuneralF841623       250301,,126.5,,2139872.73
2025/03/05,2025/03/01,SF FuneralF841760       250301,,126.5,,2139999.23
2025/03/05,2025/03/01,SF FuneralF841982       250301,,126.5,,2140125.73
2025/03/05,2025/03/01,SF FuneralF842112       250301,,126.5,,2140252.23
2025/03/05,2025/03/01,SF FuneralF842553       250301,,126.5,,2140378.73
2025/03/05,2025/03/01,SF FuneralF842586       250301,,126.5,,2140505.23
2025/03/05,2025/03/01,SF FuneralF993062       250301,,126.5,,2140631.73
2025/03/05,2025/03/01,SF FuneralF1016880      250301,,126.5,,2140758.23
2025/03/05,2025/03/01,SF FuneralF1021949      250301,,126.5,,2140884.73
2025/03/05,2025/03/01,SF FuneralFDC0000000JYD2250301,,126.5,,2141011.23
2025/03/05,2025/03/01,SF FuneralFDC0000000JZ4D250301,,126.5,,2141137.73
2025/03/05,2025/03/01,SF FuneralFDC0000000JZWN250301,,256.5,,2141394.23
2025/03/05,2025/03/01,SF FuneralFDC0000000K275250301,,126.5,,2141520.73
2025/03/05,2025/03/01,SF FuneralF1052685      250301,,126.5,,2141647.23
2025/03/05,2025/03/01,SF FuneralF1058770      250301,,126.5,,2141773.73
2025/03/05,2025/03/01,SF FuneralFDC0000000KCDD250301,,126.5,,2141900.23
2025/03/05,2025/03/01,SF FuneralF1060103      250301,,126.5,,2142026.73
2025/03/05,2025/03/01,SF FuneralFDC0000000KM0P250301,,126.5,,2142153.23
2025/03/05,2025/03/01,SF FuneralF1061702      250301,,126.5,,2142279.73
2025/03/05,2025/03/01,SF FuneralFDC0000000KVSP250301,,126.5,,2142406.23
2025/03/05,2025/03/01,SF FuneralF1066492      250301,,126.5,,2142532.73
2025/03/05,2025/03/01,SF FuneralF1079067      250301,,126.5,,2142659.23
2025/03/05,2025/03/01,SF FuneralF1079812      250301,,126.5,,2142785.73
2025/03/05,2025/03/01,SF FuneralF1084554      250301,,126.5,,2142912.23
2025/03/05,2025/03/01,SF FuneralF1084732      250301,,126.5,,2143038.73
2025/03/05,2025/03/01,SF FuneralF1109014      250301,,126.5,,2143165.23
2025/03/05,2025/03/01,SF FuneralF1109077      250301,,126.5,,2143291.73
2025/03/05,2025/03/01,SF FuneralF1109555      250301,,126.5,,2143418.23
2025/03/05,2025/03/01,SF FuneralF1110072      250301,,126.5,,2143544.73
2025/03/05,2025/03/01,SF FuneralF1110189      250301,,126.5,,2143671.23
2025/03/05,2025/03/01,SF FuneralF1111529      250301,,126.5,,2143797.73
2025/03/05,2025/03/01,SF FuneralF1113338      250301,,126.5,,2143924.23
2025/03/05,2025/03/01,SF FuneralF1114484      250301,,126.5,,2144050.73
2025/03/05,2025/03/01,SF FuneralF1114649      250301,,126.5,,2144177.23
2025/03/05,2025/03/01,SF FuneralFDC0000000N9X2250301,,126.5,,2144303.73
2025/03/05,2025/03/01,SF FuneralF1117657      250301,,126.5,,2144430.23
2025/03/05,2025/03/01,SF FuneralF1117658      250301,,126.5,,2144556.73
2025/03/05,2025/03/01,SF FuneralF744097       250301,,220,,2144776.73
2025/03/05,2025/03/01,SF FuneralFDC0000000NMVB250301,,126.5,,2144903.23
2025/03/05,2025/03/01,SF FuneralF1118461      250301,,126.5,,2145029.73
2025/03/05,2025/03/01,SF FuneralF1118977      250301,,126.5,,2145156.23
2025/03/05,2025/03/01,SF FuneralFDC0000000NXN8250301,,126.5,,2145282.73
2025/03/05,2025/03/01,SF FuneralFDC0000000P0MM250301,,126.5,,2145409.23
2025/03/05,2025/03/01,SF FuneralFDC0000000P0MS250301,,126.5,,2145535.73
2025/03/05,2025/03/01,SF FuneralFDC0000000P0W9250301,,126.5,,2145662.23
2025/03/05,2025/03/01,SF FuneralF1122279      250301,,126.5,,2145788.73
2025/03/05,2025/03/01,SF FuneralF1123259      250301,,126.5,,2145915.23
2025/03/05,2025/03/01,SF FuneralF1123917      250301,,126.5,,2146041.73
2025/03/05,2025/03/01,SF FuneralFDC0000000P7DN250301,,126.5,,2146168.23
2025/03/05,2025/03/01,SF FuneralF1125113      250301,,126.5,,2146294.73
2025/03/05,2025/03/01,SF FuneralF1127117      250301,,126.5,,2146421.23
2025/03/05,2025/03/01,SF FuneralFDC0000000PTNT250301,,256.5,,2146677.73
2025/03/05,2025/03/01,SF FuneralFDC0000000Q1NV250301,,191.5,,2146869.23
2025/03/05,2025/03/04,SF FuneralFDC0000000J8LQ250304,,63.25,,2146932.48
2025/03/05,2025/02/28,SF FuneralF991163       250301,,126.5,,2147058.98
2025/03/05,2025/03/01,SF FuneralFDC00000003375250301,,220,,2147278.98
2025/03/05,2025/03/01,SF FuneralFDC00000005N3K250301,,126.5,,2147405.48
2025/03/05,2025/03/01,SF FuneralFDC00000007FXX250301,,126.5,,2147531.98
2025/03/05,2025/03/01,SF FuneralFDC00000007J6M250301,,126.5,,2147658.48
2025/03/05,2025/03/01,SF FuneralF789403       250301,,126.5,,2147784.98
2025/03/05,2025/03/01,SF FuneralF815037       250301,,126.5,,2147911.48
2025/03/05,2025/03/01,SF FuneralF1022194      250301,,126.5,,2148037.98
2025/03/05,2025/03/01,SF FuneralF1066706      250301,,126.5,,2148164.48
2025/03/05,2025/03/01,SF FuneralF1118057      250301,,126.5,,2148290.98
2025/03/05,2025/03/01,SF FuneralF1131664      250301,,126.5,,2148417.48
2025/03/05,2025/03/01,SF FuneralF1060257      250301,,191.5,,2148608.98
2025/03/05,2025/03/01,SF FuneralF1074785      250301,,31.63,,2148640.61
2025/03/05,2025/02/26,SF FuneralF992509       250226,,126.5,,2148767.11
2025/03/05,2025/03/04,SF FuneralF823504       250304,,31.63,,2148798.74
2025/03/05,2025/02/28,SF FuneralF842509       250228,,126.5,,2148925.24
2025/03/05,2025/02/28,SF FuneralFDC00000006F75250228,,126.5,,2149051.74
2025/03/05,2025/02/28,SF FuneralF816763       250228,,126.5,,2149178.24
2025/03/05,2025/02/28,SF FuneralF842552       250228,,126.5,,2149304.74
2025/03/05,2025/02/28,SF FuneralF901022       250302,,126.5,,2149431.24
2025/03/05,2025/02/28,SF FuneralF901087       250302,,126.5,,2149557.74
2025/03/05,2025/02/28,SF FuneralF986680       250301,,126.5,,2149684.24
2025/03/05,2025/02/28,SF FuneralF987791       250301,,126.5,,2149810.74
2025/03/05,2025/02/28,SF FuneralF987808       250301,,126.5,,2149937.24
2025/03/05,2025/02/28,SF FuneralF987848       250301,,126.5,,2150063.74
2025/03/05,2025/02/28,SF FuneralF987928       250301,,126.5,,2150190.24
2025/03/05,2025/02/28,SF FuneralF987971       250301,,126.5,,2150316.74
2025/03/05,2025/02/28,SF FuneralF719196       250301,,220,,2150536.74
2025/03/05,2025/02/28,SF FuneralF988289       250301,,126.5,,2150663.24
2025/03/05,2025/02/28,SF FuneralF988301       250301,,126.5,,2150789.74
2025/03/05,2025/02/28,SF FuneralF988531       250301,,126.5,,2150916.24
2025/03/05,2025/02/28,SF FuneralF988612       250301,,126.5,,2151042.74
2025/03/05,2025/02/28,SF FuneralF990173       250301,,126.5,,2151169.24
2025/03/05,2025/02/28,SF FuneralF990616       250301,,126.5,,2151295.74
2025/03/05,2025/02/28,SF FuneralF1131669      250228,,126.5,,2151422.24
2025/03/05,2025/03/01,SF FuneralFDC00000002XML250301,,220,,2151642.24
2025/03/05,2025/03/01,SF FuneralFDC000000034P1250301,,220,,2151862.24
2025/03/05,2025/03/01,SF FuneralFDC00000005CYL250301,,126.5,,2151988.74
2025/03/05,2025/03/01,SF FuneralFDC00000005MJ0250301,,126.5,,2152115.24
2025/03/05,2025/03/01,SF FuneralFDC000000069CF250301,,126.5,,2152241.74
2025/03/05,2025/03/01,SF FuneralFDC00000006B2F250301,,126.5,,2152368.24
2025/03/05,2025/03/01,SF FuneralFDC00000006F2R250301,,126.5,,2152494.74
2025/03/05,2025/03/01,SF FuneralFDC00000006GPK250301,,126.5,,2152621.24
2025/03/05,2025/03/01,SF FuneralFDC00000006M1X250301,,126.5,,2152747.74
2025/03/05,2025/03/01,SF FuneralFDC000000074NC250301,,126.5,,2152874.24
2025/03/05,2025/03/01,SF FuneralFDC000000074Q6250301,,126.5,,2153000.74
2025/03/05,2025/03/01,SF FuneralFDC0000000784W250301,,126.5,,2153127.24
2025/03/05,2025/03/01,SF FuneralFDC00000007881250301,,126.5,,2153253.74
2025/03/05,2025/03/01,SF FuneralFDC0000000798V250301,,126.5,,2153380.24
2025/03/05,2025/03/01,SF FuneralFDC00000007F7C250301,,126.5,,2153506.74
2025/03/05,2025/03/01,SF FuneralFDC00000007HC4250301,,126.5,,2153633.24
2025/03/05,2025/03/01,SF FuneralF794498       250301,,126.5,,2153759.74
2025/03/05,2025/03/01,SF FuneralF795480       250301,,126.5,,2153886.24
2025/03/05,2025/03/01,SF FuneralFDC00000007ZGS250301,,126.5,,2154012.74
2025/03/05,2025/03/01,SF FuneralFDC000000084DF250301,,126.5,,2154139.24
2025/03/05,2025/03/01,SF FuneralF798732       250301,,126.5,,2154265.74
2025/03/05,2025/03/01,SF FuneralF798994       250301,,126.5,,2154392.24
2025/03/05,2025/03/01,SF FuneralF799858       250301,,126.5,,2154518.74
2025/03/05,2025/03/01,SF FuneralF803799       250301,,126.5,,2154645.24
2025/03/05,2025/03/01,SF FuneralF808817       250301,,126.5,,2154771.74
2025/03/05,2025/03/01,SF FuneralF803357       250301,,191.5,,2154963.24
2025/03/05,2025/03/01,SF FuneralF809123       250301,,126.5,,2155089.74
2025/03/05,2025/03/01,SF FuneralF809453       250301,,126.5,,2155216.24
2025/03/05,2025/03/01,SF FuneralF809785       250301,,126.5,,2155342.74
2025/03/05,2025/03/01,SF FuneralF810040       250301,,126.5,,2155469.24
2025/03/05,2025/03/01,SF FuneralF810420       250301,,126.5,,2155595.74
2025/03/05,2025/03/01,SF FuneralF812423       250301,,126.5,,2155722.24
2025/03/05,2025/03/01,SF FuneralF812494       250301,,126.5,,2155848.74
2025/03/05,2025/03/01,SF FuneralF812504       250301,,126.5,,2155975.24
2025/03/05,2025/03/01,SF FuneralF812677       250301,,126.5,,2156101.74
2025/03/05,2025/03/01,SF FuneralFDC00000009GM8250301,,191.5,,2156293.24
2025/03/05,2025/03/01,SF FuneralF813520       250301,,126.5,,2156419.74
2025/03/05,2025/03/01,SF FuneralF814016       250301,,126.5,,2156546.24
2025/03/05,2025/03/01,SF FuneralF814444       250301,,126.5,,2156672.74
2025/03/05,2025/03/01,SF FuneralF793915       250301,,126.5,,2156799.24
2025/03/05,2025/03/01,SF FuneralF817236       250301,,126.5,,2156925.74
2025/03/05,2025/03/01,SF FuneralF820875       250301,,126.5,,2157052.24
2025/03/05,2025/03/01,SF FuneralF820963       250301,,126.5,,2157178.74
2025/03/05,2025/03/01,SF FuneralF821554       250301,,126.5,,2157305.24
2025/03/05,2025/03/01,SF FuneralF822038       250301,,126.5,,2157431.74
2025/03/05,2025/03/01,SF FuneralF822508       250301,,126.5,,2157558.24
2025/03/05,2025/03/01,SF FuneralF822609       250301,,126.5,,2157684.74
2025/03/05,2025/03/01,SF FuneralF824018       250301,,126.5,,2157811.24
2025/03/05,2025/03/01,SF FuneralF828239       250301,,126.5,,2157937.74
2025/03/05,2025/03/01,SF FuneralF828327       250301,,126.5,,2158064.24
2025/03/05,2025/03/01,SF FuneralF828427       250301,,126.5,,2158190.74
2025/03/05,2025/03/01,SF FuneralF828489       250301,,126.5,,2158317.24
2025/03/05,2025/03/01,SF FuneralF828984       250301,,126.5,,2158443.74
2025/03/05,2025/03/01,SF FuneralF829100       250301,,126.5,,2158570.24
2025/03/05,2025/03/01,SF FuneralF829539       250301,,126.5,,2158696.74
2025/03/05,2025/03/01,SF FuneralF829895       250301,,126.5,,2158823.24
2025/03/05,2025/03/01,SF FuneralF832530       250301,,126.5,,2158949.74
2025/03/05,2025/03/01,SF FuneralF832871       250301,,126.5,,2159076.24
2025/03/05,2025/03/01,SF FuneralF833268       250301,,126.5,,2159202.74
2025/03/05,2025/03/01,SF FuneralF838876       250301,,126.5,,2159329.24
2025/03/05,2025/03/01,SF FuneralF840973       250301,,126.5,,2159455.74
2025/03/05,2025/03/01,SF FuneralF842468       250301,,126.5,,2159582.24
2025/03/05,2025/03/01,SF FuneralF992688       250301,,126.5,,2159708.74
2025/03/05,2025/03/01,SF FuneralF992856       250301,,126.5,,2159835.24
2025/03/05,2025/03/01,SF FuneralF993150       250301,,126.5,,2159961.74
2025/03/05,2025/03/01,SF FuneralF993285       250301,,126.5,,2160088.24
2025/03/05,2025/03/01,SF FuneralF993356       250301,,126.5,,2160214.74
2025/03/05,2025/03/01,SF FuneralF993504       250301,,126.5,,2160341.24
2025/03/05,2025/03/01,SF FuneralF1050796      250301,,126.5,,2160467.74
2025/03/05,2025/03/01,SF FuneralF1052114      250301,,126.5,,2160594.24
2025/03/05,2025/03/01,SF FuneralF1052759      250301,,126.5,,2160720.74
2025/03/05,2025/03/01,SF FuneralF1058769      250301,,126.5,,2160847.24
2025/03/05,2025/03/01,SF FuneralF1059535      250301,,126.5,,2160973.74
2025/03/05,2025/03/01,SF FuneralF1060180      250301,,126.5,,2161100.24
2025/03/05,2025/03/01,SF FuneralF1066423      250301,,126.5,,2161226.74
2025/03/05,2025/03/01,SF FuneralF1066634      250301,,126.5,,2161353.24
2025/03/05,2025/03/01,SF FuneralF1067012      250301,,126.5,,2161479.74
2025/03/05,2025/03/01,SF FuneralF1068339      250302,,126.5,,2161606.24
2025/03/05,2025/03/01,SF FuneralFDC0000000L03C250301,,126.5,,2161732.74
2025/03/05,2025/03/01,SF FuneralF1074441      250301,,126.5,,2161859.24
2025/03/05,2025/03/01,SF FuneralF1078206      250301,,126.5,,2161985.74
2025/03/05,2025/03/01,SF FuneralF1078258      250301,,126.5,,2162112.24
2025/03/05,2025/03/01,SF FuneralF1078973      250301,,126.5,,2162238.74
2025/03/05,2025/03/01,SF FuneralFDC0000000LHZH250301,,126.5,,2162365.24
2025/03/05,2025/03/01,SF FuneralF1084737      250301,,126.5,,2162491.74
2025/03/05,2025/03/01,SF FuneralF1084769      250301,,126.5,,2162618.24
2025/03/05,2025/03/01,SF FuneralF1085000      250301,,126.5,,2162744.74
2025/03/05,2025/03/01,SF FuneralF1104022      250301,,126.5,,2162871.24
2025/03/05,2025/03/01,SF FuneralF1104182      250301,,126.5,,2162997.74
2025/03/05,2025/03/01,SF FuneralF782723       250301,,256.5,,2163254.24
2025/03/05,2025/03/01,SF FuneralF1109750      250301,,126.5,,2163380.74
2025/03/05,2025/03/01,SF FuneralF1109889      250302,,126.5,,2163507.24
2025/03/05,2025/03/01,SF FuneralF1110239      250301,,126.5,,2163633.74
2025/03/05,2025/03/01,SF FuneralF1110333      250301,,126.5,,2163760.24
2025/03/05,2025/03/01,SF FuneralF1110570      250301,,126.5,,2163886.74
2025/03/05,2025/03/01,SF FuneralF1111314      250301,,126.5,,2164013.24
2025/03/05,2025/03/01,SF FuneralF1112256      250301,,126.5,,2164139.74
2025/03/05,2025/03/01,SF FuneralF1113757      250301,,126.5,,2164266.24
2025/03/05,2025/03/01,SF FuneralF1114224      250301,,126.5,,2164392.74
2025/03/05,2025/03/01,SF FuneralF1114436      250301,,126.5,,2164519.24
2025/03/05,2025/03/01,SF FuneralF1114499      250301,,126.5,,2164645.74
2025/03/05,2025/03/01,SF FuneralF1114732      250302,,126.5,,2164772.24
2025/03/05,2025/03/01,SF FuneralF1116019      250301,,126.5,,2164898.74
2025/03/05,2025/03/01,SF FuneralF1117240      250301,,126.5,,2165025.24
2025/03/05,2025/03/01,SF FuneralF1052233      250301,,126.5,,2165151.74
2025/03/05,2025/03/01,SF FuneralF1117414      250301,,126.5,,2165278.24
2025/03/05,2025/03/01,SF FuneralF1118021      250301,,126.5,,2165404.74
2025/03/05,2025/03/01,SF FuneralF1118117      250301,,126.5,,2165531.24
2025/03/05,2025/03/01,SF FuneralF1118943      250301,,126.5,,2165657.74
2025/03/05,2025/03/01,SF FuneralF1119089      250301,,126.5,,2165784.24
2025/03/05,2025/03/01,SF FuneralF1119688      250301,,126.5,,2165910.74
2025/03/05,2025/03/01,SF FuneralF1120132      250301,,126.5,,2166037.24
2025/03/05,2025/03/01,SF FuneralF1122045      250301,,126.5,,2166163.74
2025/03/05,2025/03/01,SF FuneralF1122049      250301,,126.5,,2166290.24
2025/03/05,2025/03/01,SF FuneralF1122060      250301,,126.5,,2166416.74
2025/03/05,2025/03/01,SF FuneralF1122347      250301,,126.5,,2166543.24
2025/03/05,2025/03/01,SF FuneralF1122674      250301,,126.5,,2166669.74
2025/03/05,2025/03/01,SF FuneralF1122779      250301,,126.5,,2166796.24
2025/03/05,2025/03/01,SF FuneralF1122873      250301,,126.5,,2166922.74
2025/03/05,2025/03/01,SF FuneralF1122914      250301,,126.5,,2167049.24
2025/03/05,2025/03/01,SF FuneralF1123194      250301,,126.5,,2167175.74
2025/03/05,2025/03/01,SF FuneralF1123540      250301,,126.5,,2167302.24
2025/03/05,2025/03/01,SF FuneralF1123901      250301,,126.5,,2167428.74
2025/03/05,2025/03/01,SF FuneralF1124514      250301,,126.5,,2167555.24
2025/03/05,2025/03/01,SF FuneralF1125675      250301,,126.5,,2167681.74
2025/03/05,2025/03/01,SF FuneralF1125955      250301,,126.5,,2167808.24
2025/03/05,2025/03/01,SF FuneralF1126224      250301,,126.5,,2167934.74
2025/03/05,2025/03/01,SF FuneralF1126859      250301,,126.5,,2168061.24
2025/03/05,2025/03/01,SF FuneralFDC0000000PLGJ250301,,126.5,,2168187.74
2025/03/05,2025/03/01,SF FuneralF1127362      250301,,126.5,,2168314.24
2025/03/05,2025/03/01,SF FuneralF1127534      250301,,126.5,,2168440.74
2025/03/05,2025/03/01,SF FuneralF1127666      250301,,126.5,,2168567.24
2025/03/05,2025/03/01,SF FuneralF736069       250301,,220,,2168787.24
2025/03/05,2025/03/01,SF FuneralFDC0000000PTP5250301,,220,,2169007.24
2025/03/05,2025/03/01,SF FuneralF1128126      250301,,126.5,,2169133.74
2025/03/05,2025/03/01,SF FuneralF1128661      250301,,126.5,,2169260.24
2025/03/05,2025/03/01,SF FuneralF1128775      250301,,126.5,,2169386.74
2025/03/05,2025/03/01,SF FuneralF1128864      250301,,126.5,,2169513.24
2025/03/05,2025/03/01,SF FuneralF1129033      250301,,126.5,,2169639.74
2025/03/05,2025/03/01,SF FuneralF1129058      250301,,126.5,,2169766.24
2025/03/05,2025/03/01,SF FuneralF1129099      250301,,126.5,,2169892.74
2025/03/05,2025/03/01,SF FuneralFDC0000000PXJW250301,,126.5,,2170019.24
2025/03/05,2025/03/01,SF FuneralF1129406      250301,,126.5,,2170145.74
2025/03/05,2025/03/01,SF FuneralF1129496      250301,,126.5,,2170272.24
2025/03/05,2025/03/01,SF FuneralFDC0000000PZ9M250301,,126.5,,2170398.74
2025/03/05,2025/03/01,SF FuneralF1130659      250301,,126.5,,2170525.24
2025/03/05,2025/03/01,SF FuneralF1131315      250301,,126.5,,2170651.74
2025/03/05,2025/03/01,SF FuneralF1132433      250301,,126.5,,2170778.24
2025/03/05,2025/03/01,SF FuneralF1132938      250301,,126.5,,2170904.74
2025/03/05,2025/03/01,SF FuneralF1133116      250301,,126.5,,2171031.24
2025/03/05,2025/03/01,SF FuneralF1133189      250302,,126.5,,2171157.74
2025/03/05,2025/03/05,SF FuneralFDC00000007RSM250305,,126.5,,2171284.24
2025/03/05,2025/03/03,SF FuneralFDC00000008B0X250303,,126.5,,2171410.74
2025/03/05,2025/03/03,SF FuneralF843968       250301,,126.5,,2171537.24
2025/03/05,2025/03/03,SF FuneralF844034       250301,,126.5,,2171663.74
2025/03/05,2025/03/03,SF FuneralF844205       250301,,126.5,,2171790.24
2025/03/05,2025/03/03,SF FuneralF844368       250301,,126.5,,2171916.74
2025/03/05,2025/03/03,SF FuneralF900779       250301,,126.5,,2172043.24
2025/03/05,2025/02/25,SF FuneralF1128830      250225,,126.5,,2172169.74
2025/03/05,2025/02/26,SF FuneralF1127963      250226,,126.5,,2172296.24
2025/03/05,2025/02/27,SF FuneralFDC000000069FM250227,,126.5,,2172422.74
2025/03/05,2025/02/27,SF FuneralF802792       250227,,126.5,,2172549.24
2025/03/05,2025/02/27,SF FuneralF1110202      250227,,126.5,,2172675.74
2025/03/05,2025/02/28,SF FuneralFDC000000062ZX250228,,126.5,,2172802.24
2025/03/05,2025/02/28,SF FuneralFDC00000006BF5250228,,126.5,,2172928.74
2025/03/05,2025/02/28,SF FuneralFDC00000006DYD250228,,126.5,,2173055.24
2025/03/05,2025/02/28,SF FuneralFDC00000006QPV250228,,126.5,,2173181.74
2025/03/05,2025/02/28,SF FuneralFDC00000006QQ8250228,,126.5,,2173308.24
2025/03/05,2025/02/28,SF FuneralFDC00000006ZJV250228,,126.5,,2173434.74
2025/03/05,2025/02/28,SF FuneralFDC000000077RC250228,,126.5,,2173561.24
2025/03/05,2025/02/28,SF FuneralFDC00000007CXR250228,,126.5,,2173687.74
2025/03/05,2025/02/28,SF FuneralF841616       250228,,126.5,,2173814.24
2025/03/05,2025/02/28,SF FuneralF844627       250228,,126.5,,2173940.74
2025/03/05,2025/02/28,SF FuneralF900838       250301,,126.5,,2174067.24
2025/03/05,2025/02/28,SF FuneralF900992       250301,,126.5,,2174193.74
2025/03/05,2025/02/28,SF FuneralF980925       250301,,126.5,,2174320.24
2025/03/05,2025/02/28,SF FuneralFDC0000000HDST250301,,126.5,,2174446.74
2025/03/05,2025/02/28,SF FuneralF989128       250301,,126.5,,2174573.24
2025/03/05,2025/02/28,SF FuneralF990455       250301,,126.5,,2174699.74
2025/03/05,2025/02/28,SF FuneralF990840       250301,,126.5,,2174826.24
2025/03/05,2025/02/28,SF FuneralF1112103      250228,,126.5,,2174952.74
2025/03/05,2025/02/28,SF FuneralF1126852      250228,,126.5,,2175079.24
2025/03/05,2025/02/28,SF FuneralF1128179      250228,,126.5,,2175205.74
2025/03/05,2025/03/01,SF FuneralFDC00000002V68250301,,220,,2175425.74
2025/03/05,2025/03/01,SF FuneralFDC00000002V75250301,,220,,2175645.74
2025/03/05,2025/03/01,SF FuneralFDC00000002V8L250301,,220,,2175865.74
2025/03/05,2025/03/01,SF FuneralFDC00000002WX1250301,,220,,2176085.74
2025/03/05,2025/03/01,SF FuneralFDC00000003C8D250301,,220,,2176305.74
2025/03/05,2025/03/01,SF FuneralFDC00000005DY8250301,,126.5,,2176432.24
2025/03/05,2025/03/01,SF FuneralFDC00000005QTQ250301,,126.5,,2176558.74
2025/03/05,2025/03/01,SF FuneralFDC00000005XF8250301,,220,,2176778.74
2025/03/05,2025/03/01,SF FuneralFDC00000002XKX250301,,220,,2176998.74
2025/03/05,2025/03/01,SF FuneralFDC00000005XFS250301,,126.5,,2177125.24
2025/03/05,2025/03/01,SF FuneralFDC000000069K5250301,,126.5,,2177251.74
2025/03/05,2025/03/01,SF FuneralFDC00000006BLX250301,,126.5,,2177378.24
2025/03/05,2025/03/01,SF FuneralFDC00000006DTN250301,,126.5,,2177504.74
2025/03/05,2025/03/01,SF FuneralFDC00000006DVG250301,,126.5,,2177631.24
2025/03/05,2025/03/01,SF FuneralFDC00000006H2Z250301,,126.5,,2177757.74
2025/03/05,2025/03/01,SF FuneralFDC00000006HKQ250301,,126.5,,2177884.24
2025/03/05,2025/03/01,SF FuneralFDC0000000696N250301,,126.5,,2178010.74
2025/03/05,2025/03/01,SF FuneralFDC0000000696X250301,,126.5,,2178137.24
2025/03/05,2025/03/01,SF FuneralFDC00000006GFH250301,,126.5,,2178263.74
2025/03/05,2025/03/01,SF FuneralFDC00000006HMY250301,,126.5,,2178390.24
2025/03/05,2025/03/01,SF FuneralFDC00000006J70250301,,126.5,,2178516.74
2025/03/05,2025/03/01,SF FuneralFDC00000006J88250301,,126.5,,2178643.24
2025/03/05,2025/03/01,SF FuneralFDC00000006JFH250301,,126.5,,2178769.74
2025/03/05,2025/03/01,SF FuneralFDC00000006MSC250301,,126.5,,2178896.24
2025/03/05,2025/03/01,SF FuneralFDC00000006N7Y250301,,126.5,,2179022.74
2025/03/05,2025/03/01,SF FuneralFDC00000006T7Y250301,,126.5,,2179149.24
2025/03/05,2025/03/01,SF FuneralFDC00000006XYH250301,,126.5,,2179275.74
2025/03/05,2025/03/01,SF FuneralFDC00000007496250301,,126.5,,2179402.24
2025/03/05,2025/03/01,SF FuneralFDC000000074C8250301,,126.5,,2179528.74
2025/03/05,2025/03/01,SF FuneralFDC000000074P0250301,,126.5,,2179655.24
2025/03/05,2025/03/01,SF FuneralFDC000000074P3250301,,126.5,,2179781.74
2025/03/05,2025/03/01,SF FuneralFDC0000000755K250301,,126.5,,2179908.24
2025/03/05,2025/03/01,SF FuneralFDC00000007665250301,,126.5,,2180034.74
2025/03/05,2025/03/01,SF FuneralFDC00000007732250301,,126.5,,2180161.24
2025/03/05,2025/03/01,SF FuneralFDC00000007DK4250301,,126.5,,2180287.74
2025/03/05,2025/03/01,SF FuneralF796648       250301,,126.5,,2180414.24
2025/03/05,2025/03/01,SF FuneralFDC000000086JW250301,,126.5,,2180540.74
2025/03/05,2025/03/01,SF FuneralFDC0000000876Q250301,,126.5,,2180667.24
2025/03/05,2025/03/01,SF FuneralFDC00000008BKT250301,,126.5,,2180793.74
2025/03/05,2025/03/01,SF FuneralF803560       250301,,126.5,,2180920.24
2025/03/05,2025/03/01,SF FuneralF804150       250301,,126.5,,2181046.74
2025/03/05,2025/03/01,SF FuneralFDC00000008PTP250301,,126.5,,2181173.24
2025/03/05,2025/03/01,SF FuneralF804402       250301,,126.5,,2181299.74
2025/03/05,2025/03/01,SF FuneralF804581       250301,,126.5,,2181426.24
2025/03/05,2025/03/01,SF FuneralF808877       250301,,126.5,,2181552.74
2025/03/05,2025/03/01,SF FuneralF808911       250301,,126.5,,2181679.24
2025/03/05,2025/03/01,SF FuneralF809034       250301,,126.5,,2181805.74
2025/03/05,2025/03/01,SF FuneralF794472       250301,,191.5,,2181997.24
2025/03/05,2025/03/01,SF FuneralF809571       250301,,126.5,,2182123.74
2025/03/05,2025/03/01,SF FuneralFDC00000006NBH250301,,126.5,,2182250.24
2025/03/05,2025/03/01,SF FuneralFDC000000074NW250301,,126.5,,2182376.74
2025/03/05,2025/03/01,SF FuneralFDC000000074TM250301,,126.5,,2182503.24
2025/03/05,2025/03/01,SF FuneralF810197       250301,,126.5,,2182629.74
2025/03/05,2025/03/01,SF FuneralF810668       250301,,126.5,,2182756.24
2025/03/05,2025/03/01,SF FuneralF811114       250301,,126.5,,2182882.74
2025/03/05,2025/03/01,SF FuneralF812647       250301,,126.5,,2183009.24
2025/03/05,2025/03/01,SF FuneralF813113       250301,,126.5,,2183135.74
2025/03/05,2025/03/01,SF FuneralF816667       250301,,126.5,,2183262.24
2025/03/05,2025/03/01,SF FuneralF816696       250301,,126.5,,2183388.74
2025/03/05,2025/03/01,SF FuneralF816746       250301,,126.5,,2183515.24
2025/03/05,2025/03/01,SF FuneralF817763       250301,,126.5,,2183641.74
2025/03/05,2025/03/01,SF FuneralF817972       250301,,126.5,,2183768.24
2025/03/05,2025/03/01,SF FuneralF818348       250301,,126.5,,2183894.74
2025/03/05,2025/03/01,SF FuneralF820537       250301,,126.5,,2184021.24
2025/03/05,2025/03/01,SF FuneralF820590       250301,,126.5,,2184147.74
2025/03/05,2025/03/01,SF FuneralF820874       250301,,126.5,,2184274.24
2025/03/05,2025/03/01,SF FuneralF820921       250301,,126.5,,2184400.74
2025/03/05,2025/03/01,SF FuneralF822270       250301,,126.5,,2184527.24
2025/03/05,2025/03/01,SF FuneralF828278       250301,,126.5,,2184653.74
2025/03/05,2025/03/01,SF FuneralF828337       250301,,126.5,,2184780.24
2025/03/05,2025/03/01,SF FuneralF828629       250301,,126.5,,2184906.74
2025/03/05,2025/03/01,SF FuneralF828751       250301,,191.5,,2185098.24
2025/03/05,2025/03/01,SF FuneralF829693       250301,,126.5,,2185224.74
2025/03/05,2025/03/01,SF FuneralFDC0000000BVWY250301,,126.5,,2185351.24
2025/03/05,2025/03/01,SF FuneralF832316       250301,,126.5,,2185477.74
2025/03/05,2025/03/01,SF FuneralF832407       250301,,126.5,,2185604.24
2025/03/05,2025/03/01,SF FuneralF832567       250301,,126.5,,2185730.74
2025/03/05,2025/03/01,SF FuneralF832583       250301,,126.5,,2185857.24
2025/03/05,2025/03/01,SF FuneralF832689       250301,,126.5,,2185983.74
2025/03/05,2025/03/01,SF FuneralF817208       250301,,126.5,,2186110.24
2025/03/05,2025/03/01,SF FuneralF833943       250301,,126.5,,2186236.74
2025/03/05,2025/03/01,SF FuneralF841697       250301,,126.5,,2186363.24
2025/03/05,2025/03/01,SF FuneralF841993       250301,,126.5,,2186489.74
2025/03/05,2025/03/01,SF FuneralF842056       250301,,126.5,,2186616.24
2025/03/05,2025/03/01,SF FuneralF812149       250301,,126.5,,2186742.74
2025/03/05,2025/03/01,SF FuneralF992737       250301,,126.5,,2186869.24
2025/03/05,2025/03/01,SF FuneralF841734       250301,,126.5,,2186995.74
2025/03/05,2025/03/01,SF FuneralF813382       250301,,126.5,,2187122.24
2025/03/05,2025/03/01,SF FuneralF820658       250301,,126.5,,2187248.74
2025/03/05,2025/03/01,SF FuneralF993125       250301,,126.5,,2187375.24
2025/03/05,2025/03/01,SF FuneralF1021470      250301,,126.5,,2187501.74
2025/03/05,2025/03/01,SF FuneralF1021511      250301,,126.5,,2187628.24
2025/03/05,2025/03/01,SF FuneralF1021536      250301,,126.5,,2187754.74
2025/03/05,2025/03/01,SF FuneralF1033928      250301,,126.5,,2187881.24
2025/03/05,2025/03/01,SF FuneralF1059434      250301,,126.5,,2188007.74
2025/03/05,2025/03/01,SF FuneralF1060321      250301,,126.5,,2188134.24
2025/03/05,2025/03/01,SF FuneralF1066389      250301,,126.5,,2188260.74
2025/03/05,2025/03/01,SF FuneralF1066403      250301,,126.5,,2188387.24
2025/03/05,2025/03/01,SF FuneralF1075237      250301,,126.5,,2188513.74
2025/03/05,2025/03/01,SF FuneralF1078367      250301,,126.5,,2188640.24
2025/03/05,2025/03/01,SF FuneralFDC0000000LHMJ250301,,126.5,,2188766.74
2025/03/05,2025/03/01,SF FuneralF1079271      250301,,126.5,,2188893.24
2025/03/05,2025/03/01,SF FuneralF1084314      250301,,126.5,,2189019.74
2025/03/05,2025/03/01,SF FuneralF1084316      250301,,126.5,,2189146.24
2025/03/05,2025/03/01,SF FuneralF1084362      250301,,126.5,,2189272.74
2025/03/05,2025/03/01,SF FuneralF1084428      250301,,126.5,,2189399.24
2025/03/05,2025/03/01,SF FuneralF1084600      250301,,126.5,,2189525.74
2025/03/05,2025/03/01,SF FuneralF1084937      250301,,126.5,,2189652.24
2025/03/05,2025/03/01,SF FuneralF1102858      250301,,126.5,,2189778.74
2025/03/05,2025/03/01,SF FuneralF1103873      250301,,126.5,,2189905.24
2025/03/05,2025/03/01,SF FuneralF1113331      250301,,126.5,,2190031.74
2025/03/05,2025/03/01,SF FuneralFDC0000000N4TX250301,,126.5,,2190158.24
2025/03/05,2025/03/01,SF FuneralF1113356      250301,,126.5,,2190284.74
2025/03/05,2025/03/01,SF FuneralF1113575      250301,,126.5,,2190411.24
2025/03/05,2025/03/01,SF FuneralF1113585      250301,,126.5,,2190537.74
2025/03/05,2025/03/01,SF FuneralF1080379      250301,,126.5,,2190664.24
2025/03/05,2025/03/01,SF FuneralF1113850      250301,,126.5,,2190790.74
2025/03/05,2025/03/01,SF FuneralF1114040      250301,,126.5,,2190917.24
2025/03/05,2025/03/01,SF FuneralFDC0000000N78R250301,,126.5,,2191043.74
2025/03/05,2025/03/01,SF FuneralF1114319      250301,,126.5,,2191170.24
2025/03/05,2025/03/01,SF FuneralF1114618      250301,,126.5,,2191296.74
2025/03/05,2025/03/01,SF FuneralFDC0000000NBJ1250301,,126.5,,2191423.24
2025/03/05,2025/03/01,SF FuneralF1115033      250301,,126.5,,2191549.74
2025/03/05,2025/03/01,SF FuneralF1115769      250301,,126.5,,2191676.24
2025/03/05,2025/03/01,SF FuneralF1117221      250301,,126.5,,2191802.74
2025/03/05,2025/03/01,SF FuneralF1117585      250301,,126.5,,2191929.24
2025/03/05,2025/03/01,SF FuneralF1117714      250301,,126.5,,2192055.74
2025/03/05,2025/03/01,SF FuneralF803891       250301,,126.5,,2192182.24
2025/03/05,2025/03/01,SF FuneralF1118104      250301,,126.5,,2192308.74
2025/03/05,2025/03/01,SF FuneralF1118179      250301,,191.5,,2192500.24
2025/03/05,2025/03/01,SF FuneralF1118888      250301,,126.5,,2192626.74
2025/03/05,2025/03/01,SF FuneralF1120315      250301,,126.5,,2192753.24
2025/03/05,2025/03/01,SF FuneralF1122006      250301,,126.5,,2192879.74
2025/03/05,2025/03/01,SF FuneralF1122246      250301,,126.5,,2193006.24
2025/03/05,2025/03/01,SF FuneralF1122334      250302,,126.5,,2193132.74
2025/03/05,2025/03/01,SF FuneralF1122376      250301,,126.5,,2193259.24
2025/03/05,2025/03/01,SF FuneralF1122866      250301,,126.5,,2193385.74
2025/03/05,2025/03/01,SF FuneralF1124073      250301,,126.5,,2193512.24
2025/03/05,2025/03/01,SF FuneralF1125474      250301,,126.5,,2193638.74
2025/03/05,2025/03/01,SF FuneralFDC0000000PJL8250301,,220,,2193858.74
2025/03/05,2025/03/01,SF FuneralF753426       250301,,220,,2194078.74
2025/03/05,2025/03/01,SF FuneralF1126230      250301,,126.5,,2194205.24
2025/03/05,2025/03/01,SF FuneralF1126927      250301,,126.5,,2194331.74
2025/03/05,2025/03/01,SF FuneralFDC0000000PNXG250301,,126.5,,2194458.24
2025/03/05,2025/03/01,SF FuneralF1127980      250301,,126.5,,2194584.74
2025/03/05,2025/03/01,SF FuneralF1127993      250301,,126.5,,2194711.24
2025/03/05,2025/03/01,SF FuneralF1128070      250301,,126.5,,2194837.74
2025/03/05,2025/03/01,SF FuneralF1128877      250301,,126.5,,2194964.24
2025/03/05,2025/03/01,SF FuneralFDC0000000PWFN250301,,126.5,,2195090.74
2025/03/05,2025/03/01,SF FuneralF1129269      250301,,126.5,,2195217.24
2025/03/05,2025/03/01,SF FuneralF1131531      250301,,126.5,,2195343.74
2025/03/05,2025/03/01,SF FuneralF1132038      250301,,126.5,,2195470.24
2025/03/05,2025/03/01,SF FuneralF1132055      250301,,126.5,,2195596.74
2025/03/05,2025/03/01,SF FuneralF1132493      250301,,126.5,,2195723.24
2025/03/05,2025/03/03,SF FuneralF813494       250303,,126.5,,2195849.74
2025/03/05,2025/03/02,SF FuneralFDC0000000B8QX250302,,126.5,,2195976.24
2025/03/05,2025/03/03,SF FuneralF842952       250301,,126.5,,2196102.74
2025/03/05,2025/03/03,SF FuneralF844036       250301,,126.5,,2196229.24
2025/03/05,2025/03/03,SF FuneralF900444       250301,,126.5,,2196355.74
2025/03/05,2025/03/03,SF FuneralF900775       250301,,126.5,,2196482.24
2025/03/05,2025/03/03,SF FuneralF1084340      250303,,126.5,,2196608.74
2025/03/05,2025/03/03,SF FuneralF1117267      250303,,126.5,,2196735.24
2025/03/05,2025/03/03,SF FuneralF1128119      250303,,126.5,,2196861.74
2025/03/05,2025/03/04,SF FuneralF1079281      250304,,126.5,,2196988.24
2025/03/05,2025/03/05,SF FuneralF819111       250305,,31.63,,2197019.87
2025/03/05,2025/03/05,SF FuneralF988205       250305,,126.5,,2197146.37
2025/03/05,2025/03/05,SF FuneralFDC00000005Q2Z250305,,63.25,,2197209.62
2025/03/05,2025/03/05,SF FuneralFDC00000005R1F250305,,63.25,,2197272.87
2025/03/05,2025/02/26,SF FuneralFDC00000007SLC250226,,126.5,,2197399.37
2025/03/05,2025/02/27,SF FuneralFDC0000000HTC0250227,,126.5,,2197525.87
2025/03/05,2025/02/27,SF FuneralF1060522      250227,,126.5,,2197652.37
2025/03/05,2025/02/28,SF FuneralFDC00000005MSB250228,,126.5,,2197778.87
2025/03/05,2025/02/28,SF FuneralFDC000000069S7250228,,126.5,,2197905.37
2025/03/05,2025/02/28,SF FuneralFDC00000006GWX250228,,126.5,,2198031.87
2025/03/05,2025/02/28,SF FuneralF808765       250228,,126.5,,2198158.37
2025/03/05,2025/02/28,SF FuneralF901016       250301,,126.5,,2198284.87
2025/03/05,2025/02/28,SF FuneralF981430       250301,,126.5,,2198411.37
2025/03/05,2025/02/28,SF FuneralF981702       250301,,126.5,,2198537.87
2025/03/05,2025/02/28,SF FuneralF987705       250301,,126.5,,2198664.37
2025/03/05,2025/02/28,SF FuneralF987781       250301,,126.5,,2198790.87
2025/03/05,2025/02/28,SF FuneralF988120       250301,,126.5,,2198917.37
2025/03/05,2025/02/28,SF FuneralF988316       250301,,126.5,,2199043.87
2025/03/05,2025/02/28,SF FuneralF988977       250301,,126.5,,2199170.37
2025/03/05,2025/02/28,SF FuneralF988983       250301,,126.5,,2199296.87
2025/03/05,2025/02/28,SF FuneralF989221       250301,,126.5,,2199423.37
2025/03/05,2025/02/28,SF FuneralF990233       250301,,126.5,,2199549.87
2025/03/05,2025/02/28,SF FuneralF990400       250301,,126.5,,2199676.37
2025/03/05,2025/02/28,SF FuneralF991122       250301,,126.5,,2199802.87
2025/03/05,2025/03/01,SF FuneralFDC00000002V56250301,,220,,2200022.87
2025/03/05,2025/03/01,SF FuneralFDC00000002VT6250301,,220,,2200242.87
2025/03/05,2025/03/01,SF FuneralFDC00000002XW8250301,,220,,2200462.87
2025/03/05,2025/03/01,SF FuneralFDC00000002Z7B250301,,220,,2200682.87
2025/03/05,2025/03/01,SF FuneralFDC000000033G7250301,,220,,2200902.87
2025/03/05,2025/03/01,SF FuneralFDC000000057VL250301,,126.5,,2201029.37
2025/03/05,2025/03/01,SF FuneralFDC00000005CZ1250301,,126.5,,2201155.87
2025/03/05,2025/03/01,SF FuneralFDC000000069C8250301,,126.5,,2201282.37
2025/03/05,2025/03/01,SF FuneralFDC000000069GS250301,,126.5,,2201408.87
2025/03/05,2025/03/01,SF FuneralFDC000000069MB250301,,126.5,,2201535.37
2025/03/05,2025/03/01,SF FuneralFDC000000069PT250301,,126.5,,2201661.87
2025/03/05,2025/03/01,SF FuneralFDC00000006BKL250301,,126.5,,2201788.37
2025/03/05,2025/03/01,SF FuneralFDC00000006BL3250301,,126.5,,2201914.87
2025/03/05,2025/03/01,SF FuneralFDC00000006BZ8250301,,126.5,,2202041.37
2025/03/05,2025/03/01,SF FuneralFDC00000006C12250301,,126.5,,2202167.87
2025/03/05,2025/03/01,SF FuneralFDC00000006C13250301,,126.5,,2202294.37
2025/03/05,2025/03/01,SF FuneralFDC00000006CSQ250301,,126.5,,2202420.87
2025/03/05,2025/03/01,SF FuneralFDC00000006DCJ250301,,126.5,,2202547.37
2025/03/05,2025/03/01,SF FuneralFDC00000006DCV250301,,126.5,,2202673.87
2025/03/05,2025/03/01,SF FuneralFDC00000006FB3250301,,126.5,,2202800.37
2025/03/05,2025/03/01,SF FuneralFDC00000006FDC250301,,126.5,,2202926.87
2025/03/05,2025/03/01,SF FuneralFDC00000006FNR250301,,126.5,,2203053.37
2025/03/05,2025/03/01,SF FuneralFDC00000006H8R250301,,126.5,,2203179.87
2025/03/05,2025/03/01,SF FuneralFDC00000006JN2250301,,126.5,,2203306.37
2025/03/05,2025/03/01,SF FuneralFDC00000006L56250301,,126.5,,2203432.87
2025/03/05,2025/03/01,SF FuneralFDC00000006PVC250301,,126.5,,2203559.37
2025/03/05,2025/03/01,SF FuneralFDC00000006R2K250301,,126.5,,2203685.87
2025/03/05,2025/03/01,SF FuneralFDC00000006XXZ250301,,126.5,,2203812.37
2025/03/05,2025/03/01,SF FuneralFDC000000072VN250301,,126.5,,2203938.87
2025/03/05,2025/03/01,SF FuneralFDC000000074XF250301,,126.5,,2204065.37
2025/03/05,2025/03/01,SF FuneralFDC0000000754T250301,,126.5,,2204191.87
2025/03/05,2025/03/01,SF FuneralFDC000000075C9250301,,126.5,,2204318.37
2025/03/05,2025/03/01,SF FuneralFDC000000076Y7250301,,126.5,,2204444.87
2025/03/05,2025/03/01,SF FuneralFDC000000076Y9250301,,126.5,,2204571.37
2025/03/05,2025/03/01,SF FuneralFDC000000077QR250301,,126.5,,2204697.87
2025/03/05,2025/03/01,SF FuneralFDC000000078KF250301,,126.5,,2204824.37
2025/03/05,2025/03/01,SF FuneralFDC000000078VR250301,,126.5,,2204950.87
2025/03/05,2025/03/01,SF FuneralFDC000000079TZ250301,,126.5,,2205077.37
2025/03/05,2025/03/01,SF FuneralFDC00000007F7Q250301,,126.5,,2205203.87
2025/03/05,2025/03/01,SF FuneralFDC00000007JRZ250301,,126.5,,2205330.37
2025/03/05,2025/03/01,SF FuneralF793817       250301,,126.5,,2205456.87
2025/03/05,2025/03/01,SF FuneralFDC00000007Q78250301,,126.5,,2205583.37
2025/03/05,2025/03/01,SF FuneralFDC00000007QNP250301,,126.5,,2205709.87
2025/03/05,2025/03/01,SF FuneralFDC00000007QX0250301,,126.5,,2205836.37
2025/03/05,2025/03/01,SF FuneralF794319       250301,,126.5,,2205962.87
2025/03/05,2025/03/01,SF FuneralFDC00000007SZH250301,,126.5,,2206089.37
2025/03/05,2025/03/01,SF FuneralF794881       250301,,126.5,,2206215.87
2025/03/05,2025/03/01,SF FuneralF795027       250301,,126.5,,2206342.37
2025/03/05,2025/03/01,SF FuneralFDC00000007V9K250301,,126.5,,2206468.87
2025/03/05,2025/03/01,SF FuneralFDC00000007X4J250301,,126.5,,2206595.37
2025/03/05,2025/03/01,SF FuneralF796400       250301,,126.5,,2206721.87
2025/03/05,2025/03/01,SF FuneralF798298       250301,,126.5,,2206848.37
2025/03/05,2025/03/01,SF FuneralFDC000000084JK250301,,126.5,,2206974.87
2025/03/05,2025/03/01,SF FuneralF798395       250301,,126.5,,2207101.37
2025/03/05,2025/03/01,SF FuneralF798610       250301,,126.5,,2207227.87
2025/03/05,2025/03/01,SF FuneralF798827       250301,,126.5,,2207354.37
2025/03/05,2025/03/01,SF FuneralF800737       250301,,126.5,,2207480.87
2025/03/05,2025/03/01,SF FuneralFDC00000008CG1250301,,126.5,,2207607.37
2025/03/05,2025/03/01,SF FuneralF802008       250301,,126.5,,2207733.87
2025/03/05,2025/03/01,SF FuneralF802815       250301,,126.5,,2207860.37
2025/03/05,2025/03/01,SF FuneralF803467       250301,,126.5,,2207986.87
2025/03/05,2025/03/01,SF FuneralF803671       250301,,126.5,,2208113.37
2025/03/05,2025/03/01,SF FuneralF803887       250301,,126.5,,2208239.87
2025/03/05,2025/03/01,SF FuneralFDC00000008P2T250301,,126.5,,2208366.37
2025/03/05,2025/03/01,SF FuneralF804771       250301,,126.5,,2208492.87
2025/03/05,2025/03/01,SF FuneralF805646       250301,,126.5,,2208619.37
2025/03/05,2025/03/01,SF FuneralF808846       250301,,126.5,,2208745.87
2025/03/05,2025/03/01,SF FuneralF809051       250301,,126.5,,2208872.37
2025/03/05,2025/03/01,SF FuneralF809075       250301,,126.5,,2208998.87
2025/03/05,2025/03/01,SF FuneralF809217       250301,,126.5,,2209125.37
2025/03/05,2025/03/01,SF FuneralF809334       250301,,126.5,,2209251.87
2025/03/05,2025/03/01,SF FuneralF809358       250301,,126.5,,2209378.37
2025/03/05,2025/03/01,SF FuneralF809893       250301,,126.5,,2209504.87
2025/03/05,2025/03/01,SF FuneralF810225       250301,,126.5,,2209631.37
2025/03/05,2025/03/01,SF FuneralF812527       250301,,126.5,,2209757.87
2025/03/05,2025/03/01,SF FuneralF814297       250301,,126.5,,2209884.37
2025/03/05,2025/03/01,SF FuneralF816701       250301,,126.5,,2210010.87
2025/03/05,2025/03/01,SF FuneralF816765       250301,,126.5,,2210137.37
2025/03/05,2025/03/01,SF FuneralF817476       250301,,126.5,,2210263.87
2025/03/05,2025/03/01,SF FuneralF818240       250301,,126.5,,2210390.37
2025/03/05,2025/03/01,SF FuneralF818642       250301,,126.5,,2210516.87
2025/03/05,2025/03/01,SF FuneralF818976       250301,,126.5,,2210643.37
2025/03/05,2025/03/01,SF FuneralF808997       250301,,126.5,,2210769.87
2025/03/05,2025/03/01,SF FuneralF820748       250301,,126.5,,2210896.37
2025/03/05,2025/03/01,SF FuneralF820876       250301,,126.5,,2211022.87
2025/03/05,2025/03/01,SF FuneralF820970       250301,,126.5,,2211149.37
2025/03/05,2025/03/01,SF FuneralF821786       250301,,126.5,,2211275.87
2025/03/05,2025/03/01,SF FuneralF822218       250301,,126.5,,2211402.37
2025/03/05,2025/03/01,SF FuneralF828296       250301,,126.5,,2211528.87
2025/03/05,2025/03/01,SF FuneralF828482       250301,,126.5,,2211655.37
2025/03/05,2025/03/01,SF FuneralF828515       250301,,126.5,,2211781.87
2025/03/05,2025/03/01,SF FuneralF830139       250301,,126.5,,2211908.37
2025/03/05,2025/03/01,SF FuneralF830516       250301,,126.5,,2212034.87
2025/03/05,2025/03/01,SF FuneralFDC0000000BVL4250301,,126.5,,2212161.37
2025/03/05,2025/03/01,SF FuneralF832534       250301,,126.5,,2212287.87
2025/03/05,2025/03/01,SF FuneralF832638       250301,,126.5,,2212414.37
2025/03/05,2025/03/01,SF FuneralF832844       250301,,126.5,,2212540.87
2025/03/05,2025/03/01,SF FuneralF833418       250301,,126.5,,2212667.37
2025/03/05,2025/03/01,SF FuneralF841706       250301,,126.5,,2212793.87
2025/03/05,2025/03/01,SF FuneralF841784       250301,,126.5,,2212920.37
2025/03/05,2025/03/01,SF FuneralF841877       250301,,126.5,,2213046.87
2025/03/05,2025/03/01,SF FuneralF842657       250301,,126.5,,2213173.37
2025/03/05,2025/03/01,SF FuneralF842801       250301,,126.5,,2213299.87
2025/03/05,2025/03/01,SF FuneralF992580       250301,,126.5,,2213426.37
2025/03/05,2025/03/01,SF FuneralFDC0000000JB57250301,,126.5,,2213552.87
2025/03/05,2025/03/01,SF FuneralF993082       250301,,126.5,,2213679.37
2025/03/05,2025/03/01,SF FuneralF993182       250301,,126.5,,2213805.87
2025/03/05,2025/03/01,SF FuneralF993211       250301,,126.5,,2213932.37
2025/03/05,2025/03/01,SF FuneralF993304       250302,,126.5,,2214058.87
2025/03/05,2025/03/01,SF FuneralF993414       250301,,126.5,,2214185.37
2025/03/05,2025/03/01,SF FuneralF993534       250301,,126.5,,2214311.87
2025/03/05,2025/03/01,SF FuneralFDC0000000JDWG250301,,126.5,,2214438.37
2025/03/05,2025/03/01,SF FuneralF1010503      250301,,126.5,,2214564.87
2025/03/05,2025/03/01,SF FuneralF1017410      250301,,126.5,,2214691.37
2025/03/05,2025/03/01,SF FuneralF1021669      250301,,126.5,,2214817.87
2025/03/05,2025/03/01,SF FuneralF1052038      250301,,126.5,,2214944.37
2025/03/05,2025/03/01,SF FuneralF1052334      250301,,126.5,,2215070.87
2025/03/05,2025/03/01,SF FuneralF1052927      250301,,126.5,,2215197.37
2025/03/05,2025/03/01,SF FuneralF1059331      250301,,126.5,,2215323.87
2025/03/05,2025/03/01,SF FuneralF1060080      250301,,126.5,,2215450.37
2025/03/05,2025/03/01,SF FuneralF1060245      250301,,126.5,,2215576.87
2025/03/05,2025/03/01,SF FuneralF1060343      250301,,126.5,,2215703.37
2025/03/05,2025/03/01,SF FuneralF1061622      250301,,126.5,,2215829.87
2025/03/05,2025/03/01,SF FuneralF1066259      250301,,126.5,,2215956.37
2025/03/05,2025/03/01,SF FuneralF1066308      250301,,126.5,,2216082.87
2025/03/05,2025/03/01,SF FuneralF1066425      250301,,126.5,,2216209.37
2025/03/05,2025/03/01,SF FuneralF1066456      250301,,126.5,,2216335.87
2025/03/05,2025/03/01,SF FuneralF1066763      250301,,126.5,,2216462.37
2025/03/05,2025/03/01,SF FuneralF1068238      250301,,126.5,,2216588.87
2025/03/05,2025/03/01,SF FuneralF1072769      250301,,126.5,,2216715.37
2025/03/05,2025/03/01,SF FuneralF1074907      250301,,126.5,,2216841.87
2025/03/05,2025/03/01,SF FuneralF1075220      250301,,126.5,,2216968.37
2025/03/05,2025/03/01,SF FuneralF1083613      250301,,126.5,,2217094.87
2025/03/05,2025/03/01,SF FuneralF1084632      250301,,126.5,,2217221.37
2025/03/05,2025/03/01,SF FuneralF1084745      250301,,126.5,,2217347.87
2025/03/05,2025/03/01,SF FuneralF1085469      250301,,126.5,,2217474.37
2025/03/05,2025/03/01,SF FuneralFDC0000000M3SD250301,,126.5,,2217600.87
2025/03/05,2025/03/01,SF FuneralF1103654      250302,,126.5,,2217727.37
2025/03/05,2025/03/01,SF FuneralF1103935      250302,,31.63,,2217759
2025/03/05,2025/03/01,SF FuneralF1109069      250301,,126.5,,2217885.5
2025/03/05,2025/03/01,SF FuneralF1109103      250301,,126.5,,2218012
2025/03/05,2025/03/01,SF FuneralF822145       250301,,191.5,,2218203.5
2025/03/05,2025/03/01,SF FuneralF1110029      250301,,126.5,,2218330
2025/03/05,2025/03/01,SF FuneralF1110061      250301,,126.5,,2218456.5
2025/03/05,2025/03/01,SF FuneralF1110606      250301,,126.5,,2218583
2025/03/05,2025/03/01,SF FuneralF1110815      250301,,126.5,,2218709.5
2025/03/05,2025/03/01,SF FuneralF1113337      250301,,126.5,,2218836
2025/03/05,2025/03/01,SF FuneralF1113739      250301,,126.5,,2218962.5
2025/03/05,2025/03/01,SF FuneralF1113786      250301,,126.5,,2219089
2025/03/05,2025/03/01,SF FuneralF1113832      250301,,126.5,,2219215.5
2025/03/05,2025/03/01,SF FuneralF1113903      250301,,126.5,,2219342
2025/03/05,2025/03/01,SF FuneralF1114104      250301,,126.5,,2219468.5
2025/03/05,2025/03/01,SF FuneralF1104065      250301,,386.5,,2219855
2025/03/05,2025/03/01,SF FuneralF1117171      250301,,126.5,,2219981.5
2025/03/05,2025/03/01,SF FuneralF1117701      250301,,126.5,,2220108
2025/03/05,2025/03/01,SF FuneralF1117716      250301,,126.5,,2220234.5
2025/03/05,2025/03/01,SF FuneralF1117873      250301,,126.5,,2220361
2025/03/05,2025/03/01,SF FuneralF1119721      250301,,126.5,,2220487.5
2025/03/05,2025/03/01,SF FuneralF1119872      250301,,126.5,,2220614
2025/03/05,2025/03/01,SF FuneralFDC0000000NVJD250301,,126.5,,2220740.5
2025/03/05,2025/03/01,SF FuneralFDC0000000NVJH250301,,126.5,,2220867
2025/03/05,2025/03/01,SF FuneralF1122073      250301,,126.5,,2220993.5
2025/03/05,2025/03/01,SF FuneralF1122191      250301,,126.5,,2221120
2025/03/05,2025/03/01,SF FuneralF1122292      250301,,126.5,,2221246.5
2025/03/05,2025/03/01,SF FuneralF1122610      250301,,126.5,,2221373
2025/03/05,2025/03/01,SF FuneralF1122621      250301,,126.5,,2221499.5
2025/03/05,2025/03/01,SF FuneralF1122660      250301,,126.5,,2221626
2025/03/05,2025/03/01,SF FuneralF1122943      250301,,126.5,,2221752.5
2025/03/05,2025/03/01,SF FuneralF1123268      250301,,126.5,,2221879
2025/03/05,2025/03/01,SF FuneralF1123897      250301,,126.5,,2222005.5
2025/03/05,2025/03/01,SF FuneralF1123904      250301,,126.5,,2222132
2025/03/05,2025/03/01,SF FuneralF1125680      250301,,126.5,,2222258.5
2025/03/05,2025/03/01,SF FuneralFDC0000000PHYJ250301,,126.5,,2222385
2025/03/05,2025/03/01,SF FuneralFDC0000000PJGC250301,,126.5,,2222511.5
2025/03/05,2025/03/01,SF FuneralF1125952      250301,,126.5,,2222638
2025/03/05,2025/03/01,SF FuneralFDC0000000PLGZ250302,,126.5,,2222764.5
2025/03/05,2025/03/01,SF FuneralF1127516      250301,,126.5,,2222891
2025/03/05,2025/03/01,SF FuneralF1127557      250301,,126.5,,2223017.5
2025/03/05,2025/03/01,SF FuneralF1127764      250301,,126.5,,2223144
2025/03/05,2025/03/01,SF FuneralF1127955      250301,,126.5,,2223270.5
2025/03/05,2025/03/01,SF FuneralF1127995      250301,,126.5,,2223397
2025/03/05,2025/03/01,SF FuneralF1128035      250301,,126.5,,2223523.5
2025/03/05,2025/03/01,SF FuneralFDC0000000PVKR250301,,126.5,,2223650
2025/03/05,2025/03/01,SF FuneralF1128876      250301,,126.5,,2223776.5
2025/03/05,2025/03/01,SF FuneralF1129541      250301,,126.5,,2223903
2025/03/05,2025/03/01,SF FuneralFDC0000000PZZK250301,,126.5,,2224029.5
2025/03/05,2025/03/01,SF FuneralFDC0000000Q0B9250301,,126.5,,2224156
2025/03/05,2025/03/01,SF FuneralF1130290      250301,,126.5,,2224282.5
2025/03/05,2025/03/01,SF FuneralF1128209      250301,,126.5,,2224409
2025/03/05,2025/03/01,SF FuneralF1131136      250301,,126.5,,2224535.5
2025/03/05,2025/03/01,SF FuneralF1131313      250301,,126.5,,2224662
2025/03/05,2025/03/01,SF FuneralF1131646      250301,,126.5,,2224788.5
2025/03/05,2025/03/01,SF FuneralF1131862      250301,,126.5,,2224915
2025/03/05,2025/03/01,SF FuneralF1132797      250301,,126.5,,2225041.5
2025/03/05,2025/03/03,SF FuneralFDC00000007GXX250302,,126.5,,2225168
2025/03/05,2025/03/03,SF FuneralF802937       250302,,126.5,,2225294.5
2025/03/05,2025/03/03,SF FuneralF828231       250302,,126.5,,2225421
2025/03/05,2025/03/03,SF FuneralF843018       250301,,126.5,,2225547.5
2025/03/05,2025/03/03,SF FuneralFDC0000000FHMJ250301,,126.5,,2225674
2025/03/05,2025/03/03,SF FuneralFDC0000000LDPQ250303,,126.5,,2225800.5
2025/03/05,2025/03/03,SF FuneralF738067       250303,,220,,2226020.5
2025/03/05,2025/03/03,SF FuneralF1131319      250303,,126.5,,2226147
2025/03/05,2025/03/01,SF FuneralFDC0000000MM9X250301,,126.5,,2226273.5
2025/03/05,2025/03/04,SF FuneralFDC0000000Q6KN250304,,126.5,,2226400
2025/03/05,2025/03/01,SF FuneralFDC0000000Q5SS250301,,191.5,,2226591.5
2025/03/05,2025/03/01,SF FuneralFDC0000000Q5ST250301,,191.5,,2226783
2025/03/05,2025/03/01,SF FuneralF1131769      250301,,126.5,,2226909.5
2025/03/05,2025/03/01,SF FuneralFDC0000000Q5VS250301,,126.5,,2227036
2025/03/05,2025/03/01,SF FuneralFDC0000000Q5VT250301,,126.5,,2227162.5
2025/03/05,2025/03/01,SF FuneralFDC0000000Q5VV250301,,191.5,,2227354
2025/03/05,2025/03/01,SF FuneralF1131803      250301,,126.5,,2227480.5
2025/03/05,2025/03/01,SF FuneralF1131902      250301,,126.5,,2227607
2025/03/05,2025/03/01,SF FuneralF1131938      250301,,126.5,,2227733.5
2025/03/05,2025/03/01,SF FuneralFDC0000000Q6W1250301,,126.5,,2227860
2025/03/05,2025/03/01,SF FuneralF1132173      250301,,126.5,,2227986.5
2025/03/05,2025/03/01,SF FuneralF1132234      250301,,126.5,,2228113
2025/03/05,2025/03/01,SF FuneralF1132269      250301,,126.5,,2228239.5
2025/03/05,2025/03/01,SF FuneralF1132272      250301,,126.5,,2228366
2025/03/05,2025/03/01,SF FuneralF1132330      250301,,126.5,,2228492.5
2025/03/05,2025/03/01,SF FuneralF1132334      250301,,126.5,,2228619
2025/03/05,2025/03/01,SF FuneralF1132795      250301,,126.5,,2228745.5
2025/03/05,2025/03/01,SF FuneralF1132800      250302,,126.5,,2228872
2025/03/05,2025/03/01,SF FuneralF1132812      250301,,126.5,,2228998.5
2025/03/05,2025/03/01,SF FuneralFDC0000000Q9N9250301,,126.5,,2229125
2025/03/05,2025/03/01,SF FuneralF1132905      250301,,126.5,,2229251.5
2025/03/05,2025/03/01,SF FuneralF1133009      250301,,126.5,,2229378
2025/03/05,2025/02/26,SF FuneralF993403       250226,,126.5,,2229504.5
2025/03/05,2025/02/26,SF FuneralF1131482      250226,,126.5,,2229631
2025/03/05,2025/02/27,SF FuneralF812512       250227,,126.5,,2229757.5
2025/03/05,2025/02/27,SF FuneralF830044       250227,,126.5,,2229884
2025/03/05,2025/02/27,SF FuneralF1055088      250227,,126.5,,2230010.5
2025/03/05,2025/02/27,SF FuneralF1122072      250227,,126.5,,2230137
2025/03/05,2025/02/28,SF FuneralF841749       250228,,31.63,,2230168.63
2025/03/05,2025/03/03,SF FuneralFDC00000003CHV250302,,220,,2230388.63
2025/03/05,2025/03/03,SF FuneralFDC00000005XTF250302,,126.5,,2230515.13
2025/03/05,2025/03/03,SF FuneralFDC00000006XCZ250302,,126.5,,2230641.63
2025/03/05,2025/03/03,SF FuneralFDC00000006XD1250302,,126.5,,2230768.13
2025/03/05,2025/03/03,SF FuneralF802871       250302,,126.5,,2230894.63
2025/03/05,2025/03/03,SF FuneralFDC00000008N59250303,,63.25,,2230957.88
2025/03/05,2025/03/03,SF FuneralF804746       250302,,126.5,,2231084.38
2025/03/05,2025/03/03,SF FuneralF811590       250303,,126.5,,2231210.88
2025/03/05,2025/03/03,SF FuneralF812446       250302,,126.5,,2231337.38
2025/03/05,2025/03/03,SF FuneralF812740       250302,,126.5,,2231463.88
2025/03/05,2025/03/03,SF FuneralF816762       250302,,126.5,,2231590.38
2025/03/05,2025/03/03,SF FuneralF828285       250303,,126.5,,2231716.88
2025/03/05,2025/03/03,SF FuneralF843096       250301,,126.5,,2231843.38
2025/03/05,2025/03/03,SF FuneralF843124       250301,,126.5,,2231969.88
2025/03/05,2025/03/03,SF FuneralF843729       250301,,126.5,,2232096.38
2025/03/05,2025/03/03,SF FuneralF843829       250301,,126.5,,2232222.88
2025/03/05,2025/03/03,SF FuneralF844156       250301,,126.5,,2232349.38
2025/03/05,2025/03/03,SF FuneralF844437       250301,,126.5,,2232475.88
2025/03/05,2025/03/03,SF FuneralF844469       250301,,126.5,,2232602.38
2025/03/05,2025/03/03,SF FuneralF844700       250301,,126.5,,2232728.88
2025/03/05,2025/03/03,SF FuneralF847276       250301,,126.5,,2232855.38
2025/03/05,2025/03/03,SF FuneralF900762       250301,,126.5,,2232981.88
2025/03/05,2025/03/03,SF FuneralF900821       250301,,126.5,,2233108.38
2025/03/05,2025/03/03,SF FuneralF1021419      250303,,126.5,,2233234.88
2025/03/05,2025/03/03,SF FuneralF1066376      250303,,126.5,,2233361.38
2025/03/05,2025/03/03,SF FuneralF1073276      250303,,126.5,,2233487.88
2025/03/05,2025/03/03,SF FuneralF1079187      250303,,126.5,,2233614.38
2025/03/05,2025/03/03,SF FuneralF1079632      250303,,126.5,,2233740.88
2025/03/05,2025/03/03,SF FuneralF1084470      250303,,126.5,,2233867.38
2025/03/05,2025/03/03,SF FuneralFDC0000000M3PX250303,,126.5,,2233993.88
2025/03/05,2025/03/03,SF FuneralF1114105      250303,,126.5,,2234120.38
2025/03/05,2025/03/03,SF FuneralF1118041      250303,,126.5,,2234246.88
2025/03/05,2025/03/03,SF FuneralFDC0000000NMNL250303,,126.5,,2234373.38
2025/03/05,2025/03/03,SF FuneralF1118485      250303,,126.5,,2234499.88
2025/03/05,2025/03/03,SF FuneralFDC0000000NR4T250303,,126.5,,2234626.38
2025/03/05,2025/03/03,SF FuneralF1119008      250303,,126.5,,2234752.88
2025/03/05,2025/03/03,SF FuneralF1119762      250303,,126.5,,2234879.38
2025/03/05,2025/03/03,SF FuneralF1129332      250303,,126.5,,2235005.88
2025/03/05,2025/03/03,SF FuneralF1132110      250303,,126.5,,2235132.38
2025/03/05,2025/03/04,SF FuneralF1122031      250304,,126.5,,2235258.88
2025/03/05,2025/03/04,SF FuneralF1131855      250304,,63.25,,2235322.13
2025/03/05,2025/02/28,SF FuneralFDC00000006Q13250228,,126.5,,2235448.63
2025/03/05,2025/02/28,SF FuneralFDC00000006QWS250228,,126.5,,2235575.13
2025/03/05,2025/02/28,SF FuneralFDC00000007449250228,,126.5,,2235701.63
2025/03/05,2025/02/28,SF FuneralFDC00000007787250228,,126.5,,2235828.13
2025/03/05,2025/02/28,SF FuneralFDC000000077RV250228,,126.5,,2235954.63
2025/03/05,2025/02/28,SF FuneralFDC000000078LS250228,,126.5,,2236081.13
2025/03/05,2025/02/28,SF FuneralFDC00000007RSY250228,,126.5,,2236207.63
2025/03/05,2025/02/28,SF FuneralFDC000000084MQ250228,,126.5,,2236334.13
2025/03/05,2025/02/28,SF FuneralF802853       250228,,126.5,,2236460.63
2025/03/05,2025/02/28,SF FuneralF804886       250228,,126.5,,2236587.13
2025/03/05,2025/02/28,SF FuneralF809045       250228,,126.5,,2236713.63
2025/03/05,2025/02/28,SF FuneralFDC0000000B7Y7250228,,126.5,,2236840.13
2025/03/05,2025/02/28,SF FuneralFDC0000000BDTB250228,,126.5,,2236966.63
2025/03/05,2025/02/28,SF FuneralF833005       250228,,126.5,,2237093.13
2025/03/05,2025/02/28,SF FuneralF841452       250228,,126.5,,2237219.63
2025/03/05,2025/02/28,SF FuneralFDC0000000H1LF250301,,126.5,,2237346.13
2025/03/05,2025/02/28,SF FuneralF901037       250301,,126.5,,2237472.63
2025/03/05,2025/02/28,SF FuneralF901069       250301,,126.5,,2237599.13
2025/03/05,2025/02/28,SF FuneralF901353       250301,,126.5,,2237725.63
2025/03/05,2025/02/28,SF FuneralFDC0000000H6N1250301,,126.5,,2237852.13
2025/03/05,2025/02/28,SF FuneralF901494       250301,,126.5,,2237978.63
2025/03/05,2025/02/28,SF FuneralF980334       250301,,126.5,,2238105.13
2025/03/05,2025/02/28,SF FuneralF980541       250301,,126.5,,2238231.63
2025/03/05,2025/02/28,SF FuneralF981079       250301,,126.5,,2238358.13
2025/03/05,2025/02/28,SF FuneralF981145       250301,,126.5,,2238484.63
2025/03/05,2025/02/28,SF FuneralF981153       250301,,126.5,,2238611.13
2025/03/05,2025/02/28,SF FuneralF981369       250301,,126.5,,2238737.63
2025/03/05,2025/02/28,SF FuneralF981512       250301,,126.5,,2238864.13
2025/03/05,2025/02/28,SF FuneralF981567       250301,,126.5,,2238990.63
2025/03/05,2025/02/28,SF FuneralF981814       250301,,126.5,,2239117.13
2025/03/05,2025/02/28,SF FuneralFDC0000000HLZJ250301,,126.5,,2239243.63
2025/03/05,2025/02/28,SF FuneralF987003       250301,,126.5,,2239370.13
2025/03/05,2025/02/28,SF FuneralF987385       250301,,126.5,,2239496.63
2025/03/05,2025/02/28,SF FuneralF987689       250301,,126.5,,2239623.13
2025/03/05,2025/02/28,SF FuneralF987747       250301,,126.5,,2239749.63
2025/03/05,2025/02/28,SF FuneralF987907       250301,,126.5,,2239876.13
2025/03/05,2025/02/28,SF FuneralFDC0000000HTXZ250301,,126.5,,2240002.63
2025/03/05,2025/02/28,SF FuneralF987987       250301,,126.5,,2240129.13
2025/03/05,2025/02/28,SF FuneralF988037       250301,,126.5,,2240255.63
2025/03/05,2025/02/28,SF FuneralFDC0000000HW71250302,,126.5,,2240382.13
2025/03/05,2025/02/28,SF FuneralF988309       250302,,126.5,,2240508.63
2025/03/05,2025/02/28,SF FuneralF988320       250301,,256.5,,2240765.13
2025/03/05,2025/02/28,SF FuneralF988370       250301,,126.5,,2240891.63
2025/03/05,2025/02/28,SF FuneralF988383       250301,,126.5,,2241018.13
2025/03/05,2025/02/28,SF FuneralF988631       250302,,126.5,,2241144.63
2025/03/05,2025/02/28,SF FuneralF988762       250301,,126.5,,2241271.13
2025/03/05,2025/02/28,SF FuneralFDC0000000HY31250301,,126.5,,2241397.63
2025/03/05,2025/02/28,SF FuneralF989115       250301,,126.5,,2241524.13
2025/03/05,2025/02/28,SF FuneralFDC0000000HYPG250301,,126.5,,2241650.63
2025/03/05,2025/02/28,SF FuneralFDC0000000J0BL250301,,126.5,,2241777.13
2025/03/05,2025/02/28,SF FuneralF990764       250301,,126.5,,2241903.63
2025/03/05,2025/02/28,SF FuneralF1060071      250228,,126.5,,2242030.13
2025/03/05,2025/02/28,SF FuneralF1061794      250228,,126.5,,2242156.63
2025/03/05,2025/02/28,SF FuneralF1108879      250228,,126.5,,2242283.13
2025/03/05,2025/02/28,SF FuneralF1109852      250228,,126.5,,2242409.63
2025/03/05,2025/02/28,SF FuneralF1114477      250228,,126.5,,2242536.13
2025/03/05,2025/02/28,SF FuneralF1114593      250228,,126.5,,2242662.63
2025/03/05,2025/02/28,SF FuneralFDC0000000P1LP250228,,126.5,,2242789.13
2025/03/05,2025/02/28,SF FuneralF1126131      250228,,126.5,,2242915.63
2025/03/05,2025/02/28,SF FuneralFDC0000000Q7SB250228,,126.5,,2243042.13
2025/03/05,2025/02/28,SF FuneralF1132360      250228,,126.5,,2243168.63
2025/03/05,2025/03/05,SF FuneralF1122926      250305,,31.63,,2243200.26
2025/03/05,2025/03/03,SF FuneralFDC00000002WSV250303,,55,,2243255.26
2025/03/05,2025/03/03,SF FuneralF814448       250302,,31.63,,2243286.89
2025/03/05,2025/03/04,SF FuneralF989270       250304,,31.63,,2243318.52
2025/03/05,2025/03/04,SF FuneralF1084842      250304,,31.63,,2243350.15
2025/03/05,2025/03/01,SF FuneralFDC000000035VW250301,,220,,2243570.15
2025/03/05,2025/03/01,SF FuneralFDC000000039XF250301,,220,,2243790.15
2025/03/05,2025/03/01,SF FuneralFDC00000003KD1250301,,220,,2244010.15
2025/03/05,2025/03/01,SF FuneralFDC00000003KGW250301,,220,,2244230.15
2025/03/05,2025/03/01,SF FuneralFDC000000058DP250301,,126.5,,2244356.65
2025/03/05,2025/03/01,SF FuneralFDC000000058HZ250301,,126.5,,2244483.15
2025/03/05,2025/03/01,SF FuneralFDC000000058KJ250301,,126.5,,2244609.65
2025/03/05,2025/03/01,SF FuneralFDC00000005D70250301,,126.5,,2244736.15
2025/03/05,2025/03/01,SF FuneralFDC00000005DB4250301,,191.5,,2244927.65
2025/03/05,2025/03/01,SF FuneralFDC00000005GVB250301,,126.5,,2245054.15
2025/03/05,2025/03/01,SF FuneralFDC00000005QGT250301,,126.5,,2245180.65
2025/03/05,2025/03/01,SF FuneralFDC00000005RYS250301,,126.5,,2245307.15
2025/03/05,2025/03/01,SF FuneralFDC00000005S0L250301,,126.5,,2245433.65
2025/03/05,2025/03/01,SF FuneralFDC00000005TWP250301,,126.5,,2245560.15
2025/03/05,2025/03/01,SF FuneralFDC00000005X70250301,,126.5,,2245686.65
2025/03/05,2025/03/01,SF FuneralFDC00000005YZR250301,,126.5,,2245813.15
2025/03/05,2025/03/01,SF FuneralFDC000000063HZ250301,,126.5,,2245939.65
2025/03/05,2025/03/01,SF FuneralFDC000000064R1250301,,126.5,,2246066.15
2025/03/05,2025/03/01,SF FuneralFDC0000000695W250301,,126.5,,2246192.65
2025/03/05,2025/03/01,SF FuneralFDC0000000697T250301,,126.5,,2246319.15
2025/03/05,2025/03/01,SF FuneralFDC0000000699J250301,,220,,2246539.15
2025/03/05,2025/03/01,SF FuneralFDC000000069D7250301,,126.5,,2246665.65
2025/03/05,2025/03/01,SF FuneralFDC000000069G3250301,,126.5,,2246792.15
2025/03/05,2025/03/01,SF FuneralFDC000000069N4250301,,126.5,,2246918.65
2025/03/05,2025/03/01,SF FuneralFDC000000069N9250301,,126.5,,2247045.15
2025/03/05,2025/03/01,SF FuneralFDC000000069TJ250301,,126.5,,2247171.65
2025/03/05,2025/03/01,SF FuneralFDC00000006B43250301,,126.5,,2247298.15
2025/03/05,2025/03/01,SF FuneralFDC00000006BGX250301,,126.5,,2247424.65
2025/03/05,2025/03/01,SF FuneralFDC00000006BSS250301,,126.5,,2247551.15
2025/03/05,2025/03/01,SF FuneralFDC00000006BZV250301,,126.5,,2247677.65
2025/03/05,2025/03/01,SF FuneralFDC00000006C6C250301,,126.5,,2247804.15
2025/03/05,2025/03/01,SF FuneralFDC00000006DH9250301,,126.5,,2247930.65
2025/03/05,2025/03/01,SF FuneralFDC00000006F09250301,,126.5,,2248057.15
2025/03/05,2025/03/01,SF FuneralFDC00000006FKD250301,,126.5,,2248183.65
2025/03/05,2025/03/01,SF FuneralFDC00000006FMB250301,,126.5,,2248310.15
2025/03/05,2025/03/01,SF FuneralFDC00000006FY8250301,,126.5,,2248436.65
2025/03/05,2025/03/01,SF FuneralFDC00000006G09250301,,126.5,,2248563.15
2025/03/05,2025/03/01,SF FuneralFDC00000006G13250301,,126.5,,2248689.65
2025/03/05,2025/03/01,SF FuneralFDC00000006G20250301,,126.5,,2248816.15
2025/03/05,2025/03/01,SF FuneralFDC00000006G4N250301,,126.5,,2248942.65
2025/03/05,2025/03/01,SF FuneralFDC00000006G56250301,,126.5,,2249069.15
2025/03/05,2025/03/01,SF FuneralFDC00000006GC4250301,,126.5,,2249195.65
2025/03/05,2025/03/01,SF FuneralFDC00000006GS9250301,,126.5,,2249322.15
2025/03/05,2025/03/01,SF FuneralFDC00000006GX0250301,,126.5,,2249448.65
2025/03/05,2025/03/01,SF FuneralFDC00000006H1K250301,,191.5,,2249640.15
2025/03/05,2025/03/01,SF FuneralFDC00000006H4R250301,,126.5,,2249766.65
2025/03/05,2025/03/01,SF FuneralFDC00000006HJH250301,,126.5,,2249893.15
2025/03/05,2025/03/01,SF FuneralFDC00000006HNV250301,,126.5,,2250019.65
2025/03/05,2025/03/01,SF FuneralFDC00000006J26250301,,126.5,,2250146.15
2025/03/05,2025/03/01,SF FuneralFDC00000006JXF250301,,126.5,,2250272.65
2025/03/05,2025/03/01,SF FuneralFDC00000006K3T250301,,126.5,,2250399.15
2025/03/05,2025/03/01,SF FuneralFDC00000006KQY250301,,126.5,,2250525.65
2025/03/05,2025/03/01,SF FuneralFDC00000006L17250301,,126.5,,2250652.15
2025/03/05,2025/03/01,SF FuneralFDC00000006L89250301,,126.5,,2250778.65
2025/03/05,2025/03/01,SF FuneralFDC00000006LDV250301,,126.5,,2250905.15
2025/03/05,2025/03/01,SF FuneralFDC00000006LWL250301,,126.5,,2251031.65
2025/03/05,2025/03/01,SF FuneralFDC00000006NLQ250301,,126.5,,2251158.15
2025/03/05,2025/03/01,SF FuneralFDC00000006NT8250301,,126.5,,2251284.65
2025/03/05,2025/03/01,SF FuneralFDC00000006PN6250301,,126.5,,2251411.15
2025/03/05,2025/03/01,SF FuneralFDC00000006Q77250301,,126.5,,2251537.65
2025/03/05,2025/03/01,SF FuneralFDC00000006QW1250301,,126.5,,2251664.15
2025/03/05,2025/03/01,SF FuneralFDC00000006R6J250301,,126.5,,2251790.65
2025/03/05,2025/03/01,SF FuneralFDC00000006R92250301,,126.5,,2251917.15
2025/03/05,2025/03/01,SF FuneralFDC00000006SR7250301,,126.5,,2252043.65
2025/03/05,2025/03/01,SF FuneralFDC00000006T2P250301,,126.5,,2252170.15
2025/03/05,2025/03/01,SF FuneralFDC00000006W8H250301,,126.5,,2252296.65
2025/03/05,2025/03/01,SF FuneralFDC00000006Y3H250301,,126.5,,2252423.15
2025/03/05,2025/03/01,SF FuneralFDC00000006YK3250301,,220,,2252643.15
2025/03/05,2025/03/01,SF FuneralFDC000000070NN250301,,126.5,,2252769.65
2025/03/05,2025/03/01,SF FuneralFDC00000007446250301,,126.5,,2252896.15
2025/03/05,2025/03/01,SF FuneralFDC0000000744T250301,,126.5,,2253022.65
2025/03/05,2025/03/01,SF FuneralFDC0000000744X250301,,126.5,,2253149.15
2025/03/05,2025/03/01,SF FuneralFDC0000000749C250301,,126.5,,2253275.65
2025/03/05,2025/03/01,SF FuneralFDC0000000749F250301,,126.5,,2253402.15
2025/03/05,2025/03/01,SF FuneralFDC000000074DV250301,,126.5,,2253528.65
2025/03/05,2025/03/01,SF FuneralFDC000000074FB250301,,126.5,,2253655.15
2025/03/05,2025/03/01,SF FuneralFDC000000074H8250301,,126.5,,2253781.65
2025/03/05,2025/03/01,SF FuneralFDC000000074MD250301,,126.5,,2253908.15
2025/03/05,2025/03/01,SF FuneralFDC000000074PK250301,,126.5,,2254034.65
2025/03/05,2025/03/01,SF FuneralFDC000000074TT250301,,126.5,,2254161.15
2025/03/05,2025/03/01,SF FuneralFDC0000000751X250301,,126.5,,2254287.65
2025/03/05,2025/03/01,SF FuneralFDC000000075J9250301,,126.5,,2254414.15
2025/03/05,2025/03/01,SF FuneralFDC000000075KQ250301,,126.5,,2254540.65
2025/03/05,2025/03/01,SF FuneralFDC0000000765P250301,,126.5,,2254667.15
2025/03/05,2025/03/01,SF FuneralFDC000000076QP250301,,220,,2254887.15
2025/03/05,2025/03/01,SF FuneralFDC000000076QQ250301,,220,,2255107.15
2025/03/05,2025/03/01,SF FuneralFDC000000077RY250301,,126.5,,2255233.65
2025/03/05,2025/03/01,SF FuneralFDC000000078YM250301,,126.5,,2255360.15
2025/03/05,2025/03/01,SF FuneralFDC0000000792L250301,,126.5,,2255486.65
2025/03/05,2025/03/01,SF FuneralFDC00000007C9G250301,,126.5,,2255613.15
2025/03/05,2025/03/01,SF FuneralFDC00000007FSK250301,,126.5,,2255739.65
2025/03/05,2025/03/01,SF FuneralFDC00000007HMD250301,,126.5,,2255866.15
2025/03/05,2025/03/01,SF FuneralFDC00000007HRP250301,,126.5,,2255992.65
2025/03/05,2025/03/01,SF FuneralFDC00000007L2T250301,,126.5,,2256119.15
2025/03/05,2025/03/01,SF FuneralFDC00000007N51250301,,126.5,,2256245.65
2025/03/05,2025/03/01,SF FuneralFDC00000007Q6T250301,,126.5,,2256372.15
2025/03/05,2025/03/01,SF FuneralFDC00000007QBF250301,,126.5,,2256498.65
2025/03/05,2025/03/01,SF FuneralFDC00000007QLK250301,,126.5,,2256625.15
2025/03/05,2025/03/01,SF FuneralFDC00000007QLN250301,,126.5,,2256751.65
2025/03/05,2025/03/01,SF FuneralFDC00000007QVL250301,,126.5,,2256878.15
2025/03/05,2025/03/01,SF FuneralFDC00000007QZ5250301,,126.5,,2257004.65
2025/03/05,2025/03/01,SF FuneralF794059       250301,,126.5,,2257131.15
2025/03/05,2025/03/01,SF FuneralFDC00000007RK9250301,,126.5,,2257257.65
2025/03/05,2025/03/01,SF FuneralFDC00000007RM4250301,,126.5,,2257384.15
2025/03/05,2025/03/01,SF FuneralF794301       250301,,126.5,,2257510.65
2025/03/05,2025/03/01,SF FuneralF794476       250301,,126.5,,2257637.15
2025/03/05,2025/03/01,SF FuneralFDC00000007RZG250301,,126.5,,2257763.65
2025/03/05,2025/03/01,SF FuneralF794703       250301,,126.5,,2257890.15
2025/03/05,2025/03/01,SF FuneralFDC00000007TBZ250301,,220,,2258110.15
2025/03/05,2025/03/01,SF FuneralFDC00000007V6C250301,,191.5,,2258301.65
2025/03/05,2025/03/01,SF FuneralFDC00000007VNC250301,,126.5,,2258428.15
2025/03/05,2025/03/01,SF FuneralFDC00000007YXP250301,,126.5,,2258554.65
2025/03/05,2025/03/01,SF FuneralFDC00000007ZCG250301,,126.5,,2258681.15
2025/03/05,2025/03/01,SF FuneralFDC000000081TN250301,,126.5,,2258807.65
2025/03/05,2025/03/01,SF FuneralF798004       250301,,126.5,,2258934.15
2025/03/05,2025/03/01,SF FuneralFDC000000084F9250301,,126.5,,2259060.65
2025/03/05,2025/03/01,SF FuneralFDC000000084FK250301,,126.5,,2259187.15
2025/03/05,2025/03/01,SF FuneralF798288       250301,,126.5,,2259313.65
2025/03/05,2025/03/01,SF FuneralF798293       250301,,126.5,,2259440.15
2025/03/05,2025/03/01,SF FuneralFDC000000084L2250301,,126.5,,2259566.65
2025/03/05,2025/03/01,SF FuneralFDC000000084X8250301,,126.5,,2259693.15
2025/03/05,2025/03/01,SF FuneralFDC0000000861Q250301,,126.5,,2259819.65
2025/03/05,2025/03/01,SF FuneralFDC0000000864L250301,,126.5,,2259946.15
2025/03/05,2025/03/01,SF FuneralFDC000000086F4250301,,126.5,,2260072.65
2025/03/05,2025/03/01,SF FuneralF799015       250301,,126.5,,2260199.15
2025/03/05,2025/03/01,SF FuneralF799704       250301,,126.5,,2260325.65
2025/03/05,2025/03/01,SF FuneralF799845       250301,,126.5,,2260452.15
2025/03/05,2025/03/01,SF FuneralF800150       250301,,126.5,,2260578.65
2025/03/05,2025/03/01,SF FuneralF800440       250301,,126.5,,2260705.15
2025/03/05,2025/03/01,SF FuneralF801041       250301,,126.5,,2260831.65
2025/03/05,2025/03/01,SF FuneralFDC00000008FVB250301,,126.5,,2260958.15
2025/03/05,2025/03/01,SF FuneralF802219       250301,,126.5,,2261084.65
2025/03/05,2025/03/01,SF FuneralF802809       250301,,126.5,,2261211.15
2025/03/05,2025/03/01,SF FuneralF802861       250301,,126.5,,2261337.65
2025/03/05,2025/03/01,SF FuneralF802860       250301,,126.5,,2261464.15
2025/03/05,2025/03/01,SF FuneralFDC00000008LK6250301,,126.5,,2261590.65
2025/03/05,2025/03/01,SF FuneralF803046       250301,,126.5,,2261717.15
2025/03/05,2025/03/01,SF FuneralFDC00000008LSX250301,,126.5,,2261843.65
2025/03/05,2025/03/01,SF FuneralF766445       250301,,220,,2262063.65
2025/03/05,2025/03/01,SF FuneralF803112       250301,,126.5,,2262190.15
2025/03/05,2025/03/01,SF FuneralFDC00000008N4V250301,,126.5,,2262316.65
2025/03/05,2025/03/01,SF FuneralF803598       250301,,126.5,,2262443.15
2025/03/05,2025/03/01,SF FuneralFDC00000008NCQ250301,,126.5,,2262569.65
2025/03/05,2025/03/01,SF FuneralFDC00000008NPV250301,,126.5,,2262696.15
2025/03/05,2025/03/01,SF FuneralF803849       250301,,126.5,,2262822.65
2025/03/05,2025/03/01,SF FuneralF803921       250301,,126.5,,2262949.15
2025/03/05,2025/03/01,SF FuneralF804016       250301,,126.5,,2263075.65
2025/03/05,2025/03/01,SF FuneralF805053       250301,,126.5,,2263202.15
2025/03/05,2025/03/01,SF FuneralF808759       250301,,126.5,,2263328.65
2025/03/05,2025/03/01,SF FuneralF808804       250301,,126.5,,2263455.15
2025/03/05,2025/03/01,SF FuneralF808799       250301,,126.5,,2263581.65
2025/03/05,2025/03/01,SF FuneralF809046       250301,,126.5,,2263708.15
2025/03/05,2025/03/01,SF FuneralF809062       250301,,126.5,,2263834.65
2025/03/05,2025/03/01,SF FuneralF809305       250301,,126.5,,2263961.15
2025/03/05,2025/03/01,SF FuneralF809319       250301,,126.5,,2264087.65
2025/03/05,2025/03/01,SF FuneralF809371       250301,,126.5,,2264214.15
2025/03/05,2025/03/01,SF FuneralF809590       250301,,126.5,,2264340.65
2025/03/05,2025/03/01,SF FuneralF809611       250301,,126.5,,2264467.15
2025/03/05,2025/03/01,SF FuneralF809716       250301,,126.5,,2264593.65
2025/03/05,2025/03/01,SF FuneralF809738       250301,,126.5,,2264720.15
2025/03/05,2025/03/01,SF FuneralF809865       250301,,126.5,,2264846.65
2025/03/05,2025/03/01,SF FuneralF809944       250301,,126.5,,2264973.15
2025/03/05,2025/03/01,SF FuneralF810176       250301,,126.5,,2265099.65
2025/03/05,2025/03/01,SF FuneralFDC000000096CX250301,,126.5,,2265226.15
2025/03/05,2025/03/01,SF FuneralF810855       250301,,126.5,,2265352.65
2025/03/05,2025/03/01,SF FuneralF812200       250301,,126.5,,2265479.15
2025/03/05,2025/03/01,SF FuneralF812370       250301,,126.5,,2265605.65
2025/03/05,2025/03/01,SF FuneralF812549       250301,,126.5,,2265732.15
2025/03/05,2025/03/01,SF FuneralF812560       250301,,126.5,,2265858.65
2025/03/05,2025/03/01,SF FuneralF812569       250301,,126.5,,2265985.15
2025/03/05,2025/03/01,SF FuneralF812637       250301,,126.5,,2266111.65
2025/03/05,2025/03/01,SF FuneralF812707       250301,,126.5,,2266238.15
2025/03/05,2025/03/01,SF FuneralF812856       250301,,126.5,,2266364.65
2025/03/05,2025/03/01,SF FuneralF812978       250301,,126.5,,2266491.15
2025/03/05,2025/03/01,SF FuneralF813255       250301,,126.5,,2266617.65
2025/03/05,2025/03/01,SF FuneralF813317       250301,,126.5,,2266744.15
2025/03/05,2025/03/01,SF FuneralF813319       250301,,126.5,,2266870.65
2025/03/05,2025/03/01,SF FuneralF813623       250301,,126.5,,2266997.15
2025/03/05,2025/03/01,SF FuneralF813654       250301,,126.5,,2267123.65
2025/03/05,2025/03/01,SF FuneralF813768       250301,,126.5,,2267250.15
2025/03/05,2025/03/01,SF FuneralF813932       250301,,126.5,,2267376.65
2025/03/05,2025/03/01,SF FuneralF813934       250301,,126.5,,2267503.15
2025/03/05,2025/03/01,SF FuneralF814552       250301,,126.5,,2267629.65
2025/03/05,2025/03/01,SF FuneralF814709       250301,,126.5,,2267756.15
2025/03/05,2025/03/01,SF FuneralF815030       250301,,126.5,,2267882.65
2025/03/05,2025/03/01,SF FuneralF816156       250301,,126.5,,2268009.15
2025/03/05,2025/03/01,SF FuneralF816674       250301,,126.5,,2268135.65
2025/03/05,2025/03/01,SF FuneralF816687       250301,,126.5,,2268262.15
2025/03/05,2025/03/01,SF FuneralF816750       250301,,126.5,,2268388.65
2025/03/05,2025/03/01,SF FuneralF816768       250301,,126.5,,2268515.15
2025/03/05,2025/03/01,SF FuneralF816898       250301,,126.5,,2268641.65
2025/03/05,2025/03/01,SF FuneralF816901       250301,,126.5,,2268768.15
2025/03/05,2025/03/01,SF FuneralF816904       250301,,126.5,,2268894.65
2025/03/05,2025/03/01,SF FuneralF816923       250301,,126.5,,2269021.15
2025/03/05,2025/03/01,SF FuneralF817042       250301,,126.5,,2269147.65
2025/03/05,2025/03/01,SF FuneralF817163       250301,,126.5,,2269274.15
2025/03/05,2025/03/01,SF FuneralF817173       250301,,126.5,,2269400.65
2025/03/05,2025/03/01,SF FuneralF817301       250301,,126.5,,2269527.15
2025/03/05,2025/03/01,SF FuneralF817352       250301,,126.5,,2269653.65
2025/03/05,2025/03/01,SF FuneralF817397       250301,,126.5,,2269780.15
2025/03/05,2025/03/01,SF FuneralF817623       250301,,126.5,,2269906.65
2025/03/05,2025/03/01,SF FuneralF817717       250301,,126.5,,2270033.15
2025/03/05,2025/03/01,SF FuneralF818549       250301,,126.5,,2270159.65
2025/03/05,2025/03/01,SF FuneralF818857       250301,,126.5,,2270286.15
2025/03/05,2025/03/01,SF FuneralF819096       250301,,126.5,,2270412.65
2025/03/05,2025/03/01,SF FuneralF819247       250301,,126.5,,2270539.15
2025/03/05,2025/03/01,SF FuneralF819874       250301,,126.5,,2270665.65
2025/03/05,2025/03/01,SF FuneralF820493       250301,,126.5,,2270792.15
2025/03/05,2025/03/01,SF FuneralF820562       250301,,126.5,,2270918.65
2025/03/05,2025/03/01,SF FuneralF820567       250301,,126.5,,2271045.15
2025/03/05,2025/03/01,SF FuneralF820611       250301,,126.5,,2271171.65
2025/03/05,2025/03/01,SF FuneralF820883       250301,,126.5,,2271298.15
2025/03/05,2025/03/01,SF FuneralF820917       250301,,126.5,,2271424.65
2025/03/05,2025/03/01,SF FuneralF820993       250301,,126.5,,2271551.15
2025/03/05,2025/03/01,SF FuneralF821279       250301,,126.5,,2271677.65
2025/03/05,2025/03/01,SF FuneralF821289       250301,,126.5,,2271804.15
2025/03/05,2025/03/01,SF FuneralF821317       250301,,126.5,,2271930.65
2025/03/05,2025/03/01,SF FuneralF821374       250301,,126.5,,2272057.15
2025/03/05,2025/03/01,SF FuneralF821809       250301,,126.5,,2272183.65
2025/03/05,2025/03/01,SF FuneralF821898       250301,,126.5,,2272310.15
2025/03/05,2025/03/01,SF FuneralF822938       250301,,126.5,,2272436.65
2025/03/05,2025/03/01,SF FuneralF822957       250301,,126.5,,2272563.15
2025/03/05,2025/03/01,SF FuneralF823271       250301,,126.5,,2272689.65
2025/03/05,2025/03/01,SF FuneralF823673       250301,,126.5,,2272816.15
2025/03/05,2025/03/01,SF FuneralF827808       250301,,126.5,,2272942.65
2025/03/05,2025/03/01,SF FuneralF828236       250301,,126.5,,2273069.15
2025/03/05,2025/03/01,SF FuneralF828403       250301,,126.5,,2273195.65
2025/03/05,2025/03/01,SF FuneralF828475       250301,,126.5,,2273322.15
2025/03/05,2025/03/01,SF FuneralFDC0000000BPTK250301,,126.5,,2273448.65
2025/03/05,2025/03/01,SF FuneralF828552       250301,,126.5,,2273575.15
2025/03/05,2025/03/01,SF FuneralF828551       250301,,126.5,,2273701.65
2025/03/05,2025/03/01,SF FuneralF828781       250301,,126.5,,2273828.15
2025/03/05,2025/03/01,SF FuneralF828841       250301,,126.5,,2273954.65
2025/03/05,2025/03/01,SF FuneralF829548       250301,,126.5,,2274081.15
2025/03/05,2025/03/01,SF FuneralF829563       250301,,126.5,,2274207.65
2025/03/05,2025/03/01,SF FuneralF829576       250301,,126.5,,2274334.15
2025/03/05,2025/03/01,SF FuneralF829600       250301,,126.5,,2274460.65
2025/03/05,2025/03/01,SF FuneralF829806       250301,,126.5,,2274587.15
2025/03/05,2025/03/01,SF FuneralF829818       250301,,126.5,,2274713.65
2025/03/05,2025/03/01,SF FuneralF830289       250301,,126.5,,2274840.15
2025/03/05,2025/03/01,SF FuneralF831159       250301,,126.5,,2274966.65
2025/03/05,2025/03/01,SF FuneralF831249       250301,,126.5,,2275093.15
2025/03/05,2025/03/01,SF FuneralF831271       250301,,126.5,,2275219.65
2025/03/05,2025/03/01,SF FuneralFDC0000000CGDG250301,,126.5,,2275346.15
2025/03/05,2025/03/01,SF FuneralF832028       250301,,191.5,,2275537.65
2025/03/05,2025/03/01,SF FuneralF832255       250301,,126.5,,2275664.15
2025/03/05,2025/03/01,SF FuneralF832088       250301,,191.5,,2275855.65
2025/03/05,2025/03/01,SF FuneralF832275       250301,,126.5,,2275982.15
2025/03/05,2025/03/01,SF FuneralF832345       250301,,126.5,,2276108.65
2025/03/05,2025/03/01,SF FuneralF832349       250301,,126.5,,2276235.15
2025/03/05,2025/03/01,SF FuneralF832406       250301,,126.5,,2276361.65
2025/03/05,2025/03/01,SF FuneralF832427       250301,,126.5,,2276488.15
2025/03/05,2025/03/01,SF FuneralF828561       250301,,126.5,,2276614.65
2025/03/05,2025/03/01,SF FuneralF832651       250301,,126.5,,2276741.15
2025/03/05,2025/03/01,SF FuneralF832660       250301,,126.5,,2276867.65
2025/03/05,2025/03/01,SF FuneralF832665       250301,,126.5,,2276994.15
2025/03/05,2025/03/01,SF FuneralF833008       250301,,126.5,,2277120.65
2025/03/05,2025/03/01,SF FuneralF833041       250301,,126.5,,2277247.15
2025/03/05,2025/03/01,SF FuneralFDC0000000CQMW250301,,126.5,,2277373.65
2025/03/05,2025/03/01,SF FuneralF833476       250301,,126.5,,2277500.15
2025/03/05,2025/03/01,SF FuneralF816669       250301,,126.5,,2277626.65
2025/03/05,2025/03/01,SF FuneralF834283       250301,,126.5,,2277753.15
2025/03/05,2025/03/01,SF FuneralF834897       250301,,126.5,,2277879.65
2025/03/05,2025/03/01,SF FuneralF841495       250301,,126.5,,2278006.15
2025/03/05,2025/03/01,SF FuneralF841611       250301,,126.5,,2278132.65
2025/03/05,2025/03/01,SF FuneralF841626       250301,,126.5,,2278259.15
2025/03/05,2025/03/01,SF FuneralF789788       250301,,126.5,,2278385.65
2025/03/05,2025/03/01,SF FuneralF841638       250301,,126.5,,2278512.15
2025/03/05,2025/03/01,SF FuneralF841660       250301,,126.5,,2278638.65
2025/03/05,2025/03/01,SF FuneralF841786       250301,,126.5,,2278765.15
2025/03/05,2025/03/01,SF FuneralF841840       250301,,126.5,,2278891.65
2025/03/05,2025/03/01,SF FuneralF841855       250301,,126.5,,2279018.15
2025/03/05,2025/03/01,SF FuneralF841879       250301,,126.5,,2279144.65
2025/03/05,2025/03/01,SF FuneralF841961       250301,,126.5,,2279271.15
2025/03/05,2025/03/01,SF FuneralF841983       250301,,126.5,,2279397.65
2025/03/05,2025/03/01,SF FuneralF842060       250301,,126.5,,2279524.15
2025/03/05,2025/03/01,SF FuneralF842073       250301,,126.5,,2279650.65
2025/03/05,2025/03/01,SF FuneralF842204       250301,,126.5,,2279777.15
2025/03/05,2025/03/01,SF FuneralF842240       250301,,126.5,,2279903.65
2025/03/05,2025/03/01,SF FuneralF842251       250301,,126.5,,2280030.15
2025/03/05,2025/03/01,SF FuneralF842266       250301,,126.5,,2280156.65
2025/03/05,2025/03/01,SF FuneralF842345       250301,,126.5,,2280283.15
2025/03/05,2025/03/01,SF FuneralF842352       250301,,126.5,,2280409.65
2025/03/05,2025/03/01,SF FuneralFDC0000000F643250301,,126.5,,2280536.15
2025/03/05,2025/03/01,SF FuneralF842575       250301,,126.5,,2280662.65
2025/03/05,2025/03/01,SF FuneralF842592       250301,,126.5,,2280789.15
2025/03/05,2025/03/01,SF FuneralF842652       250301,,126.5,,2280915.65
2025/03/05,2025/03/01,SF FuneralF842836       250301,,126.5,,2281042.15
2025/03/05,2025/03/01,SF FuneralF842849       250301,,126.5,,2281168.65
2025/03/05,2025/03/01,SF FuneralF842884       250301,,126.5,,2281295.15
2025/03/05,2025/03/01,SF FuneralF991956       250301,,126.5,,2281421.65
2025/03/05,2025/03/01,SF FuneralF992057       250301,,126.5,,2281548.15
2025/03/05,2025/03/01,SF FuneralF992603       250301,,126.5,,2281674.65
2025/03/05,2025/03/01,SF FuneralF992641       250301,,126.5,,2281801.15
2025/03/05,2025/03/01,SF FuneralF992655       250301,,126.5,,2281927.65
2025/03/05,2025/03/01,SF FuneralF992804       250301,,126.5,,2282054.15
2025/03/05,2025/03/01,SF FuneralF992920       250301,,126.5,,2282180.65
2025/03/05,2025/03/01,SF FuneralF992921       250301,,126.5,,2282307.15
2025/03/05,2025/03/01,SF FuneralF992963       250301,,126.5,,2282433.65
2025/03/05,2025/03/01,SF FuneralF992969       250301,,126.5,,2282560.15
2025/03/05,2025/03/01,SF FuneralF993081       250301,,126.5,,2282686.65
2025/03/05,2025/03/01,SF FuneralF993094       250301,,126.5,,2282813.15
2025/03/05,2025/03/01,SF FuneralFDC0000000JBPV250301,,408.31,,2283221.46
2025/03/05,2025/03/01,SF FuneralF993119       250301,,126.5,,2283347.96
2025/03/05,2025/03/01,SF FuneralF993218       250301,,126.5,,2283474.46
2025/03/05,2025/03/01,SF FuneralF993297       250301,,126.5,,2283600.96
2025/03/05,2025/03/01,SF FuneralF993333       250301,,126.5,,2283727.46
2025/03/05,2025/03/01,SF FuneralF993416       250301,,126.5,,2283853.96
2025/03/05,2025/03/01,SF FuneralF993428       250301,,126.5,,2283980.46
2025/03/05,2025/03/01,SF FuneralF993588       250301,,126.5,,2284106.96
2025/03/05,2025/03/01,SF FuneralF993744       250301,,126.5,,2284233.46
2025/03/05,2025/03/01,SF FuneralF994106       250301,,126.5,,2284359.96
2025/03/05,2025/03/01,SF FuneralF1016657      250301,,126.5,,2284486.46
2025/03/05,2025/03/01,SF FuneralF1017072      250301,,126.5,,2284612.96
2025/03/05,2025/03/01,SF FuneralF1017548      250301,,126.5,,2284739.46
2025/03/05,2025/03/01,SF FuneralF1017786      250301,,126.5,,2284865.96
2025/03/05,2025/03/01,SF FuneralF1021434      250301,,126.5,,2284992.46
2025/03/05,2025/03/01,SF FuneralF1021469      250301,,126.5,,2285118.96
2025/03/05,2025/03/01,SF FuneralF1021473      250301,,126.5,,2285245.46
2025/03/05,2025/03/01,SF FuneralF1021504      250301,,126.5,,2285371.96
2025/03/05,2025/03/01,SF FuneralF1021520      250301,,126.5,,2285498.46
2025/03/05,2025/03/01,SF FuneralF1021541      250301,,126.5,,2285624.96
2025/03/05,2025/03/01,SF FuneralF1021599      250301,,126.5,,2285751.46
2025/03/05,2025/03/01,SF FuneralF1021826      250301,,126.5,,2285877.96
2025/03/05,2025/03/01,SF FuneralF1022028      250301,,126.5,,2286004.46
2025/03/05,2025/03/01,SF FuneralFDC0000000JXLN250301,,126.5,,2286130.96
2025/03/05,2025/03/01,SF FuneralF1022233      250301,,126.5,,2286257.46
2025/03/05,2025/03/01,SF FuneralF1033524      250301,,126.5,,2286383.96
2025/03/05,2025/03/01,SF FuneralF1033542      250301,,126.5,,2286510.46
2025/03/05,2025/03/01,SF FuneralF1033566      250301,,126.5,,2286636.96
2025/03/05,2025/03/01,SF FuneralF1033871      250301,,126.5,,2286763.46
2025/03/05,2025/03/01,SF FuneralF834567       250301,,126.5,,2286889.96
2025/03/05,2025/03/01,SF FuneralF1052712      250301,,126.5,,2287016.46
2025/03/05,2025/03/01,SF FuneralF1052713      250301,,126.5,,2287142.96
2025/03/05,2025/03/01,SF FuneralFDC0000000K7W7250301,,126.5,,2287269.46
2025/03/05,2025/03/01,SF FuneralF1055284      250301,,126.5,,2287395.96
2025/03/05,2025/03/01,SF FuneralF1058608      250301,,126.5,,2287522.46
2025/03/05,2025/03/01,SF FuneralF1058610      250301,,126.5,,2287648.96
2025/03/05,2025/03/01,SF FuneralF1058666      250301,,126.5,,2287775.46
2025/03/05,2025/03/01,SF FuneralF1058681      250301,,126.5,,2287901.96
2025/03/05,2025/03/01,SF FuneralF1058682      250301,,126.5,,2288028.46
2025/03/05,2025/03/01,SF FuneralF1058685      250301,,126.5,,2288154.96
2025/03/05,2025/03/01,SF FuneralF1058711      250301,,126.5,,2288281.46
2025/03/05,2025/03/01,SF FuneralF1058774      250301,,126.5,,2288407.96
2025/03/05,2025/03/01,SF FuneralF1058777      250301,,126.5,,2288534.46
2025/03/05,2025/03/01,SF FuneralF1058835      250301,,126.5,,2288660.96
2025/03/05,2025/03/01,SF FuneralF1059291      250302,,126.5,,2288787.46
2025/03/05,2025/03/01,SF FuneralFDC0000000K9ZW250301,,126.5,,2288913.96
2025/03/05,2025/03/01,SF FuneralF1059499      250301,,126.5,,2289040.46
2025/03/05,2025/03/01,SF FuneralF1059880      250301,,126.5,,2289166.96
2025/03/05,2025/03/01,SF FuneralF1060062      250301,,126.5,,2289293.46
2025/03/05,2025/03/01,SF FuneralF1060076      250301,,126.5,,2289419.96
2025/03/05,2025/03/01,SF FuneralF1060083      250301,,126.5,,2289546.46
2025/03/05,2025/03/01,SF FuneralFDC0000000KCJJ250301,,126.5,,2289672.96
2025/03/05,2025/03/01,SF FuneralF1060196      250301,,126.5,,2289799.46
2025/03/05,2025/03/01,SF FuneralF1060234      250301,,126.5,,2289925.96
2025/03/05,2025/03/01,SF FuneralF1060389      250301,,126.5,,2290052.46
2025/03/05,2025/03/01,SF FuneralF1060441      250302,,126.5,,2290178.96
2025/03/05,2025/03/01,SF FuneralF1060696      250301,,126.5,,2290305.46
2025/03/05,2025/03/01,SF FuneralF1060791      250301,,126.5,,2290431.96
2025/03/05,2025/03/01,SF FuneralF1060799      250301,,126.5,,2290558.46
2025/03/05,2025/03/01,SF FuneralF1060941      250301,,126.5,,2290684.96
2025/03/05,2025/03/01,SF FuneralFDC0000000KJM2250301,,126.5,,2290811.46
2025/03/05,2025/03/01,SF FuneralF1061045      250301,,126.5,,2290937.96
2025/03/05,2025/03/01,SF FuneralF1061538      250302,,126.5,,2291064.46
2025/03/05,2025/03/01,SF FuneralF1061555      250301,,126.5,,2291190.96
2025/03/05,2025/03/01,SF FuneralF1061641      250302,,126.5,,2291317.46
2025/03/05,2025/03/01,SF FuneralF1066199      250301,,126.5,,2291443.96
2025/03/05,2025/03/01,SF FuneralF1066255      250301,,126.5,,2291570.46
2025/03/05,2025/03/01,SF FuneralF1066267      250301,,126.5,,2291696.96
2025/03/05,2025/03/01,SF FuneralF1066302      250301,,126.5,,2291823.46
2025/03/05,2025/03/01,SF FuneralF1066343      250301,,126.5,,2291949.96
2025/03/05,2025/03/01,SF FuneralF1066359      250301,,126.5,,2292076.46
2025/03/05,2025/03/01,SF FuneralF1066407      250301,,126.5,,2292202.96
2025/03/05,2025/03/01,SF FuneralF1066409      250301,,126.5,,2292329.46
2025/03/05,2025/03/01,SF FuneralF1066417      250301,,126.5,,2292455.96
2025/03/05,2025/03/01,SF FuneralF1066441      250301,,126.5,,2292582.46
2025/03/05,2025/03/01,SF FuneralF1066561      250301,,126.5,,2292708.96
2025/03/05,2025/03/01,SF FuneralF1066568      250301,,126.5,,2292835.46
2025/03/05,2025/03/01,SF FuneralF1066569      250301,,126.5,,2292961.96
2025/03/05,2025/03/01,SF FuneralF1066576      250301,,126.5,,2293088.46
2025/03/05,2025/03/01,SF FuneralF1066580      250301,,126.5,,2293214.96
2025/03/05,2025/03/01,SF FuneralF1066590      250301,,126.5,,2293341.46
2025/03/05,2025/03/01,SF FuneralF1066696      250301,,126.5,,2293467.96
2025/03/05,2025/03/01,SF FuneralF1066781      250301,,126.5,,2293594.46
2025/03/05,2025/03/01,SF FuneralF1067907      250301,,126.5,,2293720.96
2025/03/05,2025/03/01,SF FuneralF1067942      250301,,126.5,,2293847.46
2025/03/05,2025/03/01,SF FuneralF1068051      250301,,126.5,,2293973.96
2025/03/05,2025/03/01,SF FuneralF1068153      250301,,126.5,,2294100.46
2025/03/05,2025/03/01,SF FuneralF1072725      250301,,126.5,,2294226.96
2025/03/05,2025/03/01,SF FuneralF1072756      250301,,126.5,,2294353.46
2025/03/05,2025/03/01,SF FuneralF1072926      250301,,126.5,,2294479.96
2025/03/05,2025/03/01,SF FuneralF1073101      250301,,126.5,,2294606.46
2025/03/05,2025/03/01,SF FuneralF1073593      250301,,126.5,,2294732.96
2025/03/05,2025/03/01,SF FuneralF1073662      250301,,126.5,,2294859.46
2025/03/05,2025/03/01,SF FuneralFDC0000000LCCF250301,,126.5,,2294985.96
2025/03/05,2025/03/01,SF FuneralF1075203      250302,,126.5,,2295112.46
2025/03/05,2025/03/01,SF FuneralF1075205      250301,,126.5,,2295238.96
2025/03/05,2025/03/01,SF FuneralF1075211      250301,,126.5,,2295365.46
2025/03/05,2025/03/01,SF FuneralF1075233      250301,,126.5,,2295491.96
2025/03/05,2025/03/01,SF FuneralF1075235      250301,,126.5,,2295618.46
2025/03/05,2025/03/01,SF FuneralF1075257      250302,,126.5,,2295744.96
2025/03/05,2025/03/01,SF FuneralF1075270      250301,,126.5,,2295871.46
2025/03/05,2025/03/01,SF FuneralFDC0000000LCZ4250301,,126.5,,2295997.96
2025/03/05,2025/03/01,SF FuneralF1075304      250301,,126.5,,2296124.46
2025/03/05,2025/03/01,SF FuneralF1078097      250301,,126.5,,2296250.96
2025/03/05,2025/03/01,SF FuneralF1078193      250301,,126.5,,2296377.46
2025/03/05,2025/03/01,SF FuneralF1078202      250301,,126.5,,2296503.96
2025/03/05,2025/03/01,SF FuneralF1078223      250301,,126.5,,2296630.46
2025/03/05,2025/03/01,SF FuneralF1078331      250301,,126.5,,2296756.96
2025/03/05,2025/03/01,SF FuneralF1078370      250301,,126.5,,2296883.46
2025/03/05,2025/03/01,SF FuneralF1078383      250301,,126.5,,2297009.96
2025/03/05,2025/03/01,SF FuneralF1078401      250301,,126.5,,2297136.46
2025/03/05,2025/03/01,SF FuneralF1078406      250301,,126.5,,2297262.96
2025/03/05,2025/03/01,SF FuneralF1078489      250301,,126.5,,2297389.46
2025/03/05,2025/03/01,SF FuneralF1078494      250301,,126.5,,2297515.96
2025/03/05,2025/03/01,SF FuneralF1078512      250301,,126.5,,2297642.46
2025/03/05,2025/03/01,SF FuneralF1078563      250301,,126.5,,2297768.96
2025/03/05,2025/03/01,SF FuneralF1078593      250301,,126.5,,2297895.46
2025/03/05,2025/03/01,SF FuneralFDC0000000LGTL250301,,126.5,,2298021.96
2025/03/05,2025/03/01,SF FuneralF1078859      250301,,126.5,,2298148.46
2025/03/05,2025/03/01,SF FuneralF1078903      250301,,126.5,,2298274.96
2025/03/05,2025/03/01,SF FuneralF1079055      250301,,126.5,,2298401.46
2025/03/05,2025/03/01,SF FuneralF1079068      250301,,126.5,,2298527.96
2025/03/05,2025/03/01,SF FuneralF1079249      250301,,126.5,,2298654.46
2025/03/05,2025/03/01,SF FuneralF1079295      250301,,126.5,,2298780.96
2025/03/05,2025/03/01,SF FuneralF1079315      250301,,126.5,,2298907.46
2025/03/05,2025/03/01,SF FuneralF1079326      250301,,126.5,,2299033.96
2025/03/05,2025/03/01,SF FuneralF1079711      250301,,126.5,,2299160.46
2025/03/05,2025/03/01,SF FuneralF1079723      250301,,126.5,,2299286.96
2025/03/05,2025/03/01,SF FuneralF1080211      250301,,126.5,,2299413.46
2025/03/05,2025/03/01,SF FuneralF1080381      250301,,126.5,,2299539.96
2025/03/05,2025/03/01,SF FuneralF1080424      250301,,126.5,,2299666.46
2025/03/05,2025/03/01,SF FuneralF1084322      250301,,126.5,,2299792.96
2025/03/05,2025/03/01,SF FuneralF1084447      250301,,126.5,,2299919.46
2025/03/05,2025/03/01,SF FuneralF1084520      250301,,126.5,,2300045.96
2025/03/05,2025/03/01,SF FuneralF1084559      250301,,126.5,,2300172.46
2025/03/05,2025/03/01,SF FuneralF1084631      250301,,126.5,,2300298.96
2025/03/05,2025/03/01,SF FuneralF1084742      250301,,126.5,,2300425.46
2025/03/05,2025/03/01,SF FuneralF1084984      250301,,126.5,,2300551.96
2025/03/05,2025/03/01,SF FuneralF1084989      250301,,126.5,,2300678.46
2025/03/05,2025/03/01,SF FuneralF1085044      250301,,126.5,,2300804.96
2025/03/05,2025/03/01,SF FuneralFDC0000000M031250301,,126.5,,2300931.46
2025/03/05,2025/03/01,SF FuneralF1102923      250301,,126.5,,2301057.96
2025/03/05,2025/03/01,SF FuneralF1103563      250301,,126.5,,2301184.46
2025/03/05,2025/03/01,SF FuneralF1103609      250301,,126.5,,2301310.96
2025/03/05,2025/03/01,SF FuneralF1103640      250301,,126.5,,2301437.46
2025/03/05,2025/03/01,SF FuneralF1103659      250302,,126.5,,2301563.96
2025/03/05,2025/03/01,SF FuneralF1103787      250301,,126.5,,2301690.46
2025/03/05,2025/03/01,SF FuneralF1103810      250301,,126.5,,2301816.96
2025/03/05,2025/03/01,SF FuneralF1104108      250301,,126.5,,2301943.46
2025/03/05,2025/03/01,SF FuneralF1104110      250301,,126.5,,2302069.96
2025/03/05,2025/03/01,SF FuneralFDC0000000M9VP250301,,126.5,,2302196.46
2025/03/05,2025/03/01,SF FuneralFDC0000000M9VT250301,,126.5,,2302322.96
2025/03/05,2025/03/01,SF FuneralF1108333      250301,,126.5,,2302449.46
2025/03/05,2025/03/01,SF FuneralF1109070      250301,,126.5,,2302575.96
2025/03/05,2025/03/01,SF FuneralFDC0000000MJWF250301,,126.5,,2302702.46
2025/03/05,2025/03/01,SF FuneralF1109585      250301,,126.5,,2302828.96
2025/03/05,2025/03/01,SF FuneralF1109643      250301,,126.5,,2302955.46
2025/03/05,2025/03/01,SF FuneralF1109692      250301,,126.5,,2303081.96
2025/03/05,2025/03/01,SF FuneralF1109759      250301,,126.5,,2303208.46
2025/03/05,2025/03/01,SF FuneralF1109761      250301,,126.5,,2303334.96
2025/03/05,2025/03/01,SF FuneralFDC0000000MKQG250301,,126.5,,2303461.46
2025/03/05,2025/03/01,SF FuneralF1109841      250301,,126.5,,2303587.96
2025/03/05,2025/03/01,SF FuneralF1110049      250301,,126.5,,2303714.46
2025/03/05,2025/03/01,SF FuneralFDC0000000MLKF250301,,126.5,,2303840.96
2025/03/05,2025/03/01,SF FuneralF1110118      250301,,126.5,,2303967.46
2025/03/05,2025/03/01,SF FuneralF1110178      250301,,126.5,,2304093.96
2025/03/05,2025/03/01,SF FuneralF1085222      250301,,126.5,,2304220.46
2025/03/05,2025/03/01,SF FuneralF1110199      250301,,126.5,,2304346.96
2025/03/05,2025/03/01,SF FuneralF1110238      250301,,126.5,,2304473.46
2025/03/05,2025/03/01,SF FuneralF1110319      250301,,126.5,,2304599.96
2025/03/05,2025/03/01,SF FuneralFDC0000000MN79250301,,126.5,,2304726.46
2025/03/05,2025/03/01,SF FuneralF1110553      250301,,126.5,,2304852.96
2025/03/05,2025/03/01,SF FuneralF1110558      250301,,126.5,,2304979.46
2025/03/05,2025/03/01,SF FuneralF1110619      250301,,126.5,,2305105.96
2025/03/05,2025/03/01,SF FuneralF1110651      250301,,126.5,,2305232.46
2025/03/05,2025/03/01,SF FuneralF1111351      250301,,126.5,,2305358.96
2025/03/05,2025/03/01,SF FuneralF1021991      250301,,126.5,,2305485.46
2025/03/05,2025/03/01,SF FuneralF1111378      250301,,126.5,,2305611.96
2025/03/05,2025/03/01,SF FuneralF1111387      250301,,126.5,,2305738.46
2025/03/05,2025/03/01,SF FuneralF1111487      250301,,126.5,,2305864.96
2025/03/05,2025/03/01,SF FuneralF1111611      250301,,126.5,,2305991.46
2025/03/05,2025/03/01,SF FuneralFDC0000000MTJW250301,,126.5,,2306117.96
2025/03/05,2025/03/01,SF FuneralFDC0000000MTKT250301,,126.5,,2306244.46
2025/03/05,2025/03/01,SF FuneralF1111671      250301,,126.5,,2306370.96
2025/03/05,2025/03/01,SF FuneralF1111775      250301,,126.5,,2306497.46
2025/03/05,2025/03/01,SF FuneralF1112051      250301,,126.5,,2306623.96
2025/03/05,2025/03/01,SF FuneralFDC0000000MY2S250301,,126.5,,2306750.46
2025/03/05,2025/03/01,SF FuneralFDC0000000MY34250301,,126.5,,2306876.96
2025/03/05,2025/03/01,SF FuneralF1112097      250301,,126.5,,2307003.46
2025/03/05,2025/03/01,SF FuneralFDC0000000MY5T250301,,126.5,,2307129.96
2025/03/05,2025/03/01,SF FuneralF1113234      250301,,126.5,,2307256.46
2025/03/05,2025/03/01,SF FuneralFDC0000000N4B6250301,,126.5,,2307382.96
2025/03/05,2025/03/01,SF FuneralF1113267      250301,,126.5,,2307509.46
2025/03/05,2025/03/01,SF FuneralF1113272      250301,,126.5,,2307635.96
2025/03/05,2025/03/01,SF FuneralF1113284      250301,,126.5,,2307762.46
2025/03/05,2025/03/01,SF FuneralF1113335      250301,,126.5,,2307888.96
2025/03/05,2025/03/01,SF FuneralF1111515      250301,,126.5,,2308015.46
2025/03/05,2025/03/01,SF FuneralF1113347      250301,,126.5,,2308141.96
2025/03/05,2025/03/01,SF FuneralF1113556      250301,,126.5,,2308268.46
2025/03/05,2025/03/01,SF FuneralF1113559      250302,,126.5,,2308394.96
2025/03/05,2025/03/01,SF FuneralF1113751      250301,,126.5,,2308521.46
2025/03/05,2025/03/01,SF FuneralF1113906      250301,,126.5,,2308647.96
2025/03/05,2025/03/01,SF FuneralF1113958      250301,,126.5,,2308774.46
2025/03/05,2025/03/01,SF FuneralF1113996      250301,,126.5,,2308900.96
2025/03/05,2025/03/01,SF FuneralF1114074      250301,,126.5,,2309027.46
2025/03/05,2025/03/01,SF FuneralF1114093      250301,,126.5,,2309153.96
2025/03/05,2025/03/01,SF FuneralF1114227      250301,,126.5,,2309280.46
2025/03/05,2025/03/01,SF FuneralF1114406      250301,,126.5,,2309406.96
2025/03/05,2025/03/01,SF FuneralF1114655      250301,,126.5,,2309533.46
2025/03/05,2025/03/01,SF FuneralF1114691      250301,,126.5,,2309659.96
2025/03/05,2025/03/01,SF FuneralF1114784      250301,,126.5,,2309786.46
2025/03/05,2025/03/01,SF FuneralF1115047      250301,,126.5,,2309912.96
2025/03/05,2025/03/01,SF FuneralF1115179      250301,,126.5,,2310039.46
2025/03/05,2025/03/01,SF FuneralF1115742      250301,,126.5,,2310165.96
2025/03/05,2025/03/01,SF FuneralF1116925      250301,,126.5,,2310292.46
2025/03/05,2025/03/01,SF FuneralF1117173      250301,,126.5,,2310418.96
2025/03/05,2025/03/01,SF FuneralF1117233      250301,,126.5,,2310545.46
2025/03/05,2025/03/01,SF FuneralF1117408      250301,,126.5,,2310671.96
2025/03/05,2025/03/01,SF FuneralFDC0000000NKCH250301,,126.5,,2310798.46
2025/03/05,2025/03/01,SF FuneralF1117614      250301,,126.5,,2310924.96
2025/03/05,2025/03/01,SF FuneralF1117679      250301,,126.5,,2311051.46
2025/03/05,2025/03/01,SF FuneralF1117705      250301,,126.5,,2311177.96
2025/03/05,2025/03/01,SF FuneralF1117741      250301,,126.5,,2311304.46
2025/03/05,2025/03/01,SF FuneralF1117902      250301,,126.5,,2311430.96
2025/03/05,2025/03/01,SF FuneralF1117927      250301,,126.5,,2311557.46
2025/03/05,2025/03/01,SF FuneralF1117985      250301,,126.5,,2311683.96
2025/03/05,2025/03/01,SF FuneralF1118036      250301,,126.5,,2311810.46
2025/03/05,2025/03/01,SF FuneralF1118093      250301,,126.5,,2311936.96
2025/03/05,2025/03/01,SF FuneralF1118283      250301,,126.5,,2312063.46
2025/03/05,2025/03/01,SF FuneralF1118286      250301,,126.5,,2312189.96
2025/03/05,2025/03/01,SF FuneralF1118438      250301,,126.5,,2312316.46
2025/03/05,2025/03/01,SF FuneralF1118532      250301,,126.5,,2312442.96
2025/03/05,2025/03/01,SF FuneralF1118557      250301,,126.5,,2312569.46
2025/03/05,2025/03/01,SF FuneralF1118648      250301,,126.5,,2312695.96
2025/03/05,2025/03/01,SF FuneralF1118652      250301,,126.5,,2312822.46
2025/03/05,2025/03/01,SF FuneralF1118982      250301,,126.5,,2312948.96
2025/03/05,2025/03/01,SF FuneralF1119771      250301,,126.5,,2313075.46
2025/03/05,2025/03/01,SF FuneralF1119774      250301,,126.5,,2313201.96
2025/03/05,2025/03/01,SF FuneralF1120175      250301,,126.5,,2313328.46
2025/03/05,2025/03/01,SF FuneralF1120257      250301,,126.5,,2313454.96
2025/03/05,2025/03/01,SF FuneralF1120383      250301,,126.5,,2313581.46
2025/03/05,2025/03/01,SF FuneralF1120532      250301,,126.5,,2313707.96
2025/03/05,2025/03/01,SF FuneralF1120774      250301,,126.5,,2313834.46
2025/03/05,2025/03/01,SF FuneralF1122034      250302,,126.5,,2313960.96
2025/03/05,2025/03/01,SF FuneralF1122053      250301,,126.5,,2314087.46
2025/03/05,2025/03/01,SF FuneralF1122243      250301,,126.5,,2314213.96
2025/03/05,2025/03/01,SF FuneralF1122308      250301,,126.5,,2314340.46
2025/03/05,2025/03/01,SF FuneralF1122311      250301,,126.5,,2314466.96
2025/03/05,2025/03/01,SF FuneralF1122316      250301,,126.5,,2314593.46
2025/03/05,2025/03/01,SF FuneralFDC0000000P14H250301,,126.5,,2314719.96
2025/03/05,2025/03/01,SF FuneralF1122567      250301,,126.5,,2314846.46
2025/03/05,2025/03/01,SF FuneralF1122626      250301,,126.5,,2314972.96
2025/03/05,2025/03/01,SF FuneralF1122629      250301,,126.5,,2315099.46
2025/03/05,2025/03/01,SF FuneralF765176       250301,,220,,2315319.46
2025/03/05,2025/03/01,SF FuneralF1122825      250301,,126.5,,2315445.96
2025/03/05,2025/03/01,SF FuneralF1122833      250301,,126.5,,2315572.46
2025/03/05,2025/03/01,SF FuneralF1122850      250301,,126.5,,2315698.96
2025/03/05,2025/03/01,SF FuneralF1122857      250301,,126.5,,2315825.46
2025/03/05,2025/03/01,SF FuneralF1122878      250301,,126.5,,2315951.96
2025/03/05,2025/03/01,SF FuneralF1122886      250301,,126.5,,2316078.46
2025/03/05,2025/03/01,SF FuneralF1122900      250301,,126.5,,2316204.96
2025/03/05,2025/03/01,SF FuneralF755071       250301,,126.5,,2316331.46
2025/03/05,2025/03/01,SF FuneralF1122964      250301,,126.5,,2316457.96
2025/03/05,2025/03/01,SF FuneralFDC0000000P2ZJ250301,,126.5,,2316584.46
2025/03/05,2025/03/01,SF FuneralFDC0000000P2ZN250301,,126.5,,2316710.96
2025/03/05,2025/03/01,SF FuneralF1123018      250302,,126.5,,2316837.46
2025/03/05,2025/03/01,SF FuneralF1123064      250301,,126.5,,2316963.96
2025/03/05,2025/03/01,SF FuneralF1123113      250301,,126.5,,2317090.46
2025/03/05,2025/03/01,SF FuneralFDC0000000P4M0250301,,126.5,,2317216.96
2025/03/05,2025/03/01,SF FuneralF1123399      250301,,126.5,,2317343.46
2025/03/05,2025/03/01,SF FuneralF1123515      250301,,126.5,,2317469.96
2025/03/05,2025/03/01,SF FuneralF784391       250301,,126.5,,2317596.46
2025/03/05,2025/03/01,SF FuneralF1123581      250301,,126.5,,2317722.96
2025/03/05,2025/03/01,SF FuneralFDC0000000P5WY250301,,126.5,,2317849.46
2025/03/05,2025/03/01,SF FuneralF1123624      250301,,126.5,,2317975.96
2025/03/05,2025/03/01,SF FuneralF1123905      250301,,126.5,,2318102.46
2025/03/05,2025/03/01,SF FuneralFDC0000000P6KV250301,,126.5,,2318228.96
2025/03/05,2025/03/01,SF FuneralF1123984      250301,,126.5,,2318355.46
2025/03/05,2025/03/01,SF FuneralFDC0000000P89K250301,,126.5,,2318481.96
2025/03/05,2025/03/01,SF FuneralF1125030      250301,,126.5,,2318608.46
2025/03/05,2025/03/01,SF FuneralFDC0000000PDDF250301,,126.5,,2318734.96
2025/03/05,2025/03/01,SF FuneralF1125130      250301,,126.5,,2318861.46
2025/03/05,2025/03/01,SF FuneralF1125291      250301,,126.5,,2318987.96
2025/03/05,2025/03/01,SF FuneralF1125464      250301,,126.5,,2319114.46
2025/03/05,2025/03/01,SF FuneralF1125469      250301,,126.5,,2319240.96
2025/03/05,2025/03/01,SF FuneralF1125486      250301,,126.5,,2319367.46
2025/03/05,2025/03/01,SF FuneralFDC0000000PH3R250301,,126.5,,2319493.96
2025/03/05,2025/03/01,SF FuneralF1125687      250302,,126.5,,2319620.46
2025/03/05,2025/03/01,SF FuneralF1125834      250301,,126.5,,2319746.96
2025/03/05,2025/03/01,SF FuneralF1125871      250301,,126.5,,2319873.46
2025/03/05,2025/03/01,SF FuneralF1125960      250301,,126.5,,2319999.96
2025/03/05,2025/03/01,SF FuneralFDC0000000PK19250301,,126.5,,2320126.46
2025/03/05,2025/03/01,SF FuneralF754528       250301,,126.5,,2320252.96
2025/03/05,2025/03/01,SF FuneralFDC0000000PKGR250301,,126.5,,2320379.46
2025/03/05,2025/03/01,SF FuneralF1126165      250301,,126.5,,2320505.96
2025/03/05,2025/03/01,SF FuneralF1126175      250301,,126.5,,2320632.46
2025/03/05,2025/03/01,SF FuneralF1126269      250301,,126.5,,2320758.96
2025/03/05,2025/03/01,SF FuneralF1126835      250301,,126.5,,2320885.46
2025/03/05,2025/03/01,SF FuneralF1126847      250301,,126.5,,2321011.96
2025/03/05,2025/03/01,SF FuneralF1127569      250301,,126.5,,2321138.46
2025/03/05,2025/03/01,SF FuneralFDC0000000PQ0N250301,,126.5,,2321264.96
2025/03/05,2025/03/01,SF FuneralFDC0000000PQ35250301,,126.5,,2321391.46
2025/03/05,2025/03/01,SF FuneralF1127585      250301,,126.5,,2321517.96
2025/03/05,2025/03/01,SF FuneralF1127587      250301,,126.5,,2321644.46
2025/03/05,2025/03/01,SF FuneralF1127613      250301,,126.5,,2321770.96
2025/03/05,2025/03/01,SF FuneralFDC0000000PRPQ250301,,126.5,,2321897.46
2025/03/05,2025/03/01,SF FuneralF1127819      250301,,126.5,,2322023.96
2025/03/05,2025/03/01,SF FuneralF1127893      250301,,126.5,,2322150.46
2025/03/05,2025/03/01,SF FuneralFDC0000000PTDT250301,,126.5,,2322276.96
2025/03/05,2025/03/01,SF FuneralF1127969      250301,,126.5,,2322403.46
2025/03/05,2025/03/01,SF FuneralF1127998      250301,,126.5,,2322529.96
2025/03/05,2025/03/01,SF FuneralF1128017      250301,,126.5,,2322656.46
2025/03/05,2025/03/01,SF FuneralF1128019      250301,,126.5,,2322782.96
2025/03/05,2025/03/01,SF FuneralF1128021      250301,,126.5,,2322909.46
2025/03/05,2025/03/01,SF FuneralF1128033      250301,,126.5,,2323035.96
2025/03/05,2025/03/01,SF FuneralF1128048      250301,,126.5,,2323162.46
2025/03/05,2025/03/01,SF FuneralFDC0000000PV3G250301,,126.5,,2323288.96
2025/03/05,2025/03/01,SF FuneralF1128064      250301,,126.5,,2323415.46
2025/03/05,2025/03/01,SF FuneralF1128065      250301,,126.5,,2323541.96
2025/03/05,2025/03/01,SF FuneralF1128144      250301,,126.5,,2323668.46
2025/03/05,2025/03/01,SF FuneralFDC0000000PVC3250301,,126.5,,2323794.96
2025/03/05,2025/03/01,SF FuneralF1128224      250301,,126.5,,2323921.46
2025/03/05,2025/03/01,SF FuneralF1128240      250301,,126.5,,2324047.96
2025/03/05,2025/03/01,SF FuneralF1128346      250301,,126.5,,2324174.46
2025/03/05,2025/03/01,SF FuneralFDC0000000PVPN250301,,126.5,,2324300.96
2025/03/05,2025/03/01,SF FuneralF793826       250301,,126.5,,2324427.46
2025/03/05,2025/03/01,SF FuneralF1128673      250301,,126.5,,2324553.96
2025/03/05,2025/03/01,SF FuneralF1128683      250302,,126.5,,2324680.46
2025/03/05,2025/03/01,SF FuneralF1128713      250301,,126.5,,2324806.96
2025/03/05,2025/03/01,SF FuneralFDC0000000PVZ5250301,,126.5,,2324933.46
2025/03/05,2025/03/01,SF FuneralFDC0000000PVZL250301,,126.5,,2325059.96
2025/03/05,2025/03/01,SF FuneralFDC0000000PVZM250301,,126.5,,2325186.46
2025/03/05,2025/03/01,SF FuneralFDC0000000PVZP250301,,126.5,,2325312.96
2025/03/05,2025/03/01,SF FuneralFDC0000000PVZW250301,,126.5,,2325439.46
2025/03/05,2025/03/01,SF FuneralF1128752      250301,,126.5,,2325565.96
2025/03/05,2025/03/01,SF FuneralF1128756      250301,,126.5,,2325692.46
2025/03/05,2025/03/01,SF FuneralF1128747      250301,,126.5,,2325818.96
2025/03/05,2025/03/01,SF FuneralF1128827      250301,,126.5,,2325945.46
2025/03/05,2025/03/01,SF FuneralF1128872      250301,,126.5,,2326071.96
2025/03/05,2025/03/01,SF FuneralF1128906      250301,,126.5,,2326198.46
2025/03/05,2025/03/01,SF FuneralF1128954      250301,,256.5,,2326454.96
2025/03/05,2025/03/01,SF FuneralF1128990      250301,,126.5,,2326581.46
2025/03/05,2025/03/01,SF FuneralF1128994      250301,,126.5,,2326707.96
2025/03/05,2025/03/01,SF FuneralF1128996      250301,,126.5,,2326834.46
2025/03/05,2025/03/01,SF FuneralF1129127      250301,,126.5,,2326960.96
2025/03/05,2025/03/01,SF FuneralF1129146      250301,,126.5,,2327087.46
2025/03/05,2025/03/01,SF FuneralF1129148      250301,,126.5,,2327213.96
2025/03/05,2025/03/01,SF FuneralF1129176      250301,,126.5,,2327340.46
2025/03/05,2025/03/01,SF FuneralF793868       250301,,126.5,,2327466.96
2025/03/05,2025/03/01,SF FuneralF1129251      250301,,126.5,,2327593.46
2025/03/05,2025/03/01,SF FuneralF1129271      250301,,126.5,,2327719.96
2025/03/05,2025/03/01,SF FuneralF1129370      250301,,126.5,,2327846.46
2025/03/05,2025/03/01,SF FuneralF1129373      250301,,126.5,,2327972.96
2025/03/05,2025/03/01,SF FuneralF1129414      250301,,126.5,,2328099.46
2025/03/05,2025/03/01,SF FuneralF1129415      250301,,126.5,,2328225.96
2025/03/05,2025/03/01,SF FuneralF1129441      250301,,126.5,,2328352.46
2025/03/05,2025/03/01,SF FuneralF1129852      250301,,126.5,,2328478.96
2025/03/05,2025/03/01,SF FuneralF1130036      250302,,126.5,,2328605.46
2025/03/05,2025/03/01,SF FuneralF1130056      250301,,126.5,,2328731.96
2025/03/05,2025/03/01,SF FuneralFDC0000000Q009250301,,126.5,,2328858.46
2025/03/05,2025/03/01,SF FuneralFDC0000000Q00B250301,,126.5,,2328984.96
2025/03/05,2025/03/01,SF FuneralF1130234      250301,,126.5,,2329111.46
2025/03/05,2025/03/01,SF FuneralF1130654      250302,,126.5,,2329237.96
2025/03/05,2025/03/01,SF FuneralF1130675      250301,,126.5,,2329364.46
2025/03/05,2025/03/01,SF FuneralF1130689      250301,,126.5,,2329490.96
2025/03/05,2025/03/01,SF FuneralF1130788      250301,,126.5,,2329617.46
2025/03/05,2025/03/01,SF FuneralF1130834      250301,,126.5,,2329743.96
2025/03/05,2025/03/01,SF FuneralF1130920      250301,,126.5,,2329870.46
2025/03/05,2025/03/01,SF FuneralF1131091      250301,,126.5,,2329996.96
2025/03/05,2025/03/01,SF FuneralF1131102      250301,,126.5,,2330123.46
2025/03/05,2025/03/01,SF FuneralF1131269      250301,,126.5,,2330249.96
2025/03/05,2025/03/01,SF FuneralF794874       250301,,126.5,,2330376.46
2025/03/05,2025/03/01,SF FuneralF1131270      250302,,126.5,,2330502.96
2025/03/05,2025/03/01,SF FuneralF1131349      250301,,126.5,,2330629.46
2025/03/05,2025/03/01,SF FuneralF1127463      250301,,126.5,,2330755.96
2025/03/05,2025/03/01,SF FuneralF841750       250301,,126.5,,2330882.46
2025/03/05,2025/03/01,SF FuneralF1131474      250301,,126.5,,2331008.96
2025/03/05,2025/03/01,SF FuneralF1131517      250301,,126.5,,2331135.46
2025/03/05,2025/03/01,SF FuneralF1131518      250301,,126.5,,2331261.96
2025/03/05,2025/03/01,SF FuneralF1131532      250301,,126.5,,2331388.46
2025/03/05,2025/03/05,SF FuneralF799232       250305,,126.5,,2331514.96
2025/03/05,2025/03/05,SF FuneralF777738       250305,,126.5,,2331641.46
2025/03/05,2025/03/05,SF FuneralF1117883      250305,,126.5,,2331767.96
2025/03/05,2025/03/05,SF FuneralF1123551      250305,,63.25,,2331831.21
2025/03/05,2025/03/05,SF FuneralF1124159      250305,,63.25,,2331894.46
2025/03/05,2025/03/05,SF FuneralFDC000000040X5250305,,220,,2332114.46
2025/03/05,2025/02/21,Rev SF FuneralFDC00000007RD4250221,,-31.63,,2332082.83
2025/03/05,2025/02/28,Rev SF FuneralFDC00000007684250228,,-126.5,,2331956.33
2025/03/05,2025/03/01,Rev SF FuneralFDC00000007W2J250301,,-126.5,,2331829.83
2025/03/05,2025/03/03,Rev SF FuneralFDC00000006XD1250302,,-126.5,,2331703.33
2025/03/05,2025/02/27,Rev SF FuneralFDC0000000NR0L250227,,-126.5,,2331576.83
2025/03/05,2025/03/04,Rev SF FuneralFDC0000000B379250304,,-63.25,,2331513.58
2025/03/05,2024/11/22,Rev SF FuneralFDC0000000N005241122,,-126.5,,2331387.08
2025/03/05,2025/01/22,Rev SF FuneralFDC0000000J3SW250122,,-126.5,,2331260.58
2025/03/05,2025/02/28,Rev SF FuneralFDC0000000MV1C250228,,-126.5,,2331134.08
2025/03/05,2025/02/21,Rev SF FuneralFDC0000000J3SW250222,,-126.5,,2331007.58
2025/03/05,2025/03/01,Rev SF FuneralFDC0000000LGTL250301,,-126.5,,2330881.08
2025/03/05,2024/09/21,Rev SF FuneralFDC0000000N005240922,,-126.5,,2330754.58
2025/03/05,2025/02/18,Rev SF FuneralFDC00000006PKR250218,,-126.5,,2330628.08
2025/03/05,2024/12/11,Rev SF FuneralF1112281      241222,,-191.5,,2330436.58
2025/03/05,2025/03/01,Rev SF FuneralFDC0000000PHJK250301,,-126.5,,2330310.08
2025/03/05,2025/02/28,Rev SF FuneralFDC00000006R8B250228,,-126.5,,2330183.58
2025/03/05,2024/12/11,Rev SF FuneralFDC0000000N005241222,,-126.5,,2330057.08
2025/03/05,2024/10/22,Rev SF FuneralFDC0000000N005241022,,-126.5,,2329930.58
2025/03/05,2025/02/24,Rev SF FuneralFDC00000006YYC250224,,-126.5,,2329804.08
2025/03/05,2025/02/25,SF FuneralF803738       250225,,126.5,,2329930.58
2025/03/05,2025/02/28,SF FuneralF987180       250228,,126.5,,2330057.08
2025/03/05,2025/02/28,SF FuneralF1127775      250228,,126.5,,2330183.58
2025/03/05,2025/03/01,SF FuneralFDC00000006LC3250301,,126.5,,2330310.08
2025/03/05,2025/03/01,SF FuneralF1079110      250302,,126.5,,2330436.58
2025/03/05,2025/03/03,SF FuneralFDC000000063B7250303,,110,,2330546.58
2025/03/05,2025/03/03,SF FuneralFDC00000006SV7250302,,31.63,,2330578.21
2025/03/05,2025/03/03,SF FuneralFDC000000085QB250303,,126.5,,2330704.71
2025/03/05,2025/03/04,SF FuneralFDC00000007S9L250304,,31.63,,2330736.34
2025/03/05,2025/03/04,SF FuneralF1102938      250304,,31.63,,2330767.97
2025/03/05,2025/03/04,SF FuneralF1126100      250304,,31.63,,2330799.6
2025/03/05,2025/02/12,Rev SF FuneralFDC000000096B5250212,,-126.5,,2330673.1
2025/03/05,2025/03/03,SF FuneralFDC000000042HH250302,,55,,2330728.1
2025/03/05,2025/02/27,SF FuneralF1122622      250227,,126.5,,2330854.6
2025/03/05,2025/02/28,SF FuneralFDC00000005MKP250228,,126.5,,2330981.1
2025/03/05,2025/02/28,SF FuneralFDC000000062BR250228,,126.5,,2331107.6
2025/03/05,2025/02/28,SF FuneralF1020886      250228,,126.5,,2331234.1
2025/03/05,2025/02/28,SF FuneralFDC0000000Q9VJ250228,,126.5,,2331360.6
2025/03/05,2025/03/01,SF FuneralFDC00000009212250301,,126.5,,2331487.1
2025/03/05,2025/03/01,SF FuneralF1114755      250302,,126.5,,2331613.6
2025/03/05,2025/03/04,SF FuneralF829052       250304,,63.25,,2331676.85
2025/03/05,2025/03/05,SF FuneralFDC00000007GJV250305,,126.5,,2331803.35
2025/03/05,2025/02/26,SF FuneralF1065827      250226,,63.25,,2331866.6
2025/03/05,2025/02/27,SF FuneralF1074837      250227,,126.5,,2331993.1
2025/03/05,2025/02/28,SF FuneralFDC000000075XG250228,,126.5,,2332119.6
2025/03/05,2025/02/28,SF FuneralF1073290      250228,,126.5,,2332246.1
2025/03/05,2025/03/01,SF FuneralF784736       250301,,31.63,,2332277.73
2025/03/05,2025/03/01,SF FuneralF1078958      250301,,126.5,,2332404.23
2025/03/05,2025/03/01,SF FuneralF1132400      250301,,126.5,,2332530.73
2025/03/05,2025/03/03,SF FuneralFDC00000005LS9250303,,31.63,,2332562.36
2025/03/05,2025/03/03,SF FuneralFDC0000000756L250302,,31.63,,2332593.99
2025/03/05,2025/03/03,SF FuneralF801680       250302,,126.5,,2332720.49
2025/03/05,2025/03/03,SF FuneralFDC00000008JTK250303,,63.25,,2332783.74
2025/03/05,2025/03/03,SF FuneralFDC00000009G6B250302,,31.63,,2332815.37
2025/03/05,2025/03/05,SF FuneralFDC00000005MXX250305,,126.5,,2332941.87
2025/03/05,2025/03/05,SF FuneralFDC00000007DMT250305,,31.63,,2332973.5
2025/03/05,2025/03/03,SF FuneralFDC00000005NKJ250303,,31.63,,2333005.13
2025/03/05,2025/03/04,SF FuneralFDC000000061YD250304,,31.63,,2333036.76
2025/03/05,2025/02/26,SF FuneralFDC0000000670S250226,,126.5,,2333163.26
2025/03/05,2025/02/27,SF FuneralFDC0000000KQNN250227,,126.5,,2333289.76
2025/03/05,2025/02/27,SF FuneralF1073048      250227,,126.5,,2333416.26
2025/03/05,2025/02/27,SF FuneralFDC0000000PBGP250227,,126.5,,2333542.76
2025/03/05,2025/02/28,SF FuneralFDC00000006KYZ250228,,126.5,,2333669.26
2025/03/05,2025/02/28,SF FuneralFDC00000006KZ0250228,,126.5,,2333795.76
2025/03/05,2025/03/01,SF FuneralF812704       250301,,126.5,,2333922.26
2025/03/05,2025/03/01,SF FuneralF818043       250301,,126.5,,2334048.76
2025/03/05,2025/03/01,SF FuneralF1060961      250302,,126.5,,2334175.26
2025/03/05,2025/03/03,SF FuneralFDC00000005RZQ250303,,31.63,,2334206.89
2025/03/05,2025/03/03,SF FuneralFDC00000006NPV250302,,110,,2334316.89
2025/03/05,2025/03/03,SF FuneralF804126       250303,,31.63,,2334348.52
2025/03/05,2025/01/24,Rev SF FuneralF1129120      250128,,-126.5,,2334222.02
2025/03/05,2025/02/01,Rev SF FuneralFDC000000035VW250201,,-220,,2334002.02
2025/03/05,2025/03/01,Rev SF FuneralFDC0000000MLKF250301,,-126.5,,2333875.52
2025/03/05,2025/02/01,Rev SF FuneralFDC0000000NQPC250201,,-126.5,,2333749.02
2025/03/05,2025/03/01,Rev SF FuneralFDC0000000PVP2250301,,-126.5,,2333622.52
2025/03/05,2025/02/01,Rev SF FuneralFDC0000000PJGD250201,,-126.5,,2333496.02
2025/03/05,2025/02/22,Rev SF FuneralFDC00000005MQ8250222,,-126.5,,2333369.52
2025/03/05,2025/03/01,Rev SF FuneralFDC00000006NLQ250301,,-126.5,,2333243.02
2025/03/05,2025/03/01,Rev SF FuneralFDC00000006B43250301,,-126.5,,2333116.52
2025/03/05,2025/02/28,Rev SF FuneralFDC0000000751F250228,,-386.5,,2332730.02
2025/03/05,2025/02/28,Rev SF FuneralFDC000000070D4250228,,-126.5,,2332603.52
2025/03/05,2025/02/21,Rev SF FuneralFDC0000000855Y250221,,-126.5,,2332477.02
2025/03/05,2025/02/27,Rev SF FuneralFDC00000005V46250227,,-126.5,,2332350.52
2025/03/05,2025/03/01,Rev SF FuneralFDC000000039PJ250301,,-220,,2332130.52
2025/03/05,2025/03/01,Rev SF FuneralFDC0000000Q5SS250301,,-191.5,,2331939.02
2025/03/05,2025/03/01,Rev SF FuneralFDC0000000788C250301,,-126.5,,2331812.52
2025/03/05,2025/03/01,Rev SF FuneralFDC000000076QQ250301,,-220,,2331592.52
2025/03/05,2025/03/01,Rev SF FuneralFDC0000000Q5ST250301,,-191.5,,2331401.02
2025/03/05,2025/01/02,Rev SF FuneralFDC000000035VW250101,,-220,,2331181.02
2025/03/05,2025/03/01,Rev SF FuneralFDC00000009212250301,,-126.5,,2331054.52
2025/03/05,2025/03/01,Rev SF FuneralFDC0000000K8KW250301,,-126.5,,2330928.02
2025/03/05,2025/03/03,Rev SF FuneralFDC00000008JTK250303,,-63.25,,2330864.77
2025/03/05,2025/03/01,Rev SF FuneralFDC00000006Y3H250301,,-126.5,,2330738.27
2025/03/05,2025/03/01,Rev SF FuneralFDC000000035VW250301,,-220,,2330518.27
2025/03/05,2025/02/01,Rev SF FuneralFDC0000000PJ9Y250201,,-126.5,,2330391.77
2025/03/05,2025/02/01,Rev SF FuneralFDC0000000PJ9M250201,,-126.5,,2330265.27
2025/03/05,2025/02/28,Rev SF FuneralFDC0000000Q9VJ250228,,-126.5,,2330138.77
2025/03/05,2025/03/01,Rev SF FuneralFDC0000000Q5VV250301,,-191.5,,2329947.27
2025/03/05,2025/03/01,Rev SF FuneralFDC0000000PV3G250301,,-126.5,,2329820.77
2025/03/05,2025/03/03,Rev SF FuneralFDC0000000NMNL250303,,-126.5,,2329694.27
2025/03/05,2025/02/25,Rev SF FuneralFDC0000000NRVB250225,,-31.63,,2329662.64
2025/03/05,2025/03/01,SF FuneralF1129917      250302,,31.63,,2329694.27
2025/03/05,2025/03/03,SF FuneralFDC00000002XYZ250302,,55,,2329749.27
2025/03/05,2025/03/01,SF FuneralFDC0000000JY24250302,,31.63,,2329780.9
2025/03/05,2025/03/03,SF FuneralF994127       250303,,63.25,,2329844.15
2025/03/05,2025/02/28,SF FuneralF989917       250228,,126.5,,2329970.65
2025/03/05,2025/03/01,SF FuneralF832510       250301,,126.5,,2330097.15
2025/03/05,2025/03/01,SF FuneralF1021515      250301,,126.5,,2330223.65
2025/03/05,2025/03/01,SF FuneralF1058746      250301,,126.5,,2330350.15
2025/03/05,2025/03/01,SF FuneralF1118662      250302,,126.5,,2330476.65
2025/03/05,2025/03/04,SF FuneralF1130344      250304,,31.63,,2330508.28
2025/03/05,2025/03/01,Rev SF FuneralFDC0000000Q4W1250302,,-126.5,,2330381.78
2025/03/05,2025/03/05,EFT-EFT DEBIT TRANSFERS 061341,,37512.5,,2367894.28
2025/03/06,2025/02/28,SF FuneralFDC00000005VPZ250228,,31.63,,2367925.91
2025/03/06,2025/02/28,SF FuneralFDC00000007D3C250228,,126.5,,2368052.41
2025/03/06,2025/02/28,SF FuneralFDC000000087CQ250228,,126.5,,2368178.91
2025/03/06,2025/02/28,SF FuneralF901139       250301,,126.5,,2368305.41
2025/03/06,2025/02/28,SF FuneralF901181       250302,,126.5,,2368431.91
2025/03/06,2025/02/28,SF FuneralF980282       250301,,126.5,,2368558.41
2025/03/06,2025/02/28,SF FuneralFDC0000000HC2B250301,,126.5,,2368684.91
2025/03/06,2025/02/28,SF FuneralF989566       250301,,126.5,,2368811.41
2025/03/06,2025/02/28,SF FuneralF1114486      250228,,126.5,,2368937.91
2025/03/06,2025/02/28,SF FuneralFDC0000000NJNG250228,,126.5,,2369064.41
2025/03/06,2025/02/28,SF FuneralFDC0000000NJNK250228,,126.5,,2369190.91
2025/03/06,2025/02/28,SF FuneralF1120573      250228,,31.63,,2369222.54
2025/03/06,2025/02/28,SF FuneralFDC0000000PK37250228,,126.5,,2369349.04
2025/03/06,2025/03/01,SF FuneralFDC00000006FPY250301,,126.5,,2369475.54
2025/03/06,2025/03/01,SF FuneralFDC00000006GMK250301,,126.5,,2369602.04
2025/03/06,2025/03/01,SF FuneralFDC00000006NNL250301,,126.5,,2369728.54
2025/03/06,2025/03/01,SF FuneralFDC00000006P0S250301,,126.5,,2369855.04
2025/03/06,2025/03/01,SF FuneralFDC00000006T73250301,,126.5,,2369981.54
2025/03/06,2025/03/01,SF FuneralFDC00000006VP7250301,,126.5,,2370108.04
2025/03/06,2025/03/01,SF FuneralFDC00000007RVS250301,,191.5,,2370299.54
2025/03/06,2025/03/01,SF FuneralFDC000000086MP250301,,126.5,,2370426.04
2025/03/06,2025/03/01,SF FuneralFDC000000086MQ250301,,126.5,,2370552.54
2025/03/06,2025/03/01,SF FuneralF820961       250301,,126.5,,2370679.04
2025/03/06,2025/03/01,SF FuneralF831162       250301,,126.5,,2370805.54
2025/03/06,2025/03/01,SF FuneralF832973       250301,,126.5,,2370932.04
2025/03/06,2025/03/01,SF FuneralF842311       250301,,126.5,,2371058.54
2025/03/06,2025/03/01,SF FuneralF993271       250301,,126.5,,2371185.04
2025/03/06,2025/03/01,SF FuneralF993709       250301,,126.5,,2371311.54
2025/03/06,2025/03/01,SF FuneralF1022060      250301,,126.5,,2371438.04
2025/03/06,2025/03/01,SF FuneralF1022061      250301,,126.5,,2371564.54
2025/03/06,2025/03/01,SF FuneralFDC0000000K226250301,,126.5,,2371691.04
2025/03/06,2025/03/01,SF FuneralF1058860      250301,,126.5,,2371817.54
2025/03/06,2025/03/01,SF FuneralF1066652      250301,,126.5,,2371944.04
2025/03/06,2025/03/01,SF FuneralFDC0000000L1TB250301,,126.5,,2372070.54
2025/03/06,2025/03/01,SF FuneralF1078251      250301,,126.5,,2372197.04
2025/03/06,2025/03/01,SF FuneralF1078431      250301,,126.5,,2372323.54
2025/03/06,2025/03/01,SF FuneralF1078432      250301,,126.5,,2372450.04
2025/03/06,2025/03/01,SF FuneralF1078463      250301,,126.5,,2372576.54
2025/03/06,2025/03/01,SF FuneralF1079363      250301,,126.5,,2372703.04
2025/03/06,2025/03/01,SF FuneralF1084903      250301,,126.5,,2372829.54
2025/03/06,2025/03/01,SF FuneralF1085194      250301,,126.5,,2372956.04
2025/03/06,2025/03/01,SF FuneralFDC0000000M1BW250301,,126.5,,2373082.54
2025/03/06,2025/03/01,SF FuneralFDC0000000M2PV250301,,126.5,,2373209.04
2025/03/06,2025/03/01,SF FuneralFDC0000000M2Q1250301,,126.5,,2373335.54
2025/03/06,2025/03/01,SF FuneralF1109043      250301,,126.5,,2373462.04
2025/03/06,2025/03/01,SF FuneralFDC0000000MKD6250301,,126.5,,2373588.54
2025/03/06,2025/03/01,SF FuneralF1109656      250301,,126.5,,2373715.04
2025/03/06,2025/03/01,SF FuneralF1109757      250301,,126.5,,2373841.54
2025/03/06,2025/03/01,SF FuneralF1110002      250301,,126.5,,2373968.04
2025/03/06,2025/03/01,SF FuneralFDC0000000N5LT250301,,126.5,,2374094.54
2025/03/06,2025/03/01,SF FuneralF1113916      250301,,126.5,,2374221.04
2025/03/06,2025/03/01,SF FuneralF1113937      250302,,63.25,,2374284.29
2025/03/06,2025/03/01,SF FuneralF1113991      250301,,126.5,,2374410.79
2025/03/06,2025/03/01,SF FuneralF1114476      250301,,126.5,,2374537.29
2025/03/06,2025/03/01,SF FuneralF1115167      250301,,126.5,,2374663.79
2025/03/06,2025/03/01,SF FuneralF1122306      250301,,191.5,,2374855.29
2025/03/06,2025/03/01,SF FuneralF1122625      250301,,126.5,,2374981.79
2025/03/06,2025/03/01,SF FuneralFDC0000000P1GF250301,,126.5,,2375108.29
2025/03/06,2025/03/01,SF FuneralF1124069      250301,,126.5,,2375234.79
2025/03/06,2025/03/01,SF FuneralF1124764      250301,,126.5,,2375361.29
2025/03/06,2025/03/01,SF FuneralF1122649      250301,,126.5,,2375487.79
2025/03/06,2025/03/01,SF FuneralF1125974      250301,,126.5,,2375614.29
2025/03/06,2025/03/01,SF FuneralF1126003      250301,,126.5,,2375740.79
2025/03/06,2025/03/01,SF FuneralFDC0000000PLSR250301,,126.5,,2375867.29
2025/03/06,2025/03/01,SF FuneralFDC0000000PLST250301,,126.5,,2375993.79
2025/03/06,2025/03/01,SF FuneralF1126958      250301,,126.5,,2376120.29
2025/03/06,2025/03/01,SF FuneralFDC0000000PNJW250301,,126.5,,2376246.79
2025/03/06,2025/03/01,SF FuneralFDC0000000PQJ9250301,,126.5,,2376373.29
2025/03/06,2025/03/01,SF FuneralF1128138      250301,,126.5,,2376499.79
2025/03/06,2025/03/01,SF FuneralF1128228      250301,,126.5,,2376626.29
2025/03/06,2025/03/01,SF FuneralFDC0000000PWPF250301,,126.5,,2376752.79
2025/03/06,2025/03/01,SF FuneralFDC0000000PWPP250301,,126.5,,2376879.29
2025/03/06,2025/03/01,SF FuneralF1128975      250302,,126.5,,2377005.79
2025/03/06,2025/03/01,SF FuneralF1129281      250301,,126.5,,2377132.29
2025/03/06,2025/03/01,SF FuneralFDC0000000PZ3Y250301,,126.5,,2377258.79
2025/03/06,2025/03/01,SF FuneralF1131490      250301,,126.5,,2377385.29
2025/03/06,2025/03/01,SF FuneralF1132342      250301,,126.5,,2377511.79
2025/03/06,2025/03/01,SF FuneralF1132877      250301,,126.5,,2377638.29
2025/03/06,2025/03/05,SF FuneralF828742       250305,,126.5,,2377764.79
2025/03/06,2025/02/26,SF FuneralF829655       250226,,126.5,,2377891.29
2025/03/06,2025/02/26,SF FuneralF1120563      250226,,126.5,,2378017.79
2025/03/06,2025/03/03,SF FuneralFDC00000004CSK250303,,55,,2378072.79
2025/03/06,2025/03/03,SF FuneralFDC00000004CSL250303,,55,,2378127.79
2025/03/06,2025/03/03,SF FuneralFDC00000005LWP250302,,31.63,,2378159.42
2025/03/06,2025/03/03,SF FuneralFDC00000006NRN250302,,220,,2378379.42
2025/03/06,2025/03/03,SF FuneralFDC000000070CJ250303,,31.63,,2378411.05
2025/03/06,2025/03/03,SF FuneralF812202       250303,,31.63,,2378442.68
2025/03/06,2025/03/03,SF FuneralF820956       250302,,31.63,,2378474.31
2025/03/06,2025/03/03,SF FuneralFDC0000000CWBD250302,,31.63,,2378505.94
2025/03/06,2025/03/03,SF FuneralF843991       250301,,126.5,,2378632.44
2025/03/06,2025/03/03,SF FuneralFDC0000000FMK0250301,,126.5,,2378758.94
2025/03/06,2025/03/03,SF FuneralF1068038      250303,,126.5,,2378885.44
2025/03/06,2025/02/27,SF FuneralF823197       250227,,126.5,,2379011.94
2025/03/06,2025/02/27,SF FuneralF827904       250227,,126.5,,2379138.44
2025/03/06,2025/02/25,SF FuneralFDC00000005N6C250225,,126.5,,2379264.94
2025/03/06,2025/03/04,SF FuneralFDC00000007LG1250304,,31.63,,2379296.57
2025/03/06,2025/03/04,SF FuneralF797821       250304,,63.25,,2379359.82
2025/03/06,2025/03/04,SF FuneralF818153       250304,,31.63,,2379391.45
2025/03/06,2025/03/04,SF FuneralFDC0000000JCMX250304,,126.5,,2379517.95
2025/03/06,2025/03/04,SF FuneralF1110349      250304,,31.63,,2379549.58
2025/03/06,2025/03/04,SF FuneralF1118994      250304,,63.25,,2379612.83
2025/03/06,2025/02/25,SF FuneralF1055118      250225,,126.5,,2379739.33
2025/03/06,2025/03/03,SF FuneralF814988       250302,,126.5,,2379865.83
2025/03/06,2025/03/03,SF FuneralF1073577      250303,,126.5,,2379992.33
2025/03/06,2025/03/03,SF FuneralF1116789      250303,,63.25,,2380055.58
2025/03/06,2025/03/04,SF FuneralFDC0000000Q9Y4250304,,63.25,,2380118.83
2025/03/06,2025/03/03,SF FuneralF1122727      250303,,31.63,,2380150.46
2025/03/06,2025/03/05,SF FuneralFDC0000000LG2D250305,,31.63,,2380182.09
2025/03/06,2025/02/28,SF FuneralFDC0000000D307250228,,31.63,,2380213.72
2025/03/06,2025/03/01,SF FuneralFDC0000000JVCB250302,,31.63,,2380245.35
2025/03/06,2025/03/01,SF FuneralF1120593      250302,,31.63,,2380276.98
2025/03/06,2025/03/01,SF FuneralFDC0000000PZBG250302,,31.63,,2380308.61
2025/03/06,2025/03/03,SF FuneralF834650       250302,,31.63,,2380340.24
2025/03/06,2025/03/03,SF FuneralFDC0000000K09V250303,,31.63,,2380371.87
2025/03/06,2025/03/03,SF FuneralF1079351      250303,,31.63,,2380403.5
2025/03/06,2025/03/05,SF FuneralF1078566      250305,,31.63,,2380435.13
2025/03/06,2025/02/28,SF FuneralF1108544      250228,,126.5,,2380561.63
2025/03/06,2025/03/03,SF FuneralF813312       250302,,126.5,,2380688.13
2025/03/06,2025/02/24,SF FuneralF1122992      250224,,126.5,,2380814.63
2025/03/06,2025/03/01,SF FuneralFDC0000000P9CK250301,,126.5,,2380941.13
2025/03/06,2025/03/01,SF FuneralFDC0000000PPDH250301,,126.5,,2381067.63
2025/03/06,2025/03/01,SF FuneralFDC0000000PPDJ250301,,126.5,,2381194.13
2025/03/06,2025/03/03,SF FuneralFDC000000050LF250302,,220,,2381414.13
2025/03/06,2025/03/03,SF FuneralFDC00000007WPC250302,,126.5,,2381540.63
2025/03/06,2025/02/27,SF FuneralF844410       250227,,126.5,,2381667.13
2025/03/06,2025/02/27,SF FuneralF1123281      250227,,126.5,,2381793.63
2025/03/06,2025/03/05,SF FuneralFDC0000000LFXQ250305,,126.5,,2381920.13
2025/03/06,2025/02/24,SF FuneralFDC000000071VG250223,,126.5,,2382046.63
2025/03/06,2025/02/28,SF FuneralFDC00000007T63250228,,126.5,,2382173.13
2025/03/06,2025/02/28,SF FuneralFDC0000000KJ24250228,,126.5,,2382299.63
2025/03/06,2025/03/01,SF FuneralFDC00000006HZY250301,,126.5,,2382426.13
2025/03/06,2025/03/01,SF FuneralFDC0000000PPCM250301,,126.5,,2382552.63
2025/03/06,2025/03/01,SF FuneralFDC0000000PPDG250301,,126.5,,2382679.13
2025/03/06,2025/03/01,SF FuneralFDC0000000PPDL250301,,126.5,,2382805.63
2025/03/06,2025/02/27,SF FuneralF828088       250227,,126.5,,2382932.13
2025/03/06,2025/02/28,SF FuneralF799168       250228,,126.5,,2383058.63
2025/03/06,2025/03/01,SF FuneralF1122295      250302,,31.63,,2383090.26
2025/03/06,2025/03/01,SF FuneralF1128250      250301,,126.5,,2383216.76
2025/03/06,2025/03/03,SF FuneralFDC00000005YNL250303,,55,,2383271.76
2025/03/06,2025/03/03,SF FuneralFDC00000005YW3250303,,31.63,,2383303.39
2025/03/06,2025/03/03,SF FuneralF1123098      250303,,31.63,,2383335.02
2025/03/06,2025/03/05,SF FuneralFDC00000005X1Y250305,,126.5,,2383461.52
2025/03/06,2025/03/05,SF FuneralFDC000000064GW250305,,31.63,,2383493.15
2025/03/06,2025/02/28,SF FuneralFDC00000002P3B250228,,220,,2383713.15
2025/03/06,2025/02/28,SF FuneralFDC00000002WQL250228,,220,,2383933.15
2025/03/06,2025/02/28,SF FuneralFDC00000003B9H250228,,220,,2384153.15
2025/03/06,2025/02/28,SF FuneralFDC00000003BCR250228,,220,,2384373.15
2025/03/06,2025/02/28,SF FuneralFDC00000003BF2250228,,220,,2384593.15
2025/03/06,2025/02/28,SF FuneralFDC00000003F74250228,,220,,2384813.15
2025/03/06,2025/02/28,SF FuneralFDC000000043MJ250228,,220,,2385033.15
2025/03/06,2025/02/28,SF FuneralFDC00000006BXY250228,,126.5,,2385159.65
2025/03/06,2025/02/28,SF FuneralFDC00000006JBM250228,,220,,2385379.65
2025/03/06,2025/02/28,SF FuneralF901425       250302,,126.5,,2385506.15
2025/03/06,2025/02/28,SF FuneralF813340       250301,,256.5,,2385762.65
2025/03/06,2025/02/28,SF FuneralFDC0000000HYKZ250301,,126.5,,2385889.15
2025/03/06,2025/03/01,SF FuneralFDC00000002VNY250301,,220,,2386109.15
2025/03/06,2025/03/01,SF FuneralFDC00000002W6Z250301,,220,,2386329.15
2025/03/06,2025/03/01,SF FuneralFDC00000002WW9250301,,220,,2386549.15
2025/03/06,2025/03/01,SF FuneralFDC00000002YRR250301,,220,,2386769.15
2025/03/06,2025/03/01,SF FuneralFDC00000002Z3Z250301,,220,,2386989.15
2025/03/06,2025/03/01,SF FuneralFDC000000033L6250301,,220,,2387209.15
2025/03/06,2025/03/01,SF FuneralFDC000000033MG250301,,220,,2387429.15
2025/03/06,2025/03/01,SF FuneralFDC000000033VR250301,,220,,2387649.15
2025/03/06,2025/03/01,SF FuneralFDC00000003403250301,,220,,2387869.15
2025/03/06,2025/03/01,SF FuneralFDC0000000342Z250301,,220,,2388089.15
2025/03/06,2025/03/01,SF FuneralFDC0000000349H250301,,220,,2388309.15
2025/03/06,2025/03/01,SF FuneralFDC0000000353T250301,,220,,2388529.15
2025/03/06,2025/03/01,SF FuneralFDC00000003BPQ250301,,220,,2388749.15
2025/03/06,2025/03/01,SF FuneralFDC00000003DMR250301,,220,,2388969.15
2025/03/06,2025/03/01,SF FuneralFDC00000003KSQ250301,,220,,2389189.15
2025/03/06,2025/03/01,SF FuneralFDC00000003LCK250301,,220,,2389409.15
2025/03/06,2025/03/01,SF FuneralFDC00000003LM4250301,,220,,2389629.15
2025/03/06,2025/03/01,SF FuneralFDC00000003T9W250301,,220,,2389849.15
2025/03/06,2025/03/01,SF FuneralFDC00000003TKQ250301,,220,,2390069.15
2025/03/06,2025/03/01,SF FuneralFDC00000003TM4250301,,220,,2390289.15
2025/03/06,2025/03/01,SF FuneralFDC00000003V14250301,,220,,2390509.15
2025/03/06,2025/03/01,SF FuneralFDC00000003V5C250301,,220,,2390729.15
2025/03/06,2025/03/01,SF FuneralFDC000000041MN250301,,220,,2390949.15
2025/03/06,2025/03/01,SF FuneralFDC000000044KP250301,,220,,2391169.15
2025/03/06,2025/03/01,SF FuneralFDC000000044LX250301,,220,,2391389.15
2025/03/06,2025/03/01,SF FuneralFDC000000058KZ250301,,126.5,,2391515.65
2025/03/06,2025/03/01,SF FuneralFDC000000058Q7250301,,126.5,,2391642.15
2025/03/06,2025/03/01,SF FuneralFDC000000058RL250301,,126.5,,2391768.65
2025/03/06,2025/03/01,SF FuneralFDC000000058TR250301,,126.5,,2391895.15
2025/03/06,2025/03/01,SF FuneralFDC00000005DDM250301,,126.5,,2392021.65
2025/03/06,2025/03/01,SF FuneralFDC00000005WTL250301,,220,,2392241.65
2025/03/06,2025/03/01,SF FuneralFDC00000005X3S250301,,126.5,,2392368.15
2025/03/06,2025/03/01,SF FuneralFDC00000006GXL250301,,220,,2392588.15
2025/03/06,2025/03/01,SF FuneralFDC00000006KQQ250301,,126.5,,2392714.65
2025/03/06,2025/03/01,SF FuneralFDC00000006LYV250301,,126.5,,2392841.15
2025/03/06,2025/03/01,SF FuneralFDC00000006NTV250301,,126.5,,2392967.65
2025/03/06,2025/03/01,SF FuneralFDC0000000759N250301,,126.5,,2393094.15
2025/03/06,2025/03/01,SF FuneralFDC0000000763V250301,,126.5,,2393220.65
2025/03/06,2025/03/01,SF FuneralFDC000000076V3250301,,126.5,,2393347.15
2025/03/06,2025/03/01,SF FuneralFDC0000000790M250301,,126.5,,2393473.65
2025/03/06,2025/03/01,SF FuneralFDC0000000790R250301,,126.5,,2393600.15
2025/03/06,2025/03/01,SF FuneralFDC0000000795V250301,,126.5,,2393726.65
2025/03/06,2025/03/01,SF FuneralFDC00000007BSC250301,,126.5,,2393853.15
2025/03/06,2025/03/01,SF FuneralFDC00000007GF7250301,,126.5,,2393979.65
2025/03/06,2025/03/01,SF FuneralFDC00000007MXQ250301,,126.5,,2394106.15
2025/03/06,2025/03/01,SF FuneralFDC00000007NWH250301,,126.5,,2394232.65
2025/03/06,2025/03/01,SF FuneralFDC00000007RL7250301,,126.5,,2394359.15
2025/03/06,2025/03/01,SF FuneralFDC00000007S28250301,,126.5,,2394485.65
2025/03/06,2025/03/01,SF FuneralF809074       250301,,126.5,,2394612.15
2025/03/06,2025/03/01,SF FuneralFDC00000009G8T250301,,126.5,,2394738.65
2025/03/06,2025/03/01,SF FuneralF782540       250301,,256.5,,2394995.15
2025/03/06,2025/03/01,SF FuneralF813487       250301,,126.5,,2395121.65
2025/03/06,2025/03/01,SF FuneralF815173       250301,,126.5,,2395248.15
2025/03/06,2025/03/01,SF FuneralF818950       250301,,126.5,,2395374.65
2025/03/06,2025/03/01,SF FuneralF821111       250301,,126.5,,2395501.15
2025/03/06,2025/03/01,SF FuneralF821379       250301,,126.5,,2395627.65
2025/03/06,2025/03/01,SF FuneralFDC0000000BD0Y250301,,220,,2395847.65
2025/03/06,2025/03/01,SF FuneralF822538       250301,,126.5,,2395974.15
2025/03/06,2025/03/01,SF FuneralF822546       250301,,126.5,,2396100.65
2025/03/06,2025/03/01,SF FuneralF782650       250301,,191.5,,2396292.15
2025/03/06,2025/03/01,SF FuneralF782679       250301,,386.5,,2396678.65
2025/03/06,2025/03/01,SF FuneralFDC0000000CLLX250301,,126.5,,2396805.15
2025/03/06,2025/03/01,SF FuneralFDC0000000F7JG250301,,126.5,,2396931.65
2025/03/06,2025/03/01,SF FuneralF1052080      250301,,126.5,,2397058.15
2025/03/06,2025/03/01,SF FuneralF818002       250301,,191.5,,2397249.65
2025/03/06,2025/03/01,SF FuneralFDC0000000LG8C250301,,126.5,,2397376.15
2025/03/06,2025/03/01,SF FuneralF1110129      250301,,126.5,,2397502.65
2025/03/06,2025/03/01,SF FuneralF1122298      250301,,126.5,,2397629.15
2025/03/06,2025/03/01,SF FuneralFDC0000000P2JQ250301,,126.5,,2397755.65
2025/03/06,2025/03/01,SF FuneralFDC0000000P2JW250301,,126.5,,2397882.15
2025/03/06,2025/03/01,SF FuneralFDC0000000PXHG250301,,126.5,,2398008.65
2025/03/06,2025/03/01,SF FuneralFDC0000000PXHK250301,,126.5,,2398135.15
2025/03/06,2025/03/01,SF FuneralFDC0000000PXHP250301,,126.5,,2398261.65
2025/03/06,2025/03/03,SF FuneralFDC00000002W44250302,,220,,2398481.65
2025/03/06,2025/03/03,SF FuneralFDC00000003C1B250303,,220,,2398701.65
2025/03/06,2025/03/03,SF FuneralFDC00000004HNC250302,,220,,2398921.65
2025/03/06,2025/03/03,SF FuneralFDC00000006DX6250302,,126.5,,2399048.15
2025/03/06,2025/03/03,SF FuneralFDC00000007595250302,,126.5,,2399174.65
2025/03/06,2025/03/03,SF FuneralFDC000000086B4250303,,126.5,,2399301.15
2025/03/06,2025/03/03,SF FuneralFDC00000008P69250303,,126.5,,2399427.65
2025/03/06,2025/03/03,SF FuneralF804587       250302,,126.5,,2399554.15
2025/03/06,2025/03/03,SF FuneralF809672       250303,,126.5,,2399680.65
2025/03/06,2025/03/03,SF FuneralFDC00000009F3K250302,,126.5,,2399807.15
2025/03/06,2025/03/03,SF FuneralF832817       250302,,126.5,,2399933.65
2025/03/06,2025/03/03,SF FuneralF843017       250301,,126.5,,2400060.15
2025/03/06,2025/03/03,SF FuneralF988353       250303,,126.5,,2400186.65
2025/03/06,2025/03/03,SF FuneralF1113743      250303,,126.5,,2400313.15
2025/03/06,2025/03/03,SF FuneralFDC0000000NLRJ250303,,126.5,,2400439.65
2025/03/06,2025/03/04,SF FuneralFDC00000002WBH250304,,220,,2400659.65
2025/03/06,2025/03/04,SF FuneralFDC0000000353W250304,,220,,2400879.65
2025/03/06,2025/03/04,SF FuneralFDC0000000PXPX250304,,126.5,,2401006.15
2025/03/06,2025/03/04,SF FuneralF1129151      250304,,126.5,,2401132.65
2025/03/06,2025/03/04,SF FuneralFDC0000000Q73N250304,,220,,2401352.65
2025/03/06,2025/03/05,SF FuneralFDC000000044KN250305,,220,,2401572.65
2025/03/06,2025/02/24,SF FuneralF1060269      250224,,126.5,,2401699.15
2025/03/06,2025/02/27,SF FuneralF813559       250227,,126.5,,2401825.65
2025/03/06,2025/02/28,SF FuneralFDC000000071SG250228,,126.5,,2401952.15
2025/03/06,2025/02/28,SF FuneralF900538       250228,,126.5,,2402078.65
2025/03/06,2025/02/28,SF FuneralFDC0000000LPDK250228,,126.5,,2402205.15
2025/03/06,2025/03/01,SF FuneralF1119757      250302,,126.5,,2402331.65
2025/03/06,2025/03/04,SF FuneralF809863       250304,,126.5,,2402458.15
2025/03/06,2025/03/01,SF FuneralF1078542      250301,,126.5,,2402584.65
2025/03/06,2025/03/01,SF FuneralFDC0000000NJHM250301,,63.25,,2402647.9
2025/03/06,2025/03/01,SF FuneralF1132101      250302,,126.5,,2402774.4
2025/03/06,2025/02/27,SF FuneralFDC00000006FN3250227,,126.5,,2402900.9
2025/03/06,2025/03/03,SF FuneralF1120655      250303,,31.63,,2402932.53
2025/03/06,2025/02/25,SF FuneralFDC000000071GF250225,,63.25,,2402995.78
2025/03/06,2025/02/24,SF FuneralF847428       250222,,126.5,,2403122.28
2025/03/06,2025/02/27,SF FuneralF1017500      250227,,126.5,,2403248.78
2025/03/06,2025/03/01,SF FuneralF1058813      250301,,126.5,,2403375.28
2025/03/06,2025/03/01,SF FuneralF1066521      250301,,126.5,,2403501.78
2025/03/06,2025/03/01,SF FuneralF1118621      250301,,126.5,,2403628.28
2025/03/06,2025/03/01,SF FuneralF1120274      250301,,126.5,,2403754.78
2025/03/06,2025/03/01,SF FuneralF1122651      250301,,126.5,,2403881.28
2025/03/06,2025/03/01,SF FuneralF1125945      250301,,126.5,,2404007.78
2025/03/06,2025/03/01,SF FuneralFDC0000000PWDW250302,,126.5,,2404134.28
2025/03/06,2025/03/01,SF FuneralF1128901      250302,,126.5,,2404260.78
2025/03/06,2025/03/01,SF FuneralF1129147      250301,,126.5,,2404387.28
2025/03/06,2025/03/03,SF FuneralF1132899      250303,,126.5,,2404513.78
2025/03/06,2025/03/04,SF FuneralF1129464      250304,,31.63,,2404545.41
2025/03/06,2025/02/27,SF FuneralF1054807      250227,,126.5,,2404671.91
2025/03/06,2025/02/26,SF FuneralF1079719      250226,,126.5,,2404798.41
2025/03/06,2025/03/01,SF FuneralF1021491      250302,,31.63,,2404830.04
2025/03/06,2025/03/01,SF FuneralF1130021      250301,,126.5,,2404956.54
2025/03/06,2025/03/01,SF FuneralF1131634      250302,,126.5,,2405083.04
2025/03/06,2025/03/04,SF FuneralF810426       250304,,31.63,,2405114.67
2025/03/06,2025/02/27,SF FuneralFDC00000006D6F250227,,126.5,,2405241.17
2025/03/06,2025/02/27,SF FuneralF900891       250227,,126.5,,2405367.67
2025/03/06,2025/02/25,SF FuneralFDC00000007QDJ250225,,126.5,,2405494.17
2025/03/06,2025/02/25,SF FuneralF844602       250225,,63.25,,2405557.42
2025/03/06,2025/02/25,SF FuneralF1115181      250225,,63.25,,2405620.67
2025/03/06,2025/03/05,SF FuneralFDC00000009XJM250305,,191.5,,2405812.17
2025/03/06,2025/03/04,SF FuneralFDC00000004CPJ250304,,220,,2406032.17
2025/03/06,2025/03/04,SF FuneralF811655       250304,,31.63,,2406063.8
2025/03/06,2025/03/04,SF FuneralF1061590      250304,,126.5,,2406190.3
2025/03/06,2025/03/04,SF FuneralF1123207      250304,,126.5,,2406316.8
2025/03/06,2025/02/26,SF FuneralF828407       250226,,126.5,,2406443.3
2025/03/06,2025/02/26,SF FuneralF1060097      250226,,126.5,,2406569.8
2025/03/06,2025/02/28,SF FuneralF811059       250228,,126.5,,2406696.3
2025/03/06,2025/02/28,SF FuneralF816342       250228,,126.5,,2406822.8
2025/03/06,2025/02/28,SF FuneralF818589       250228,,126.5,,2406949.3
2025/03/06,2025/02/28,SF FuneralFDC0000000B988250228,,126.5,,2407075.8
2025/03/06,2025/02/28,SF FuneralF832724       250228,,126.5,,2407202.3
2025/03/06,2025/02/28,SF FuneralF987032       250301,,126.5,,2407328.8
2025/03/06,2025/02/28,SF FuneralF987067       250301,,126.5,,2407455.3
2025/03/06,2025/02/28,SF FuneralF987880       250301,,126.5,,2407581.8
2025/03/06,2025/02/28,SF FuneralF988968       250301,,126.5,,2407708.3
2025/03/06,2025/02/28,SF FuneralF989000       250301,,126.5,,2407834.8
2025/03/06,2025/02/28,SF FuneralF991066       250301,,126.5,,2407961.3
2025/03/06,2025/03/03,SF FuneralF809759       250303,,63.25,,2408024.55
2025/03/06,2025/03/03,SF FuneralF819802       250303,,31.63,,2408056.18
2025/03/06,2025/03/03,SF FuneralF843179       250301,,126.5,,2408182.68
2025/03/06,2025/03/03,SF FuneralF843666       250301,,126.5,,2408309.18
2025/03/06,2025/03/03,SF FuneralF843677       250301,,126.5,,2408435.68
2025/03/06,2025/03/03,SF FuneralF901297       250303,,31.63,,2408467.31
2025/03/06,2025/03/03,SF FuneralF1033557      250303,,126.5,,2408593.81
2025/03/06,2025/03/03,SF FuneralF1066605      250303,,126.5,,2408720.31
2025/03/06,2025/03/03,SF FuneralF1066643      250303,,126.5,,2408846.81
2025/03/06,2025/03/03,SF FuneralF987001       250303,,126.5,,2408973.31
2025/03/06,2025/03/03,SF FuneralFDC0000000NC01250303,,63.25,,2409036.56
2025/03/06,2025/03/03,SF FuneralF1115130      250303,,63.25,,2409099.81
2025/03/06,2025/03/03,SF FuneralF1117317      250303,,126.5,,2409226.31
2025/03/06,2025/03/03,SF FuneralFDC0000000PXX8250303,,126.5,,2409352.81
2025/03/06,2025/03/03,SF FuneralF1130847      250303,,31.63,,2409384.44
2025/03/06,2025/03/01,SF FuneralFDC00000006W22250301,,126.5,,2409510.94
2025/03/06,2025/03/01,SF FuneralFDC0000000792S250301,,126.5,,2409637.44
2025/03/06,2025/03/01,SF FuneralF795662       250301,,126.5,,2409763.94
2025/03/06,2025/03/01,SF FuneralF809680       250301,,126.5,,2409890.44
2025/03/06,2025/03/01,SF FuneralF812266       250301,,126.5,,2410016.94
2025/03/06,2025/03/01,SF FuneralF812974       250301,,126.5,,2410143.44
2025/03/06,2025/03/01,SF FuneralF817036       250301,,126.5,,2410269.94
2025/03/06,2025/03/01,SF FuneralF821500       250301,,126.5,,2410396.44
2025/03/06,2025/03/01,SF FuneralF829946       250301,,126.5,,2410522.94
2025/03/06,2025/03/01,SF FuneralF830531       250301,,126.5,,2410649.44
2025/03/06,2025/03/01,SF FuneralF832166       250301,,126.5,,2410775.94
2025/03/06,2025/03/01,SF FuneralF832842       250301,,126.5,,2410902.44
2025/03/06,2025/03/01,SF FuneralF833056       250301,,126.5,,2411028.94
2025/03/06,2025/03/01,SF FuneralF833091       250301,,126.5,,2411155.44
2025/03/06,2025/03/01,SF FuneralF992771       250301,,126.5,,2411281.94
2025/03/06,2025/03/01,SF FuneralF993322       250302,,126.5,,2411408.44
2025/03/06,2025/03/01,SF FuneralF1059301      250301,,126.5,,2411534.94
2025/03/06,2025/03/01,SF FuneralF1059339      250301,,126.5,,2411661.44
2025/03/06,2025/03/01,SF FuneralF1059713      250301,,126.5,,2411787.94
2025/03/06,2025/03/01,SF FuneralF1060493      250301,,126.5,,2411914.44
2025/03/06,2025/03/01,SF FuneralF1068116      250301,,126.5,,2412040.94
2025/03/06,2025/03/01,SF FuneralF1078387      250301,,126.5,,2412167.44
2025/03/06,2025/03/01,SF FuneralF1078452      250301,,126.5,,2412293.94
2025/03/06,2025/03/01,SF FuneralF1084553      250301,,126.5,,2412420.44
2025/03/06,2025/03/01,SF FuneralF1084677      250301,,126.5,,2412546.94
2025/03/06,2025/03/01,SF FuneralF1108713      250301,,126.5,,2412673.44
2025/03/06,2025/03/01,SF FuneralF1108718      250301,,126.5,,2412799.94
2025/03/06,2025/03/01,SF FuneralF1109650      250301,,126.5,,2412926.44
2025/03/06,2025/03/01,SF FuneralF1110057      250301,,126.5,,2413052.94
2025/03/06,2025/03/01,SF FuneralF1110192      250301,,126.5,,2413179.44
2025/03/06,2025/03/01,SF FuneralFDC0000000MN61250301,,126.5,,2413305.94
2025/03/06,2025/03/01,SF FuneralF1113287      250301,,126.5,,2413432.44
2025/03/06,2025/03/01,SF FuneralF1113740      250301,,126.5,,2413558.94
2025/03/06,2025/03/01,SF FuneralF1114367      250301,,126.5,,2413685.44
2025/03/06,2025/03/01,SF FuneralF1115131      250301,,126.5,,2413811.94
2025/03/06,2025/03/01,SF FuneralF1118015      250301,,126.5,,2413938.44
2025/03/06,2025/03/01,SF FuneralF1122640      250301,,126.5,,2414064.94
2025/03/06,2025/03/01,SF FuneralF1123004      250301,,126.5,,2414191.44
2025/03/06,2025/03/01,SF FuneralF1125005      250302,,126.5,,2414317.94
2025/03/06,2025/03/01,SF FuneralF1126056      250301,,126.5,,2414444.44
2025/03/06,2025/03/01,SF FuneralFDC0000000PLRZ250301,,126.5,,2414570.94
2025/03/06,2025/03/01,SF FuneralFDC0000000PLS2250301,,126.5,,2414697.44
2025/03/06,2025/03/01,SF FuneralF1127559      250301,,126.5,,2414823.94
2025/03/06,2025/03/01,SF FuneralF1128044      250301,,126.5,,2414950.44
2025/03/06,2025/03/01,SF FuneralF1128068      250301,,126.5,,2415076.94
2025/03/06,2025/03/01,SF FuneralF1128654      250301,,126.5,,2415203.44
2025/03/06,2025/03/01,SF FuneralF1128687      250301,,126.5,,2415329.94
2025/03/06,2025/03/01,SF FuneralF1129034      250301,,126.5,,2415456.44
2025/03/06,2025/03/01,SF FuneralF1129164      250302,,126.5,,2415582.94
2025/03/06,2025/03/01,SF FuneralF1129275      250301,,126.5,,2415709.44
2025/03/06,2025/03/01,SF FuneralF1129278      250301,,126.5,,2415835.94
2025/03/06,2025/03/01,SF FuneralF1130287      250301,,126.5,,2415962.44
2025/03/06,2025/03/01,SF FuneralF1131637      250301,,126.5,,2416088.94
2025/03/06,2025/03/01,SF FuneralF1131652      250301,,126.5,,2416215.44
2025/03/06,2025/03/01,SF FuneralF1131683      250301,,126.5,,2416341.94
2025/03/06,2025/03/01,SF FuneralFDC0000000Q5XG250301,,126.5,,2416468.44
2025/03/06,2025/03/01,SF FuneralF1132262      250301,,126.5,,2416594.94
2025/03/06,2025/03/01,SF FuneralF1132412      250301,,126.5,,2416721.44
2025/03/06,2025/03/01,SF FuneralFDC00000003ZV3250301,,220,,2416941.44
2025/03/06,2025/03/01,SF FuneralFDC00000006FXT250301,,126.5,,2417067.94
2025/03/06,2025/03/01,SF FuneralFDC00000006MKC250301,,126.5,,2417194.44
2025/03/06,2025/03/01,SF FuneralFDC0000000787J250301,,126.5,,2417320.94
2025/03/06,2025/03/01,SF FuneralFDC00000007F7F250301,,126.5,,2417447.44
2025/03/06,2025/03/01,SF FuneralFDC00000007V4R250301,,126.5,,2417573.94
2025/03/06,2025/03/01,SF FuneralFDC000000083N4250301,,126.5,,2417700.44
2025/03/06,2025/03/01,SF FuneralF803234       250301,,126.5,,2417826.94
2025/03/06,2025/03/01,SF FuneralF814841       250301,,191.5,,2418018.44
2025/03/06,2025/03/01,SF FuneralF817151       250301,,126.5,,2418144.94
2025/03/06,2025/03/01,SF FuneralF821797       250301,,126.5,,2418271.44
2025/03/06,2025/03/01,SF FuneralF828638       250301,,126.5,,2418397.94
2025/03/06,2025/03/01,SF FuneralF834977       250301,,126.5,,2418524.44
2025/03/06,2025/03/01,SF FuneralF993544       250301,,126.5,,2418650.94
2025/03/06,2025/03/01,SF FuneralF1022085      250301,,126.5,,2418777.44
2025/03/06,2025/03/01,SF FuneralF1033531      250301,,126.5,,2418903.94
2025/03/06,2025/03/01,SF FuneralF1054686      250301,,126.5,,2419030.44
2025/03/06,2025/03/01,SF FuneralF1060968      250302,,31.63,,2419062.07
2025/03/06,2025/03/01,SF FuneralF1078340      250301,,126.5,,2419188.57
2025/03/06,2025/03/01,SF FuneralFDC0000000LFBS250301,,126.5,,2419315.07
2025/03/06,2025/03/01,SF FuneralF1084566      250301,,126.5,,2419441.57
2025/03/06,2025/03/01,SF FuneralFDC0000000LZSC250301,,126.5,,2419568.07
2025/03/06,2025/03/01,SF FuneralFDC0000000M02F250301,,126.5,,2419694.57
2025/03/06,2025/03/01,SF FuneralF1110119      250301,,126.5,,2419821.07
2025/03/06,2025/03/01,SF FuneralF1110266      250301,,126.5,,2419947.57
2025/03/06,2025/03/01,SF FuneralF1110404      250301,,126.5,,2420074.07
2025/03/06,2025/03/01,SF FuneralF1111969      250301,,126.5,,2420200.57
2025/03/06,2025/03/01,SF FuneralF1114103      250301,,126.5,,2420327.07
2025/03/06,2025/03/01,SF FuneralFDC0000000NHKW250301,,126.5,,2420453.57
2025/03/06,2025/03/01,SF FuneralF1117415      250301,,126.5,,2420580.07
2025/03/06,2025/03/01,SF FuneralF1117719      250301,,126.5,,2420706.57
2025/03/06,2025/03/01,SF FuneralF1117992      250301,,126.5,,2420833.07
2025/03/06,2025/03/01,SF FuneralF1118165      250301,,126.5,,2420959.57
2025/03/06,2025/03/01,SF FuneralF1123486      250301,,126.5,,2421086.07
2025/03/06,2025/03/01,SF FuneralFDC0000000PJFW250302,,126.5,,2421212.57
2025/03/06,2025/03/01,SF FuneralF1125959      250301,,126.5,,2421339.07
2025/03/06,2025/03/01,SF FuneralFDC0000000PJPN250301,,126.5,,2421465.57
2025/03/06,2025/03/01,SF FuneralF1126828      250301,,126.5,,2421592.07
2025/03/06,2025/03/01,SF FuneralF1127102      250301,,126.5,,2421718.57
2025/03/06,2025/03/01,SF FuneralFDC0000000PW8R250301,,126.5,,2421845.07
2025/03/06,2025/03/01,SF FuneralF1128858      250301,,126.5,,2421971.57
2025/03/06,2025/03/01,SF FuneralF1129009      250301,,126.5,,2422098.07
2025/03/06,2025/03/01,SF FuneralF1129343      250301,,126.5,,2422224.57
2025/03/06,2025/03/01,SF FuneralF1130057      250301,,126.5,,2422351.07
2025/03/06,2025/03/01,SF FuneralF1131856      250301,,126.5,,2422477.57
2025/03/06,2025/03/01,SF FuneralF1131974      250301,,126.5,,2422604.07
2025/03/06,2025/03/03,SF FuneralFDC00000002WYL250303,,55,,2422659.07
2025/03/06,2025/03/03,SF FuneralFDC00000003591250303,,55,,2422714.07
2025/03/06,2025/03/03,SF FuneralFDC00000006NYW250303,,63.25,,2422777.32
2025/03/06,2025/03/03,SF FuneralF804342       250302,,126.5,,2422903.82
2025/03/06,2025/03/03,SF FuneralF844264       250301,,126.5,,2423030.32
2025/03/06,2025/03/03,SF FuneralF890610       250301,,126.5,,2423156.82
2025/03/06,2025/03/03,SF FuneralFDC0000000JCQW250303,,126.5,,2423283.32
2025/03/06,2025/03/03,SF FuneralFDC0000000LG54250303,,126.5,,2423409.82
2025/03/06,2025/03/03,SF FuneralF1109753      250303,,126.5,,2423536.32
2025/03/06,2025/03/03,SF FuneralF1109875      250303,,126.5,,2423662.82
2025/03/06,2025/03/03,SF FuneralFDC0000000NG63250303,,126.5,,2423789.32
2025/03/06,2025/03/03,SF FuneralF1122918      250303,,126.5,,2423915.82
2025/03/06,2025/03/03,SF FuneralF1128685      250303,,126.5,,2424042.32
2025/03/06,2025/03/03,SF FuneralF1131761      250303,,126.5,,2424168.82
2025/03/06,2025/03/03,SF FuneralF1131859      250303,,126.5,,2424295.32
2025/03/06,2025/03/06,SF FuneralF814201       250306,,126.5,,2424421.82
2025/03/06,2025/02/25,SF FuneralFDC00000006DFX250225,,126.5,,2424548.32
2025/03/06,2025/02/25,SF FuneralFDC000000082Y0250225,,126.5,,2424674.82
2025/03/06,2025/02/25,SF FuneralF802651       250225,,126.5,,2424801.32
2025/03/06,2025/02/27,SF FuneralFDC000000076PX250227,,126.5,,2424927.82
2025/03/06,2025/02/27,SF FuneralFDC000000076PZ250227,,126.5,,2425054.32
2025/03/06,2025/02/27,SF FuneralF812845       250227,,126.5,,2425180.82
2025/03/06,2025/02/27,SF FuneralF813783       250227,,126.5,,2425307.32
2025/03/06,2025/02/27,SF FuneralF823850       250227,,126.5,,2425433.82
2025/03/06,2025/02/27,SF FuneralF842369       250227,,126.5,,2425560.32
2025/03/06,2025/02/27,SF FuneralF1055126      250227,,126.5,,2425686.82
2025/03/06,2025/02/27,SF FuneralFDC0000000NY0B250227,,126.5,,2425813.32
2025/03/06,2025/02/28,SF FuneralF799947       250228,,126.5,,2425939.82
2025/03/06,2025/02/28,SF FuneralF809907       250228,,126.5,,2426066.32
2025/03/06,2025/02/28,SF FuneralF820998       250228,,126.5,,2426192.82
2025/03/06,2025/02/28,SF FuneralF843866       250228,,126.5,,2426319.32
2025/03/06,2025/02/28,SF FuneralF901431       250301,,126.5,,2426445.82
2025/03/06,2025/02/28,SF FuneralF980309       250301,,126.5,,2426572.32
2025/03/06,2025/02/28,SF FuneralF981358       250301,,126.5,,2426698.82
2025/03/06,2025/02/28,SF FuneralF987875       250301,,126.5,,2426825.32
2025/03/06,2025/02/28,SF FuneralF988667       250301,,126.5,,2426951.82
2025/03/06,2025/02/28,SF FuneralF988693       250301,,126.5,,2427078.32
2025/03/06,2025/03/04,SF FuneralF804460       250304,,63.25,,2427141.57
2025/03/06,2025/03/04,SF FuneralF1073535      250304,,126.5,,2427268.07
2025/03/06,2025/03/04,SF FuneralF1073651      250304,,126.5,,2427394.57
2025/03/06,2025/03/04,SF FuneralF1078281      250304,,63.25,,2427457.82
2025/03/06,2025/03/04,SF FuneralF1078342      250304,,126.5,,2427584.32
2025/03/06,2025/03/04,SF FuneralF1115031      250304,,31.63,,2427615.95
2025/03/06,2025/03/04,SF FuneralF1131657      250304,,31.63,,2427647.58
2025/03/06,2025/03/05,SF FuneralFDC00000006JJK250305,,63.25,,2427710.83
2025/03/06,2025/03/05,SF FuneralF992226       250305,,126.5,,2427837.33
2025/03/06,2025/03/05,SF FuneralF993436       250305,,126.5,,2427963.83
2025/03/06,2025/02/28,SF FuneralF797260       250228,,31.63,,2427995.46
2025/03/06,2025/02/28,SF FuneralFDC0000000BBV2250228,,31.63,,2428027.09
2025/03/06,2025/02/28,SF FuneralF821595       250228,,31.63,,2428058.72
2025/03/06,2025/03/04,SF FuneralF809823       250304,,31.63,,2428090.35
2025/03/06,2025/03/05,SF FuneralF1123944      250305,,31.63,,2428121.98
2025/03/06,2025/03/04,SF FuneralFDC00000008C95250304,,31.63,,2428153.61
2025/03/06,2025/03/04,SF FuneralF804949       250304,,31.63,,2428185.24
2025/03/06,2025/03/04,SF FuneralF832888       250304,,31.63,,2428216.87
2025/03/06,2025/03/04,SF FuneralF988005       250304,,31.63,,2428248.5
2025/03/06,2025/03/04,SF FuneralF1073297      250304,,31.63,,2428280.13
2025/03/06,2025/03/04,SF FuneralF1112349      250304,,31.63,,2428311.76
2025/03/06,2025/03/06,SF FuneralF805236       250306,,31.63,,2428343.39
2025/03/06,2025/02/28,SF FuneralF814064       250228,,31.63,,2428375.02
2025/03/06,2025/02/28,SF FuneralF829859       250228,,31.63,,2428406.65
2025/03/06,2025/03/03,SF FuneralFDC00000005N4P250303,,31.63,,2428438.28
2025/03/06,2025/03/03,SF FuneralFDC00000007GG1250302,,31.63,,2428469.91
2025/03/06,2025/03/03,SF FuneralF1052717      250303,,31.63,,2428501.54
2025/03/06,2025/03/03,SF FuneralF1068000      250303,,31.63,,2428533.17
2025/03/06,2025/03/03,SF FuneralF1068148      250303,,31.63,,2428564.8
2025/03/06,2025/03/04,SF FuneralFDC00000008JLD250304,,31.63,,2428596.43
2025/03/06,2025/03/04,SF FuneralF813552       250304,,31.63,,2428628.06
2025/03/06,2025/03/04,SF FuneralF989148       250304,,31.63,,2428659.69
2025/03/06,2025/03/04,SF FuneralF1122761      250304,,31.63,,2428691.32
2025/03/06,2025/03/03,SF FuneralF811593       250303,,31.63,,2428722.95
2025/03/06,2025/03/03,SF FuneralFDC0000000LJ60250303,,31.63,,2428754.58
2025/03/06,2025/03/03,SF FuneralF1130901      250303,,31.63,,2428786.21
2025/03/06,2025/03/04,SF FuneralF1021235      250304,,31.63,,2428817.84
2025/03/06,2025/03/04,SF FuneralF1111742      250304,,31.63,,2428849.47
2025/03/06,2025/03/04,SF FuneralFDC0000000NRQK250304,,31.63,,2428881.1
2025/03/06,2025/02/28,SF FuneralFDC00000006M5Y250228,,31.63,,2428912.73
2025/03/06,2025/02/28,SF FuneralFDC00000006M60250228,,31.63,,2428944.36
2025/03/06,2025/02/28,SF FuneralFDC00000006M62250228,,31.63,,2428975.99
2025/03/06,2025/02/28,SF FuneralFDC00000007ZWN250228,,31.63,,2429007.62
2025/03/06,2025/02/28,SF FuneralFDC00000007ZWY250228,,31.63,,2429039.25
2025/03/06,2025/02/28,SF FuneralF831922       250228,,31.63,,2429070.88
2025/03/06,2025/02/28,SF FuneralFDC0000000D37W250228,,31.63,,2429102.51
2025/03/06,2025/02/28,SF FuneralF1074537      250228,,31.63,,2429134.14
2025/03/06,2025/03/04,SF FuneralF900687       250304,,31.63,,2429165.77
2025/03/06,2025/03/04,SF FuneralF993633       250304,,31.63,,2429197.4
2025/03/06,2025/03/04,SF FuneralFDC0000000PJX8250304,,31.63,,2429229.03
2025/03/06,2025/03/04,SF FuneralF1128998      250304,,31.63,,2429260.66
2025/03/06,2025/02/28,SF FuneralFDC00000006M5S250228,,31.63,,2429292.29
2025/03/06,2025/02/28,SF FuneralFDC00000006M5X250228,,31.63,,2429323.92
2025/03/06,2025/03/03,SF FuneralFDC00000007GFX250302,,31.63,,2429355.55
2025/03/06,2025/03/03,SF FuneralFDC0000000F3H4250303,,31.63,,2429387.18
2025/03/06,2025/03/04,SF FuneralF813326       250304,,31.63,,2429418.81
2025/03/06,2025/03/04,SF FuneralF1074917      250304,,31.63,,2429450.44
2025/03/06,2025/03/04,SF FuneralFDC0000000LK43250304,,31.63,,2429482.07
2025/03/06,2025/03/04,SF FuneralF1110634      250304,,31.63,,2429513.7
2025/03/06,2025/03/04,SF FuneralF1118352      250304,,31.63,,2429545.33
2025/03/06,2025/03/04,SF FuneralF1132209      250304,,31.63,,2429576.96
2025/03/06,2025/03/03,SF FuneralFDC00000008MY8250302,,31.63,,2429608.59
2025/03/06,2025/03/03,SF FuneralFDC0000000FCJY250303,,31.63,,2429640.22
2025/03/06,2025/03/04,SF FuneralF819196       250304,,31.63,,2429671.85
2025/03/06,2025/03/04,SF FuneralF989519       250304,,31.63,,2429703.48
2025/03/06,2025/03/06,SF FuneralF1124328      250306,,31.63,,2429735.11
2025/03/06,2025/02/25,SF FuneralF809397       250225,,126.5,,2429861.61
2025/03/06,2025/02/25,SF FuneralF815962       250225,,126.5,,2429988.11
2025/03/06,2025/02/25,SF FuneralF827856       250225,,126.5,,2430114.61
2025/03/06,2025/02/25,SF FuneralFDC0000000JH4V250225,,126.5,,2430241.11
2025/03/06,2025/02/25,SF FuneralFDC0000000JH68250225,,126.5,,2430367.61
2025/03/06,2025/02/25,SF FuneralF1111373      250225,,63.25,,2430430.86
2025/03/06,2025/02/27,SF FuneralFDC0000000BG56250227,,386.5,,2430817.36
2025/03/06,2025/02/28,SF FuneralF820860       250228,,126.5,,2430943.86
2025/03/06,2025/02/28,SF FuneralF988678       250301,,126.5,,2431070.36
2025/03/06,2025/02/28,SF FuneralF1020968      250228,,126.5,,2431196.86
2025/03/06,2025/02/28,SF FuneralFDC0000000K0XX250228,,126.5,,2431323.36
2025/03/06,2025/02/28,SF FuneralF1103881      250228,,126.5,,2431449.86
2025/03/06,2025/02/28,SF FuneralF1103884      250228,,126.5,,2431576.36
2025/03/06,2025/03/01,SF FuneralFDC00000006G05250301,,126.5,,2431702.86
2025/03/06,2025/03/01,SF FuneralFDC00000006QWT250301,,126.5,,2431829.36
2025/03/06,2025/03/01,SF FuneralF803665       250301,,126.5,,2431955.86
2025/03/06,2025/03/01,SF FuneralF812614       250301,,126.5,,2432082.36
2025/03/06,2025/03/01,SF FuneralF813190       250301,,126.5,,2432208.86
2025/03/06,2025/03/01,SF FuneralF817271       250301,,126.5,,2432335.36
2025/03/06,2025/03/01,SF FuneralF821478       250301,,126.5,,2432461.86
2025/03/06,2025/03/01,SF FuneralF993302       250301,,126.5,,2432588.36
2025/03/06,2025/03/01,SF FuneralF1078351      250301,,126.5,,2432714.86
2025/03/06,2025/03/01,SF FuneralF1080390      250301,,126.5,,2432841.36
2025/03/06,2025/03/01,SF FuneralF1085003      250302,,126.5,,2432967.86
2025/03/06,2025/03/01,SF FuneralF1118101      250301,,126.5,,2433094.36
2025/03/06,2025/03/01,SF FuneralF1122299      250302,,126.5,,2433220.86
2025/03/06,2025/03/01,SF FuneralF1122352      250301,,126.5,,2433347.36
2025/03/06,2025/03/01,SF FuneralF1122846      250301,,126.5,,2433473.86
2025/03/06,2025/03/01,SF FuneralF1123568      250301,,126.5,,2433600.36
2025/03/06,2025/03/01,SF FuneralF1127510      250301,,126.5,,2433726.86
2025/03/06,2025/03/01,SF FuneralF1131542      250301,,126.5,,2433853.36
2025/03/06,2025/03/01,SF FuneralF1131871      250301,,126.5,,2433979.86
2025/03/06,2025/03/01,SF FuneralF1131901      250301,,126.5,,2434106.36
2025/03/06,2025/03/01,SF FuneralFDC0000000Q8CQ250301,,126.5,,2434232.86
2025/03/06,2025/03/03,SF FuneralFDC00000006FHL250303,,126.5,,2434359.36
2025/03/06,2025/03/03,SF FuneralF793327       250302,,63.25,,2434422.61
2025/03/06,2025/03/03,SF FuneralF801619       250303,,126.5,,2434549.11
2025/03/06,2025/03/03,SF FuneralF809295       250303,,126.5,,2434675.61
2025/03/06,2025/03/03,SF FuneralF816957       250303,,126.5,,2434802.11
2025/03/06,2025/03/03,SF FuneralF842990       250301,,126.5,,2434928.61
2025/03/06,2025/03/03,SF FuneralF992955       250303,,126.5,,2435055.11
2025/03/06,2025/03/03,SF FuneralF1126148      250303,,126.5,,2435181.61
2025/03/06,2025/03/03,SF FuneralF1126171      250303,,126.5,,2435308.11
2025/03/06,2025/03/04,SF FuneralF813130       250304,,63.25,,2435371.36
2025/03/06,2025/03/04,SF FuneralF814037       250304,,63.25,,2435434.61
2025/03/06,2025/03/04,SF FuneralF821730       250304,,126.5,,2435561.11
2025/03/06,2025/03/04,SF FuneralF830587       250304,,63.25,,2435624.36
2025/03/06,2025/03/04,SF FuneralF989374       250304,,63.25,,2435687.61
2025/03/06,2025/03/04,SF FuneralF1122767      250304,,63.25,,2435750.86
2025/03/06,2025/03/04,SF FuneralFDC0000000PVXC250304,,126.5,,2435877.36
2025/03/06,2025/03/04,SF FuneralF1128929      250304,,63.25,,2435940.61
2025/03/06,2025/03/04,SF FuneralF1132934      250304,,126.5,,2436067.11
2025/03/06,2025/03/06,SF FuneralF1124168      250306,,63.25,,2436130.36
2025/03/06,2025/02/25,SF FuneralFDC0000000B81R250225,,126.5,,2436256.86
2025/03/06,2025/02/26,SF FuneralF823410       250226,,126.5,,2436383.36
2025/03/06,2025/02/26,SF FuneralF1124602      250226,,126.5,,2436509.86
2025/03/06,2025/02/27,SF FuneralFDC00000005WJR250227,,126.5,,2436636.36
2025/03/06,2025/02/27,SF FuneralF1085056      250227,,126.5,,2436762.86
2025/03/06,2025/03/01,SF FuneralFDC00000006GZ4250301,,126.5,,2436889.36
2025/03/06,2025/03/01,SF FuneralF1117389      250301,,126.5,,2437015.86
2025/03/06,2025/03/04,SF FuneralF1114824      250304,,126.5,,2437142.36
2025/03/06,2025/02/27,SF FuneralF802865       250227,,126.5,,2437268.86
2025/03/06,2025/03/01,SF FuneralFDC00000006K9V250301,,126.5,,2437395.36
2025/03/06,2025/03/01,SF FuneralFDC00000007RXY250301,,126.5,,2437521.86
2025/03/06,2025/03/01,SF FuneralF832352       250301,,126.5,,2437648.36
2025/03/06,2025/03/01,SF FuneralF834702       250301,,126.5,,2437774.86
2025/03/06,2025/03/01,SF FuneralF1066524      250302,,126.5,,2437901.36
2025/03/06,2025/03/01,SF FuneralFDC0000000MLCW250301,,126.5,,2438027.86
2025/03/06,2025/03/01,SF FuneralFDC0000000NBDB250301,,126.5,,2438154.36
2025/03/06,2025/03/01,SF FuneralFDC0000000NBQ9250301,,126.5,,2438280.86
2025/03/06,2025/03/01,SF FuneralF1118299      250301,,126.5,,2438407.36
2025/03/06,2025/03/01,SF FuneralF1119699      250301,,126.5,,2438533.86
2025/03/06,2025/03/01,SF FuneralF1131849      250301,,126.5,,2438660.36
2025/03/06,2025/03/03,SF FuneralF843566       250301,,126.5,,2438786.86
2025/03/06,2025/03/04,SF FuneralF1052673      250304,,63.25,,2438850.11
2025/03/06,2025/03/04,SF FuneralFDC0000000Q1HZ250304,,95.75,,2438945.86
2025/03/06,2025/02/28,SF FuneralFDC00000007FSG250228,,126.5,,2439072.36
2025/03/06,2025/02/28,SF FuneralF901083       250301,,126.5,,2439198.86
2025/03/06,2025/02/28,SF FuneralF901173       250301,,126.5,,2439325.36
2025/03/06,2025/02/28,SF FuneralF901338       250301,,126.5,,2439451.86
2025/03/06,2025/02/28,SF FuneralF986750       250301,,126.5,,2439578.36
2025/03/06,2025/02/28,SF FuneralF987173       250302,,126.5,,2439704.86
2025/03/06,2025/02/28,SF FuneralF987760       250228,,126.5,,2439831.36
2025/03/06,2025/02/28,SF FuneralFDC0000000HTF1250228,,126.5,,2439957.86
2025/03/06,2025/02/28,SF FuneralF1113636      250228,,126.5,,2440084.36
2025/03/06,2025/03/01,SF FuneralFDC000000075SB250301,,126.5,,2440210.86
2025/03/06,2025/03/01,SF FuneralF803248       250301,,126.5,,2440337.36
2025/03/06,2025/03/01,SF FuneralF820491       250301,,126.5,,2440463.86
2025/03/06,2025/03/01,SF FuneralF820870       250301,,126.5,,2440590.36
2025/03/06,2025/03/01,SF FuneralFDC0000000BHG7250301,,126.5,,2440716.86
2025/03/06,2025/03/01,SF FuneralF829902       250301,,126.5,,2440843.36
2025/03/06,2025/03/01,SF FuneralF830850       250301,,126.5,,2440969.86
2025/03/06,2025/03/01,SF FuneralF833107       250301,,126.5,,2441096.36
2025/03/06,2025/03/01,SF FuneralF1066530      250301,,126.5,,2441222.86
2025/03/06,2025/03/01,SF FuneralFDC0000000MKVL250301,,126.5,,2441349.36
2025/03/06,2025/03/01,SF FuneralF1122330      250301,,126.5,,2441475.86
2025/03/06,2025/03/01,SF FuneralF1122756      250301,,126.5,,2441602.36
2025/03/06,2025/03/01,SF FuneralF1130770      250301,,126.5,,2441728.86
2025/03/06,2025/03/01,SF FuneralF1131625      250301,,126.5,,2441855.36
2025/03/06,2025/03/03,SF FuneralF1085169      250303,,126.5,,2441981.86
2025/03/06,2025/03/04,SF FuneralF841866       250304,,63.25,,2442045.11
2025/03/06,2025/03/04,SF FuneralF842064       250304,,63.25,,2442108.36
2025/03/06,2025/03/04,SF FuneralF1074818      250304,,63.25,,2442171.61
2025/03/06,2025/03/04,SF FuneralF1074821      250304,,63.25,,2442234.86
2025/03/06,2025/03/04,SF FuneralFDC0000000M17C250304,,386.5,,2442621.36
2025/03/06,2025/03/04,SF FuneralFDC0000000P4SX250304,,95.75,,2442717.11
2025/03/06,2025/03/04,SF FuneralF1123426      250304,,95.75,,2442812.86
2025/03/06,2025/02/28,SF FuneralFDC00000006B8Q250228,,31.63,,2442844.49
2025/03/06,2025/02/28,SF FuneralFDC00000006B9H250228,,31.63,,2442876.12
2025/03/06,2025/02/28,SF FuneralFDC00000006G4Y250228,,31.63,,2442907.75
2025/03/06,2025/03/03,SF FuneralFDC0000000502G250303,,31.63,,2442939.38
2025/03/06,2025/03/03,SF FuneralF818028       250303,,31.63,,2442971.01
2025/03/06,2025/03/03,SF FuneralF1108567      250303,,31.63,,2443002.64
2025/03/06,2025/03/04,SF FuneralF986691       250304,,31.63,,2443034.27
2025/03/06,2025/03/06,SF FuneralFDC00000005N6M250306,,31.63,,2443065.9
2025/03/06,2025/02/27,SF FuneralFDC00000006B0G250227,,126.5,,2443192.4
2025/03/06,2025/02/27,SF FuneralFDC00000006VYM250227,,126.5,,2443318.9
2025/03/06,2025/02/28,SF FuneralFDC000000080W5250228,,126.5,,2443445.4
2025/03/06,2025/02/28,SF FuneralF817496       250228,,126.5,,2443571.9
2025/03/06,2025/02/28,SF FuneralF819502       250228,,126.5,,2443698.4
2025/03/06,2025/02/28,SF FuneralF833799       250228,,126.5,,2443824.9
2025/03/06,2025/02/28,SF FuneralF988788       250301,,126.5,,2443951.4
2025/03/06,2025/02/28,SF FuneralF990724       250301,,126.5,,2444077.9
2025/03/06,2025/02/28,SF FuneralFDC0000000J3CL250228,,126.5,,2444204.4
2025/03/06,2025/02/28,SF FuneralFDC0000000L11W250228,,126.5,,2444330.9
2025/03/06,2025/03/01,SF FuneralF764504       250301,,220,,2444550.9
2025/03/06,2025/03/01,SF FuneralF829723       250301,,126.5,,2444677.4
2025/03/06,2025/03/01,SF FuneralF1052764      250301,,126.5,,2444803.9
2025/03/06,2025/03/01,SF FuneralF1078194      250301,,126.5,,2444930.4
2025/03/06,2025/03/01,SF FuneralF1125932      250301,,126.5,,2445056.9
2025/03/06,2025/03/01,SF FuneralF1126812      250301,,126.5,,2445183.4
2025/03/06,2025/03/01,SF FuneralFDC0000000PWDX250301,,126.5,,2445309.9
2025/03/06,2025/03/03,SF FuneralFDC00000003DZP250302,,220,,2445529.9
2025/03/06,2025/03/03,SF FuneralFDC00000005N79250303,,63.25,,2445593.15
2025/03/06,2025/03/03,SF FuneralFDC00000007VS3250303,,126.5,,2445719.65
2025/03/06,2025/03/03,SF FuneralF800850       250303,,126.5,,2445846.15
2025/03/06,2025/03/03,SF FuneralF844400       250301,,126.5,,2445972.65
2025/03/06,2025/03/03,SF FuneralF844466       250301,,126.5,,2446099.15
2025/03/06,2025/03/03,SF FuneralF866947       250303,,126.5,,2446225.65
2025/03/06,2025/03/03,SF FuneralFDC0000000GMZ0250302,,126.5,,2446352.15
2025/03/06,2025/03/03,SF FuneralF1078316      250303,,126.5,,2446478.65
2025/03/06,2025/03/03,SF FuneralF1117357      250303,,126.5,,2446605.15
2025/03/06,2025/03/03,SF FuneralFDC0000000PHYR250303,,126.5,,2446731.65
2025/03/06,2025/03/03,SF FuneralF1128235      250303,,126.5,,2446858.15
2025/03/06,2025/03/03,SF FuneralFDC0000000Q5HW250303,,126.5,,2446984.65
2025/03/06,2025/03/03,SF FuneralFDC0000000Q5HY250303,,126.5,,2447111.15
2025/03/06,2025/03/04,SF FuneralF1058712      250304,,126.5,,2447237.65
2025/03/06,2025/03/06,SF FuneralFDC00000006P5B250306,,126.5,,2447364.15
2025/03/06,2025/02/25,SF FuneralF828499       250225,,63.25,,2447427.4
2025/03/06,2025/02/25,SF FuneralF828912       250225,,63.25,,2447490.65
2025/03/06,2025/02/25,SF FuneralF1118142      250225,,63.25,,2447553.9
2025/03/06,2025/02/28,SF FuneralFDC00000006C6F250228,,126.5,,2447680.4
2025/03/06,2025/02/28,SF FuneralFDC00000006NKM250228,,126.5,,2447806.9
2025/03/06,2025/02/28,SF FuneralFDC00000006NLN250228,,126.5,,2447933.4
2025/03/06,2025/02/28,SF FuneralFDC000000079LR250228,,126.5,,2448059.9
2025/03/06,2025/02/28,SF FuneralFDC00000007NF0250228,,126.5,,2448186.4
2025/03/06,2025/02/28,SF FuneralFDC0000000B3H1250228,,126.5,,2448312.9
2025/03/06,2025/02/28,SF FuneralF831174       250228,,63.25,,2448376.15
2025/03/06,2025/02/28,SF FuneralF831255       250228,,126.5,,2448502.65
2025/03/06,2025/02/28,SF FuneralF980296       250228,,126.5,,2448629.15
2025/03/06,2025/02/28,SF FuneralF989782       250301,,126.5,,2448755.65
2025/03/06,2025/02/28,SF FuneralF1121980      250228,,126.5,,2448882.15
2025/03/06,2025/03/01,SF FuneralFDC00000005JS3250301,,126.5,,2449008.65
2025/03/06,2025/03/01,SF FuneralFDC00000006GGQ250301,,126.5,,2449135.15
2025/03/06,2025/03/01,SF FuneralFDC00000006HJV250301,,126.5,,2449261.65
2025/03/06,2025/03/01,SF FuneralFDC00000006HYX250301,,126.5,,2449388.15
2025/03/06,2025/03/01,SF FuneralFDC00000006HYZ250301,,126.5,,2449514.65
2025/03/06,2025/03/01,SF FuneralFDC00000006LYC250301,,126.5,,2449641.15
2025/03/06,2025/03/01,SF FuneralFDC00000007B7R250301,,126.5,,2449767.65
2025/03/06,2025/03/01,SF FuneralFDC00000007RQB250301,,126.5,,2449894.15
2025/03/06,2025/03/01,SF FuneralF809687       250301,,126.5,,2450020.65
2025/03/06,2025/03/01,SF FuneralF810436       250301,,126.5,,2450147.15
2025/03/06,2025/03/01,SF FuneralF814686       250301,,126.5,,2450273.65
2025/03/06,2025/03/01,SF FuneralF816940       250301,,126.5,,2450400.15
2025/03/06,2025/03/01,SF FuneralFDC00000009XBM250301,,126.5,,2450526.65
2025/03/06,2025/03/01,SF FuneralF822505       250301,,126.5,,2450653.15
2025/03/06,2025/03/01,SF FuneralF822686       250301,,126.5,,2450779.65
2025/03/06,2025/03/01,SF FuneralF828602       250301,,126.5,,2450906.15
2025/03/06,2025/03/01,SF FuneralF828717       250301,,126.5,,2451032.65
2025/03/06,2025/03/01,SF FuneralF830979       250301,,126.5,,2451159.15
2025/03/06,2025/03/01,SF FuneralF834158       250301,,126.5,,2451285.65
2025/03/06,2025/03/01,SF FuneralF993776       250301,,126.5,,2451412.15
2025/03/06,2025/03/01,SF FuneralF1021993      250301,,126.5,,2451538.65
2025/03/06,2025/03/01,SF FuneralF1034029      250301,,126.5,,2451665.15
2025/03/06,2025/03/01,SF FuneralF1066372      250301,,126.5,,2451791.65
2025/03/06,2025/03/01,SF FuneralF1066495      250301,,126.5,,2451918.15
2025/03/06,2025/03/01,SF FuneralF1066496      250301,,126.5,,2452044.65
2025/03/06,2025/03/01,SF FuneralF1066542      250301,,126.5,,2452171.15
2025/03/06,2025/03/01,SF FuneralF1084764      250301,,126.5,,2452297.65
2025/03/06,2025/03/01,SF FuneralF1084889      250301,,126.5,,2452424.15
2025/03/06,2025/03/01,SF FuneralF1085019      250301,,126.5,,2452550.65
2025/03/06,2025/03/01,SF FuneralF1103778      250301,,126.5,,2452677.15
2025/03/06,2025/03/01,SF FuneralF1110067      250301,,126.5,,2452803.65
2025/03/06,2025/03/01,SF FuneralFDC0000000MLY3250301,,126.5,,2452930.15
2025/03/06,2025/03/01,SF FuneralF774341       250301,,126.5,,2453056.65
2025/03/06,2025/03/01,SF FuneralF1117352      250301,,126.5,,2453183.15
2025/03/06,2025/03/01,SF FuneralF1117353      250301,,126.5,,2453309.65
2025/03/06,2025/03/01,SF FuneralF1117717      250301,,126.5,,2453436.15
2025/03/06,2025/03/01,SF FuneralF1118161      250301,,126.5,,2453562.65
2025/03/06,2025/03/01,SF FuneralFDC0000000NRDR250301,,126.5,,2453689.15
2025/03/06,2025/03/01,SF FuneralFDC0000000P1HC250301,,126.5,,2453815.65
2025/03/06,2025/03/01,SF FuneralFDC0000000PJ9M250301,,126.5,,2453942.15
2025/03/06,2025/03/01,SF FuneralFDC0000000PJ9Y250301,,126.5,,2454068.65
2025/03/06,2025/03/01,SF FuneralFDC0000000PLVM250301,,191.5,,2454260.15
2025/03/06,2025/03/01,SF FuneralF1127409      250301,,126.5,,2454386.65
2025/03/06,2025/03/01,SF FuneralF1127681      250301,,126.5,,2454513.15
2025/03/06,2025/03/01,SF FuneralF1127721      250301,,126.5,,2454639.65
2025/03/06,2025/03/01,SF FuneralF1128702      250301,,126.5,,2454766.15
2025/03/06,2025/03/01,SF FuneralF1128992      250301,,126.5,,2454892.65
2025/03/06,2025/03/01,SF FuneralF1131060      250301,,126.5,,2455019.15
2025/03/06,2025/03/01,SF FuneralF1131463      250301,,126.5,,2455145.65
2025/03/06,2025/03/01,SF FuneralF1131498      250301,,126.5,,2455272.15
2025/03/06,2025/03/01,SF FuneralF1131504      250301,,126.5,,2455398.65
2025/03/06,2025/03/01,SF FuneralF1131545      250301,,126.5,,2455525.15
2025/03/06,2025/03/01,SF FuneralFDC0000000Q9FN250301,,126.5,,2455651.65
2025/03/06,2025/03/01,SF FuneralF1133082      250301,,126.5,,2455778.15
2025/03/06,2025/03/03,SF FuneralFDC00000004D3N250302,,220,,2455998.15
2025/03/06,2025/03/03,SF FuneralF1129055      250303,,256.5,,2456254.65
2025/03/06,2025/03/03,SF FuneralF1129167      250303,,126.5,,2456381.15
2025/03/06,2025/03/03,SF FuneralF1129451      250303,,126.5,,2456507.65
2025/03/06,2025/03/03,SF FuneralF1131786      250303,,126.5,,2456634.15
2025/03/06,2025/03/04,SF FuneralF900439       250304,,126.5,,2456760.65
2025/03/06,2025/02/25,SF FuneralFDC00000005P50250225,,126.5,,2456887.15
2025/03/06,2025/02/25,SF FuneralF847351       250225,,126.5,,2457013.65
2025/03/06,2025/02/25,SF FuneralF1111732      250225,,63.25,,2457076.9
2025/03/06,2025/02/25,SF FuneralF1129403      250225,,63.25,,2457140.15
2025/03/06,2025/02/28,SF FuneralFDC00000005WZF250228,,220,,2457360.15
2025/03/06,2025/02/28,SF FuneralFDC00000007D3P250228,,126.5,,2457486.65
2025/03/06,2025/02/28,SF FuneralF808783       250228,,126.5,,2457613.15
2025/03/06,2025/02/28,SF FuneralF810186       250228,,126.5,,2457739.65
2025/03/06,2025/02/28,SF FuneralF901104       250301,,126.5,,2457866.15
2025/03/06,2025/02/28,SF FuneralF1021354      250228,,126.5,,2457992.65
2025/03/06,2025/02/28,SF FuneralF1110269      250228,,126.5,,2458119.15
2025/03/06,2025/02/28,SF FuneralF1127584      250228,,126.5,,2458245.65
2025/03/06,2025/03/01,SF FuneralFDC00000006JBD250301,,126.5,,2458372.15
2025/03/06,2025/03/01,SF FuneralFDC00000006LYB250301,,126.5,,2458498.65
2025/03/06,2025/03/01,SF FuneralFDC00000007924250301,,126.5,,2458625.15
2025/03/06,2025/03/01,SF FuneralF798802       250301,,126.5,,2458751.65
2025/03/06,2025/03/01,SF FuneralF803690       250301,,126.5,,2458878.15
2025/03/06,2025/03/01,SF FuneralFDC00000008TZS250301,,126.5,,2459004.65
2025/03/06,2025/03/01,SF FuneralF808507       250301,,126.5,,2459131.15
2025/03/06,2025/03/01,SF FuneralF818730       250301,,126.5,,2459257.65
2025/03/06,2025/03/01,SF FuneralF820882       250301,,126.5,,2459384.15
2025/03/06,2025/03/01,SF FuneralFDC0000000BQ83250301,,126.5,,2459510.65
2025/03/06,2025/03/01,SF FuneralF833360       250301,,126.5,,2459637.15
2025/03/06,2025/03/01,SF FuneralF833403       250301,,126.5,,2459763.65
2025/03/06,2025/03/01,SF FuneralF993576       250301,,126.5,,2459890.15
2025/03/06,2025/03/01,SF FuneralF993626       250301,,126.5,,2460016.65
2025/03/06,2025/03/01,SF FuneralF994128       250301,,126.5,,2460143.15
2025/03/06,2025/03/01,SF FuneralF1022256      250301,,126.5,,2460269.65
2025/03/06,2025/03/01,SF FuneralF1060082      250301,,126.5,,2460396.15
2025/03/06,2025/03/01,SF FuneralF1066219      250301,,126.5,,2460522.65
2025/03/06,2025/03/01,SF FuneralF1072704      250301,,126.5,,2460649.15
2025/03/06,2025/03/01,SF FuneralF1078417      250301,,126.5,,2460775.65
2025/03/06,2025/03/01,SF FuneralF1078659      250301,,126.5,,2460902.15
2025/03/06,2025/03/01,SF FuneralF1079457      250301,,126.5,,2461028.65
2025/03/06,2025/03/01,SF FuneralF1110204      250301,,126.5,,2461155.15
2025/03/06,2025/03/01,SF FuneralF1113866      250301,,126.5,,2461281.65
2025/03/06,2025/03/01,SF FuneralF1113989      250301,,126.5,,2461408.15
2025/03/06,2025/03/01,SF FuneralF1117599      250301,,126.5,,2461534.65
2025/03/06,2025/03/01,SF FuneralF1117613      250301,,126.5,,2461661.15
2025/03/06,2025/03/01,SF FuneralF1118156      250301,,126.5,,2461787.65
2025/03/06,2025/03/01,SF FuneralF1119702      250301,,126.5,,2461914.15
2025/03/06,2025/03/01,SF FuneralF1122386      250301,,126.5,,2462040.65
2025/03/06,2025/03/01,SF FuneralFDC0000000PJGD250301,,126.5,,2462167.15
2025/03/06,2025/03/01,SF FuneralF1126135      250301,,126.5,,2462293.65
2025/03/06,2025/03/01,SF FuneralF1126855      250301,,126.5,,2462420.15
2025/03/06,2025/03/01,SF FuneralF1129383      250301,,126.5,,2462546.65
2025/03/06,2025/03/01,SF FuneralF1130292      250301,,126.5,,2462673.15
2025/03/06,2025/03/01,SF FuneralF1131515      250301,,126.5,,2462799.65
2025/03/06,2025/03/03,SF FuneralF1060981      250303,,63.25,,2462862.9
2025/03/06,2025/03/03,SF FuneralF1061516      250303,,63.25,,2462926.15
2025/03/06,2025/03/03,SF FuneralFDC0000000Q23M250303,,126.5,,2463052.65
2025/03/06,2025/03/03,SF FuneralF1130629      250303,,126.5,,2463179.15
2025/03/06,2025/03/04,SF FuneralF809291       250304,,63.25,,2463242.4
2025/03/06,2025/03/04,SF FuneralF820830       250304,,63.25,,2463305.65
2025/03/06,2025/03/04,SF FuneralFDC0000000G8FM250304,,278.31,,2463583.96
2025/03/06,2025/03/04,SF FuneralF900698       250304,,63.25,,2463647.21
2025/03/06,2025/03/04,SF FuneralFDC0000000HG11250304,,63.25,,2463710.46
2025/03/06,2025/03/04,SF FuneralF989170       250304,,63.25,,2463773.71
2025/03/06,2025/03/04,SF FuneralFDC0000000J0D4250304,,63.25,,2463836.96
2025/03/06,2025/03/04,SF FuneralF1123179      250304,,126.5,,2463963.46
2025/03/06,2025/03/04,SF FuneralFDC0000000PX0F250304,,126.5,,2464089.96
2025/03/06,2025/03/04,SF FuneralF1131753      250304,,126.5,,2464216.46
2025/03/06,2025/02/25,SF FuneralF822166       250225,,126.5,,2464342.96
2025/03/06,2025/02/25,SF FuneralF823295       250225,,63.25,,2464406.21
2025/03/06,2025/02/25,SF FuneralFDC0000000BJSH250225,,63.25,,2464469.46
2025/03/06,2025/02/25,SF FuneralFDC0000000CSW4250225,,63.25,,2464532.71
2025/03/06,2025/02/25,SF FuneralF833475       250225,,63.25,,2464595.96
2025/03/06,2025/02/25,SF FuneralF1066680      250225,,63.25,,2464659.21
2025/03/06,2025/02/25,SF FuneralF1074969      250225,,126.5,,2464785.71
2025/03/06,2025/02/26,SF FuneralF841280       250226,,126.5,,2464912.21
2025/03/06,2025/02/26,SF FuneralF1074810      250226,,126.5,,2465038.71
2025/03/06,2025/02/26,SF FuneralF1108403      250226,,126.5,,2465165.21
2025/03/06,2025/02/27,SF FuneralFDC00000005NR8250227,,126.5,,2465291.71
2025/03/06,2025/02/27,SF FuneralFDC00000005X6H250227,,126.5,,2465418.21
2025/03/06,2025/02/27,SF FuneralF802536       250227,,126.5,,2465544.71
2025/03/06,2025/02/27,SF FuneralF812851       250227,,126.5,,2465671.21
2025/03/06,2025/02/27,SF FuneralF815060       250227,,126.5,,2465797.71
2025/03/06,2025/02/27,SF FuneralF827806       250227,,126.5,,2465924.21
2025/03/06,2025/02/27,SF FuneralF827966       250227,,126.5,,2466050.71
2025/03/06,2025/02/27,SF FuneralF842318       250227,,126.5,,2466177.21
2025/03/06,2025/02/27,SF FuneralF993006       250227,,126.5,,2466303.71
2025/03/06,2025/02/27,SF FuneralFDC0000000L0XP250227,,126.5,,2466430.21
2025/03/06,2025/02/27,SF FuneralF1073283      250227,,126.5,,2466556.71
2025/03/06,2025/02/28,SF FuneralFDC00000007548250228,,126.5,,2466683.21
2025/03/06,2025/03/01,SF FuneralFDC00000006G6N250301,,126.5,,2466809.71
2025/03/06,2025/03/01,SF FuneralFDC00000006HTV250301,,126.5,,2466936.21
2025/03/06,2025/03/01,SF FuneralFDC0000000751B250301,,126.5,,2467062.71
2025/03/06,2025/03/01,SF FuneralFDC00000007G3P250301,,126.5,,2467189.21
2025/03/06,2025/03/01,SF FuneralFDC00000007G3Q250301,,126.5,,2467315.71
2025/03/06,2025/03/01,SF FuneralFDC00000007TN2250301,,126.5,,2467442.21
2025/03/06,2025/03/01,SF FuneralFDC00000007TYW250301,,126.5,,2467568.71
2025/03/06,2025/03/01,SF FuneralF804756       250301,,126.5,,2467695.21
2025/03/06,2025/03/01,SF FuneralF805158       250301,,126.5,,2467821.71
2025/03/06,2025/03/01,SF FuneralF818960       250301,,126.5,,2467948.21
2025/03/06,2025/03/01,SF FuneralF821375       250301,,126.5,,2468074.71
2025/03/06,2025/03/01,SF FuneralF828609       250301,,126.5,,2468201.21
2025/03/06,2025/03/01,SF FuneralF832891       250301,,126.5,,2468327.71
2025/03/06,2025/03/01,SF FuneralF833576       250301,,126.5,,2468454.21
2025/03/06,2025/03/01,SF FuneralFDC0000000F5K4250301,,126.5,,2468580.71
2025/03/06,2025/03/01,SF FuneralF842697       250301,,126.5,,2468707.21
2025/03/06,2025/03/01,SF FuneralF993225       250301,,126.5,,2468833.71
2025/03/06,2025/03/01,SF FuneralF993413       250301,,126.5,,2468960.21
2025/03/06,2025/03/01,SF FuneralF1017411      250301,,126.5,,2469086.71
2025/03/06,2025/03/01,SF FuneralF1021188      250301,,126.5,,2469213.21
2025/03/06,2025/03/01,SF FuneralF1021483      250301,,126.5,,2469339.71
2025/03/06,2025/03/01,SF FuneralF1021819      250301,,126.5,,2469466.21
2025/03/06,2025/03/01,SF FuneralF1022296      250301,,126.5,,2469592.71
2025/03/06,2025/03/01,SF FuneralF1033637      250302,,126.5,,2469719.21
2025/03/06,2025/03/01,SF FuneralFDC0000000JZ75250301,,191.5,,2469910.71
2025/03/06,2025/03/01,SF FuneralF1054843      250301,,126.5,,2470037.21
2025/03/06,2025/03/01,SF FuneralF1059876      250301,,126.5,,2470163.71
2025/03/06,2025/03/01,SF FuneralF1067912      250301,,126.5,,2470290.21
2025/03/06,2025/03/01,SF FuneralF1068057      250301,,126.5,,2470416.71
2025/03/06,2025/03/01,SF FuneralF1073130      250301,,126.5,,2470543.21
2025/03/06,2025/03/01,SF FuneralF900696       250301,,126.5,,2470669.71
2025/03/06,2025/03/01,SF FuneralF1084533      250301,,126.5,,2470796.21
2025/03/06,2025/03/01,SF FuneralF1108423      250301,,126.5,,2470922.71
2025/03/06,2025/03/01,SF FuneralF1110543      250301,,126.5,,2471049.21
2025/03/06,2025/03/01,SF FuneralF1114830      250301,,126.5,,2471175.71
2025/03/06,2025/03/01,SF FuneralF1118798      250301,,126.5,,2471302.21
2025/03/06,2025/03/01,SF FuneralF774452       250301,,126.5,,2471428.71
2025/03/06,2025/03/01,SF FuneralF1125913      250301,,126.5,,2471555.21
2025/03/06,2025/03/01,SF FuneralF1129037      250301,,126.5,,2471681.71
2025/03/06,2025/03/01,SF FuneralF1131690      250301,,126.5,,2471808.21
2025/03/06,2025/03/01,SF FuneralF1132427      250301,,126.5,,2471934.71
2025/03/06,2025/03/01,SF FuneralF1132874      250301,,126.5,,2472061.21
2025/03/06,2025/03/03,SF FuneralFDC00000006086250302,,386.5,,2472447.71
2025/03/06,2025/03/03,SF FuneralFDC000000086DL250303,,126.5,,2472574.21
2025/03/06,2025/03/03,SF FuneralF803743       250302,,126.5,,2472700.71
2025/03/06,2025/03/03,SF FuneralF812701       250303,,126.5,,2472827.21
2025/03/06,2025/03/03,SF FuneralF813036       250303,,126.5,,2472953.71
2025/03/06,2025/03/03,SF FuneralF814587       250303,,63.25,,2473016.96
2025/03/06,2025/03/03,SF FuneralF843683       250301,,126.5,,2473143.46
2025/03/06,2025/03/03,SF FuneralF901072       250303,,63.25,,2473206.71
2025/03/06,2025/03/03,SF FuneralFDC0000000M3GP250303,,126.5,,2473333.21
2025/03/06,2025/03/03,SF FuneralFDC0000000MGPG250303,,126.5,,2473459.71
2025/03/06,2025/03/03,SF FuneralF1110212      250303,,126.5,,2473586.21
2025/03/06,2025/03/03,SF FuneralFDC0000000Q55Y250303,,126.5,,2473712.71
2025/03/06,2025/03/03,SF FuneralFDC0000000Q57L250303,,256.5,,2473969.21
2025/03/06,2025/03/03,SF FuneralFDC0000000Q5M4250303,,126.5,,2474095.71
2025/03/06,2025/03/04,SF FuneralFDC0000000PWZG250304,,126.5,,2474222.21
2025/03/06,2025/02/25,SF FuneralFDC00000006L7Y250225,,126.5,,2474348.71
2025/03/06,2025/02/25,SF FuneralF987227       250225,,126.5,,2474475.21
2025/03/06,2025/02/25,SF FuneralF1055121      250225,,126.5,,2474601.71
2025/03/06,2025/02/25,SF FuneralF1125125      250225,,126.5,,2474728.21
2025/03/06,2025/02/26,SF FuneralF992130       250226,,126.5,,2474854.71
2025/03/06,2025/02/27,SF FuneralFDC0000000692Q250227,,126.5,,2474981.21
2025/03/06,2025/02/27,SF FuneralFDC00000006NBS250227,,126.5,,2475107.71
2025/03/06,2025/02/27,SF FuneralFDC00000006WQQ250227,,126.5,,2475234.21
2025/03/06,2025/02/27,SF FuneralFDC00000007RS3250227,,126.5,,2475360.71
2025/03/06,2025/02/27,SF FuneralF820698       250227,,126.5,,2475487.21
2025/03/06,2025/02/27,SF FuneralF828167       250227,,126.5,,2475613.71
2025/03/06,2025/02/27,SF FuneralF828649       250227,,126.5,,2475740.21
2025/03/06,2025/02/27,SF FuneralF1058811      250227,,126.5,,2475866.71
2025/03/06,2025/02/27,SF FuneralFDC0000000MLCR250227,,126.5,,2475993.21
2025/03/06,2025/02/27,SF FuneralF1113187      250227,,126.5,,2476119.71
2025/03/06,2025/02/27,SF FuneralF1116645      250227,,126.5,,2476246.21
2025/03/06,2025/02/28,SF FuneralF832692       250228,,126.5,,2476372.71
2025/03/06,2025/02/28,SF FuneralF1110750      250228,,126.5,,2476499.21
2025/03/06,2025/03/01,SF FuneralF794717       250301,,126.5,,2476625.71
2025/03/06,2025/03/01,SF FuneralFDC00000007SRR250301,,126.5,,2476752.21
2025/03/06,2025/03/01,SF FuneralF821102       250301,,126.5,,2476878.71
2025/03/06,2025/03/01,SF FuneralF993697       250301,,126.5,,2477005.21
2025/03/06,2025/03/01,SF FuneralFDC0000000JW95250301,,126.5,,2477131.71
2025/03/06,2025/03/01,SF FuneralF1021785      250301,,126.5,,2477258.21
2025/03/06,2025/03/01,SF FuneralF1066751      250301,,126.5,,2477384.71
2025/03/06,2025/03/01,SF FuneralF843717       250301,,126.5,,2477511.21
2025/03/06,2025/03/01,SF FuneralF1078928      250301,,126.5,,2477637.71
2025/03/06,2025/03/01,SF FuneralF1103178      250302,,126.5,,2477764.21
2025/03/06,2025/03/01,SF FuneralF1109632      250301,,126.5,,2477890.71
2025/03/06,2025/03/01,SF FuneralF1113610      250301,,126.5,,2478017.21
2025/03/06,2025/03/01,SF FuneralFDC0000000N8H7250301,,126.5,,2478143.71
2025/03/06,2025/03/01,SF FuneralF1117647      250301,,126.5,,2478270.21
2025/03/06,2025/03/01,SF FuneralF1117996      250301,,126.5,,2478396.71
2025/03/06,2025/03/01,SF FuneralF1126915      250302,,126.5,,2478523.21
2025/03/06,2025/03/01,SF FuneralF1128248      250301,,126.5,,2478649.71
2025/03/06,2025/03/01,SF FuneralFDC0000000PX1V250301,,126.5,,2478776.21
2025/03/06,2025/03/01,SF FuneralF1131772      250301,,126.5,,2478902.71
2025/03/06,2025/03/01,SF FuneralF1131787      250301,,126.5,,2479029.21
2025/03/06,2025/03/01,SF FuneralF1131988      250301,,126.5,,2479155.71
2025/03/06,2025/03/01,SF FuneralF1132256      250301,,126.5,,2479282.21
2025/03/06,2025/03/03,SF FuneralFDC0000000N5DS250303,,126.5,,2479408.71
2025/03/06,2025/03/03,SF FuneralFDC0000000N5SP250303,,126.5,,2479535.21
2025/03/06,2025/03/03,SF FuneralFDC0000000PX28250303,,126.5,,2479661.71
2025/03/06,2025/03/03,SF FuneralF993966       250303,,126.5,,2479788.21
2025/03/06,2025/03/03,SF FuneralF1133033      250303,,126.5,,2479914.71
2025/03/06,2025/03/04,SF FuneralFDC0000000642K250304,,126.5,,2480041.21
2025/03/06,2025/03/04,SF FuneralFDC00000006430250304,,126.5,,2480167.71
2025/03/06,2025/03/04,SF FuneralF830472       250304,,63.25,,2480230.96
2025/03/06,2025/03/04,SF FuneralF1117303      250304,,63.25,,2480294.21
2025/03/06,2025/03/04,SF FuneralFDC0000000PW5P250304,,126.5,,2480420.71
2025/03/06,2025/03/06,SF FuneralFDC00000007H45250306,,63.25,,2480483.96
2025/03/06,2025/03/06,SF FuneralFDC00000007H48250306,,63.25,,2480547.21
2025/03/06,2025/02/28,SF FuneralF805595       250228,,31.63,,2480578.84
2025/03/06,2025/02/28,SF FuneralF1130222      250228,,31.63,,2480610.47
2025/03/06,2025/03/03,SF FuneralFDC000000067C7250303,,31.63,,2480642.1
2025/03/06,2025/03/04,SF FuneralFDC00000008M09250304,,31.63,,2480673.73
2025/03/06,2025/03/04,SF FuneralF805662       250304,,31.63,,2480705.36
2025/03/06,2025/03/04,SF FuneralF823596       250304,,31.63,,2480736.99
2025/03/06,2025/03/04,SF FuneralF833515       250304,,31.63,,2480768.62
2025/03/06,2025/03/04,SF FuneralF833824       250304,,31.63,,2480800.25
2025/03/06,2025/03/04,SF FuneralF834645       250304,,31.63,,2480831.88
2025/03/06,2025/03/04,SF FuneralF799620       250304,,64.13,,2480896.01
2025/03/06,2025/02/25,SF FuneralF830212       250225,,63.25,,2480959.26
2025/03/06,2025/02/27,SF FuneralF820304       250227,,126.5,,2481085.76
2025/03/06,2025/02/28,SF FuneralFDC00000006H51250228,,126.5,,2481212.26
2025/03/06,2025/02/28,SF FuneralFDC00000006SQQ250228,,126.5,,2481338.76
2025/03/06,2025/02/28,SF FuneralFDC00000007BNT250228,,126.5,,2481465.26
2025/03/06,2025/02/28,SF FuneralF819886       250228,,126.5,,2481591.76
2025/03/06,2025/02/28,SF FuneralF981359       250301,,126.5,,2481718.26
2025/03/06,2025/02/28,SF FuneralFDC0000000KY4F250228,,126.5,,2481844.76
2025/03/06,2025/02/28,SF FuneralFDC0000000M48G250228,,126.5,,2481971.26
2025/03/06,2025/02/28,SF FuneralFDC0000000M74G250228,,126.5,,2482097.76
2025/03/06,2025/02/28,SF FuneralF1118080      250228,,126.5,,2482224.26
2025/03/06,2025/02/28,SF FuneralF1126215      250228,,126.5,,2482350.76
2025/03/06,2025/03/01,SF FuneralFDC00000005RWW250301,,126.5,,2482477.26
2025/03/06,2025/03/01,SF FuneralFDC00000006Y92250301,,126.5,,2482603.76
2025/03/06,2025/03/01,SF FuneralFDC00000007SB8250301,,126.5,,2482730.26
2025/03/06,2025/03/01,SF FuneralF801189       250301,,126.5,,2482856.76
2025/03/06,2025/03/01,SF FuneralF813511       250301,,126.5,,2482983.26
2025/03/06,2025/03/01,SF FuneralF822172       250301,,126.5,,2483109.76
2025/03/06,2025/03/01,SF FuneralF832883       250301,,126.5,,2483236.26
2025/03/06,2025/03/01,SF FuneralF1052665      250301,,126.5,,2483362.76
2025/03/06,2025/03/01,SF FuneralF1060778      250301,,126.5,,2483489.26
2025/03/06,2025/03/01,SF FuneralFDC0000000NH4C250301,,126.5,,2483615.76
2025/03/06,2025/03/01,SF FuneralFDC0000000NH50250301,,126.5,,2483742.26
2025/03/06,2025/03/01,SF FuneralFDC0000000NM3K250301,,126.5,,2483868.76
2025/03/06,2025/03/01,SF FuneralF987867       250301,,126.5,,2483995.26
2025/03/06,2025/03/01,SF FuneralF1126120      250301,,126.5,,2484121.76
2025/03/06,2025/03/01,SF FuneralF1126161      250301,,126.5,,2484248.26
2025/03/06,2025/03/01,SF FuneralF1126241      250301,,126.5,,2484374.76
2025/03/06,2025/03/01,SF FuneralF1126853      250301,,126.5,,2484501.26
2025/03/06,2025/03/01,SF FuneralF1126898      250301,,126.5,,2484627.76
2025/03/06,2025/03/01,SF FuneralF1127822      250301,,126.5,,2484754.26
2025/03/06,2025/03/01,SF FuneralF1131638      250301,,126.5,,2484880.76
2025/03/06,2025/03/01,SF FuneralF1131654      250301,,126.5,,2485007.26
2025/03/06,2025/03/01,SF FuneralFDC0000000Q8CR250301,,126.5,,2485133.76
2025/03/06,2025/03/03,SF FuneralF821900       250302,,126.5,,2485260.26
2025/03/06,2025/03/03,SF FuneralFDC0000000FSQ5250301,,126.5,,2485386.76
2025/03/06,2025/03/03,SF FuneralF844330       250301,,126.5,,2485513.26
2025/03/06,2025/03/03,SF FuneralF844544       250301,,126.5,,2485639.76
2025/03/06,2025/03/03,SF FuneralF844779       250302,,126.5,,2485766.26
2025/03/06,2025/03/03,SF FuneralF1052893      250303,,126.5,,2485892.76
2025/03/06,2025/03/03,SF FuneralFDC0000000K5M2250303,,126.5,,2486019.26
2025/03/06,2025/03/03,SF FuneralF1066715      250303,,126.5,,2486145.76
2025/03/06,2025/03/03,SF FuneralF1072961      250303,,63.25,,2486209.01
2025/03/06,2025/03/03,SF FuneralF1113623      250303,,126.5,,2486335.51
2025/03/06,2025/03/03,SF FuneralF1113897      250303,,126.5,,2486462.01
2025/03/06,2025/03/03,SF FuneralF1118012      250303,,126.5,,2486588.51
2025/03/06,2025/02/26,SF FuneralFDC0000000HQGQ250226,,126.5,,2486715.01
2025/03/06,2025/02/27,SF FuneralFDC00000008MG8250227,,126.5,,2486841.51
2025/03/06,2025/02/27,SF FuneralF1074933      250227,,126.5,,2486968.01
2025/03/06,2025/02/28,SF FuneralFDC000000077TX250228,,126.5,,2487094.51
2025/03/06,2025/02/28,SF FuneralF796540       250228,,126.5,,2487221.01
2025/03/06,2025/02/28,SF FuneralF815404       250228,,126.5,,2487347.51
2025/03/06,2025/02/28,SF FuneralF821014       250228,,126.5,,2487474.01
2025/03/06,2025/02/28,SF FuneralF822280       250228,,126.5,,2487600.51
2025/03/06,2025/02/28,SF FuneralF832849       250228,,126.5,,2487727.01
2025/03/06,2025/02/28,SF FuneralF833196       250228,,126.5,,2487853.51
2025/03/06,2025/02/28,SF FuneralF981319       250301,,126.5,,2487980.01
2025/03/06,2025/02/28,SF FuneralF986707       250301,,126.5,,2488106.51
2025/03/06,2025/02/28,SF FuneralF987178       250302,,126.5,,2488233.01
2025/03/06,2025/02/28,SF FuneralF987841       250301,,126.5,,2488359.51
2025/03/06,2025/02/28,SF FuneralF987895       250301,,126.5,,2488486.01
2025/03/06,2025/02/28,SF FuneralF987943       250301,,126.5,,2488612.51
2025/03/06,2025/02/28,SF FuneralF988297       250301,,126.5,,2488739.01
2025/03/06,2025/02/28,SF FuneralF988319       250301,,126.5,,2488865.51
2025/03/06,2025/02/28,SF FuneralF988939       250301,,126.5,,2488992.01
2025/03/06,2025/02/28,SF FuneralF989224       250301,,126.5,,2489118.51
2025/03/06,2025/02/28,SF FuneralF989435       250301,,126.5,,2489245.01
2025/03/06,2025/02/28,SF FuneralF989591       250302,,126.5,,2489371.51
2025/03/06,2025/02/28,SF FuneralF989915       250301,,126.5,,2489498.01
2025/03/06,2025/02/28,SF FuneralFDC0000000NFC1250228,,126.5,,2489624.51
2025/03/06,2025/03/01,SF FuneralFDC00000002WFK250301,,220,,2489844.51
2025/03/06,2025/03/01,SF FuneralFDC00000005DQW250301,,191.5,,2490036.01
2025/03/06,2025/03/01,SF FuneralFDC00000006DQJ250301,,126.5,,2490162.51
2025/03/06,2025/03/01,SF FuneralFDC00000006F3Y250301,,126.5,,2490289.01
2025/03/06,2025/03/01,SF FuneralFDC00000006K7X250301,,126.5,,2490415.51
2025/03/06,2025/03/01,SF FuneralFDC00000006QWX250301,,126.5,,2490542.01
2025/03/06,2025/03/01,SF FuneralFDC00000007QPG250301,,126.5,,2490668.51
2025/03/06,2025/03/01,SF FuneralFDC00000007S5B250301,,126.5,,2490795.01
2025/03/06,2025/03/01,SF FuneralF798639       250301,,126.5,,2490921.51
2025/03/06,2025/03/01,SF FuneralF800123       250301,,126.5,,2491048.01
2025/03/06,2025/03/01,SF FuneralF803544       250301,,126.5,,2491174.51
2025/03/06,2025/03/01,SF FuneralF808891       250301,,126.5,,2491301.01
2025/03/06,2025/03/01,SF FuneralF809177       250301,,126.5,,2491427.51
2025/03/06,2025/03/01,SF FuneralF816771       250301,,126.5,,2491554.01
2025/03/06,2025/03/01,SF FuneralF817169       250301,,126.5,,2491680.51
2025/03/06,2025/03/01,SF FuneralF828503       250301,,126.5,,2491807.01
2025/03/06,2025/03/01,SF FuneralF830870       250301,,126.5,,2491933.51
2025/03/06,2025/03/01,SF FuneralF1021738      250301,,126.5,,2492060.01
2025/03/06,2025/03/01,SF FuneralF1033755      250301,,126.5,,2492186.51
2025/03/06,2025/03/01,SF FuneralF1052464      250301,,126.5,,2492313.01
2025/03/06,2025/03/01,SF FuneralF1059457      250301,,126.5,,2492439.51
2025/03/06,2025/03/01,SF FuneralFDC0000000KQKZ250301,,126.5,,2492566.01
2025/03/06,2025/03/01,SF FuneralF1062685      250301,,213.31,,2492779.32
2025/03/06,2025/03/01,SF FuneralF1067935      250301,,126.5,,2492905.82
2025/03/06,2025/03/01,SF FuneralF1068036      250301,,386.5,,2493292.32
2025/03/06,2025/03/01,SF FuneralFDC0000000LDQ0250301,,126.5,,2493418.82
2025/03/06,2025/03/01,SF FuneralF1078537      250301,,126.5,,2493545.32
2025/03/06,2025/03/01,SF FuneralF1084665      250301,,126.5,,2493671.82
2025/03/06,2025/03/01,SF FuneralFDC0000000LXL0250301,,126.5,,2493798.32
2025/03/06,2025/03/01,SF FuneralFDC0000000M0ZJ250301,,126.5,,2493924.82
2025/03/06,2025/03/01,SF FuneralFDC0000000MNDX250301,,126.5,,2494051.32
2025/03/06,2025/03/01,SF FuneralF1111909      250301,,126.5,,2494177.82
2025/03/06,2025/03/01,SF FuneralF1113261      250301,,126.5,,2494304.32
2025/03/06,2025/03/01,SF FuneralF1113956      250301,,126.5,,2494430.82
2025/03/06,2025/03/01,SF FuneralF1114030      250301,,126.5,,2494557.32
2025/03/06,2025/03/01,SF FuneralF1114387      250301,,126.5,,2494683.82
2025/03/06,2025/03/01,SF FuneralF1117326      250301,,126.5,,2494810.32
2025/03/06,2025/03/01,SF FuneralFDC0000000NMK3250301,,126.5,,2494936.82
2025/03/06,2025/03/01,SF FuneralFDC0000000P0V7250301,,126.5,,2495063.32
2025/03/06,2025/03/01,SF FuneralFDC0000000P0VQ250301,,126.5,,2495189.82
2025/03/06,2025/03/01,SF FuneralFDC0000000P0W1250301,,126.5,,2495316.32
2025/03/06,2025/03/01,SF FuneralFDC0000000P113250301,,126.5,,2495442.82
2025/03/06,2025/03/01,SF FuneralF1122349      250302,,126.5,,2495569.32
2025/03/06,2025/03/01,SF FuneralF1122807      250301,,126.5,,2495695.82
2025/03/06,2025/03/01,SF FuneralF1123398      250301,,126.5,,2495822.32
2025/03/06,2025/03/01,SF FuneralF1123937      250301,,126.5,,2495948.82
2025/03/06,2025/03/01,SF FuneralFDC0000000P74R250301,,126.5,,2496075.32
2025/03/06,2025/03/01,SF FuneralF1125769      250301,,126.5,,2496201.82
2025/03/06,2025/03/01,SF FuneralF1126062      250301,,126.5,,2496328.32
2025/03/06,2025/03/01,SF FuneralF1126929      250302,,126.5,,2496454.82
2025/03/06,2025/03/01,SF FuneralF1128039      250301,,126.5,,2496581.32
2025/03/06,2025/03/01,SF FuneralF1128045      250301,,126.5,,2496707.82
2025/03/06,2025/03/01,SF FuneralF1128193      250301,,126.5,,2496834.32
2025/03/06,2025/03/01,SF FuneralF1128216      250301,,126.5,,2496960.82
2025/03/06,2025/03/01,SF FuneralFDC0000000PW0G250301,,126.5,,2497087.32
2025/03/06,2025/03/01,SF FuneralF1129090      250301,,126.5,,2497213.82
2025/03/06,2025/03/01,SF FuneralF1129216      250301,,191.5,,2497405.32
2025/03/06,2025/03/01,SF FuneralF1129350      250301,,126.5,,2497531.82
2025/03/06,2025/03/01,SF FuneralF1129362      250301,,126.5,,2497658.32
2025/03/06,2025/03/01,SF FuneralF1129492      250301,,126.5,,2497784.82
2025/03/06,2025/03/01,SF FuneralF1129873      250301,,126.5,,2497911.32
2025/03/06,2025/03/01,SF FuneralF1131628      250301,,126.5,,2498037.82
2025/03/06,2025/03/01,SF FuneralF1132329      250301,,126.5,,2498164.32
2025/03/06,2025/03/03,SF FuneralFDC00000003S1L250303,,55,,2498219.32
2025/03/06,2025/03/03,SF FuneralFDC00000005Z3L250303,,31.63,,2498250.95
2025/03/06,2025/03/03,SF FuneralFDC00000006GNR250303,,31.63,,2498282.58
2025/03/06,2025/03/02,SF FuneralF819229       250302,,31.63,,2498314.21
2025/03/06,2025/03/03,SF FuneralFDC0000000BV0W250303,,63.25,,2498377.46
2025/03/06,2025/03/03,SF FuneralF1021004      250303,,31.63,,2498409.09
2025/03/06,2025/03/03,SF FuneralF1108536      250303,,126.5,,2498535.59
2025/03/06,2025/03/03,SF FuneralF1131666      250303,,126.5,,2498662.09
2025/03/06,2025/03/03,SF FuneralF1132251      250303,,126.5,,2498788.59
2025/03/06,2025/03/04,SF FuneralFDC00000002Y4M250304,,55,,2498843.59
2025/03/06,2025/03/04,SF FuneralF821545       250304,,47.88,,2498891.47
2025/03/06,2025/03/04,SF FuneralF988913       250304,,31.63,,2498923.1
2025/03/06,2025/03/04,SF FuneralF990232       250304,,31.63,,2498954.73
2025/03/06,2025/03/04,SF FuneralF1108251      250304,,31.63,,2498986.36
2025/03/06,2025/03/04,SF FuneralF981451       250304,,31.63,,2499017.99
2025/03/06,2025/02/28,SF FuneralFDC0000000LPGL250228,,126.5,,2499144.49
2025/03/06,2025/03/01,SF FuneralFDC0000000M9BC250301,,126.5,,2499270.99
2025/03/06,2025/02/28,Rev SF FuneralFDC00000006M5S250228,,-31.63,,2499239.36
2025/03/06,2025/02/28,Rev SF FuneralFDC00000006M5X250228,,-31.63,,2499207.73
2025/03/06,2025/02/28,Rev SF FuneralFDC00000006M5Y250228,,-31.63,,2499176.1
2025/03/06,2025/02/28,Rev SF FuneralFDC00000006M60250228,,-31.63,,2499144.47
2025/03/06,2025/02/28,Rev SF FuneralFDC00000006M62250228,,-31.63,,2499112.84
2025/03/06,2025/03/05,Rev SF FuneralFDC00000007DMT250305,,-31.63,,2499081.21
2025/03/06,2025/03/03,Rev SF FuneralFDC00000005YNL250303,,-55,,2499026.21
2025/03/06,2025/03/03,Rev SF FuneralFDC00000005YW3250303,,-31.63,,2498994.58
2025/03/06,2025/02/28,Rev SF FuneralFDC00000007548250228,,-126.5,,2498868.08
2025/03/06,2025/02/24,Rev SF FuneralFDC000000071VG250223,,-126.5,,2498741.58
2025/03/06,2025/02/28,Rev SF FuneralFDC00000009P9Q250228,,-126.5,,2498615.08
2025/03/06,2025/02/28,Rev SF FuneralFDC00000005V1Y250228,,-126.5,,2498488.58
2025/03/06,2025/03/01,Rev SF FuneralFDC00000006HZY250301,,-126.5,,2498362.08
2025/03/06,2025/02/27,Rev SF FuneralFDC0000000L0XP250227,,-126.5,,2498235.58
2025/03/06,2025/01/28,Rev SF FuneralFDC00000009P9Q250128,,-126.5,,2498109.08
2025/03/06,2025/03/01,Rev SF FuneralFDC000000076QP250301,,-220,,2497889.08
2025/03/06,2025/03/03,Rev SF FuneralFDC00000007VS3250303,,-126.5,,2497762.58
2025/03/06,2025/02/27,Rev SF FuneralFDC00000006ZHS250227,,-126.5,,2497636.08
2025/03/06,2025/02/25,SF FuneralFDC0000000J2KL250225,,126.5,,2497762.58
2025/03/06,2025/02/28,SF FuneralFDC00000007T44250228,,126.5,,2497889.08
2025/03/06,2025/02/28,SF FuneralF1124163      250228,,126.5,,2498015.58
2025/03/06,2025/03/03,SF FuneralF987310       250303,,31.63,,2498047.21
2025/03/06,2025/03/04,SF FuneralF1114433      250304,,31.63,,2498078.84
2025/03/06,2025/03/04,SF FuneralF1123497      250304,,31.63,,2498110.47
2025/03/06,2025/02/27,SF FuneralF1112482      250227,,126.5,,2498236.97
2025/03/06,2025/03/01,SF FuneralF813564       250301,,126.5,,2498363.47
2025/03/06,2025/03/03,SF FuneralF1133144      250303,,63.25,,2498426.72
2025/03/06,2025/03/04,SF FuneralF987466       250304,,63.25,,2498489.97
2025/03/06,2025/03/04,SF FuneralFDC0000000N8FK250304,,63.25,,2498553.22
2025/03/06,2025/02/28,Rev SF FuneralFDC0000000HDST250301,,-126.5,,2498426.72
2025/03/06,2025/02/28,SF FuneralF798393       250228,,126.5,,2498553.22
2025/03/06,2025/02/28,SF FuneralF1052326      250228,,126.5,,2498679.72
2025/03/06,2025/03/03,SF FuneralF987096       250303,,63.25,,2498742.97
2025/03/06,2025/03/03,SF FuneralF1110362      250303,,31.63,,2498774.6
2025/03/06,2025/03/03,SF FuneralF1111949      250303,,63.25,,2498837.85
2025/03/06,2025/03/04,SF FuneralFDC00000008L2B250304,,63.25,,2498901.1
2025/03/06,2025/03/04,SF FuneralF817760       250304,,63.25,,2498964.35
2025/03/06,2025/03/04,SF FuneralF1066227      250304,,31.63,,2498995.98
2025/03/06,2025/03/06,Fee-Teller Transactions,,-14.59,,2498981.39
2025/03/06,2025/03/06,Dep-Cash-SFTDC2023823084,,213.31,14.59,2499194.7
2025/03/06,2025/03/06,Fee-Teller Transactions,,-14.8,,2499179.9
2025/03/06,2025/03/06,Dep-Cash-9012141254082,,220,14.8,2499399.9
2025/03/06,2025/03/03,SF FuneralFDC00000006XFK250303,,31.63,,2499431.53
2025/03/06,2025/03/03,SF FuneralFDC00000006XFM250303,,31.63,,2499463.16
2025/03/06,2025/03/04,SF FuneralF798602       250304,,63.25,,2499526.41
2025/03/06,2025/02/25,SF FuneralF981599       250225,,126.5,,2499652.91
2025/03/06,2025/02/25,SF FuneralFDC0000000BHGP250225,,63.25,,2499716.16
2025/03/06,2025/02/27,SF FuneralFDC00000009BR8250227,,126.5,,2499842.66
2025/03/06,2025/02/27,SF FuneralF1118058      250227,,126.5,,2499969.16
2025/03/06,2025/02/28,SF FuneralF822466       250228,,126.5,,2500095.66
2025/03/06,2025/03/01,SF FuneralFDC00000007GR6250301,,31.63,,2500127.29
2025/03/06,2025/03/01,SF FuneralF1123898      250301,,126.5,,2500253.79
2025/03/06,2025/03/03,SF FuneralFDC00000005RR8250303,,31.63,,2500285.42
2025/03/06,2025/03/03,SF FuneralF827602       250303,,31.63,,2500317.05
2025/03/06,2025/03/03,SF FuneralF1073147      250303,,31.63,,2500348.68
2025/03/06,2025/03/03,SF FuneralFDC0000000N77J250303,,126.5,,2500475.18
2025/03/06,2025/03/03,SF FuneralF1124140      250303,,31.63,,2500506.81
2025/03/06,2025/03/04,SF FuneralFDC0000000455X250304,,55,,2500561.81
2025/03/06,2025/03/04,SF FuneralFDC00000008JVD250304,,31.63,,2500593.44
2025/03/06,2025/03/04,SF FuneralF1111675      250304,,31.63,,2500625.07
2025/03/06,2025/03/04,SF FuneralF1127482      250304,,31.63,,2500656.7
2025/03/06,2025/03/04,SF FuneralF1131696      250304,,31.63,,2500688.33
2025/03/06,2025/03/06,Supreme Fun Comm,,-1198154.93,,1302533.4
2025/03/06,2025/03/06,Fee-Txn Notify E-Mail,,-1,,1302532.4
2025/03/06,2025/03/06,Fee-Txn Notify E-Mail,,-1,,1302531.4
2025/03/06,2025/02/25,SF FuneralF1131904      250225,,126.5,,1302657.9
2025/03/06,2025/02/28,SF FuneralF1084933      250228,,126.5,,1302784.4
2025/03/06,2025/03/03,SF FuneralFDC000000069CL250303,,31.63,,1302816.03
2025/03/06,2025/03/03,SF FuneralF1111332      250303,,31.63,,1302847.66
2025/03/06,2025/03/03,SF FuneralF1115794      250303,,31.63,,1302879.29
2025/03/06,2025/02/25,SF FuneralF1130766      250225,,126.5,,1303005.79
2025/03/06,2025/02/27,SF FuneralF817487       250227,,126.5,,1303132.29
2025/03/06,2025/03/04,SF FuneralF993729       250304,,126.5,,1303258.79
2025/03/06,2025/02/25,SF FuneralF989478       250225,,126.5,,1303385.29
2025/03/06,2025/02/28,SF FuneralFDC00000006ZRW250228,,126.5,,1303511.79
2025/03/06,2025/03/03,SF FuneralFDC0000000376D250303,,55,,1303566.79
2025/03/06,2025/03/03,SF FuneralFDC00000004NQM250302,,31.63,,1303598.42
2025/03/06,2025/03/03,SF FuneralFDC00000004NQP250302,,31.63,,1303630.05
2025/03/06,2025/03/03,SF FuneralFDC000000070PX250303,,31.63,,1303661.68
2025/03/06,2025/03/03,SF FuneralFDC00000007H6K250303,,31.63,,1303693.31
2025/03/06,2025/03/03,SF FuneralFDC00000007PP8250303,,31.63,,1303724.94
2025/03/06,2025/03/03,SF FuneralF800626       250303,,31.63,,1303756.57
2025/03/06,2025/03/03,SF FuneralFDC0000000918Q250303,,47.88,,1303804.45
2025/03/06,2025/03/03,SF FuneralF843034       250303,,31.63,,1303836.08
2025/03/06,2025/03/03,SF FuneralF1017630      250303,,31.63,,1303867.71
2025/03/06,2025/03/03,SF FuneralF1060055      250303,,31.63,,1303899.34
2025/03/06,2025/03/03,SF FuneralF1117477      250303,,31.63,,1303930.97
2025/03/06,2025/03/03,SF FuneralF1125116      250303,,31.63,,1303962.6
2025/03/06,2025/03/03,SF FuneralF1131037      250303,,31.63,,1303994.23
2025/03/06,2025/03/03,SF FuneralF1132388      250303,,31.63,,1304025.86
2025/03/06,2025/03/04,SF FuneralFDC00000005H2H250304,,31.63,,1304057.49
2025/03/06,2025/03/04,SF FuneralFDC00000007ZD3250304,,31.63,,1304089.12
2025/03/06,2025/03/04,SF FuneralFDC000000088BV250304,,31.63,,1304120.75
2025/03/06,2025/03/04,SF FuneralF815933       250304,,63.25,,1304184
2025/03/06,2025/03/04,SF FuneralF815955       250304,,31.63,,1304215.63
2025/03/06,2025/03/04,SF FuneralF831704       250304,,31.63,,1304247.26
2025/03/06,2025/03/04,SF FuneralFDC0000000K09P250304,,65,,1304312.26
2025/03/06,2025/03/04,SF FuneralF1080246      250304,,31.63,,1304343.89
2025/03/06,2025/03/04,SF FuneralFDC0000000ML5T250304,,63.25,,1304407.14
2025/03/06,2025/03/04,SF FuneralF1123129      250304,,31.63,,1304438.77
2025/03/06,2025/03/05,SF FuneralF1124171      250305,,31.63,,1304470.4
2025/03/06,2025/03/04,Rev SF FuneralFDC0000000NRQK250304,,-31.63,,1304438.77
2025/03/06,2025/02/28,Rev SF FuneralFDC00000007ZWN250228,,-31.63,,1304407.14
2025/03/06,2025/03/03,Rev SF FuneralFDC00000007GFX250302,,-31.63,,1304375.51
2025/03/06,2025/03/03,Rev SF FuneralFDC00000007GG1250302,,-31.63,,1304343.88
2025/03/06,2025/03/03,Rev SF FuneralFDC0000000FCJY250303,,-31.63,,1304312.25
2025/03/06,2025/02/28,Rev SF FuneralFDC00000007D3P250228,,-126.5,,1304185.75
2025/03/06,2025/02/28,Rev SF FuneralFDC0000000B3H1250228,,-126.5,,1304059.25
2025/03/06,2025/02/25,Rev SF FuneralFDC0000000J2KL250225,,-126.5,,1303932.75
2025/03/06,2025/02/28,Rev SF FuneralFDC00000007T44250228,,-126.5,,1303806.25
2025/03/06,2025/02/27,Rev SF FuneralFDC00000005X6H250227,,-126.5,,1303679.75
2025/03/06,2025/02/27,Rev SF FuneralFDC00000009BR8250227,,-126.5,,1303553.25
2025/03/06,2025/03/01,Rev SF FuneralFDC0000000PJ9M250301,,-126.5,,1303426.75
2025/03/06,2025/03/01,Rev SF FuneralFDC0000000Q57G250301,,-126.5,,1303300.25
2025/03/06,2025/03/01,Rev SF FuneralFDC00000006G05250301,,-126.5,,1303173.75
2025/03/06,2025/03/01,Rev SF FuneralFDC0000000Q57J250301,,-126.5,,1303047.25
2025/03/06,2025/02/28,Rev SF FuneralFDC0000000706X250228,,-126.5,,1302920.75
2025/03/06,2025/03/01,Rev SF FuneralFDC00000006QWT250301,,-126.5,,1302794.25
2025/03/06,2025/02/27,Rev SF FuneralFDC00000006B0G250227,,-126.5,,1302667.75
2025/03/06,2025/02/27,Rev SF FuneralFDC00000006WQQ250227,,-126.5,,1302541.25
2025/03/06,2025/02/28,Rev SF FuneralFDC00000006NKM250228,,-126.5,,1302414.75
2025/03/06,2025/02/28,Rev SF FuneralFDC00000006NLN250228,,-126.5,,1302288.25
2025/03/06,2025/02/28,Rev SF FuneralFDC0000000K0XX250228,,-126.5,,1302161.75
2025/03/06,2025/02/28,Rev SF FuneralFDC0000000KY4F250228,,-126.5,,1302035.25
2025/03/06,2025/03/01,Rev SF FuneralFDC0000000PJ9Y250301,,-126.5,,1301908.75
2025/03/06,2025/03/01,Rev SF FuneralFDC0000000PJGD250301,,-126.5,,1301782.25
2025/03/06,2025/02/27,Rev SF FuneralFDC00000005WJR250227,,-126.5,,1301655.75
2025/03/06,2025/03/06,SF FuneralF1078865      250306,,47.88,,1301703.63
2025/03/06,2025/03/01,SF FuneralF1129188      250301,,126.5,,1301830.13
2025/03/06,2025/03/03,SF FuneralFDC00000005M4T250303,,63.25,,1301893.38
2025/03/06,2025/03/03,SF FuneralF815501       250303,,63.25,,1301956.63
2025/03/06,2025/03/03,SF FuneralF1129089      250303,,63.25,,1302019.88
2025/03/06,2025/03/04,SF FuneralFDC00000002QF4250304,,55,,1302074.88
2025/03/06,2025/03/04,SF FuneralF796739       250304,,31.63,,1302106.51
2025/03/06,2025/03/04,SF FuneralF989212       250304,,63.25,,1302169.76
2025/03/06,2025/03/04,SF FuneralF1127432      250304,,31.63,,1302201.39
2025/03/06,2025/03/06,SF FuneralF1122718      250306,,31.63,,1302233.02
2025/03/06,2025/03/01,SF FuneralF1079151      250301,,386.93,,1302619.95
2025/03/06,2025/03/01,SF FuneralF1114730      250302,,31.63,,1302651.58
2025/03/06,2025/03/04,SF FuneralF828867       250304,,31.63,,1302683.21
2025/03/06,2025/03/04,SF FuneralF1118809      250304,,31.63,,1302714.84
2025/03/06,2025/03/04,SF FuneralF1118948      250304,,63.25,,1302778.09
2025/03/06,2025/03/05,SF FuneralFDC00000008X5B250305,,31.63,,1302809.72
2025/03/06,2025/03/05,SF FuneralF833010       250305,,126.5,,1302936.22
2025/03/06,2025/03/03,SF FuneralF811084       250303,,63.25,,1302999.47
2025/03/06,2025/03/03,SF FuneralFDC0000000CSY7250303,,31.63,,1303031.1
2025/03/06,2025/03/03,SF FuneralF834614       250303,,31.63,,1303062.73
2025/03/06,2025/03/03,SF FuneralF844339       250303,,31.63,,1303094.36
2025/03/06,2025/03/03,SF FuneralF987492       250303,,31.63,,1303125.99
2025/03/06,2025/03/03,SF FuneralF1100809      250303,,31.63,,1303157.62
2025/03/06,2025/03/03,SF FuneralF1102914      250303,,31.63,,1303189.25
2025/03/06,2025/03/03,SF FuneralF823862       250303,,63.25,,1303252.5
2025/03/06,2025/03/03,SF FuneralFDC0000000MSC7250303,,47.88,,1303300.38
2025/03/06,2025/03/04,SF FuneralF1127485      250304,,31.63,,1303332.01
2025/03/06,2025/02/25,Rev SF FuneralFDC00000007TPG250225,,-126.5,,1303205.51
2025/03/06,2025/03/06,EFT-EFT DEBIT TRANSFERS 061351,,11388.5,,1314594.01
2025/03/07,2025/02/28,SF FuneralF1020801      250228,,126.5,,1314720.51
2025/03/07,2025/03/04,SF FuneralFDC000000072SM250304,,31.63,,1314752.14
2025/03/07,2025/03/04,SF FuneralFDC0000000776Q250304,,63.25,,1314815.39
2025/03/07,2025/03/04,SF FuneralF814465       250304,,31.63,,1314847.02
2025/03/07,2025/03/04,SF FuneralF816327       250304,,63.25,,1314910.27
2025/03/07,2025/03/04,SF FuneralF818368       250304,,63.25,,1314973.52
2025/03/07,2025/03/04,SF FuneralFDC0000000MWP0250304,,63.25,,1315036.77
2025/03/07,2025/03/04,SF FuneralF1111979      250304,,63.25,,1315100.02
2025/03/07,2025/03/04,SF FuneralF1112152      250304,,31.63,,1315131.65
2025/03/07,2025/03/04,SF FuneralF1130277      250304,,31.63,,1315163.28
2025/03/07,2025/03/06,SF FuneralF1110763      250306,,31.63,,1315194.91
2025/03/07,2025/03/05,SF FuneralFDC00000005V4Z250305,,31.63,,1315226.54
2025/03/07,2025/03/05,SF FuneralFDC0000000NR68250305,,63.25,,1315289.79
2025/03/07,2025/03/05,SF FuneralF1119016      250305,,95.75,,1315385.54
2025/03/07,2025/02/26,SF FuneralF820113       250226,,225.75,,1315611.29
2025/03/07,2025/03/03,SF FuneralFDC00000006BK1250303,,31.63,,1315642.92
2025/03/07,2025/03/03,SF FuneralFDC00000007GXS250303,,31.63,,1315674.55
2025/03/07,2025/03/03,SF FuneralFDC000000097F2250303,,63.25,,1315737.8
2025/03/07,2025/03/03,SF FuneralFDC000000097G6250303,,63.25,,1315801.05
2025/03/07,2025/03/03,SF FuneralF987157       250303,,63.25,,1315864.3
2025/03/07,2025/03/03,SF FuneralF1127505      250303,,31.63,,1315895.93
2025/03/07,2025/03/01,SF FuneralFDC000000072LZ250301,,126.5,,1316022.43
2025/03/07,2025/03/04,SF FuneralF833912       250304,,63.25,,1316085.68
2025/03/07,2025/03/04,SF FuneralF1103986      250304,,31.63,,1316117.31
2025/03/07,2025/02/25,SF FuneralF1130925      250225,,126.5,,1316243.81
2025/03/07,2025/02/27,SF FuneralFDC00000005TYG250227,,126.5,,1316370.31
2025/03/07,2025/02/27,SF FuneralFDC00000008LCV250227,,126.5,,1316496.81
2025/03/07,2025/02/27,SF FuneralF831145       250227,,63.25,,1316560.06
2025/03/07,2025/02/28,SF FuneralFDC0000000594M250228,,126.5,,1316686.56
2025/03/07,2025/02/28,SF FuneralFDC000000093ZC250228,,126.5,,1316813.06
2025/03/07,2025/02/28,SF FuneralFDC00000009Q9G250228,,126.5,,1316939.56
2025/03/07,2025/02/28,SF FuneralF819922       250228,,126.5,,1317066.06
2025/03/07,2025/02/28,SF FuneralF988752       250228,,126.5,,1317192.56
2025/03/07,2025/02/28,SF FuneralF1073391      250228,,126.5,,1317319.06
2025/03/07,2025/02/28,SF FuneralF1118991      250228,,126.5,,1317445.56
2025/03/07,2025/03/01,SF FuneralF1079383      250302,,126.5,,1317572.06
2025/03/07,2025/03/01,SF FuneralF1114537      250301,,126.5,,1317698.56
2025/03/07,2025/03/03,SF FuneralFDC00000006GTL250302,,126.5,,1317825.06
2025/03/07,2025/03/03,SF FuneralFDC00000006MPX250303,,126.5,,1317951.56
2025/03/07,2025/03/03,SF FuneralFDC00000007C9V250303,,63.25,,1318014.81
2025/03/07,2025/03/03,SF FuneralF795788       250303,,126.5,,1318141.31
2025/03/07,2025/03/03,SF FuneralF1079120      250303,,126.5,,1318267.81
2025/03/07,2025/03/03,SF FuneralF1103852      250303,,63.25,,1318331.06
2025/03/07,2025/03/03,SF FuneralFDC0000000NQ7P250303,,126.5,,1318457.56
2025/03/07,2025/03/03,SF FuneralF1129904      250303,,31.63,,1318489.19
2025/03/07,2025/03/03,SF FuneralF1130649      250303,,31.63,,1318520.82
2025/03/07,2025/03/03,SF FuneralF1130713      250303,,31.63,,1318552.45
2025/03/07,2025/03/03,SF FuneralF1131799      250303,,63.25,,1318615.7
2025/03/07,2025/03/04,SF FuneralFDC00000005SV4250304,,126.5,,1318742.2
2025/03/07,2025/03/04,SF FuneralFDC00000005V54250304,,126.5,,1318868.7
2025/03/07,2025/03/04,SF FuneralFDC00000007DFS250304,,31.63,,1318900.33
2025/03/07,2025/03/04,SF FuneralFDC00000008P1H250304,,63.25,,1318963.58
2025/03/07,2025/03/04,SF FuneralFDC00000008TJ6250304,,126.5,,1319090.08
2025/03/07,2025/03/04,SF FuneralF981761       250304,,63.25,,1319153.33
2025/03/07,2025/03/04,SF FuneralFDC0000000JCZG250304,,63.25,,1319216.58
2025/03/07,2025/03/04,SF FuneralF1066577      250304,,126.5,,1319343.08
2025/03/07,2025/03/04,SF FuneralF1131536      250304,,31.63,,1319374.71
2025/03/07,2025/03/05,SF FuneralFDC000000060TF250305,,126.5,,1319501.21
2025/03/07,2025/03/05,SF FuneralF993615       250305,,126.5,,1319627.71
2025/03/07,2025/03/05,SF FuneralF1060919      250305,,31.63,,1319659.34
2025/03/07,2025/03/05,SF FuneralF1124144      250305,,31.63,,1319690.97
2025/03/07,2025/03/01,SF FuneralF1111595      250302,,31.63,,1319722.6
2025/03/07,2025/03/03,SF FuneralFDC00000005GH0250303,,31.63,,1319754.23
2025/03/07,2025/03/03,SF FuneralFDC00000005RR7250303,,31.63,,1319785.86
2025/03/07,2025/03/03,SF FuneralFDC000000074Y5250303,,55,,1319840.86
2025/03/07,2025/03/03,SF FuneralF815135       250303,,31.63,,1319872.49
2025/03/07,2025/03/03,SF FuneralF834044       250303,,31.63,,1319904.12
2025/03/07,2025/03/03,SF FuneralF901184       250303,,31.63,,1319935.75
2025/03/07,2025/03/03,SF FuneralF986655       250303,,31.63,,1319967.38
2025/03/07,2025/03/03,SF FuneralF990276       250303,,31.63,,1319999.01
2025/03/07,2025/03/03,SF FuneralF993678       250303,,31.63,,1320030.64
2025/03/07,2025/03/03,SF FuneralF1016810      250303,,31.63,,1320062.27
2025/03/07,2025/03/03,SF FuneralF1102887      250303,,31.63,,1320093.9
2025/03/07,2025/03/03,SF FuneralF1112394      250303,,31.63,,1320125.53
2025/03/07,2025/03/03,SF FuneralF1115136      250303,,31.63,,1320157.16
2025/03/07,2025/03/03,SF FuneralF1132453      250303,,31.63,,1320188.79
2025/03/07,2025/03/04,SF FuneralFDC00000003BTC250304,,55,,1320243.79
2025/03/07,2025/03/04,SF FuneralFDC00000005P3L250304,,31.63,,1320275.42
2025/03/07,2025/03/04,SF FuneralFDC00000005P3Q250304,,31.63,,1320307.05
2025/03/07,2025/03/04,SF FuneralFDC00000007KLD250304,,31.63,,1320338.68
2025/03/07,2025/03/04,SF FuneralFDC00000007ZH7250304,,31.63,,1320370.31
2025/03/07,2025/03/04,SF FuneralF811275       250304,,31.63,,1320401.94
2025/03/07,2025/03/04,SF FuneralFDC0000000BMW2250304,,31.63,,1320433.57
2025/03/07,2025/03/04,SF FuneralFDC0000000BT1S250304,,31.63,,1320465.2
2025/03/07,2025/03/04,SF FuneralF987241       250304,,31.63,,1320496.83
2025/03/07,2025/03/04,SF FuneralFDC0000000J00M250304,,31.63,,1320528.46
2025/03/07,2025/03/04,SF FuneralFDC0000000N526250304,,31.63,,1320560.09
2025/03/07,2025/03/04,SF FuneralF1118865      250304,,31.63,,1320591.72
2025/03/07,2025/03/04,SF FuneralF1128762      250304,,31.63,,1320623.35
2025/03/07,2025/03/05,SF FuneralF800771       250305,,31.63,,1320654.98
2025/03/07,2025/03/05,SF FuneralF823094       250305,,31.63,,1320686.61
2025/03/07,2025/03/06,SF FuneralFDC00000005P8B250306,,31.63,,1320718.24
2025/03/07,2025/02/28,SF FuneralFDC0000000H5YY250302,,31.63,,1320749.87
2025/03/07,2025/02/28,SF FuneralF819674       250302,,31.63,,1320781.5
2025/03/07,2025/03/01,SF FuneralFDC00000007VKH250301,,31.63,,1320813.13
2025/03/07,2025/03/03,SF FuneralFDC00000007DSV250303,,31.63,,1320844.76
2025/03/07,2025/03/03,SF FuneralFDC00000007WVJ250303,,31.63,,1320876.39
2025/03/07,2025/03/03,SF FuneralFDC000000086PX250302,,31.63,,1320908.02
2025/03/07,2025/03/03,SF FuneralF802251       250303,,31.63,,1320939.65
2025/03/07,2025/03/03,SF FuneralF813361       250303,,31.63,,1320971.28
2025/03/07,2025/03/03,SF FuneralF815144       250303,,31.63,,1321002.91
2025/03/07,2025/03/03,SF FuneralF822865       250303,,31.63,,1321034.54
2025/03/07,2025/03/03,SF FuneralFDC0000000FVPD250303,,31.63,,1321066.17
2025/03/07,2025/03/03,SF FuneralFDC0000000KYZ5250303,,31.63,,1321097.8
2025/03/07,2025/03/03,SF FuneralF1072930      250303,,31.63,,1321129.43
2025/03/07,2025/03/03,SF FuneralF1073218      250303,,31.63,,1321161.06
2025/03/07,2025/03/03,SF FuneralF1104295      250303,,31.63,,1321192.69
2025/03/07,2025/03/03,SF FuneralFDC0000000ML65250303,,31.63,,1321224.32
2025/03/07,2025/03/03,SF FuneralF1115957      250303,,31.63,,1321255.95
2025/03/07,2025/03/03,SF FuneralF1118957      250303,,31.63,,1321287.58
2025/03/07,2025/03/03,SF FuneralF1119088      250303,,31.63,,1321319.21
2025/03/07,2025/03/03,SF FuneralF1108848      250303,,31.63,,1321350.84
2025/03/07,2025/03/03,SF FuneralF1128005      250303,,31.63,,1321382.47
2025/03/07,2025/03/03,SF FuneralF1132386      250303,,31.63,,1321414.1
2025/03/07,2025/03/04,SF FuneralFDC00000006H1Y250304,,31.63,,1321445.73
2025/03/07,2025/03/04,SF FuneralF814180       250304,,31.63,,1321477.36
2025/03/07,2025/03/04,SF FuneralF816581       250304,,31.63,,1321508.99
2025/03/07,2025/03/04,SF FuneralF821837       250304,,47.88,,1321556.87
2025/03/07,2025/03/04,SF FuneralF827707       250304,,31.63,,1321588.5
2025/03/07,2025/03/04,SF FuneralF830294       250304,,31.63,,1321620.13
2025/03/07,2025/03/04,SF FuneralF841781       250304,,31.63,,1321651.76
2025/03/07,2025/03/04,SF FuneralF993770       250304,,31.63,,1321683.39
2025/03/07,2025/03/04,SF FuneralFDC0000000K22X250304,,31.63,,1321715.02
2025/03/07,2025/03/04,SF FuneralF1110079      250304,,31.63,,1321746.65
2025/03/07,2025/03/04,SF FuneralF1133043      250304,,31.63,,1321778.28
2025/03/07,2025/03/05,SF FuneralFDC0000000MLNC250305,,31.63,,1321809.91
2025/03/07,2025/03/06,SF FuneralFDC00000006ZNM250306,,31.63,,1321841.54
2025/03/07,2025/02/25,SF FuneralF1115170      250225,,63.25,,1321904.79
2025/03/07,2025/02/25,SF FuneralF1117876      250225,,63.25,,1321968.04
2025/03/07,2025/02/28,SF FuneralFDC00000006WVV250228,,126.5,,1322094.54
2025/03/07,2025/02/28,SF FuneralF989907       250228,,126.5,,1322221.04
2025/03/07,2025/02/28,SF FuneralF1079342      250228,,126.5,,1322347.54
2025/03/07,2025/03/03,SF FuneralFDC000000092Y1250303,,63.25,,1322410.79
2025/03/07,2025/03/03,SF FuneralFDC0000000931H250303,,63.25,,1322474.04
2025/03/07,2025/03/03,SF FuneralF813239       250303,,63.25,,1322537.29
2025/03/07,2025/03/03,SF FuneralF814420       250303,,63.25,,1322600.54
2025/03/07,2025/03/03,SF FuneralF820521       250303,,63.25,,1322663.79
2025/03/07,2025/03/03,SF FuneralF830749       250303,,126.5,,1322790.29
2025/03/07,2025/03/03,SF FuneralF838867       250303,,63.25,,1322853.54
2025/03/07,2025/03/03,SF FuneralF988900       250303,,95.75,,1322949.29
2025/03/07,2025/03/03,SF FuneralF989102       250303,,63.25,,1323012.54
2025/03/07,2025/03/03,SF FuneralF1066517      250303,,63.25,,1323075.79
2025/03/07,2025/03/03,SF FuneralF1067883      250303,,63.25,,1323139.04
2025/03/07,2025/03/03,SF FuneralFDC0000000LJW6250303,,106.66,,1323245.7
2025/03/07,2025/03/03,SF FuneralF1128802      250303,,63.25,,1323308.95
2025/03/07,2025/03/03,SF FuneralFDC0000000PW49250303,,63.25,,1323372.2
2025/03/07,2025/03/03,SF FuneralF1128971      250303,,63.25,,1323435.45
2025/03/07,2025/03/03,SF FuneralFDC0000000Q02V250303,,63.25,,1323498.7
2025/03/07,2025/03/03,SF FuneralF1133155      250303,,126.5,,1323625.2
2025/03/07,2025/03/04,SF FuneralFDC00000007LTS250304,,63.25,,1323688.45
2025/03/07,2025/03/04,SF FuneralF799997       250304,,63.25,,1323751.7
2025/03/07,2025/03/04,SF FuneralFDC00000008T3Y250304,,63.25,,1323814.95
2025/03/07,2025/03/04,SF FuneralF810870       250304,,63.25,,1323878.2
2025/03/07,2025/03/04,SF FuneralF818508       250304,,63.25,,1323941.45
2025/03/07,2025/03/04,SF FuneralF821562       250304,,63.25,,1324004.7
2025/03/07,2025/03/04,SF FuneralFDC0000000BJ3M250304,,63.25,,1324067.95
2025/03/07,2025/03/04,SF FuneralF828969       250304,,63.25,,1324131.2
2025/03/07,2025/03/04,SF FuneralF834077       250304,,63.25,,1324194.45
2025/03/07,2025/03/04,SF FuneralF842929       250304,,63.25,,1324257.7
2025/03/07,2025/03/04,SF FuneralF1065745      250304,,63.25,,1324320.95
2025/03/07,2025/03/04,SF FuneralFDC0000000Q9SY250304,,63.25,,1324384.2
2025/03/07,2025/03/03,SF FuneralFDC00000006PQZ250303,,126.5,,1324510.7
2025/03/07,2025/03/03,SF FuneralFDC0000000HS6H250303,,31.63,,1324542.33
2025/03/07,2025/03/03,SF FuneralF1125114      250303,,31.63,,1324573.96
2025/03/07,2025/03/04,SF FuneralF797055       250304,,31.63,,1324605.59
2025/03/07,2025/03/04,SF FuneralF1067943      250304,,126.5,,1324732.09
2025/03/07,2025/03/04,SF FuneralFDC0000000ML7D250304,,31.63,,1324763.72
2025/03/07,2025/03/04,SF FuneralFDC0000000NN7N250304,,31.63,,1324795.35
2025/03/07,2025/03/04,SF FuneralF1120129      250304,,31.63,,1324826.98
2025/03/07,2025/03/04,SF FuneralF1121768      250304,,63.25,,1324890.23
2025/03/07,2025/03/04,SF FuneralF1123132      250304,,31.63,,1324921.86
2025/03/07,2025/03/04,SF FuneralF1132354      250304,,31.63,,1324953.49
2025/03/07,2025/02/27,SF FuneralFDC0000000B23F250227,,126.5,,1325079.99
2025/03/07,2025/03/06,SF FuneralFDC00000005MJG250306,,126.5,,1325206.49
2025/03/07,2025/03/05,SF FuneralF1059424      250305,,31.63,,1325238.12
2025/03/07,2025/03/05,SF FuneralF1060723      250305,,126.5,,1325364.62
2025/03/07,2025/03/01,SF FuneralF1072856      250302,,31.63,,1325396.25
2025/03/07,2025/03/07,SF FuneralFDC000000080FL250307,,126.5,,1325522.75
2025/03/07,2025/03/07,SF FuneralF803505       250307,,31.63,,1325554.38
2025/03/07,2025/03/07,SF FuneralFDC0000000L9LD250307,,126.5,,1325680.88
2025/03/07,2025/03/07,SF FuneralF1131921      250307,,31.63,,1325712.51
2025/03/07,2025/03/04,SF FuneralF804091       250304,,31.63,,1325744.14
2025/03/07,2025/03/04,SF FuneralFDC00000009383250304,,31.63,,1325775.77
2025/03/07,2025/03/04,SF FuneralF809963       250304,,126.5,,1325902.27
2025/03/07,2025/03/04,SF FuneralF816158       250304,,63.25,,1325965.52
2025/03/07,2025/03/04,SF FuneralF844086       250304,,63.25,,1326028.77
2025/03/07,2025/03/04,SF FuneralF991967       250304,,63.25,,1326092.02
2025/03/07,2025/03/04,SF FuneralF1061069      250304,,31.63,,1326123.65
2025/03/07,2025/03/04,SF FuneralF1067949      250304,,126.5,,1326250.15
2025/03/07,2025/03/04,SF FuneralF1078209      250304,,31.63,,1326281.78
2025/03/07,2025/03/04,SF FuneralF1118892      250304,,31.63,,1326313.41
2025/03/07,2025/03/04,SF FuneralF1132297      250304,,126.5,,1326439.91
2025/03/07,2025/03/03,SF FuneralFDC00000008MKX250303,,31.63,,1326471.54
2025/03/07,2025/03/03,SF FuneralFDC0000000LGT5250303,,126.5,,1326598.04
2025/03/07,2025/03/03,SF FuneralF1078677      250303,,126.5,,1326724.54
2025/03/07,2025/03/03,SF FuneralF1123277      250303,,31.63,,1326756.17
2025/03/07,2025/03/07,SF FuneralFDC00000006PSF250307,,31.63,,1326787.8
2025/03/07,2025/03/07,SF FuneralF1126874      250307,,31.63,,1326819.43
2025/03/07,2025/03/07,SF FuneralF1127416      250307,,63.25,,1326882.68
2025/03/07,2025/03/03,SF FuneralF1079348      250303,,31.63,,1326914.31
2025/03/07,2025/03/04,SF FuneralFDC000000051KX250304,,31.63,,1326945.94
2025/03/07,2025/03/04,SF FuneralFDC00000007FBC250304,,31.63,,1326977.57
2025/03/07,2025/03/04,SF FuneralF801219       250304,,31.63,,1327009.2
2025/03/07,2025/03/04,SF FuneralFDC00000008M07250304,,31.63,,1327040.83
2025/03/07,2025/03/04,SF FuneralF1078493      250304,,31.63,,1327072.46
2025/03/07,2025/03/04,SF FuneralF1083692      250304,,31.63,,1327104.09
2025/03/07,2025/03/04,SF FuneralF1111731      250304,,31.63,,1327135.72
2025/03/07,2025/03/04,SF FuneralF1120226      250304,,31.63,,1327167.35
2025/03/07,2025/03/04,SF FuneralF1132381      250304,,31.63,,1327198.98
2025/03/07,2025/03/05,SF FuneralF1110314      250305,,31.63,,1327230.61
2025/03/07,2025/03/06,SF FuneralF1109029      250306,,31.63,,1327262.24
2025/03/07,2025/03/07,SF FuneralFDC00000007Q48250307,,31.63,,1327293.87
2025/03/07,2025/03/07,SF FuneralFDC00000007ZWN250307,,31.63,,1327325.5
2025/03/07,2025/03/07,SF FuneralFDC00000007ZWY250307,,31.63,,1327357.13
2025/03/07,2025/03/07,SF FuneralF814303       250307,,31.63,,1327388.76
2025/03/07,2025/03/07,SF FuneralF1119753      250307,,31.63,,1327420.39
2025/03/07,2025/03/07,SF FuneralF1122752      250307,,31.63,,1327452.02
2025/03/07,2025/03/07,SF FuneralFDC0000000PK3S250307,,31.63,,1327483.65
2025/03/07,2025/03/04,SF FuneralF1058830      250304,,63.25,,1327546.9
2025/03/07,2025/03/04,SF FuneralF1129384      250304,,63.25,,1327610.15
2025/03/07,2025/03/03,SF FuneralF986985       250303,,63.25,,1327673.4
2025/03/07,2025/03/04,SF FuneralF822295       250304,,63.25,,1327736.65
2025/03/07,2025/03/03,SF FuneralF1052812      250303,,31.63,,1327768.28
2025/03/07,2025/03/04,SF FuneralFDC00000006SSB250304,,31.63,,1327799.91
2025/03/07,2025/03/04,SF FuneralFDC00000006ST9250304,,31.63,,1327831.54
2025/03/07,2025/03/04,SF FuneralFDC00000006STJ250304,,31.63,,1327863.17
2025/03/07,2025/03/04,SF FuneralF989177       250304,,31.63,,1327894.8
2025/03/07,2025/03/04,SF FuneralF1066647      250304,,31.63,,1327926.43
2025/03/07,2025/03/04,SF FuneralF1073828      250304,,31.63,,1327958.06
2025/03/07,2025/03/04,SF FuneralF1124052      250304,,31.63,,1327989.69
2025/03/07,2025/03/04,SF FuneralF1127480      250304,,31.63,,1328021.32
2025/03/07,2025/03/04,SF FuneralF1131484      250304,,31.63,,1328052.95
2025/03/07,2025/03/04,SF FuneralF1131495      250304,,31.63,,1328084.58
2025/03/07,2025/03/07,SF FuneralF841714       250307,,31.63,,1328116.21
2025/03/07,2025/03/07,SF FuneralFDC0000000HVXH250308,,31.63,,1328147.84
2025/03/07,2025/03/07,SF FuneralF1022106      250307,,31.63,,1328179.47
2025/03/07,2025/03/07,SF FuneralF1125111      250307,,31.63,,1328211.1
2025/03/07,2025/03/03,SF FuneralFDC0000000F7T2250303,,31.63,,1328242.73
2025/03/07,2025/03/03,SF FuneralF1118416      250303,,31.63,,1328274.36
2025/03/07,2025/03/04,SF FuneralFDC00000007WH2250304,,47.88,,1328322.24
2025/03/07,2025/03/04,SF FuneralF827761       250304,,31.63,,1328353.87
2025/03/07,2025/03/04,SF FuneralF827812       250304,,31.63,,1328385.5
2025/03/07,2025/03/04,SF FuneralF834203       250304,,31.63,,1328417.13
2025/03/07,2025/03/04,SF FuneralF843037       250304,,31.63,,1328448.76
2025/03/07,2025/03/04,SF FuneralF986709       250304,,31.63,,1328480.39
2025/03/07,2025/03/04,SF FuneralF1020936      250304,,31.63,,1328512.02
2025/03/07,2025/03/04,SF FuneralFDC0000000NNP9250304,,31.63,,1328543.65
2025/03/07,2025/03/04,SF FuneralF1126072      250304,,31.63,,1328575.28
2025/03/07,2025/03/04,SF FuneralF1126086      250304,,31.63,,1328606.91
2025/03/07,2025/03/04,SF FuneralF1127528      250304,,31.63,,1328638.54
2025/03/07,2025/03/04,SF FuneralF1127863      250304,,31.63,,1328670.17
2025/03/07,2025/03/04,SF FuneralF1131622      250304,,31.63,,1328701.8
2025/03/07,2025/03/04,SF FuneralF1132895      250304,,31.63,,1328733.43
2025/03/07,2025/03/07,SF FuneralFDC00000007MW5250307,,31.63,,1328765.06
2025/03/07,2025/03/07,SF FuneralF812905       250307,,31.63,,1328796.69
2025/03/07,2025/03/07,SF FuneralF817655       250307,,31.63,,1328828.32
2025/03/07,2025/03/07,SF FuneralFDC0000000B37Y250307,,31.63,,1328859.95
2025/03/07,2025/03/07,SF FuneralF834544       250307,,31.63,,1328891.58
2025/03/07,2025/03/07,SF FuneralFDC0000000D307250307,,31.63,,1328923.21
2025/03/07,2025/03/07,SF FuneralF1110444      250307,,31.63,,1328954.84
2025/03/07,2025/03/07,SF FuneralF1130338      250307,,31.63,,1328986.47
2025/03/07,2025/03/03,SF FuneralF794739       250303,,63.25,,1329049.72
2025/03/07,2025/03/03,SF FuneralF801671       250303,,63.25,,1329112.97
2025/03/07,2025/03/03,SF FuneralF831218       250303,,63.25,,1329176.22
2025/03/07,2025/03/04,SF FuneralF814319       250304,,63.25,,1329239.47
2025/03/07,2025/03/06,SF FuneralFDC0000000GS5M250306,,126.5,,1329365.97
2025/03/07,2025/02/27,SF FuneralFDC00000005F5Y250227,,126.5,,1329492.47
2025/03/07,2025/03/03,SF FuneralF1127788      250303,,126.5,,1329618.97
2025/03/07,2025/03/07,SF FuneralF843220       250307,,63.25,,1329682.22
2025/03/07,2025/03/07,SF FuneralFDC0000000KY6Y250307,,126.5,,1329808.72
2025/03/07,2025/03/01,SF FuneralF820664       250301,,126.5,,1329935.22
2025/03/07,2025/03/03,SF FuneralF1075155      250303,,63.25,,1329998.47
2025/03/07,2025/03/03,SF FuneralF1060944      250303,,31.63,,1330030.1
2025/03/07,2025/03/03,SF FuneralF1123291      250303,,31.63,,1330061.73
2025/03/07,2025/03/04,SF FuneralF799673       250304,,31.63,,1330093.36
2025/03/07,2025/03/04,SF FuneralF802169       250304,,31.63,,1330124.99
2025/03/07,2025/03/04,SF FuneralF822125       250304,,31.63,,1330156.62
2025/03/07,2025/03/04,SF FuneralF1021467      250304,,31.63,,1330188.25
2025/03/07,2025/03/04,SF FuneralFDC0000000L215250304,,31.63,,1330219.88
2025/03/07,2025/03/04,SF FuneralF1084860      250304,,31.63,,1330251.51
2025/03/07,2025/03/04,SF FuneralF1132785      250304,,31.63,,1330283.14
2025/03/07,2025/03/06,SF FuneralF1016768      250306,,31.63,,1330314.77
2025/03/07,2025/03/07,SF FuneralF989273       250309,,31.63,,1330346.4
2025/03/07,2025/03/07,SF FuneralF819674       250309,,31.63,,1330378.03
2025/03/07,2025/03/07,SF FuneralF990787       250308,,31.63,,1330409.66
2025/03/07,2025/03/07,SF FuneralFDC0000000K7CQ250307,,31.63,,1330441.29
2025/03/07,2025/03/07,SF FuneralF1079664      250307,,31.63,,1330472.92
2025/03/07,2025/03/07,SF FuneralF1079691      250307,,31.63,,1330504.55
2025/03/07,2025/03/07,SF FuneralF1080183      250307,,31.63,,1330536.18
2025/03/07,2025/03/07,SF FuneralF1132265      250307,,31.63,,1330567.81
2025/03/07,2025/03/04,SF FuneralF1084648      250304,,63.25,,1330631.06
2025/03/07,2025/03/04,SF FuneralF1102904      250304,,63.25,,1330694.31
2025/03/07,2025/03/04,SF FuneralF1124763      250304,,63.25,,1330757.56
2025/03/07,2025/03/04,SF FuneralF1129149      250304,,63.25,,1330820.81
2025/03/07,2025/03/07,SF FuneralFDC000000080KL250307,,126.5,,1330947.31
2025/03/07,2025/02/26,SF FuneralFDC0000000NBV2250226,,63.25,,1331010.56
2025/03/07,2025/02/26,SF FuneralF1115107      250226,,63.25,,1331073.81
2025/03/07,2025/03/01,SF FuneralF1117998      250302,,31.63,,1331105.44
2025/03/07,2025/03/01,SF FuneralF1122782      250301,,126.5,,1331231.94
2025/03/07,2025/03/04,SF FuneralFDC000000072H2250304,,63.25,,1331295.19
2025/03/07,2025/03/04,SF FuneralF844728       250304,,31.63,,1331326.82
2025/03/07,2025/03/04,SF FuneralF1111588      250304,,31.63,,1331358.45
2025/03/07,2025/03/04,SF FuneralF1118308      250304,,31.63,,1331390.08
2025/03/07,2025/03/04,SF FuneralF1127611      250304,,31.63,,1331421.71
2025/03/07,2025/03/05,SF FuneralF1120815      250305,,31.63,,1331453.34
2025/03/07,2025/02/25,SF FuneralF827839       250225,,126.5,,1331579.84
2025/03/07,2025/03/01,SF FuneralF1084288      250301,,31.63,,1331611.47
2025/03/07,2025/03/03,SF FuneralF842916       250303,,63.25,,1331674.72
2025/03/07,2025/03/03,SF FuneralF1073862      250303,,31.63,,1331706.35
2025/03/07,2025/03/03,SF FuneralF1080529      250303,,31.63,,1331737.98
2025/03/07,2025/03/03,SF FuneralF1124114      250303,,31.63,,1331769.61
2025/03/07,2025/03/04,SF FuneralFDC00000006SLB250304,,126.5,,1331896.11
2025/03/07,2025/03/04,SF FuneralFDC00000007CPB250304,,31.63,,1331927.74
2025/03/07,2025/03/04,SF FuneralFDC000000080WH250304,,31.63,,1331959.37
2025/03/07,2025/03/04,SF FuneralFDC000000086NT250304,,126.5,,1332085.87
2025/03/07,2025/03/04,SF FuneralFDC00000008851250304,,31.63,,1332117.5
2025/03/07,2025/03/04,SF FuneralF810630       250304,,63.25,,1332180.75
2025/03/07,2025/03/04,SF FuneralF1060950      250304,,31.63,,1332212.38
2025/03/07,2025/03/04,SF FuneralF1065982      250304,,31.63,,1332244.01
2025/03/07,2025/03/04,SF FuneralF1066639      250304,,126.5,,1332370.51
2025/03/07,2025/03/04,SF FuneralF1074649      250304,,31.63,,1332402.14
2025/03/07,2025/03/04,SF FuneralF1080286      250304,,31.63,,1332433.77
2025/03/07,2025/03/04,SF FuneralF1115105      250304,,31.63,,1332465.4
2025/03/07,2025/03/04,SF FuneralF1132314      250304,,31.63,,1332497.03
2025/03/07,2025/03/04,SF FuneralF1132378      250304,,31.63,,1332528.66
2025/03/07,2025/03/07,SF FuneralFDC0000000628F250307,,31.63,,1332560.29
2025/03/07,2025/03/07,SF FuneralFDC00000006P6D250307,,31.63,,1332591.92
2025/03/07,2025/03/07,SF FuneralF842737       250307,,31.63,,1332623.55
2025/03/07,2025/03/07,SF FuneralF993809       250307,,31.63,,1332655.18
2025/03/07,2025/03/07,SF FuneralF993837       250307,,31.63,,1332686.81
2025/03/07,2025/02/22,Rev SF FuneralFDC0000000BD9L250222,,-126.5,,1332560.31
2025/03/07,2025/02/28,Rev SF FuneralFDC000000093ZC250228,,-126.5,,1332433.81
2025/03/07,2025/02/19,Rev SF FuneralFDC000000068V7250219,,-126.5,,1332307.31
2025/03/07,2025/03/03,Rev SF FuneralFDC0000000KYZ5250303,,-31.63,,1332275.68
2025/03/07,2025/03/03,Rev SF FuneralFDC0000000F3H4250303,,-31.63,,1332244.05
2025/03/07,2025/03/03,Rev SF FuneralFDC00000007H6K250303,,-31.63,,1332212.42
2025/03/07,2025/03/03,Rev SF FuneralFDC0000000LJ60250303,,-31.63,,1332180.79
2025/03/07,2025/03/06,Rev SF FuneralFDC00000005P8B250306,,-31.63,,1332149.16
2025/03/07,2025/02/24,Rev SF FuneralFDC00000007H6K250224,,-31.63,,1332117.53
2025/03/07,2025/03/01,Rev SF FuneralFDC0000000KJM2250301,,-126.5,,1331991.03
2025/03/07,2025/02/25,Rev SF FuneralFDC0000000CSW4250225,,-63.25,,1331927.78
2025/03/07,2025/03/05,Rev SF FuneralFDC000000060TF250305,,-126.5,,1331801.28
2025/03/07,2025/03/03,SF FuneralFDC00000006Q80250303,,31.63,,1331832.91
2025/03/07,2025/03/04,SF FuneralFDC00000006CWD250304,,55,,1331887.91
2025/03/07,2025/03/04,SF FuneralF800205       250304,,31.63,,1331919.54
2025/03/07,2025/03/04,SF FuneralF831001       250304,,63.25,,1331982.79
2025/03/07,2025/03/04,SF FuneralF1112534      250304,,63.25,,1332046.04
2025/03/07,2025/02/28,SF FuneralF821118       250228,,126.5,,1332172.54
2025/03/07,2025/02/28,SF FuneralF822207       250228,,126.5,,1332299.04
2025/03/07,2025/02/28,SF FuneralFDC0000000LW45250228,,126.5,,1332425.54
2025/03/07,2025/02/28,SF FuneralF1084387      250228,,126.5,,1332552.04
2025/03/07,2025/03/03,SF FuneralFDC0000000BDNZ250303,,126.5,,1332678.54
2025/03/07,2025/03/04,SF FuneralFDC00000005NFK250304,,31.63,,1332710.17
2025/03/07,2025/03/04,SF FuneralFDC00000007CY2250304,,63.25,,1332773.42
2025/03/07,2025/03/04,SF FuneralF811790       250304,,31.63,,1332805.05
2025/03/07,2025/03/04,SF FuneralF814235       250304,,63.25,,1332868.3
2025/03/07,2025/03/04,SF FuneralF816835       250304,,31.63,,1332899.93
2025/03/07,2025/03/04,SF FuneralFDC0000000BG38250304,,126.5,,1333026.43
2025/03/07,2025/03/04,SF FuneralF823292       250304,,63.25,,1333089.68
2025/03/07,2025/03/04,SF FuneralF831226       250304,,31.63,,1333121.31
2025/03/07,2025/03/04,SF FuneralF988932       250304,,63.25,,1333184.56
2025/03/07,2025/03/04,SF FuneralF1016839      250304,,31.63,,1333216.19
2025/03/07,2025/03/04,SF FuneralF1066156      250304,,63.25,,1333279.44
2025/03/07,2025/03/04,SF FuneralF1079430      250304,,63.25,,1333342.69
2025/03/07,2025/03/04,SF FuneralF1124420      250304,,63.25,,1333405.94
2025/03/07,2025/03/04,SF FuneralF1126262      250304,,31.63,,1333437.57
2025/03/07,2025/03/04,SF FuneralF1127395      250304,,63.25,,1333500.82
2025/03/07,2025/03/07,SF FuneralFDC0000000J2Y1250308,,31.63,,1333532.45
2025/03/07,2025/03/07,SF FuneralF993478       250307,,31.63,,1333564.08
2025/03/07,2024/05/27,Rev SF FuneralFDC000000032B1240527,,-220,,1333344.08
2025/03/07,2024/04/29,Rev SF FuneralFDC000000032B1240427,,-220,,1333124.08
2025/03/07,2024/03/27,Rev SF FuneralFDC000000032B1240327,,-220,,1332904.08
2025/03/07,2025/02/27,Rev SF FuneralFDC000000032B1250227,,-220,,1332684.08
2025/03/07,2024/08/27,Rev SF FuneralFDC000000032B1240827,,-220,,1332464.08
2025/03/07,2024/09/27,Rev SF FuneralFDC000000032B1240927,,-220,,1332244.08
2025/03/07,2025/03/03,Rev SF FuneralFDC00000007GXX250302,,-126.5,,1332117.58
2025/03/07,2025/03/04,SF FuneralF1118693      250304,,63.25,,1332180.83
2025/03/07,2025/03/04,SF FuneralF1132340      250304,,126.5,,1332307.33
2025/03/07,2025/03/07,SF FuneralF980379       250307,,31.63,,1332338.96
2025/03/07,2025/02/26,SF FuneralFDC0000000B78Q250226,,126.5,,1332465.46
2025/03/07,2025/02/27,SF FuneralFDC0000000K22Y250227,,126.5,,1332591.96
2025/03/07,2025/03/01,SF FuneralFDC0000000LVKL250301,,126.5,,1332718.46
2025/03/07,2025/03/03,SF FuneralFDC00000006XGF250303,,63.25,,1332781.71
2025/03/07,2025/03/03,SF FuneralF1123166      250303,,31.63,,1332813.34
2025/03/07,2025/03/04,SF FuneralF805648       250304,,31.63,,1332844.97
2025/03/07,2025/03/04,SF FuneralF818338       250304,,63.25,,1332908.22
2025/03/07,2025/03/04,SF FuneralF1022109      250304,,63.25,,1332971.47
2025/03/07,2025/03/04,SF FuneralF1132930      250304,,63.25,,1333034.72
2025/03/07,2025/03/04,SF FuneralF1132936      250304,,31.63,,1333066.35
2025/03/07,2025/03/07,SF FuneralFDC00000004LL7250307,,220,,1333286.35
2025/03/07,2025/03/07,SF FuneralF1123272      250307,,126.5,,1333412.85
2025/03/07,2025/02/28,SF FuneralFDC00000006DH6250228,,126.5,,1333539.35
2025/03/07,2025/03/04,SF FuneralFDC00000005P72250304,,63.25,,1333602.6
2025/03/07,2025/03/04,SF FuneralF833229       250304,,63.25,,1333665.85
2025/03/07,2025/03/04,SF FuneralFDC0000000HTVZ250304,,63.25,,1333729.1
2025/03/07,2025/03/04,SF FuneralF991505       250304,,63.25,,1333792.35
2025/03/07,2025/03/04,SF FuneralF1078543      250304,,63.25,,1333855.6
2025/03/07,2025/03/04,SF FuneralF1078560      250304,,63.25,,1333918.85
2025/03/07,2025/02/28,SF FuneralF989298       250228,,126.5,,1334045.35
2025/03/07,2025/03/03,SF FuneralF986862       250303,,63.25,,1334108.6
2025/03/07,2025/03/04,SF FuneralF1066029      250304,,31.63,,1334140.23
2025/03/07,2025/03/04,SF FuneralF1121999      250304,,63.25,,1334203.48
2025/03/07,2025/03/06,SF FuneralFDC000000074JB250306,,126.5,,1334329.98
2025/03/07,2025/02/27,SF FuneralF1065797      250227,,126.5,,1334456.48
2025/03/07,2025/02/28,SF FuneralF1068243      250228,,126.5,,1334582.98
2025/03/07,2025/03/04,SF FuneralF1133019      250304,,63.25,,1334646.23
2025/03/07,2025/03/04,SF FuneralF1133468      250304,,63.25,,1334709.48
2025/03/07,2025/03/07,Fee-Internet-Beneficiary,,-18.64,,1334690.84
2025/03/07,2025/03/07,Supreme,,-1157006.88,18.64,177683.96
2025/03/07,2025/03/07,Fee-Txn Notify E-Mail,,-1,,177682.96
2025/03/07,2025/03/07,Fee-Txn Notify E-Mail,,-1,,177681.96
2025/03/07,2025/03/04,SF FuneralFDC00000005P4K250304,,31.63,,177713.59
2025/03/07,2025/03/04,SF FuneralF1067978      250304,,31.63,,177745.22
2025/03/07,2025/02/28,SF FuneralF900834       250228,,126.5,,177871.72
2025/03/07,2025/03/03,SF FuneralFDC00000005NWL250303,,31.63,,177903.35
2025/03/07,2025/03/03,SF FuneralFDC00000005NX7250303,,31.63,,177934.98
2025/03/07,2025/03/04,SF FuneralFDC000000030DF250304,,55,,177989.98
2025/03/07,2025/02/28,SF FuneralF794631       250228,,126.5,,178116.48
2025/03/07,2025/02/27,SF FuneralF829530       250227,,126.5,,178242.98
2025/03/07,2025/03/04,SF FuneralFDC0000000CY56250304,,31.63,,178274.61
2025/03/07,2025/03/03,SF FuneralFDC00000009DX3250302,,31.63,,178306.24
2025/03/07,2025/03/03,SF FuneralF843043       250301,,126.5,,178432.74
2025/03/07,2025/02/26,SF FuneralF1016844      250226,,191.5,,178624.24
2025/03/07,2025/02/28,SF FuneralFDC0000000772K250228,,126.5,,178750.74
2025/03/07,2025/02/28,SF FuneralFDC000000077WH250228,,126.5,,178877.24
2025/03/07,2025/02/28,SF FuneralF830255       250228,,126.5,,179003.74
2025/03/07,2025/02/28,SF FuneralF1110539      250228,,126.5,,179130.24
2025/03/07,2025/02/28,SF FuneralF1123295      250228,,126.5,,179256.74
2025/03/07,2025/03/03,SF FuneralFDC000000071S5250303,,31.63,,179288.37
2025/03/07,2025/03/03,SF FuneralF989598       250303,,63.25,,179351.62
2025/03/07,2025/03/04,SF FuneralFDC00000006MV3250304,,63.25,,179414.87
2025/03/07,2025/03/04,SF FuneralFDC000000078FZ250304,,31.63,,179446.5
2025/03/07,2025/03/04,SF FuneralFDC00000007LQC250304,,63.25,,179509.75
2025/03/07,2025/03/04,SF FuneralFDC00000007YH4250304,,31.63,,179541.38
2025/03/07,2025/03/04,SF FuneralF798676       250304,,31.63,,179573.01
2025/03/07,2025/03/04,SF FuneralF820828       250304,,63.25,,179636.26
2025/03/07,2025/03/04,SF FuneralF830023       250304,,31.63,,179667.89
2025/03/07,2025/03/04,SF FuneralF989331       250304,,63.25,,179731.14
2025/03/07,2025/03/04,SF FuneralF991415       250304,,31.63,,179762.77
2025/03/07,2025/03/04,SF FuneralF1020608      250304,,31.63,,179794.4
2025/03/07,2025/03/04,SF FuneralF1060316      250304,,31.63,,179826.03
2025/03/07,2025/03/04,SF FuneralF1060838      250304,,31.63,,179857.66
2025/03/07,2025/03/04,SF FuneralF1061865      250304,,31.63,,179889.29
2025/03/07,2025/03/04,SF FuneralF1062646      250304,,31.63,,179920.92
2025/03/07,2025/03/04,SF FuneralF1079178      250304,,31.63,,179952.55
2025/03/07,2025/03/04,SF FuneralF1079259      250304,,31.63,,179984.18
2025/03/07,2025/03/04,SF FuneralFDC0000000LVMD250304,,31.63,,180015.81
2025/03/07,2025/03/04,SF FuneralF1116010      250304,,31.63,,180047.44
2025/03/07,2025/03/04,SF FuneralF1118420      250304,,31.63,,180079.07
2025/03/07,2025/03/04,SF FuneralF1123402      250304,,63.25,,180142.32
2025/03/07,2025/03/04,SF FuneralF1132383      250304,,63.25,,180205.57
2025/03/07,2025/03/04,SF FuneralF1132989      250304,,31.63,,180237.2
2025/03/07,2025/03/05,SF FuneralF1117934      250305,,126.5,,180363.7
2025/03/07,2025/03/07,SF FuneralF1114116      250307,,31.63,,180395.33
2025/03/07,2025/03/07,SF FuneralF1127351      250307,,31.63,,180426.96
2025/03/07,2025/02/22,Rev SF FuneralFDC00000007RJK250222,,-126.5,,180300.46
2025/03/07,2025/02/28,Rev SF FuneralFDC0000000KXPG250228,,-126.5,,180173.96
2025/03/07,2025/03/01,Rev SF FuneralFDC0000000751B250301,,-126.5,,180047.46
2025/03/07,2025/02/25,Rev SF FuneralFDC0000000JH4V250225,,-126.5,,179920.96
2025/03/07,2025/02/27,Rev SF FuneralFDC0000000LCT3250227,,-126.5,,179794.46
2025/03/07,2025/02/27,Rev SF FuneralFDC0000000LCT7250227,,-126.5,,179667.96
2025/03/07,2025/03/03,Rev SF FuneralFDC0000000BDNZ250303,,-126.5,,179541.46
2025/03/07,2025/03/03,Rev SF FuneralFDC0000000Q23M250303,,-126.5,,179414.96
2025/03/07,2025/01/24,Rev SF FuneralFDC0000000JKF4250125,,-126.5,,179288.46
2025/03/07,2025/02/27,Rev SF FuneralFDC00000005VCP250227,,-126.5,,179161.96
2025/03/07,2025/02/17,Rev SF FuneralFDC0000000Q451250217,,-126.5,,179035.46
2025/03/07,2025/02/25,Rev SF FuneralFDC0000000JKF4250225,,-126.5,,178908.96
2025/03/07,2025/02/28,Rev SF FuneralFDC000000077WH250228,,-126.5,,178782.46
2025/03/07,2025/03/04,Rev SF FuneralFDC0000000NNP9250304,,-31.63,,178750.83
2025/03/07,2025/03/07,Rev SF FuneralFDC00000007ZWN250307,,-31.63,,178719.2
2025/03/07,2025/03/07,Rev SF FuneralFDC0000000K7CQ250307,,-31.63,,178687.57
2025/03/07,2025/03/04,Rev SF FuneralFDC00000006STJ250304,,-31.63,,178655.94
2025/03/07,2025/03/04,Rev SF FuneralFDC00000006ST9250304,,-31.63,,178624.31
2025/03/07,2024/12/11,Rev SF FuneralF1020953      241228,,-126.5,,178497.81
2025/03/07,2025/03/06,Rev SF FuneralFDC0000000GS5M250306,,-126.5,,178371.31
2025/03/07,2025/03/04,SF FuneralF801331       250304,,31.63,,178402.94
2025/03/07,2025/03/04,SF FuneralFDC0000000N7JJ250304,,63.25,,178466.19
2025/03/07,2025/03/04,SF FuneralF1122862      250304,,31.63,,178497.82
2025/03/07,2025/03/04,SF FuneralF1123027      250304,,31.63,,178529.45
2025/03/07,2025/03/03,SF FuneralFDC0000000J02Z250303,,126.5,,178655.95
2025/03/07,2025/03/03,SF FuneralF791581       250303,,47.88,,178703.83
2025/03/07,2025/02/27,SF FuneralF841844       250227,,126.5,,178830.33
2025/03/07,2025/03/04,SF FuneralF1033965      250304,,63.25,,178893.58
2025/03/07,2025/03/04,SF FuneralFDC000000061NF250304,,31.63,,178925.21
2025/03/07,2025/03/04,SF FuneralFDC0000000892D250304,,31.63,,178956.84
2025/03/07,2025/03/04,SF FuneralF806032       250304,,31.63,,178988.47
2025/03/07,2025/03/04,SF FuneralF809435       250304,,31.63,,179020.1
2025/03/07,2025/03/04,SF FuneralF829557       250304,,31.63,,179051.73
2025/03/07,2025/03/04,SF FuneralF986694       250304,,31.63,,179083.36
2025/03/07,2025/03/04,SF FuneralFDC0000000J23L250304,,31.63,,179114.99
2025/03/07,2025/03/04,SF FuneralF1052200      250304,,31.63,,179146.62
2025/03/07,2025/03/04,SF FuneralF843649       250304,,31.63,,179178.25
2025/03/07,2025/03/04,SF FuneralF1061075      250304,,31.63,,179209.88
2025/03/07,2025/03/04,SF FuneralF1068023      250304,,31.63,,179241.51
2025/03/07,2025/03/04,SF FuneralFDC0000000MCB7250304,,63.25,,179304.76
2025/03/07,2025/03/04,SF FuneralF1111329      250304,,31.63,,179336.39
2025/03/07,2025/03/04,SF FuneralF1117702      250304,,31.63,,179368.02
2025/03/07,2025/03/04,SF FuneralF820999       250304,,31.63,,179399.65
2025/03/07,2025/03/04,SF FuneralF1125142      250304,,31.63,,179431.28
2025/03/07,2025/03/04,SF FuneralF1130345      250304,,31.63,,179462.91
2025/03/07,2025/03/04,SF FuneralFDC0000000Q3J8250304,,126.5,,179589.41
2025/03/07,2025/02/28,SF FuneralF1022070      250228,,126.5,,179715.91
2025/03/07,2025/03/04,SF FuneralF830037       250304,,63.25,,179779.16
2025/03/07,2025/03/04,SF FuneralF828946       250304,,63.25,,179842.41
2025/03/07,2025/03/04,SF FuneralF989085       250304,,31.63,,179874.04
2025/03/07,2025/03/04,SF FuneralF1054618      250304,,31.63,,179905.67
2025/03/07,2025/03/04,SF FuneralF1113963      250304,,31.63,,179937.3
2025/03/07,2025/03/04,SF FuneralF1118898      250304,,63.25,,180000.55
2025/03/07,2025/03/04,SF FuneralF1130346      250304,,31.63,,180032.18
2025/03/07,2025/02/28,SF FuneralF820290       250228,,126.5,,180158.68
2025/03/07,2025/02/28,SF FuneralF1125855      250228,,126.5,,180285.18
2025/03/08,2025/03/04,SF FuneralFDC00000006B9G250304,,31.63,,180316.81
2025/03/08,2025/03/04,SF FuneralF993778       250304,,63.25,,180380.06
2025/03/08,2025/03/04,SF FuneralF1016973      250304,,31.63,,180411.69
2025/03/08,2025/03/04,SF FuneralF1022184      250304,,31.63,,180443.32
2025/03/08,2025/03/04,SF FuneralF1123619      250304,,63.25,,180506.57
2025/03/08,2025/03/07,SF FuneralFDC000000070HM250307,,63.25,,180569.82
2025/03/08,2025/03/07,SF FuneralF798583       250307,,31.63,,180601.45
2025/03/08,2025/03/06,SF FuneralFDC000000077XQ250306,,126.5,,180727.95
2025/03/08,2025/02/26,SF FuneralF830232       250226,,126.5,,180854.45
2025/03/08,2025/02/28,SF FuneralFDC000000075CB250228,,126.5,,180980.95
2025/03/08,2025/02/28,SF FuneralFDC00000007F6Z250228,,126.5,,181107.45
2025/03/08,2025/03/01,SF FuneralF1114460      250302,,126.5,,181233.95
2025/03/08,2025/03/03,SF FuneralFDC00000007D5W250303,,63.25,,181297.2
2025/03/08,2025/03/03,SF FuneralF820769       250303,,31.63,,181328.83
2025/03/08,2025/03/04,SF FuneralFDC00000006QTN250304,,31.63,,181360.46
2025/03/08,2025/03/04,SF FuneralFDC00000006Y7S250304,,31.63,,181392.09
2025/03/08,2025/03/04,SF FuneralF815053       250304,,63.25,,181455.34
2025/03/08,2025/03/04,SF FuneralF833123       250304,,31.63,,181486.97
2025/03/08,2025/03/04,SF FuneralF834932       250304,,63.25,,181550.22
2025/03/08,2025/03/04,SF FuneralF987244       250304,,31.63,,181581.85
2025/03/08,2025/03/04,SF FuneralFDC0000000JJ2Y250304,,63.25,,181645.1
2025/03/08,2025/03/04,SF FuneralF1017666      250304,,31.63,,181676.73
2025/03/08,2025/03/04,SF FuneralF1050698      250304,,31.63,,181708.36
2025/03/08,2025/03/04,SF FuneralF1060963      250304,,63.25,,181771.61
2025/03/08,2025/03/04,SF FuneralF1073379      250304,,31.63,,181803.24
2025/03/08,2025/03/04,SF FuneralF1073746      250304,,31.63,,181834.87
2025/03/08,2025/03/04,SF FuneralF1074598      250304,,31.63,,181866.5
2025/03/08,2025/03/04,SF FuneralF1078491      250304,,63.25,,181929.75
2025/03/08,2025/03/04,SF FuneralF1079384      250304,,63.25,,181993
2025/03/08,2025/03/04,SF FuneralF1080328      250304,,63.25,,182056.25
2025/03/08,2025/03/04,SF FuneralFDC0000000MK76250304,,63.25,,182119.5
2025/03/08,2025/03/04,SF FuneralF1111967      250304,,63.25,,182182.75
2025/03/08,2025/03/04,SF FuneralF1127719      250304,,31.63,,182214.38
2025/03/08,2025/03/04,SF FuneralF1129417      250304,,31.63,,182246.01
2025/03/08,2025/03/04,SF FuneralF1130519      250304,,63.25,,182309.26
2025/03/08,2025/03/04,SF FuneralF1131798      250304,,31.63,,182340.89
2025/03/08,2025/03/04,SF FuneralF739720       250304,,64.13,,182405.02
2025/03/08,2025/03/04,SF FuneralF1118962      250304,,31.63,,182436.65
2025/03/08,2025/03/06,SF FuneralFDC0000000N9ZS250306,,126.5,,182563.15
2025/03/08,2025/03/07,SF FuneralFDC000000078XC250307,,126.5,,182689.65
2025/03/08,2025/03/07,SF FuneralFDC00000007W5T250307,,126.5,,182816.15
2025/03/08,2025/03/07,SF FuneralF1061613      250307,,31.63,,182847.78
2025/03/08,2025/03/04,SF FuneralFDC0000000722W250304,,63.25,,182911.03
2025/03/08,2025/03/04,SF FuneralF821893       250304,,63.25,,182974.28
2025/03/08,2025/03/04,SF FuneralF1128868      250304,,126.5,,183100.78
2025/03/08,2025/03/04,SF FuneralF1130748      250304,,63.25,,183164.03
2025/03/08,2025/03/03,SF FuneralF822919       250303,,63.25,,183227.28
2025/03/08,2025/03/04,SF FuneralF993963       250304,,63.25,,183290.53
2025/03/08,2025/03/05,SF FuneralF1074875      250305,,126.5,,183417.03
2025/03/08,2025/03/04,SF FuneralF1128976      250304,,63.25,,183480.28
2025/03/08,2025/03/05,SF FuneralF1083874      250305,,63.25,,183543.53
2025/03/08,2025/03/03,SF FuneralFDC000000069C5250303,,31.63,,183575.16
2025/03/08,2025/03/03,SF FuneralF810327       250303,,31.63,,183606.79
2025/03/08,2025/03/03,SF FuneralF1079340      250303,,31.63,,183638.42
2025/03/08,2025/03/03,SF FuneralFDC0000000Q9HH250303,,31.63,,183670.05
2025/03/08,2025/03/04,SF FuneralFDC00000005L57250304,,31.63,,183701.68
2025/03/08,2025/03/04,SF FuneralFDC000000064P9250304,,31.63,,183733.31
2025/03/08,2025/03/04,SF FuneralF805200       250304,,31.63,,183764.94
2025/03/08,2025/03/04,SF FuneralF817682       250304,,31.63,,183796.57
2025/03/08,2025/03/04,SF FuneralFDC0000000CWFK250304,,31.63,,183828.2
2025/03/08,2025/03/04,SF FuneralF1033680      250304,,31.63,,183859.83
2025/03/08,2025/03/04,SF FuneralF1085179      250304,,31.63,,183891.46
2025/03/08,2025/03/04,SF FuneralFDC0000000NRVB250304,,31.63,,183923.09
2025/03/08,2025/03/04,SF FuneralF1123030      250304,,31.63,,183954.72
2025/03/08,2025/03/04,SF FuneralF1127417      250304,,31.63,,183986.35
2025/03/08,2025/03/04,SF FuneralF1130616      250304,,31.63,,184017.98
2025/03/08,2025/03/04,SF FuneralF1132382      250304,,31.63,,184049.61
2025/03/08,2025/03/05,SF FuneralF842872       250305,,31.63,,184081.24
2025/03/08,2025/02/28,SF FuneralFDC0000000CHJP250228,,126.5,,184207.74
2025/03/08,2025/02/28,SF FuneralF1113738      250228,,126.5,,184334.24
2025/03/08,2025/03/04,SF FuneralF810730       250304,,63.25,,184397.49
2025/03/08,2025/03/04,SF FuneralF1132844      250304,,126.5,,184523.99
2025/03/08,2025/03/05,SF FuneralF1123193      250305,,126.5,,184650.49
2025/03/08,2025/03/06,SF FuneralF1122638      250306,,63.25,,184713.74
2025/03/08,2025/03/05,SF FuneralF1118016      250305,,126.5,,184840.24
2025/03/08,2025/03/04,SF FuneralF1073139      250304,,63.25,,184903.49
2025/03/08,2025/03/08,SF FuneralFDC00000005FXR250308,,63.25,,184966.74
2025/03/08,2025/03/08,SF FuneralF805805       250308,,126.5,,185093.24
2025/03/08,2025/03/08,SF FuneralF819348       250308,,63.25,,185156.49
2025/03/08,2025/03/08,SF FuneralF1116780      250308,,63.25,,185219.74
2025/03/08,2025/03/08,SF FuneralF1118079      250308,,126.5,,185346.24
2025/03/08,2025/03/04,SF FuneralF834882       250304,,31.63,,185377.87
2025/03/08,2025/03/04,SF FuneralF1104234      250304,,31.63,,185409.5
2025/03/08,2025/03/07,SF FuneralF774474       250307,,156.28,,185565.78
2025/03/08,2025/03/07,SF FuneralFDC0000000JXK7250307,,31.63,,185597.41
2025/03/08,2025/03/08,SF FuneralFDC00000005XNC250308,,31.63,,185629.04
2025/03/08,2025/03/08,SF FuneralFDC00000007GR6250308,,31.63,,185660.67
2025/03/08,2025/03/08,SF FuneralF994082       250309,,126.5,,185787.17
2025/03/08,2025/03/08,SF FuneralF1017512      250309,,31.63,,185818.8
2025/03/08,2025/03/08,SF FuneralF1084539      250309,,31.63,,185850.43
2025/03/08,2025/03/08,SF FuneralF1121775      250309,,47.88,,185898.31
2025/03/08,2025/03/08,SF FuneralF1121892      250309,,31.63,,185929.94
2025/03/08,2025/03/04,SF FuneralFDC00000007CQV250304,,31.63,,185961.57
2025/03/08,2025/03/04,SF FuneralF812669       250304,,63.25,,186024.82
2025/03/08,2025/03/04,SF FuneralF1118348      250304,,31.63,,186056.45
2025/03/08,2025/03/04,SF FuneralF1130991      250304,,31.63,,186088.08
2025/03/08,2025/03/06,SF FuneralF1079631      250306,,31.63,,186119.71
2025/03/08,2025/02/28,SF FuneralFDC00000005PZ2250228,,126.5,,186246.21
2025/03/08,2025/02/28,SF FuneralFDC00000008KGQ250228,,126.5,,186372.71
2025/03/08,2025/03/08,SF FuneralF1117944      250308,,126.5,,186499.21
2025/03/08,2025/02/26,SF FuneralFDC0000000BV1Z250226,,126.5,,186625.71
2025/03/08,2025/02/27,SF FuneralF1108323      250227,,126.5,,186752.21
2025/03/08,2025/02/27,SF FuneralF1122196      250227,,126.5,,186878.71
2025/03/08,2025/03/03,SF FuneralF1066625      250303,,126.5,,187005.21
2025/03/08,2025/03/08,SF FuneralF1129917      250309,,31.63,,187036.84
2025/03/08,2025/03/02,SF FuneralF829764       250302,,63.25,,187100.09
2025/03/08,2025/03/01,SF FuneralFDC0000000795H250301,,126.5,,187226.59
2025/03/08,2025/03/04,SF FuneralF822239       250304,,31.63,,187258.22
2025/03/08,2025/03/04,SF FuneralF827810       250304,,63.25,,187321.47
2025/03/08,2025/03/04,SF FuneralF1122750      250304,,31.63,,187353.1
2025/03/08,2025/03/08,SF FuneralFDC0000000JY24250309,,31.63,,187384.73
2025/03/08,2025/02/27,SF FuneralFDC0000000J98K250227,,126.5,,187511.23
2025/03/08,2025/02/28,SF FuneralF816819       250228,,126.5,,187637.73
2025/03/08,2025/03/04,SF FuneralFDC00000002XZF250304,,110,,187747.73
2025/03/08,2025/03/04,SF FuneralFDC00000006X91250304,,31.63,,187779.36
2025/03/08,2025/03/04,SF FuneralFDC000000079QY250304,,31.63,,187810.99
2025/03/08,2025/03/04,SF FuneralF1020916      250304,,31.63,,187842.62
2025/03/08,2025/03/04,SF FuneralF1054894      250304,,126.5,,187969.12
2025/03/08,2025/03/04,SF FuneralF1078878      250304,,126.5,,188095.62
2025/03/08,2025/03/04,SF FuneralF1132974      250304,,63.25,,188158.87
2025/03/08,2025/03/04,SF FuneralF1133049      250304,,126.5,,188285.37
2025/03/08,2025/03/08,SF FuneralF1020601      250308,,31.63,,188317
2025/03/08,2025/03/08,SF FuneralF1104260      250309,,63.25,,188380.25
2025/03/08,2025/03/04,SF FuneralFDC0000000Q4KK250304,,126.5,,188506.75
2025/03/08,2025/03/03,Rev SF FuneralFDC000000069C5250303,,-31.63,,188475.12
2025/03/08,2025/03/04,Rev SF FuneralFDC00000005L57250304,,-31.63,,188443.49
2025/03/08,2024/11/28,Rev SF FuneralFDC00000007NF0241128,,-126.5,,188316.99
2025/03/08,2025/02/22,Rev SF FuneralFDC0000000LLT3250223,,-126.5,,188190.49
2025/03/08,2025/02/25,Rev SF FuneralFDC00000007D6D250225,,-126.5,,188063.99
2025/03/08,2025/02/28,Rev SF FuneralFDC000000075CB250228,,-126.5,,187937.49
2025/03/08,2025/03/04,Rev SF FuneralFDC0000000MK76250304,,-63.25,,187874.24
2025/03/08,2025/03/04,Rev SF FuneralFDC0000000BJ3M250304,,-63.25,,187810.99
2025/03/08,2025/02/28,Rev SF FuneralFDC0000000CHJP250228,,-126.5,,187684.49
2025/03/08,2025/03/07,Rev SF FuneralFDC000000080KL250307,,-126.5,,187557.99
2025/03/08,2025/03/03,Rev SF FuneralF843043       250301,,-126.5,,187431.49
2025/03/08,2025/02/27,SF FuneralFDC0000000677F250227,,126.5,,187557.99
2025/03/08,2025/02/27,SF FuneralF987365       250227,,126.5,,187684.49
2025/03/08,2025/02/28,SF FuneralF1022047      250228,,126.5,,187810.99
2025/03/08,2025/03/03,SF FuneralFDC00000009HK1250303,,63.25,,187874.24
2025/03/08,2025/03/03,SF FuneralF1111395      250303,,31.63,,187905.87
2025/03/08,2025/03/04,SF FuneralF833072       250304,,31.63,,187937.5
2025/03/08,2025/03/05,SF FuneralF840927       250305,,63.25,,188000.75
2025/03/08,2025/03/05,SF FuneralF844044       250305,,31.63,,188032.38
2025/03/08,2025/03/07,SF FuneralF986934       250307,,31.63,,188064.01
2025/03/08,2025/03/08,SF FuneralFDC00000009MWX250308,,63.25,,188127.26
2025/03/08,2025/02/28,SF FuneralF1127943      250228,,126.5,,188253.76
2025/03/08,2025/03/07,Rev SF FuneralFDC0000000L9LD250307,,-126.5,,188127.26
2025/03/08,2025/02/28,SF FuneralFDC00000007H55250228,,126.5,,188253.76
2025/03/08,2025/02/28,SF FuneralF988162       250301,,126.5,,188380.26
2025/03/08,2025/03/03,SF FuneralF1118033      250303,,31.63,,188411.89
2025/03/08,2024/12/11,Rev SF FuneralF989474       241222,,-126.5,,188285.39
2025/03/08,2025/02/22,Rev SF FuneralFDC00000006625250222,,-126.5,,188158.89
2025/03/08,2025/02/27,Rev SF FuneralFDC0000000677F250227,,-126.5,,188032.39
2025/03/08,2025/01/11,Rev SF FuneralFDC00000009W98250111,,-126.5,,187905.89
2025/03/08,2025/03/08,Rev SF FuneralFDC00000005FXR250308,,-63.25,,187842.64
2025/03/08,2025/03/07,Rev SF FuneralFDC0000000JXK7250307,,-31.63,,187811.01
2025/03/08,2025/03/04,Rev SF FuneralFDC0000000NRVB250304,,-31.63,,187779.38
2025/03/08,2025/03/03,Rev SF FuneralFDC00000009HK1250303,,-63.25,,187716.13
2025/03/08,2025/02/11,Rev SF FuneralFDC00000009W98250211,,-126.5,,187589.63
2025/03/08,2025/03/04,SF FuneralFDC0000000788B250304,,31.63,,187621.26
