"Txn date","Effective","Description","Truncated card number","Amount","Charges","Balance"
"2025-02-06","2025-01-30","SF FuneralFDC00000007D3C250130","","126.5","","1154078.48"
"2025-02-06","2025-01-31","SF FuneralF901139       250201","","126.5","","1154204.98"
"2025-02-06","2025-01-31","SF FuneralF901181       250202","","126.5","","1154331.48"
"2025-02-06","2025-01-31","SF FuneralF980282       250201","","126.5","","1154457.98"
"2025-02-06","2025-01-31","SF FuneralFDC0000000HC2B250201","","126.5","","1154584.48"
"2025-02-06","2025-01-31","SF FuneralF988231       250201","","126.5","","1154710.98"
"2025-02-06","2025-01-31","SF FuneralF989566       250201","","126.5","","1154837.48"
"2025-02-06","2025-01-31","SF FuneralF1120573      250131","","31.63","","1154869.11"
"2025-02-06","2025-02-01","SF FuneralFDC00000006FPY250201","","126.5","","1154995.61"
"2025-02-06","2025-02-01","SF FuneralFDC00000006GMK250201","","126.5","","1155122.11"
"2025-02-06","2025-02-01","SF FuneralFDC00000006NNL250201","","126.5","","1155248.61"
"2025-02-06","2025-02-01","SF FuneralFDC00000006P0S250201","","126.5","","1155375.11"
"2025-02-06","2025-02-01","SF FuneralFDC00000006T73250201","","126.5","","1155501.61"
"2025-02-06","2025-02-01","SF FuneralFDC00000006VP7250201","","126.5","","1155628.11"
"2025-02-06","2025-02-01","SF FuneralFDC000000086MP250201","","126.5","","1155754.61"
"2025-02-06","2025-02-01","SF FuneralFDC000000086MQ250201","","126.5","","1155881.11"
"2025-02-06","2025-02-01","SF FuneralF820961       250201","","126.5","","1156007.61"
"2025-02-06","2025-02-01","SF FuneralF831162       250201","","126.5","","1156134.11"
"2025-02-06","2025-02-01","SF FuneralF832973       250201","","126.5","","1156260.61"
"2025-02-06","2025-02-01","SF FuneralF842311       250201","","126.5","","1156387.11"
"2025-02-06","2025-02-01","SF FuneralF993271       250201","","126.5","","1156513.61"
"2025-02-06","2025-02-01","SF FuneralF993673       250201","","126.5","","1156640.11"
"2025-02-06","2025-02-01","SF FuneralF993709       250201","","126.5","","1156766.61"
"2025-02-06","2025-02-01","SF FuneralF1022060      250201","","126.5","","1156893.11"
"2025-02-06","2025-02-01","SF FuneralF1022061      250201","","126.5","","1157019.61"
"2025-02-06","2025-02-01","SF FuneralFDC0000000K226250201","","126.5","","1157146.11"
"2025-02-06","2025-02-01","SF FuneralF1058860      250201","","126.5","","1157272.61"
"2025-02-06","2025-02-01","SF FuneralF1066652      250201","","126.5","","1157399.11"
"2025-02-06","2025-02-01","SF FuneralFDC0000000L1TB250201","","126.5","","1157525.61"
"2025-02-06","2025-02-01","SF FuneralF1078251      250201","","126.5","","1157652.11"
"2025-02-06","2025-02-01","SF FuneralF1078431      250201","","126.5","","1157778.61"
"2025-02-06","2025-02-01","SF FuneralF1078432      250201","","126.5","","1157905.11"
"2025-02-06","2025-02-01","SF FuneralF1078463      250201","","126.5","","1158031.61"
"2025-02-06","2025-02-01","SF FuneralF1079363      250201","","126.5","","1158158.11"
"2025-02-06","2025-02-01","SF FuneralF1084903      250201","","126.5","","1158284.61"
"2025-02-06","2025-02-01","SF FuneralF1085194      250201","","126.5","","1158411.11"
"2025-02-06","2025-02-01","SF FuneralFDC0000000M1BW250201","","126.5","","1158537.61"
"2025-02-06","2025-02-01","SF FuneralFDC0000000M2PV250201","","126.5","","1158664.11"
"2025-02-06","2025-02-01","SF FuneralFDC0000000M2Q1250201","","126.5","","1158790.61"
"2025-02-06","2025-02-01","SF FuneralF1109043      250201","","126.5","","1158917.11"
"2025-02-06","2025-02-01","SF FuneralFDC0000000MKD6250201","","126.5","","1159043.61"
"2025-02-06","2025-02-01","SF FuneralF1109656      250201","","126.5","","1159170.11"
"2025-02-06","2025-02-01","SF FuneralF1109757      250201","","126.5","","1159296.61"
"2025-02-06","2025-02-01","SF FuneralF1110002      250201","","126.5","","1159423.11"
"2025-02-06","2025-02-01","SF FuneralFDC0000000N5LT250201","","126.5","","1159549.61"
"2025-02-06","2025-02-01","SF FuneralF1113916      250201","","126.5","","1159676.11"
"2025-02-06","2025-02-01","SF FuneralF1113937      250202","","63.25","","1159739.36"
"2025-02-06","2025-02-01","SF FuneralF1113991      250201","","126.5","","1159865.86"
"2025-02-06","2025-02-01","SF FuneralF1114476      250201","","126.5","","1159992.36"
"2025-02-06","2025-02-01","SF FuneralF1115167      250201","","126.5","","1160118.86"
"2025-02-06","2025-02-01","SF FuneralF1118224      250202","","126.5","","1160245.36"
"2025-02-06","2025-02-01","SF FuneralF1122306      250201","","191.5","","1160436.86"
"2025-02-06","2025-02-01","SF FuneralF1122625      250201","","126.5","","1160563.36"
"2025-02-06","2025-02-01","SF FuneralFDC0000000P1GF250201","","126.5","","1160689.86"
"2025-02-06","2025-02-01","SF FuneralF1124069      250201","","126.5","","1160816.36"
"2025-02-06","2025-02-01","SF FuneralF1124764      250201","","126.5","","1160942.86"
"2025-02-06","2025-02-01","SF FuneralF1122649      250201","","126.5","","1161069.36"
"2025-02-06","2025-02-01","SF FuneralF1125974      250201","","126.5","","1161195.86"
"2025-02-06","2025-02-01","SF FuneralF1126003      250201","","126.5","","1161322.36"
"2025-02-06","2025-02-01","SF FuneralFDC0000000PLSR250201","","126.5","","1161448.86"
"2025-02-06","2025-02-01","SF FuneralFDC0000000PLST250201","","126.5","","1161575.36"
"2025-02-06","2025-02-01","SF FuneralF1126958      250201","","126.5","","1161701.86"
"2025-02-06","2025-02-01","SF FuneralFDC0000000PQJ9250201","","126.5","","1161828.36"
"2025-02-06","2025-02-01","SF FuneralF1128138      250201","","126.5","","1161954.86"
"2025-02-06","2025-02-01","SF FuneralF1128228      250201","","126.5","","1162081.36"
"2025-02-06","2025-02-01","SF FuneralFDC0000000PWPF250201","","126.5","","1162207.86"
"2025-02-06","2025-02-01","SF FuneralFDC0000000PWPP250201","","126.5","","1162334.36"
"2025-02-06","2025-02-01","SF FuneralF1128975      250202","","126.5","","1162460.86"
"2025-02-06","2025-02-01","SF FuneralF1129281      250201","","126.5","","1162587.36"
"2025-02-06","2025-02-01","SF FuneralFDC0000000PZ3Y250201","","126.5","","1162713.86"
"2025-02-06","2025-02-01","SF FuneralF1130626      250201","","126.5","","1162840.36"
"2025-02-06","2025-02-03","SF FuneralFDC00000004CSK250203","","55","","1162895.36"
"2025-02-06","2025-02-03","SF FuneralFDC00000004CSL250203","","55","","1162950.36"
"2025-02-06","2025-02-03","SF FuneralFDC00000006NRN250202","","220","","1163170.36"
"2025-02-06","2025-02-03","SF FuneralFDC000000070CJ250203","","31.63","","1163201.99"
"2025-02-06","2025-02-03","SF FuneralF820956       250202","","31.63","","1163233.62"
"2025-02-06","2025-02-03","SF FuneralFDC0000000CWBD250202","","31.63","","1163265.25"
"2025-02-06","2025-02-03","SF FuneralF843991       250201","","126.5","","1163391.75"
"2025-02-06","2025-02-03","SF FuneralFDC0000000FMK0250201","","126.5","","1163518.25"
"2025-02-06","2025-02-03","SF FuneralF1068038      250203","","126.5","","1163644.75"
"2025-02-06","2025-02-03","SF FuneralFDC0000000KZ2C250203","","31.63","","1163676.38"
"2025-02-06","2025-02-05","SF FuneralF828742       250205","","126.5","","1163802.88"
"2025-02-06","2025-02-04","SF FuneralFDC00000007LG1250204","","31.63","","1163834.51"
"2025-02-06","2025-02-04","SF FuneralF797821       250204","","63.25","","1163897.76"
"2025-02-06","2025-02-04","SF FuneralF818153       250204","","31.63","","1163929.39"
"2025-02-06","2025-02-04","SF FuneralF1110349      250204","","31.63","","1163961.02"
"2025-02-06","2025-02-04","SF FuneralF1118994      250204","","63.25","","1164024.27"
"2025-02-06","2025-01-29","SF FuneralF1068037      250129","","126.5","","1164150.77"
"2025-02-06","2025-01-30","SF FuneralF799168       250130","","126.5","","1164277.27"
"2025-02-06","2025-02-01","SF FuneralF1078314      250201","","126.5","","1164403.77"
"2025-02-06","2025-02-01","SF FuneralF1122295      250202","","31.63","","1164435.4"
"2025-02-06","2025-02-03","SF FuneralFDC00000005LQV250203","","31.63","","1164467.03"
"2025-02-06","2025-02-03","SF FuneralFDC00000005YNL250203","","55","","1164522.03"
"2025-02-06","2025-02-03","SF FuneralFDC00000005YW3250203","","31.63","","1164553.66"
"2025-02-06","2025-02-03","SF FuneralFDC00000006PJZ250203","","126.5","","1164680.16"
"2025-02-06","2025-02-03","SF FuneralF795788       250203","","126.5","","1164806.66"
"2025-02-06","2025-02-03","SF FuneralFDC000000087G6250202","","31.63","","1164838.29"
"2025-02-06","2025-02-03","SF FuneralF819012       250203","","31.63","","1164869.92"
"2025-02-06","2025-02-04","SF FuneralFDC00000007SVT250204","","126.5","","1164996.42"
"2025-02-06","2025-02-04","SF FuneralF1085179      250204","","31.63","","1165028.05"
"2025-02-06","2025-02-05","SF FuneralF1124138      250205","","31.63","","1165059.68"
"2025-02-06","2025-01-29","SF FuneralFDC00000002WQL250129","","220","","1165279.68"
"2025-02-06","2025-01-29","SF FuneralFDC00000003B9H250129","","220","","1165499.68"
"2025-02-06","2025-01-29","SF FuneralFDC00000003BF2250129","","220","","1165719.68"
"2025-02-06","2025-01-30","SF FuneralFDC00000006JBM250130","","220","","1165939.68"
"2025-02-06","2025-01-31","SF FuneralFDC00000003BCR250131","","220","","1166159.68"
"2025-02-06","2025-01-31","SF FuneralFDC000000043MJ250131","","220","","1166379.68"
"2025-02-06","2025-01-31","SF FuneralF901425       250202","","126.5","","1166506.18"
"2025-02-06","2025-01-31","SF FuneralF813340       250201","","256.5","","1166762.68"
"2025-02-06","2025-01-31","SF FuneralFDC0000000HYKZ250201","","126.5","","1166889.18"
"2025-02-06","2025-02-01","SF FuneralFDC00000002VNY250201","","220","","1167109.18"
"2025-02-06","2025-02-01","SF FuneralFDC00000002VTC250201","","220","","1167329.18"
"2025-02-06","2025-02-01","SF FuneralFDC00000002W6Z250201","","220","","1167549.18"
"2025-02-06","2025-02-01","SF FuneralFDC00000002WW9250201","","220","","1167769.18"
"2025-02-06","2025-02-01","SF FuneralFDC00000002YRR250201","","220","","1167989.18"
"2025-02-06","2025-02-01","SF FuneralFDC00000002Z3Z250201","","220","","1168209.18"
"2025-02-06","2025-02-01","SF FuneralFDC000000033L6250201","","220","","1168429.18"
"2025-02-06","2025-02-01","SF FuneralFDC000000033MG250201","","220","","1168649.18"
"2025-02-06","2025-02-01","SF FuneralFDC000000033VR250201","","220","","1168869.18"
"2025-02-06","2025-02-01","SF FuneralFDC00000003403250201","","220","","1169089.18"
"2025-02-06","2025-02-01","SF FuneralFDC0000000342Z250201","","220","","1169309.18"
"2025-02-06","2025-02-01","SF FuneralFDC0000000349H250201","","220","","1169529.18"
"2025-02-06","2025-02-01","SF FuneralFDC0000000353T250201","","220","","1169749.18"
"2025-02-06","2025-02-01","SF FuneralFDC00000003BPQ250201","","220","","1169969.18"
"2025-02-06","2025-02-01","SF FuneralFDC00000003DMR250201","","220","","1170189.18"
"2025-02-06","2025-02-01","SF FuneralFDC00000003KSQ250201","","220","","1170409.18"
"2025-02-06","2025-02-01","SF FuneralFDC00000003LCK250201","","220","","1170629.18"
"2025-02-06","2025-02-01","SF FuneralFDC00000003LM4250201","","220","","1170849.18"
"2025-02-06","2025-02-01","SF FuneralFDC00000003T9W250201","","220","","1171069.18"
"2025-02-06","2025-02-01","SF FuneralFDC00000003TKQ250201","","220","","1171289.18"
"2025-02-06","2025-02-01","SF FuneralFDC00000003TM4250201","","220","","1171509.18"
"2025-02-06","2025-02-01","SF FuneralFDC00000003V07250201","","220","","1171729.18"
"2025-02-06","2025-02-01","SF FuneralFDC00000003V14250201","","220","","1171949.18"
"2025-02-06","2025-02-01","SF FuneralFDC00000003V18250201","","220","","1172169.18"
"2025-02-06","2025-02-01","SF FuneralFDC00000003V5C250201","","220","","1172389.18"
"2025-02-06","2025-02-01","SF FuneralFDC000000041MN250201","","220","","1172609.18"
"2025-02-06","2025-02-01","SF FuneralFDC000000044KP250201","","220","","1172829.18"
"2025-02-06","2025-02-01","SF FuneralFDC000000044LX250201","","220","","1173049.18"
"2025-02-06","2025-02-01","SF FuneralFDC000000058KZ250201","","126.5","","1173175.68"
"2025-02-06","2025-02-01","SF FuneralFDC000000058Q7250201","","126.5","","1173302.18"
"2025-02-06","2025-02-01","SF FuneralFDC000000058RL250201","","126.5","","1173428.68"
"2025-02-06","2025-02-01","SF FuneralFDC000000058TR250201","","126.5","","1173555.18"
"2025-02-06","2025-02-01","SF FuneralFDC00000005DDM250201","","126.5","","1173681.68"
"2025-02-06","2025-02-01","SF FuneralFDC00000005WTL250201","","220","","1173901.68"
"2025-02-06","2025-02-01","SF FuneralFDC00000005X3S250201","","126.5","","1174028.18"
"2025-02-06","2025-02-01","SF FuneralFDC000000064DL250201","","126.5","","1174154.68"
"2025-02-06","2025-02-01","SF FuneralFDC00000006GXL250201","","220","","1174374.68"
"2025-02-06","2025-02-01","SF FuneralFDC00000006KQQ250201","","126.5","","1174501.18"
"2025-02-06","2025-02-01","SF FuneralFDC00000006LYV250201","","126.5","","1174627.68"
"2025-02-06","2025-02-01","SF FuneralFDC00000006NTV250201","","126.5","","1174754.18"
"2025-02-06","2025-02-01","SF FuneralFDC0000000759N250201","","126.5","","1174880.68"
"2025-02-06","2025-02-01","SF FuneralFDC000000076V3250201","","126.5","","1175007.18"
"2025-02-06","2025-02-01","SF FuneralFDC0000000790M250201","","126.5","","1175133.68"
"2025-02-06","2025-02-01","SF FuneralFDC0000000790R250201","","126.5","","1175260.18"
"2025-02-06","2025-02-01","SF FuneralFDC0000000795V250201","","126.5","","1175386.68"
"2025-02-06","2025-02-01","SF FuneralFDC000000079C0250201","","126.5","","1175513.18"
"2025-02-06","2025-02-01","SF FuneralFDC00000007BSC250201","","126.5","","1175639.68"
"2025-02-06","2025-02-01","SF FuneralFDC00000007GF7250201","","126.5","","1175766.18"
"2025-02-06","2025-02-01","SF FuneralFDC00000007MXK250201","","126.5","","1175892.68"
"2025-02-06","2025-02-01","SF FuneralFDC00000007MXQ250201","","126.5","","1176019.18"
"2025-02-06","2025-02-01","SF FuneralFDC00000007NWH250201","","126.5","","1176145.68"
"2025-02-06","2025-02-01","SF FuneralFDC00000007RL7250201","","126.5","","1176272.18"
"2025-02-06","2025-02-01","SF FuneralFDC00000007S28250201","","126.5","","1176398.68"
"2025-02-06","2025-02-01","SF FuneralF809074       250201","","126.5","","1176525.18"
"2025-02-06","2025-02-01","SF FuneralFDC00000009G8T250201","","126.5","","1176651.68"
"2025-02-06","2025-02-01","SF FuneralF782540       250201","","256.5","","1176908.18"
"2025-02-06","2025-02-01","SF FuneralF813487       250201","","126.5","","1177034.68"
"2025-02-06","2025-02-01","SF FuneralF815173       250201","","126.5","","1177161.18"
"2025-02-06","2025-02-01","SF FuneralF821111       250201","","126.5","","1177287.68"
"2025-02-06","2025-02-01","SF FuneralFDC0000000BD0Y250201","","220","","1177507.68"
"2025-02-06","2025-02-01","SF FuneralF822538       250201","","126.5","","1177634.18"
"2025-02-06","2025-02-01","SF FuneralF822546       250201","","126.5","","1177760.68"
"2025-02-06","2025-02-01","SF FuneralF782650       250201","","191.5","","1177952.18"
"2025-02-06","2025-02-01","SF FuneralF782679       250201","","386.5","","1178338.68"
"2025-02-06","2025-02-01","SF FuneralFDC0000000CLLX250201","","126.5","","1178465.18"
"2025-02-06","2025-02-01","SF FuneralFDC0000000F7JG250201","","126.5","","1178591.68"
"2025-02-06","2025-02-01","SF FuneralF818002       250201","","191.5","","1178783.18"
"2025-02-06","2025-02-01","SF FuneralF1074680      250201","","126.5","","1178909.68"
"2025-02-06","2025-02-01","SF FuneralFDC0000000LG8C250201","","126.5","","1179036.18"
"2025-02-06","2025-02-01","SF FuneralF1108670      250201","","126.5","","1179162.68"
"2025-02-06","2025-02-01","SF FuneralF1110129      250201","","126.5","","1179289.18"
"2025-02-06","2025-02-01","SF FuneralF1122298      250201","","126.5","","1179415.68"
"2025-02-06","2025-02-01","SF FuneralFDC0000000P2JQ250201","","126.5","","1179542.18"
"2025-02-06","2025-02-01","SF FuneralFDC0000000P2JW250201","","126.5","","1179668.68"
"2025-02-06","2025-02-01","SF FuneralFDC0000000PXHG250201","","126.5","","1179795.18"
"2025-02-06","2025-02-01","SF FuneralFDC0000000PXHK250201","","126.5","","1179921.68"
"2025-02-06","2025-02-01","SF FuneralFDC0000000PXHP250201","","126.5","","1180048.18"
"2025-02-06","2025-02-03","SF FuneralFDC00000002W44250202","","220","","1180268.18"
"2025-02-06","2025-02-03","SF FuneralFDC00000003C1B250203","","220","","1180488.18"
"2025-02-06","2025-02-03","SF FuneralFDC000000041PX250202","","220","","1180708.18"
"2025-02-06","2025-02-03","SF FuneralFDC00000004HNC250202","","220","","1180928.18"
"2025-02-06","2025-02-03","SF FuneralFDC00000006DX6250202","","126.5","","1181054.68"
"2025-02-06","2025-02-03","SF FuneralFDC00000007595250202","","126.5","","1181181.18"
"2025-02-06","2025-02-03","SF FuneralFDC000000086B4250203","","126.5","","1181307.68"
"2025-02-06","2025-02-03","SF FuneralFDC00000008P69250203","","126.5","","1181434.18"
"2025-02-06","2025-02-03","SF FuneralF804587       250202","","126.5","","1181560.68"
"2025-02-06","2025-02-03","SF FuneralF809672       250203","","126.5","","1181687.18"
"2025-02-06","2025-02-03","SF FuneralFDC00000009F3K250202","","126.5","","1181813.68"
"2025-02-06","2025-02-03","SF FuneralF832817       250202","","126.5","","1181940.18"
"2025-02-06","2025-02-03","SF FuneralF843017       250201","","126.5","","1182066.68"
"2025-02-06","2025-02-03","SF FuneralF844266       250201","","126.5","","1182193.18"
"2025-02-06","2025-02-03","SF FuneralF988353       250203","","126.5","","1182319.68"
"2025-02-06","2025-02-03","SF FuneralF1113743      250203","","126.5","","1182446.18"
"2025-02-06","2025-02-03","SF FuneralFDC0000000NLRJ250203","","126.5","","1182572.68"
"2025-02-06","2025-02-04","SF FuneralFDC00000002WBH250204","","220","","1182792.68"
"2025-02-06","2025-02-04","SF FuneralFDC0000000353W250204","","220","","1183012.68"
"2025-02-06","2025-02-04","SF FuneralFDC0000000PXPX250204","","126.5","","1183139.18"
"2025-02-06","2025-02-04","SF FuneralF1129151      250204","","126.5","","1183265.68"
"2025-02-06","2025-02-05","SF FuneralFDC000000044KN250205","","220","","1183485.68"
"2025-02-06","2025-02-01","SF FuneralFDC0000000JVCB250202","","31.63","","1183517.31"
"2025-02-06","2025-02-01","SF FuneralFDC0000000KH3D250202","","31.63","","1183548.94"
"2025-02-06","2025-02-01","SF FuneralFDC0000000LNR4250202","","31.63","","1183580.57"
"2025-02-06","2025-02-01","SF FuneralFDC0000000PZBG250202","","31.63","","1183612.2"
"2025-02-06","2025-02-01","SF FuneralFDC0000000PZBK250202","","31.63","","1183643.83"
"2025-02-06","2025-02-03","SF FuneralF814448       250202","","31.63","","1183675.46"
"2025-02-06","2025-02-03","SF FuneralF834650       250202","","31.63","","1183707.09"
"2025-02-06","2025-02-03","SF FuneralF1122727      250203","","31.63","","1183738.72"
"2025-02-06","2025-02-04","SF FuneralF1111731      250204","","31.63","","1183770.35"
"2025-02-06","2025-02-01","SF FuneralFDC0000000PZBL250202","","31.63","","1183801.98"
"2025-02-06","2025-02-01","SF FuneralFDC0000000PZBM250202","","31.63","","1183833.61"
"2025-02-06","2025-02-04","SF FuneralF811401       250204","","31.63","","1183865.24"
"2025-02-06","2025-02-04","SF FuneralF816581       250204","","31.63","","1183896.87"
"2025-02-06","2025-02-01","SF FuneralF1078542      250201","","126.5","","1184023.37"
"2025-02-06","2025-01-29","SF FuneralF900538       250129","","126.5","","1184149.87"
"2025-02-06","2025-02-01","SF FuneralF1079383      250202","","126.5","","1184276.37"
"2025-02-06","2025-02-05","SF FuneralFDC0000000LFXQ250205","","126.5","","1184402.87"
"2025-02-06","2025-02-03","SF FuneralFDC00000007JPM250202","","63.25","","1184466.12"
"2025-02-06","2025-02-01","SF FuneralFDC00000006HZY250201","","126.5","","1184592.62"
"2025-02-06","2025-02-01","SF FuneralF1119757      250202","","126.5","","1184719.12"
"2025-02-06","2025-02-01","SF FuneralF1058813      250201","","126.5","","1184845.62"
"2025-02-06","2025-02-01","SF FuneralF1066521      250201","","126.5","","1184972.12"
"2025-02-06","2025-02-01","SF FuneralF1118621      250201","","126.5","","1185098.62"
"2025-02-06","2025-02-01","SF FuneralF1120274      250201","","126.5","","1185225.12"
"2025-02-06","2025-02-01","SF FuneralF1122651      250201","","126.5","","1185351.62"
"2025-02-06","2025-02-01","SF FuneralF1125945      250201","","126.5","","1185478.12"
"2025-02-06","2025-02-01","SF FuneralFDC0000000PWDW250202","","126.5","","1185604.62"
"2025-02-06","2025-02-01","SF FuneralF1128901      250202","","126.5","","1185731.12"
"2025-02-06","2025-02-01","SF FuneralF1129147      250201","","126.5","","1185857.62"
"2025-02-06","2025-02-04","SF FuneralF1129464      250204","","31.63","","1185889.25"
"2025-02-06","2025-02-04","SF FuneralF810426       250204","","31.63","","1185920.88"
"2025-02-06","2025-02-01","SF FuneralF1021491      250202","","31.63","","1185952.51"
"2025-02-06","2025-02-01","SF FuneralF1072856      250202","","31.63","","1185984.14"
"2025-02-06","2025-02-03","SF FuneralF1120655      250203","","31.63","","1186015.77"
"2025-02-06","2025-02-01","SF FuneralFDC00000006W22250201","","126.5","","1186142.27"
"2025-02-06","2025-02-01","SF FuneralFDC0000000792S250201","","126.5","","1186268.77"
"2025-02-06","2025-02-01","SF FuneralF795662       250201","","126.5","","1186395.27"
"2025-02-06","2025-02-01","SF FuneralF798994       250201","","126.5","","1186521.77"
"2025-02-06","2025-02-01","SF FuneralF783950       250201","","126.5","","1186648.27"
"2025-02-06","2025-02-01","SF FuneralF809680       250201","","126.5","","1186774.77"
"2025-02-06","2025-02-01","SF FuneralF812266       250201","","126.5","","1186901.27"
"2025-02-06","2025-02-01","SF FuneralF812974       250201","","126.5","","1187027.77"
"2025-02-06","2025-02-01","SF FuneralF817036       250201","","126.5","","1187154.27"
"2025-02-06","2025-02-01","SF FuneralF821500       250201","","126.5","","1187280.77"
"2025-02-06","2025-02-01","SF FuneralF829946       250201","","126.5","","1187407.27"
"2025-02-06","2025-02-01","SF FuneralF830531       250201","","126.5","","1187533.77"
"2025-02-06","2025-02-01","SF FuneralF832166       250201","","126.5","","1187660.27"
"2025-02-06","2025-02-01","SF FuneralF832842       250201","","126.5","","1187786.77"
"2025-02-06","2025-02-01","SF FuneralF833056       250201","","126.5","","1187913.27"
"2025-02-06","2025-02-01","SF FuneralF833091       250201","","126.5","","1188039.77"
"2025-02-06","2025-02-01","SF FuneralF992771       250201","","126.5","","1188166.27"
"2025-02-06","2025-02-01","SF FuneralF993322       250202","","126.5","","1188292.77"
"2025-02-06","2025-02-01","SF FuneralF1059301      250201","","126.5","","1188419.27"
"2025-02-06","2025-02-01","SF FuneralF1059339      250201","","126.5","","1188545.77"
"2025-02-06","2025-02-01","SF FuneralF1059713      250201","","126.5","","1188672.27"
"2025-02-06","2025-02-01","SF FuneralF1060493      250201","","126.5","","1188798.77"
"2025-02-06","2025-02-01","SF FuneralF1062683      250202","","126.5","","1188925.27"
"2025-02-06","2025-02-01","SF FuneralF1068116      250201","","126.5","","1189051.77"
"2025-02-06","2025-02-01","SF FuneralF1078452      250201","","126.5","","1189178.27"
"2025-02-06","2025-02-01","SF FuneralF1078980      250201","","126.5","","1189304.77"
"2025-02-06","2025-02-01","SF FuneralF1084553      250201","","126.5","","1189431.27"
"2025-02-06","2025-02-01","SF FuneralF1084677      250201","","126.5","","1189557.77"
"2025-02-06","2025-02-01","SF FuneralFDC0000000LXMD250201","","191.5","","1189749.27"
"2025-02-06","2025-02-01","SF FuneralF1108713      250201","","126.5","","1189875.77"
"2025-02-06","2025-02-01","SF FuneralF1108718      250201","","126.5","","1190002.27"
"2025-02-06","2025-02-01","SF FuneralF1109650      250201","","126.5","","1190128.77"
"2025-02-06","2025-02-01","SF FuneralF1110057      250201","","126.5","","1190255.27"
"2025-02-06","2025-02-01","SF FuneralF1110100      250201","","126.5","","1190381.77"
"2025-02-06","2025-02-01","SF FuneralF1110192      250201","","126.5","","1190508.27"
"2025-02-06","2025-02-01","SF FuneralF1110214      250201","","126.5","","1190634.77"
"2025-02-06","2025-02-01","SF FuneralFDC0000000MN61250201","","126.5","","1190761.27"
"2025-02-06","2025-02-01","SF FuneralF1113287      250201","","126.5","","1190887.77"
"2025-02-06","2025-02-01","SF FuneralF1113740      250201","","126.5","","1191014.27"
"2025-02-06","2025-02-01","SF FuneralF1114367      250201","","126.5","","1191140.77"
"2025-02-06","2025-02-01","SF FuneralF1115131      250201","","126.5","","1191267.27"
"2025-02-06","2025-02-01","SF FuneralF1118015      250201","","126.5","","1191393.77"
"2025-02-06","2025-02-01","SF FuneralF1122640      250201","","126.5","","1191520.27"
"2025-02-06","2025-02-01","SF FuneralF1123004      250201","","126.5","","1191646.77"
"2025-02-06","2025-02-01","SF FuneralF1125005      250202","","126.5","","1191773.27"
"2025-02-06","2025-02-01","SF FuneralF1126056      250201","","126.5","","1191899.77"
"2025-02-06","2025-02-01","SF FuneralFDC0000000PLRZ250201","","126.5","","1192026.27"
"2025-02-06","2025-02-01","SF FuneralFDC0000000PLS2250201","","126.5","","1192152.77"
"2025-02-06","2025-02-01","SF FuneralF1127559      250201","","126.5","","1192279.27"
"2025-02-06","2025-02-01","SF FuneralF1128044      250201","","126.5","","1192405.77"
"2025-02-06","2025-02-01","SF FuneralF1128654      250201","","126.5","","1192532.27"
"2025-02-06","2025-02-01","SF FuneralF1129034      250201","","126.5","","1192658.77"
"2025-02-06","2025-02-01","SF FuneralF1129164      250202","","126.5","","1192785.27"
"2025-02-06","2025-02-01","SF FuneralF1129275      250201","","126.5","","1192911.77"
"2025-02-06","2025-02-01","SF FuneralF1129278      250201","","126.5","","1193038.27"
"2025-02-06","2025-02-01","SF FuneralF1130287      250201","","126.5","","1193164.77"
"2025-02-06","2025-01-29","SF FuneralFDC0000000B988250129","","126.5","","1193291.27"
"2025-02-06","2025-01-29","SF FuneralF832724       250129","","126.5","","1193417.77"
"2025-02-06","2025-01-31","SF FuneralF987032       250201","","126.5","","1193544.27"
"2025-02-06","2025-01-31","SF FuneralF987067       250201","","126.5","","1193670.77"
"2025-02-06","2025-01-31","SF FuneralF987880       250201","","126.5","","1193797.27"
"2025-02-06","2025-01-31","SF FuneralF988968       250201","","126.5","","1193923.77"
"2025-02-06","2025-01-31","SF FuneralF989000       250201","","126.5","","1194050.27"
"2025-02-06","2025-01-31","SF FuneralF991066       250201","","126.5","","1194176.77"
"2025-02-06","2025-02-03","SF FuneralF809759       250203","","63.25","","1194240.02"
"2025-02-06","2025-02-03","SF FuneralF819802       250203","","31.63","","1194271.65"
"2025-02-06","2025-02-03","SF FuneralF843179       250201","","126.5","","1194398.15"
"2025-02-06","2025-02-03","SF FuneralF843666       250201","","126.5","","1194524.65"
"2025-02-06","2025-02-03","SF FuneralF843677       250201","","126.5","","1194651.15"
"2025-02-06","2025-02-03","SF FuneralF901297       250203","","31.63","","1194682.78"
"2025-02-06","2025-02-03","SF FuneralF1033557      250203","","126.5","","1194809.28"
"2025-02-06","2025-02-03","SF FuneralF1066605      250203","","126.5","","1194935.78"
"2025-02-06","2025-02-03","SF FuneralF1066643      250203","","126.5","","1195062.28"
"2025-02-06","2025-02-03","SF FuneralF987001       250203","","126.5","","1195188.78"
"2025-02-06","2025-02-03","SF FuneralF1117317      250203","","126.5","","1195315.28"
"2025-02-06","2025-02-05","SF FuneralFDC00000009XJM250205","","191.5","","1195506.78"
"2025-02-06","2025-01-28","SF FuneralF844602       250128","","63.25","","1195570.03"
"2025-02-06","2025-01-28","SF FuneralF1115181      250128","","63.25","","1195633.28"
"2025-02-06","2025-02-04","SF FuneralFDC00000004CPJ250204","","220","","1195853.28"
"2025-02-06","2025-02-04","SF FuneralF811655       250204","","31.63","","1195884.91"
"2025-02-06","2025-02-04","SF FuneralFDC0000000J23L250204","","31.63","","1195916.54"
"2025-02-06","2025-02-04","SF FuneralF1061590      250204","","126.5","","1196043.04"
"2025-02-06","2025-02-04","SF FuneralF1123207      250204","","126.5","","1196169.54"
"2025-02-06","2025-02-06","SF FuneralF1078865      250206","","47.88","","1196217.42"
"2025-02-06","2025-02-03","SF FuneralFDC00000003591250203","","55","","1196272.42"
"2025-02-06","2025-02-03","SF FuneralFDC00000006NYW250203","","63.25","","1196335.67"
"2025-02-06","2025-02-03","SF FuneralF844264       250201","","126.5","","1196462.17"
"2025-02-06","2025-02-03","SF FuneralF890610       250201","","126.5","","1196588.67"
"2025-02-06","2025-02-03","SF FuneralFDC0000000JCQW250203","","126.5","","1196715.17"
"2025-02-06","2025-02-03","SF FuneralFDC0000000LG54250203","","126.5","","1196841.67"
"2025-02-06","2025-02-03","SF FuneralF1109753      250203","","126.5","","1196968.17"
"2025-02-06","2025-02-03","SF FuneralF1109875      250203","","126.5","","1197094.67"
"2025-02-06","2025-02-03","SF FuneralFDC0000000NG63250203","","126.5","","1197221.17"
"2025-02-06","2025-02-03","SF FuneralF1122918      250203","","126.5","","1197347.67"
"2025-02-06","2025-02-03","SF FuneralF1128685      250203","","126.5","","1197474.17"
"2025-02-06","2025-02-04","SF FuneralF797213       250204","","31.63","","1197505.8"
"2025-02-06","2025-02-04","SF FuneralF804460       250204","","63.25","","1197569.05"
"2025-02-06","2025-02-04","SF FuneralF1073535      250204","","126.5","","1197695.55"
"2025-02-06","2025-02-04","SF FuneralF1073651      250204","","126.5","","1197822.05"
"2025-02-06","2025-02-04","SF FuneralF1078342      250204","","126.5","","1197948.55"
"2025-02-06","2025-02-04","SF FuneralF1115031      250204","","31.63","","1197980.18"
"2025-02-06","2025-02-05","SF FuneralFDC00000006JJK250205","","63.25","","1198043.43"
"2025-02-06","2025-02-05","SF FuneralFDC00000006VR4250205","","63.25","","1198106.68"
"2025-02-06","2025-02-05","SF FuneralF992226       250205","","126.5","","1198233.18"
"2025-02-06","2025-02-05","SF FuneralF993436       250205","","126.5","","1198359.68"
"2025-02-06","2025-01-29","SF FuneralF805407       250129","","126.5","","1198486.18"
"2025-02-06","2025-01-30","SF FuneralF843866       250130","","126.5","","1198612.68"
"2025-02-06","2025-01-31","SF FuneralF901431       250201","","126.5","","1198739.18"
"2025-02-06","2025-01-31","SF FuneralF980309       250201","","126.5","","1198865.68"
"2025-02-06","2025-01-31","SF FuneralF981358       250201","","126.5","","1198992.18"
"2025-02-06","2025-01-31","SF FuneralF987875       250201","","126.5","","1199118.68"
"2025-02-06","2025-01-31","SF FuneralF988667       250201","","126.5","","1199245.18"
"2025-02-06","2025-01-31","SF FuneralF988693       250201","","126.5","","1199371.68"
"2025-02-06","2025-02-01","SF FuneralFDC00000003ZV3250201","","220","","1199591.68"
"2025-02-06","2025-02-01","SF FuneralFDC00000006FXT250201","","126.5","","1199718.18"
"2025-02-06","2025-02-01","SF FuneralFDC00000006MKC250201","","126.5","","1199844.68"
"2025-02-06","2025-02-01","SF FuneralFDC0000000787J250201","","126.5","","1199971.18"
"2025-02-06","2025-02-01","SF FuneralFDC00000007V4R250201","","126.5","","1200097.68"
"2025-02-06","2025-02-01","SF FuneralFDC000000083N4250201","","126.5","","1200224.18"
"2025-02-06","2025-02-01","SF FuneralF814841       250201","","191.5","","1200415.68"
"2025-02-06","2025-02-01","SF FuneralF817151       250201","","126.5","","1200542.18"
"2025-02-06","2025-02-01","SF FuneralF821797       250201","","126.5","","1200668.68"
"2025-02-06","2025-02-01","SF FuneralF828638       250201","","126.5","","1200795.18"
"2025-02-06","2025-02-01","SF FuneralF834977       250201","","126.5","","1200921.68"
"2025-02-06","2025-02-01","SF FuneralF993544       250201","","126.5","","1201048.18"
"2025-02-06","2025-02-01","SF FuneralF1022085      250201","","126.5","","1201174.68"
"2025-02-06","2025-02-01","SF FuneralF1033531      250201","","126.5","","1201301.18"
"2025-02-06","2025-02-01","SF FuneralF1054686      250201","","126.5","","1201427.68"
"2025-02-06","2025-02-01","SF FuneralF1060968      250202","","31.63","","1201459.31"
"2025-02-06","2025-02-01","SF FuneralF1078340      250201","","126.5","","1201585.81"
"2025-02-06","2025-02-01","SF FuneralFDC0000000LFBS250201","","126.5","","1201712.31"
"2025-02-06","2025-02-01","SF FuneralF1084397      250201","","126.5","","1201838.81"
"2025-02-06","2025-02-01","SF FuneralF1084566      250201","","126.5","","1201965.31"
"2025-02-06","2025-02-01","SF FuneralFDC0000000LZSC250201","","126.5","","1202091.81"
"2025-02-06","2025-02-01","SF FuneralFDC0000000M02F250201","","126.5","","1202218.31"
"2025-02-06","2025-02-01","SF FuneralF1110119      250201","","126.5","","1202344.81"
"2025-02-06","2025-02-01","SF FuneralF1110266      250201","","126.5","","1202471.31"
"2025-02-06","2025-02-01","SF FuneralF1110404      250201","","126.5","","1202597.81"
"2025-02-06","2025-02-01","SF FuneralF1111969      250201","","126.5","","1202724.31"
"2025-02-06","2025-02-01","SF FuneralF1114103      250201","","126.5","","1202850.81"
"2025-02-06","2025-02-01","SF FuneralF1117415      250201","","126.5","","1202977.31"
"2025-02-06","2025-02-01","SF FuneralFDC0000000NHKW250201","","126.5","","1203103.81"
"2025-02-06","2025-02-01","SF FuneralF1117719      250201","","126.5","","1203230.31"
"2025-02-06","2025-02-01","SF FuneralF1117992      250201","","126.5","","1203356.81"
"2025-02-06","2025-02-01","SF FuneralF1118165      250201","","126.5","","1203483.31"
"2025-02-06","2025-02-01","SF FuneralF1122858      250201","","126.5","","1203609.81"
"2025-02-06","2025-02-01","SF FuneralF1123486      250201","","126.5","","1203736.31"
"2025-02-06","2025-02-01","SF FuneralFDC0000000PJFW250202","","126.5","","1203862.81"
"2025-02-06","2025-02-01","SF FuneralF1125959      250201","","126.5","","1203989.31"
"2025-02-06","2025-02-01","SF FuneralFDC0000000PJPN250201","","126.5","","1204115.81"
"2025-02-06","2025-02-01","SF FuneralFDC0000000PJPS250201","","126.5","","1204242.31"
"2025-02-06","2025-02-01","SF FuneralF1126008      250202","","126.5","","1204368.81"
"2025-02-06","2025-02-01","SF FuneralF1127102      250201","","126.5","","1204495.31"
"2025-02-06","2025-02-01","SF FuneralF1127609      250201","","126.5","","1204621.81"
"2025-02-06","2025-02-01","SF FuneralFDC0000000PW8R250201","","126.5","","1204748.31"
"2025-02-06","2025-02-01","SF FuneralF1128858      250201","","126.5","","1204874.81"
"2025-02-06","2025-02-01","SF FuneralF1129009      250201","","126.5","","1205001.31"
"2025-02-06","2025-02-01","SF FuneralF1129343      250201","","126.5","","1205127.81"
"2025-02-06","2025-02-01","SF FuneralF1130057      250201","","126.5","","1205254.31"
"2025-02-06","2025-02-06","SF FuneralF814201       250206","","126.5","","1205380.81"
"2025-02-06","2025-01-31","SF FuneralFDC00000006B8Q250131","","31.63","","1205412.44"
"2025-02-06","2025-01-31","SF FuneralFDC00000006B9H250131","","31.63","","1205444.07"
"2025-02-06","2025-01-31","SF FuneralFDC00000006G4Y250131","","31.63","","1205475.7"
"2025-02-06","2025-01-31","SF FuneralFDC00000006M5S250131","","31.63","","1205507.33"
"2025-02-06","2025-01-31","SF FuneralFDC00000006M5X250131","","31.63","","1205538.96"
"2025-02-06","2025-01-31","SF FuneralFDC00000006M5Y250131","","31.63","","1205570.59"
"2025-02-06","2025-01-31","SF FuneralFDC00000006M60250131","","31.63","","1205602.22"
"2025-02-06","2025-01-31","SF FuneralFDC00000006M62250131","","31.63","","1205633.85"
"2025-02-06","2025-01-31","SF FuneralFDC00000007TC1250131","","31.63","","1205665.48"
"2025-02-06","2025-01-31","SF FuneralFDC00000007ZWN250131","","31.63","","1205697.11"
"2025-02-06","2025-01-31","SF FuneralFDC00000007ZWY250131","","31.63","","1205728.74"
"2025-02-06","2025-01-31","SF FuneralF797260       250131","","31.63","","1205760.37"
"2025-02-06","2025-01-31","SF FuneralF805275       250131","","31.63","","1205792"
"2025-02-06","2025-01-31","SF FuneralF805595       250131","","31.63","","1205823.63"
"2025-02-06","2025-01-31","SF FuneralF814064       250131","","31.63","","1205855.26"
"2025-02-06","2025-01-31","SF FuneralFDC0000000BBV2250131","","31.63","","1205886.89"
"2025-02-06","2025-01-31","SF FuneralF821595       250131","","31.63","","1205918.52"
"2025-02-06","2025-01-31","SF FuneralF829859       250131","","31.63","","1205950.15"
"2025-02-06","2025-01-31","SF FuneralF834570       250131","","31.63","","1205981.78"
"2025-02-06","2025-01-31","SF FuneralFDC0000000D37W250131","","31.63","","1206013.41"
"2025-02-06","2025-01-31","SF FuneralFDC0000000DZCH250131","","31.63","","1206045.04"
"2025-02-06","2025-01-31","SF FuneralF988945       250202","","31.63","","1206076.67"
"2025-02-06","2025-01-31","SF FuneralF1033704      250131","","31.63","","1206108.3"
"2025-02-06","2025-01-31","SF FuneralF1074537      250131","","31.63","","1206139.93"
"2025-02-06","2025-01-31","SF FuneralF1110444      250131","","31.63","","1206171.56"
"2025-02-06","2025-02-03","SF FuneralFDC0000000502G250203","","31.63","","1206203.19"
"2025-02-06","2025-02-03","SF FuneralFDC00000005N4P250203","","31.63","","1206234.82"
"2025-02-06","2025-02-03","SF FuneralFDC000000067C7250203","","31.63","","1206266.45"
"2025-02-06","2025-02-03","SF FuneralFDC00000007GFX250202","","31.63","","1206298.08"
"2025-02-06","2025-02-03","SF FuneralFDC00000007GG1250202","","31.63","","1206329.71"
"2025-02-06","2025-02-03","SF FuneralF797906       250203","","31.63","","1206361.34"
"2025-02-06","2025-02-03","SF FuneralFDC00000008MY8250202","","31.63","","1206392.97"
"2025-02-06","2025-02-03","SF FuneralF811324       250203","","112.88","","1206505.85"
"2025-02-06","2025-02-03","SF FuneralF811593       250203","","31.63","","1206537.48"
"2025-02-06","2025-02-03","SF FuneralF802331       250203","","31.63","","1206569.11"
"2025-02-06","2025-02-03","SF FuneralF818028       250203","","31.63","","1206600.74"
"2025-02-06","2025-02-03","SF FuneralFDC0000000F3H4250203","","31.63","","1206632.37"
"2025-02-06","2025-02-03","SF FuneralFDC0000000FCJY250203","","31.63","","1206664"
"2025-02-06","2025-02-03","SF FuneralF988318       250203","","31.63","","1206695.63"
"2025-02-06","2025-02-03","SF FuneralF1068148      250203","","31.63","","1206727.26"
"2025-02-06","2025-02-03","SF FuneralFDC0000000LJ60250203","","31.63","","1206758.89"
"2025-02-06","2025-02-03","SF FuneralF1117412      250203","","31.63","","1206790.52"
"2025-02-06","2025-02-03","SF FuneralF1130901      250203","","31.63","","1206822.15"
"2025-02-06","2025-02-01","SF FuneralFDC0000000MNF7250201","","31.63","","1206853.78"
"2025-02-06","2025-01-28","SF FuneralF823295       250128","","63.25","","1206917.03"
"2025-02-06","2025-01-28","SF FuneralFDC0000000BJSH250128","","63.25","","1206980.28"
"2025-02-06","2025-01-28","SF FuneralF828912       250128","","63.25","","1207043.53"
"2025-02-06","2025-01-28","SF FuneralF830212       250128","","63.25","","1207106.78"
"2025-02-06","2025-01-28","SF FuneralF832692       250128","","126.5","","1207233.28"
"2025-02-06","2025-01-28","SF FuneralF1111373      250128","","63.25","","1207296.53"
"2025-02-06","2025-01-28","SF FuneralF1111732      250128","","63.25","","1207359.78"
"2025-02-06","2025-01-29","SF FuneralF828840       250129","","126.5","","1207486.28"
"2025-02-06","2025-01-29","SF FuneralF833799       250129","","126.5","","1207612.78"
"2025-02-06","2025-01-29","SF FuneralF900691       250129","","126.5","","1207739.28"
"2025-02-06","2025-01-29","SF FuneralF1118080      250129","","126.5","","1207865.78"
"2025-02-06","2025-01-29","SF FuneralF1126215      250129","","126.5","","1207992.28"
"2025-02-06","2025-01-30","SF FuneralFDC00000006H51250130","","126.5","","1208118.78"
"2025-02-06","2025-01-30","SF FuneralFDC00000007BNT250130","","126.5","","1208245.28"
"2025-02-06","2025-01-30","SF FuneralFDC00000007BP4250130","","126.5","","1208371.78"
"2025-02-06","2025-01-30","SF FuneralFDC00000007D3P250130","","126.5","","1208498.28"
"2025-02-06","2025-01-30","SF FuneralFDC0000000J3CL250130","","126.5","","1208624.78"
"2025-02-06","2025-01-30","SF FuneralFDC0000000LVNH250130","","126.5","","1208751.28"
"2025-02-06","2025-02-04","SF FuneralF793715       250204","","31.63","","1208782.91"
"2025-02-06","2025-02-04","SF FuneralFDC00000008C95250204","","31.63","","1208814.54"
"2025-02-06","2025-02-04","SF FuneralFDC00000008JLD250204","","31.63","","1208846.17"
"2025-02-06","2025-02-04","SF FuneralFDC00000008M07250204","","31.63","","1208877.8"
"2025-02-06","2025-02-04","SF FuneralFDC00000008M09250204","","31.63","","1208909.43"
"2025-02-06","2025-02-04","SF FuneralF804949       250204","","31.63","","1208941.06"
"2025-02-06","2025-02-04","SF FuneralF805662       250204","","31.63","","1208972.69"
"2025-02-06","2025-02-04","SF FuneralFDC00000008YCZ250204","","31.63","","1209004.32"
"2025-02-06","2025-02-04","SF FuneralF809823       250204","","31.63","","1209035.95"
"2025-02-06","2025-02-04","SF FuneralF813326       250204","","31.63","","1209067.58"
"2025-02-06","2025-02-04","SF FuneralF813552       250204","","31.63","","1209099.21"
"2025-02-06","2025-02-04","SF FuneralF819196       250204","","31.63","","1209130.84"
"2025-02-06","2025-02-04","SF FuneralF823596       250204","","31.63","","1209162.47"
"2025-02-06","2025-02-04","SF FuneralF832888       250204","","31.63","","1209194.1"
"2025-02-06","2025-02-04","SF FuneralF833515       250204","","31.63","","1209225.73"
"2025-02-06","2025-02-04","SF FuneralF833824       250204","","31.63","","1209257.36"
"2025-02-06","2025-02-04","SF FuneralF833890       250204","","31.63","","1209288.99"
"2025-02-06","2025-02-04","SF FuneralF834645       250204","","31.63","","1209320.62"
"2025-02-06","2025-02-04","SF FuneralF988005       250204","","31.63","","1209352.25"
"2025-02-06","2025-02-04","SF FuneralF989148       250204","","31.63","","1209383.88"
"2025-02-06","2025-02-04","SF FuneralF989519       250204","","31.63","","1209415.51"
"2025-02-06","2025-02-04","SF FuneralF992519       250204","","31.63","","1209447.14"
"2025-02-06","2025-02-04","SF FuneralF1016819      250204","","31.63","","1209478.77"
"2025-02-06","2025-02-04","SF FuneralF1067990      250204","","31.63","","1209510.4"
"2025-02-06","2025-02-04","SF FuneralF1073297      250204","","31.63","","1209542.03"
"2025-02-06","2025-02-04","SF FuneralF1074917      250204","","31.63","","1209573.66"
"2025-02-06","2025-02-04","SF FuneralFDC0000000LK43250204","","31.63","","1209605.29"
"2025-02-06","2025-02-04","SF FuneralF1110634      250204","","31.63","","1209636.92"
"2025-02-06","2025-02-04","SF FuneralF1111742      250204","","31.63","","1209668.55"
"2025-02-06","2025-02-04","SF FuneralF1112349      250204","","31.63","","1209700.18"
"2025-02-06","2025-02-04","SF FuneralFDC0000000N7MN250204","","31.63","","1209731.81"
"2025-02-06","2025-02-04","SF FuneralF1118352      250204","","31.63","","1209763.44"
"2025-02-06","2025-02-04","SF FuneralFDC0000000NRQK250204","","31.63","","1209795.07"
"2025-02-06","2025-02-04","SF FuneralF1122761      250204","","31.63","","1209826.7"
"2025-02-06","2025-02-04","SF FuneralFDC0000000PJX8250204","","31.63","","1209858.33"
"2025-02-06","2025-02-04","SF FuneralF1128998      250204","","31.63","","1209889.96"
"2025-02-06","2025-01-31","SF FuneralFDC000000079LR250131","","126.5","","1210016.46"
"2025-02-06","2025-01-31","SF FuneralF831174       250131","","63.25","","1210079.71"
"2025-02-06","2025-01-31","SF FuneralF901097       250201","","126.5","","1210206.21"
"2025-02-06","2025-01-31","SF FuneralF901099       250201","","126.5","","1210332.71"
"2025-02-06","2025-01-31","SF FuneralF901173       250201","","126.5","","1210459.21"
"2025-02-06","2025-01-31","SF FuneralF901338       250201","","126.5","","1210585.71"
"2025-02-06","2025-01-31","SF FuneralF980437       250201","","126.5","","1210712.21"
"2025-02-06","2025-01-31","SF FuneralF981114       250201","","126.5","","1210838.71"
"2025-02-06","2025-01-31","SF FuneralF981359       250201","","126.5","","1210965.21"
"2025-02-06","2025-01-31","SF FuneralF981554       250201","","126.5","","1211091.71"
"2025-02-06","2025-01-31","SF FuneralFDC0000000HG1M250201","","126.5","","1211218.21"
"2025-02-06","2025-01-31","SF FuneralF987173       250202","","126.5","","1211344.71"
"2025-02-06","2025-01-31","SF FuneralF987914       250201","","126.5","","1211471.21"
"2025-02-06","2025-01-31","SF FuneralF988322       250201","","126.5","","1211597.71"
"2025-02-06","2025-01-31","SF FuneralF988678       250201","","126.5","","1211724.21"
"2025-02-06","2025-01-31","SF FuneralF988788       250201","","126.5","","1211850.71"
"2025-02-06","2025-01-31","SF FuneralF989782       250201","","126.5","","1211977.21"
"2025-02-06","2025-01-31","SF FuneralF990724       250201","","126.5","","1212103.71"
"2025-02-06","2025-01-31","SF FuneralFDC0000000KY2H250131","","63.25","","1212166.96"
"2025-02-06","2025-02-03","SF FuneralFDC00000003DZP250202","","220","","1212386.96"
"2025-02-06","2025-02-03","SF FuneralFDC00000005N79250203","","63.25","","1212450.21"
"2025-02-06","2025-02-03","SF FuneralFDC00000006086250202","","386.5","","1212836.71"
"2025-02-06","2025-02-03","SF FuneralFDC00000006FHL250203","","126.5","","1212963.21"
"2025-02-06","2025-02-03","SF FuneralF793327       250202","","63.25","","1213026.46"
"2025-02-06","2025-02-03","SF FuneralFDC00000007VS3250203","","126.5","","1213152.96"
"2025-02-06","2025-02-03","SF FuneralFDC000000086DL250203","","126.5","","1213279.46"
"2025-02-06","2025-02-03","SF FuneralF800850       250203","","126.5","","1213405.96"
"2025-02-06","2025-02-03","SF FuneralF801619       250203","","126.5","","1213532.46"
"2025-02-06","2025-02-03","SF FuneralF803743       250202","","126.5","","1213658.96"
"2025-02-06","2025-02-03","SF FuneralF809295       250203","","126.5","","1213785.46"
"2025-02-06","2025-02-03","SF FuneralF812315       250203","","63.25","","1213848.71"
"2025-02-06","2025-02-03","SF FuneralF812701       250203","","126.5","","1213975.21"
"2025-02-06","2025-02-03","SF FuneralF813036       250203","","126.5","","1214101.71"
"2025-02-06","2025-02-03","SF FuneralF814587       250203","","63.25","","1214164.96"
"2025-02-06","2025-02-03","SF FuneralF820741       250203","","63.25","","1214228.21"
"2025-02-06","2025-02-03","SF FuneralF821900       250202","","126.5","","1214354.71"
"2025-02-06","2025-02-03","SF FuneralF842990       250201","","126.5","","1214481.21"
"2025-02-06","2025-02-03","SF FuneralF843566       250201","","126.5","","1214607.71"
"2025-02-06","2025-02-03","SF FuneralF843683       250201","","126.5","","1214734.21"
"2025-02-06","2025-02-03","SF FuneralFDC0000000FSQ5250201","","126.5","","1214860.71"
"2025-02-06","2025-02-03","SF FuneralF844330       250201","","126.5","","1214987.21"
"2025-02-06","2025-02-03","SF FuneralF844352       250201","","126.5","","1215113.71"
"2025-02-06","2025-02-03","SF FuneralF844400       250201","","126.5","","1215240.21"
"2025-02-06","2025-02-03","SF FuneralF844466       250201","","126.5","","1215366.71"
"2025-02-06","2025-02-03","SF FuneralF844544       250201","","126.5","","1215493.21"
"2025-02-06","2025-02-03","SF FuneralF844779       250202","","126.5","","1215619.71"
"2025-02-06","2025-02-03","SF FuneralF866947       250203","","126.5","","1215746.21"
"2025-02-06","2025-02-03","SF FuneralFDC0000000GMZ0250202","","126.5","","1215872.71"
"2025-02-06","2025-02-03","SF FuneralF901072       250203","","63.25","","1215935.96"
"2025-02-06","2025-02-03","SF FuneralF992955       250203","","126.5","","1216062.46"
"2025-02-06","2025-02-03","SF FuneralF1052893      250203","","126.5","","1216188.96"
"2025-02-06","2025-02-03","SF FuneralFDC0000000K5M2250203","","126.5","","1216315.46"
"2025-02-06","2025-02-03","SF FuneralF1060981      250203","","63.25","","1216378.71"
"2025-02-06","2025-02-03","SF FuneralF1061516      250203","","63.25","","1216441.96"
"2025-02-06","2025-02-03","SF FuneralF1066715      250203","","126.5","","1216568.46"
"2025-02-06","2025-02-03","SF FuneralF1072961      250203","","63.25","","1216631.71"
"2025-02-06","2025-02-03","SF FuneralF1078316      250203","","126.5","","1216758.21"
"2025-02-06","2025-02-03","SF FuneralF1085169      250203","","126.5","","1216884.71"
"2025-02-06","2025-02-03","SF FuneralFDC0000000M3GP250203","","126.5","","1217011.21"
"2025-02-06","2025-02-03","SF FuneralFDC0000000MGPG250203","","126.5","","1217137.71"
"2025-02-06","2025-02-03","SF FuneralF1110212      250203","","126.5","","1217264.21"
"2025-02-06","2025-02-03","SF FuneralF1113623      250203","","126.5","","1217390.71"
"2025-02-06","2025-02-03","SF FuneralFDC0000000N5DS250203","","126.5","","1217517.21"
"2025-02-06","2025-02-03","SF FuneralF1113897      250203","","126.5","","1217643.71"
"2025-02-06","2025-02-03","SF FuneralFDC0000000N5SP250203","","126.5","","1217770.21"
"2025-02-06","2025-02-03","SF FuneralFDC0000000N6CD250203","","126.5","","1217896.71"
"2025-02-06","2025-02-03","SF FuneralF1118012      250203","","126.5","","1218023.21"
"2025-02-06","2025-02-03","SF FuneralFDC0000000PHYR250203","","126.5","","1218149.71"
"2025-02-06","2025-02-03","SF FuneralF1126148      250203","","126.5","","1218276.21"
"2025-02-06","2025-02-03","SF FuneralF1126171      250203","","126.5","","1218402.71"
"2025-02-06","2025-02-03","SF FuneralF1127788      250203","","126.5","","1218529.21"
"2025-02-06","2025-02-03","SF FuneralF1128235      250203","","126.5","","1218655.71"
"2025-02-06","2025-02-03","SF FuneralF1128360      250203","","126.5","","1218782.21"
"2025-02-06","2025-02-03","SF FuneralF1128819      250203","","126.5","","1218908.71"
"2025-02-06","2025-02-03","SF FuneralFDC0000000PX28250203","","126.5","","1219035.21"
"2025-02-06","2025-02-03","SF FuneralF993966       250203","","126.5","","1219161.71"
"2025-02-06","2025-02-03","SF FuneralF1129035      250203","","126.5","","1219288.21"
"2025-02-06","2025-02-03","SF FuneralF1129167      250203","","126.5","","1219414.71"
"2025-02-06","2025-02-03","SF FuneralF1129451      250203","","126.5","","1219541.21"
"2025-02-06","2025-02-03","SF FuneralFDC0000000Q23M250203","","126.5","","1219667.71"
"2025-02-06","2025-02-03","SF FuneralF1130629      250203","","126.5","","1219794.21"
"2025-02-06","2025-02-06","SF FuneralFDC00000005N6M250206","","31.63","","1219825.84"
"2025-02-06","2025-02-06","SF FuneralFDC00000006ZNM250206","","31.63","","1219857.47"
"2025-02-06","2025-02-06","SF FuneralF805236       250206","","31.63","","1219889.1"
"2025-02-06","2025-02-06","SF FuneralF1124328      250206","","31.63","","1219920.73"
"2025-02-06","2025-02-06","SF FuneralFDC000000074JB250206","","126.5","","1220047.23"
"2025-02-06","2025-02-06","SF FuneralFDC00000007H45250206","","63.25","","1220110.48"
"2025-02-06","2025-02-06","SF FuneralFDC00000007H48250206","","63.25","","1220173.73"
"2025-02-06","2025-02-06","SF FuneralF1124168      250206","","63.25","","1220236.98"
"2025-02-06","2025-02-05","SF FuneralF1123551      250205","","63.25","","1220300.23"
"2025-02-06","2025-02-01","SF FuneralFDC000000048Z6250201","","220","","1220520.23"
"2025-02-06","2025-02-01","SF FuneralFDC00000005JS3250201","","126.5","","1220646.73"
"2025-02-06","2025-02-01","SF FuneralFDC00000005RWW250201","","126.5","","1220773.23"
"2025-02-06","2025-02-01","SF FuneralFDC00000006FKD250201","","126.5","","1220899.73"
"2025-02-06","2025-02-01","SF FuneralFDC00000006G05250201","","126.5","","1221026.23"
"2025-02-06","2025-02-01","SF FuneralFDC00000006G6N250201","","126.5","","1221152.73"
"2025-02-06","2025-02-01","SF FuneralFDC00000006GGQ250201","","126.5","","1221279.23"
"2025-02-06","2025-02-01","SF FuneralFDC00000006GZ4250201","","126.5","","1221405.73"
"2025-02-06","2025-02-01","SF FuneralFDC00000006HTV250201","","126.5","","1221532.23"
"2025-02-06","2025-02-01","SF FuneralFDC00000006HYX250201","","126.5","","1221658.73"
"2025-02-06","2025-02-01","SF FuneralFDC00000006JBD250201","","126.5","","1221785.23"
"2025-02-06","2025-02-01","SF FuneralFDC00000006K9V250201","","126.5","","1221911.73"
"2025-02-06","2025-02-01","SF FuneralFDC00000006LYB250201","","126.5","","1222038.23"
"2025-02-06","2025-02-01","SF FuneralFDC00000006LYC250201","","126.5","","1222164.73"
"2025-02-06","2025-02-01","SF FuneralFDC00000006PVM250201","","126.5","","1222291.23"
"2025-02-06","2025-02-01","SF FuneralFDC00000006QWT250201","","126.5","","1222417.73"
"2025-02-06","2025-02-01","SF FuneralFDC00000006R6J250201","","126.5","","1222544.23"
"2025-02-06","2025-02-01","SF FuneralFDC00000006Y92250201","","126.5","","1222670.73"
"2025-02-06","2025-02-01","SF FuneralFDC0000000751B250201","","126.5","","1222797.23"
"2025-02-06","2025-02-01","SF FuneralFDC000000075JH250201","","126.5","","1222923.73"
"2025-02-06","2025-02-01","SF FuneralFDC000000075SB250201","","126.5","","1223050.23"
"2025-02-06","2025-02-01","SF FuneralFDC0000000788C250201","","126.5","","1223176.73"
"2025-02-06","2025-02-01","SF FuneralFDC00000007924250201","","126.5","","1223303.23"
"2025-02-06","2025-02-01","SF FuneralFDC00000007B7R250201","","126.5","","1223429.73"
"2025-02-06","2025-02-01","SF FuneralFDC00000007C4G250201","","126.5","","1223556.23"
"2025-02-06","2025-02-01","SF FuneralFDC00000007G3P250201","","126.5","","1223682.73"
"2025-02-06","2025-02-01","SF FuneralFDC00000007G3Q250201","","126.5","","1223809.23"
"2025-02-06","2025-02-01","SF FuneralFDC00000007RQB250201","","126.5","","1223935.73"
"2025-02-06","2025-02-01","SF FuneralFDC00000007RXY250201","","126.5","","1224062.23"
"2025-02-06","2025-02-01","SF FuneralFDC00000007SB8250201","","126.5","","1224188.73"
"2025-02-06","2025-02-01","SF FuneralF794717       250201","","126.5","","1224315.23"
"2025-02-06","2025-02-01","SF FuneralFDC00000007TN2250201","","126.5","","1224441.73"
"2025-02-06","2025-02-01","SF FuneralF798655       250201","","126.5","","1224568.23"
"2025-02-06","2025-02-01","SF FuneralF798802       250201","","126.5","","1224694.73"
"2025-02-06","2025-02-01","SF FuneralF801041       250201","","126.5","","1224821.23"
"2025-02-06","2025-02-01","SF FuneralF801189       250201","","126.5","","1224947.73"
"2025-02-06","2025-02-01","SF FuneralF803248       250201","","126.5","","1225074.23"
"2025-02-06","2025-02-01","SF FuneralF803665       250201","","126.5","","1225200.73"
"2025-02-06","2025-02-01","SF FuneralF803690       250201","","126.5","","1225327.23"
"2025-02-06","2025-02-01","SF FuneralF805158       250201","","126.5","","1225453.73"
"2025-02-06","2025-02-01","SF FuneralFDC00000008TZS250201","","126.5","","1225580.23"
"2025-02-06","2025-02-01","SF FuneralF808507       250201","","126.5","","1225706.73"
"2025-02-06","2025-02-01","SF FuneralF812200       250201","","126.5","","1225833.23"
"2025-02-06","2025-02-01","SF FuneralF812614       250201","","126.5","","1225959.73"
"2025-02-06","2025-02-01","SF FuneralF812689       250201","","126.5","","1226086.23"
"2025-02-06","2025-02-01","SF FuneralF812704       250201","","126.5","","1226212.73"
"2025-02-06","2025-02-01","SF FuneralF813190       250201","","126.5","","1226339.23"
"2025-02-06","2025-02-01","SF FuneralF813511       250201","","126.5","","1226465.73"
"2025-02-06","2025-02-01","SF FuneralF814686       250201","","126.5","","1226592.23"
"2025-02-06","2025-02-01","SF FuneralF764504       250201","","220","","1226812.23"
"2025-02-06","2025-02-01","SF FuneralF815401       250201","","126.5","","1226938.73"
"2025-02-06","2025-02-01","SF FuneralF816940       250201","","126.5","","1227065.23"
"2025-02-06","2025-02-01","SF FuneralFDC00000009XBM250201","","126.5","","1227191.73"
"2025-02-06","2025-02-01","SF FuneralF817271       250201","","126.5","","1227318.23"
"2025-02-06","2025-02-01","SF FuneralF818043       250201","","126.5","","1227444.73"
"2025-02-06","2025-02-01","SF FuneralF818728       250201","","126.5","","1227571.23"
"2025-02-06","2025-02-01","SF FuneralF818730       250201","","126.5","","1227697.73"
"2025-02-06","2025-02-01","SF FuneralF818960       250201","","126.5","","1227824.23"
"2025-02-06","2025-02-01","SF FuneralF819874       250201","","126.5","","1227950.73"
"2025-02-06","2025-02-01","SF FuneralF820491       250201","","126.5","","1228077.23"
"2025-02-06","2025-02-01","SF FuneralF820870       250201","","126.5","","1228203.73"
"2025-02-06","2025-02-01","SF FuneralF820882       250201","","126.5","","1228330.23"
"2025-02-06","2025-02-01","SF FuneralF821102       250201","","126.5","","1228456.73"
"2025-02-06","2025-02-01","SF FuneralF821375       250201","","126.5","","1228583.23"
"2025-02-06","2025-02-01","SF FuneralF821478       250201","","126.5","","1228709.73"
"2025-02-06","2025-02-01","SF FuneralF821493       250201","","126.5","","1228836.23"
"2025-02-06","2025-02-01","SF FuneralF822172       250201","","126.5","","1228962.73"
"2025-02-06","2025-02-01","SF FuneralF822505       250201","","126.5","","1229089.23"
"2025-02-06","2025-02-01","SF FuneralF822686       250201","","126.5","","1229215.73"
"2025-02-06","2025-02-01","SF FuneralFDC0000000BHG7250201","","126.5","","1229342.23"
"2025-02-06","2025-02-01","SF FuneralF828602       250201","","126.5","","1229468.73"
"2025-02-06","2025-02-01","SF FuneralF828609       250201","","126.5","","1229595.23"
"2025-02-06","2025-02-01","SF FuneralFDC0000000BQ83250201","","126.5","","1229721.73"
"2025-02-06","2025-02-01","SF FuneralF828717       250201","","126.5","","1229848.23"
"2025-02-06","2025-02-01","SF FuneralF829723       250201","","126.5","","1229974.73"
"2025-02-06","2025-02-01","SF FuneralF829902       250201","","126.5","","1230101.23"
"2025-02-06","2025-02-01","SF FuneralF830554       250201","","126.5","","1230227.73"
"2025-02-06","2025-02-01","SF FuneralF830979       250201","","126.5","","1230354.23"
"2025-02-06","2025-02-01","SF FuneralF832352       250201","","126.5","","1230480.73"
"2025-02-06","2025-02-01","SF FuneralF832883       250201","","126.5","","1230607.23"
"2025-02-06","2025-02-01","SF FuneralF832891       250201","","126.5","","1230733.73"
"2025-02-06","2025-02-01","SF FuneralF833107       250201","","126.5","","1230860.23"
"2025-02-06","2025-02-01","SF FuneralF833360       250201","","126.5","","1230986.73"
"2025-02-06","2025-02-01","SF FuneralF833403       250201","","126.5","","1231113.23"
"2025-02-06","2025-02-01","SF FuneralF833576       250201","","126.5","","1231239.73"
"2025-02-06","2025-02-01","SF FuneralF834158       250201","","126.5","","1231366.23"
"2025-02-06","2025-02-01","SF FuneralF834231       250201","","126.5","","1231492.73"
"2025-02-06","2025-02-01","SF FuneralF834702       250201","","126.5","","1231619.23"
"2025-02-06","2025-02-01","SF FuneralF842028       250201","","126.5","","1231745.73"
"2025-02-06","2025-02-01","SF FuneralF812782       250201","","126.5","","1231872.23"
"2025-02-06","2025-02-01","SF FuneralFDC0000000F5K4250201","","126.5","","1231998.73"
"2025-02-06","2025-02-01","SF FuneralF842697       250201","","126.5","","1232125.23"
"2025-02-06","2025-02-01","SF FuneralF993225       250201","","126.5","","1232251.73"
"2025-02-06","2025-02-01","SF FuneralF993302       250201","","126.5","","1232378.23"
"2025-02-06","2025-02-01","SF FuneralF993413       250201","","126.5","","1232504.73"
"2025-02-06","2025-02-01","SF FuneralF993576       250201","","126.5","","1232631.23"
"2025-02-06","2025-02-01","SF FuneralF993626       250201","","126.5","","1232757.73"
"2025-02-06","2025-02-01","SF FuneralF993776       250201","","126.5","","1232884.23"
"2025-02-06","2025-02-01","SF FuneralFDC0000000JDTD250201","","126.5","","1233010.73"
"2025-02-06","2025-02-01","SF FuneralF994128       250201","","126.5","","1233137.23"
"2025-02-06","2025-02-01","SF FuneralF1021188      250201","","126.5","","1233263.73"
"2025-02-06","2025-02-01","SF FuneralFDC0000000JW95250201","","126.5","","1233390.23"
"2025-02-06","2025-02-01","SF FuneralF1021785      250201","","126.5","","1233516.73"
"2025-02-06","2025-02-01","SF FuneralF1021819      250201","","126.5","","1233643.23"
"2025-02-06","2025-02-01","SF FuneralF1021875      250201","","126.5","","1233769.73"
"2025-02-06","2025-02-01","SF FuneralF1021993      250201","","126.5","","1233896.23"
"2025-02-06","2025-02-01","SF FuneralF1022256      250201","","126.5","","1234022.73"
"2025-02-06","2025-02-01","SF FuneralF1022296      250201","","126.5","","1234149.23"
"2025-02-06","2025-02-01","SF FuneralF1033637      250202","","126.5","","1234275.73"
"2025-02-06","2025-02-01","SF FuneralFDC0000000JZ75250201","","191.5","","1234467.23"
"2025-02-06","2025-02-01","SF FuneralF1052652      250201","","126.5","","1234593.73"
"2025-02-06","2025-02-01","SF FuneralF1052665      250201","","126.5","","1234720.23"
"2025-02-06","2025-02-01","SF FuneralF1052764      250201","","126.5","","1234846.73"
"2025-02-06","2025-02-01","SF FuneralF1054843      250201","","126.5","","1234973.23"
"2025-02-06","2025-02-01","SF FuneralF1059382      250201","","126.5","","1235099.73"
"2025-02-06","2025-02-01","SF FuneralF1059876      250201","","126.5","","1235226.23"
"2025-02-06","2025-02-01","SF FuneralF1060082      250201","","126.5","","1235352.73"
"2025-02-06","2025-02-01","SF FuneralF1060201      250201","","126.5","","1235479.23"
"2025-02-06","2025-02-01","SF FuneralF1060778      250201","","126.5","","1235605.73"
"2025-02-06","2025-02-01","SF FuneralF1065804      250201","","126.5","","1235732.23"
"2025-02-06","2025-02-01","SF FuneralF1066372      250201","","126.5","","1235858.73"
"2025-02-06","2025-02-01","SF FuneralF1066496      250201","","126.5","","1235985.23"
"2025-02-06","2025-02-01","SF FuneralF1066524      250202","","126.5","","1236111.73"
"2025-02-06","2025-02-01","SF FuneralF1066530      250201","","126.5","","1236238.23"
"2025-02-06","2025-02-01","SF FuneralF1066537      250201","","126.5","","1236364.73"
"2025-02-06","2025-02-01","SF FuneralF1066542      250201","","126.5","","1236491.23"
"2025-02-06","2025-02-01","SF FuneralF1066576      250201","","126.5","","1236617.73"
"2025-02-06","2025-02-01","SF FuneralF1066751      250201","","126.5","","1236744.23"
"2025-02-06","2025-02-01","SF FuneralF1067912      250201","","126.5","","1236870.73"
"2025-02-06","2025-02-01","SF FuneralF1068057      250201","","126.5","","1236997.23"
"2025-02-06","2025-02-01","SF FuneralF843717       250201","","126.5","","1237123.73"
"2025-02-06","2025-02-01","SF FuneralF1072704      250201","","126.5","","1237250.23"
"2025-02-06","2025-02-01","SF FuneralF783897       250201","","191.5","","1237441.73"
"2025-02-06","2025-02-01","SF FuneralF1078194      250201","","126.5","","1237568.23"
"2025-02-06","2025-02-01","SF FuneralF1078351      250201","","126.5","","1237694.73"
"2025-02-06","2025-02-01","SF FuneralF900696       250201","","126.5","","1237821.23"
"2025-02-06","2025-02-01","SF FuneralF1078659      250201","","126.5","","1237947.73"
"2025-02-06","2025-02-01","SF FuneralF1078903      250201","","126.5","","1238074.23"
"2025-02-06","2025-02-01","SF FuneralF1078909      250201","","126.5","","1238200.73"
"2025-02-06","2025-02-01","SF FuneralF1078928      250201","","126.5","","1238327.23"
"2025-02-06","2025-02-01","SF FuneralF1078958      250201","","126.5","","1238453.73"
"2025-02-06","2025-02-01","SF FuneralF1079457      250201","","126.5","","1238580.23"
"2025-02-06","2025-02-01","SF FuneralF1079557      250201","","126.5","","1238706.73"
"2025-02-06","2025-02-01","SF FuneralF901506       250201","","126.5","","1238833.23"
"2025-02-06","2025-02-01","SF FuneralF1084533      250201","","126.5","","1238959.73"
"2025-02-06","2025-02-01","SF FuneralF1084764      250201","","126.5","","1239086.23"
"2025-02-06","2025-02-01","SF FuneralF1084889      250201","","126.5","","1239212.73"
"2025-02-06","2025-02-01","SF FuneralF1085019      250201","","126.5","","1239339.23"
"2025-02-06","2025-02-01","SF FuneralF1103178      250202","","126.5","","1239465.73"
"2025-02-06","2025-02-01","SF FuneralF1103778      250201","","126.5","","1239592.23"
"2025-02-06","2025-02-01","SF FuneralF1108423      250201","","126.5","","1239718.73"
"2025-02-06","2025-02-01","SF FuneralF1109632      250201","","126.5","","1239845.23"
"2025-02-06","2025-02-01","SF FuneralFDC0000000MKVL250201","","126.5","","1239971.73"
"2025-02-06","2025-02-01","SF FuneralFDC0000000MLCW250201","","126.5","","1240098.23"
"2025-02-06","2025-02-01","SF FuneralF1110067      250201","","126.5","","1240224.73"
"2025-02-06","2025-02-01","SF FuneralFDC0000000MLY3250201","","126.5","","1240351.23"
"2025-02-06","2025-02-01","SF FuneralF1110204      250201","","126.5","","1240477.73"
"2025-02-06","2025-02-01","SF FuneralF1110493      250201","","126.5","","1240604.23"
"2025-02-06","2025-02-01","SF FuneralF1110543      250201","","126.5","","1240730.73"
"2025-02-06","2025-02-01","SF FuneralFDC0000000MXXW250201","","126.5","","1240857.23"
"2025-02-06","2025-02-01","SF FuneralF1113556      250201","","126.5","","1240983.73"
"2025-02-06","2025-02-01","SF FuneralF1113610      250201","","126.5","","1241110.23"
"2025-02-06","2025-02-01","SF FuneralF1113837      250201","","126.5","","1241236.73"
"2025-02-06","2025-02-01","SF FuneralF1113866      250201","","126.5","","1241363.23"
"2025-02-06","2025-02-01","SF FuneralF1113989      250201","","126.5","","1241489.73"
"2025-02-06","2025-02-01","SF FuneralF774341       250201","","126.5","","1241616.23"
"2025-02-06","2025-02-01","SF FuneralFDC0000000N8H7250201","","126.5","","1241742.73"
"2025-02-06","2025-02-01","SF FuneralF1085003      250202","","126.5","","1241869.23"
"2025-02-06","2025-02-01","SF FuneralF1114830      250201","","126.5","","1241995.73"
"2025-02-06","2025-02-01","SF FuneralFDC0000000NBDB250201","","126.5","","1242122.23"
"2025-02-06","2025-02-01","SF FuneralFDC0000000NBQ9250201","","126.5","","1242248.73"
"2025-02-06","2025-02-01","SF FuneralFDC0000000NH4C250201","","126.5","","1242375.23"
"2025-02-06","2025-02-01","SF FuneralFDC0000000NH50250201","","126.5","","1242501.73"
"2025-02-06","2025-02-01","SF FuneralF1117323      250201","","126.5","","1242628.23"
"2025-02-06","2025-02-01","SF FuneralF1117352      250201","","126.5","","1242754.73"
"2025-02-06","2025-02-01","SF FuneralF1117353      250201","","126.5","","1242881.23"
"2025-02-06","2025-02-01","SF FuneralF1117389      250201","","126.5","","1243007.73"
"2025-02-06","2025-02-01","SF FuneralF1117599      250201","","126.5","","1243134.23"
"2025-02-06","2025-02-01","SF FuneralF1117613      250201","","126.5","","1243260.73"
"2025-02-06","2025-02-01","SF FuneralFDC0000000NL11250201","","126.5","","1243387.23"
"2025-02-06","2025-02-01","SF FuneralF1117647      250201","","126.5","","1243513.73"
"2025-02-06","2025-02-01","SF FuneralF1117705      250201","","126.5","","1243640.23"
"2025-02-06","2025-02-01","SF FuneralFDC0000000NLXM250201","","126.5","","1243766.73"
"2025-02-06","2025-02-01","SF FuneralF1117996      250201","","126.5","","1243893.23"
"2025-02-06","2025-02-01","SF FuneralFDC0000000NM3K250201","","126.5","","1244019.73"
"2025-02-06","2025-02-01","SF FuneralF1118101      250201","","126.5","","1244146.23"
"2025-02-06","2025-02-01","SF FuneralF1118156      250201","","126.5","","1244272.73"
"2025-02-06","2025-02-01","SF FuneralF1118161      250201","","126.5","","1244399.23"
"2025-02-06","2025-02-01","SF FuneralFDC0000000NMPJ250201","","126.5","","1244525.73"
"2025-02-06","2025-02-01","SF FuneralF1118561      250201","","126.5","","1244652.23"
"2025-02-06","2025-02-01","SF FuneralF1118798      250201","","126.5","","1244778.73"
"2025-02-06","2025-02-01","SF FuneralFDC0000000NRDR250201","","126.5","","1244905.23"
"2025-02-06","2025-02-01","SF FuneralF1119699      250201","","126.5","","1245031.73"
"2025-02-06","2025-02-01","SF FuneralF1119702      250201","","126.5","","1245158.23"
"2025-02-06","2025-02-01","SF FuneralF1122299      250202","","126.5","","1245284.73"
"2025-02-06","2025-02-01","SF FuneralF1122330      250201","","126.5","","1245411.23"
"2025-02-06","2025-02-01","SF FuneralF1122352      250201","","126.5","","1245537.73"
"2025-02-06","2025-02-01","SF FuneralF1122386      250201","","126.5","","1245664.23"
"2025-02-06","2025-02-01","SF FuneralF774452       250201","","126.5","","1245790.73"
"2025-02-06","2025-02-01","SF FuneralF1122590      250201","","126.5","","1245917.23"
"2025-02-06","2025-02-01","SF FuneralFDC0000000P1G5250201","","126.5","","1246043.73"
"2025-02-06","2025-02-01","SF FuneralFDC0000000P1HC250201","","126.5","","1246170.23"
"2025-02-06","2025-02-01","SF FuneralF1122756      250201","","126.5","","1246296.73"
"2025-02-06","2025-02-01","SF FuneralF987867       250201","","126.5","","1246423.23"
"2025-02-06","2025-02-01","SF FuneralF1122828      250201","","126.5","","1246549.73"
"2025-02-06","2025-02-01","SF FuneralF1122846      250201","","126.5","","1246676.23"
"2025-02-06","2025-02-01","SF FuneralF1123026      250201","","126.5","","1246802.73"
"2025-02-06","2025-02-01","SF FuneralF1123568      250201","","126.5","","1246929.23"
"2025-02-06","2025-02-01","SF FuneralF1125767      250202","","126.5","","1247055.73"
"2025-02-06","2025-02-01","SF FuneralFDC0000000PJ77250201","","126.5","","1247182.23"
"2025-02-06","2025-02-01","SF FuneralFDC0000000PJ9M250201","","126.5","","1247308.73"
"2025-02-06","2025-02-01","SF FuneralFDC0000000PJ9Y250201","","126.5","","1247435.23"
"2025-02-06","2025-02-01","SF FuneralF1125804      250201","","126.5","","1247561.73"
"2025-02-06","2025-02-01","SF FuneralF1125913      250201","","126.5","","1247688.23"
"2025-02-06","2025-02-01","SF FuneralFDC0000000PJGD250201","","126.5","","1247814.73"
"2025-02-06","2025-02-01","SF FuneralFDC0000000PJGF250201","","126.5","","1247941.23"
"2025-02-06","2025-02-01","SF FuneralF1125932      250201","","126.5","","1248067.73"
"2025-02-06","2025-02-01","SF FuneralF1126135      250201","","126.5","","1248194.23"
"2025-02-06","2025-02-01","SF FuneralF1126120      250201","","126.5","","1248320.73"
"2025-02-06","2025-02-01","SF FuneralF1126161      250201","","126.5","","1248447.23"
"2025-02-06","2025-02-01","SF FuneralF1126241      250201","","126.5","","1248573.73"
"2025-02-06","2025-02-01","SF FuneralF1126812      250201","","126.5","","1248700.23"
"2025-02-06","2025-02-01","SF FuneralF1126853      250201","","126.5","","1248826.73"
"2025-02-06","2025-02-01","SF FuneralF1126855      250201","","126.5","","1248953.23"
"2025-02-06","2025-02-01","SF FuneralF1126898      250201","","126.5","","1249079.73"
"2025-02-06","2025-02-01","SF FuneralF1126915      250202","","126.5","","1249206.23"
"2025-02-06","2025-02-01","SF FuneralF1126949      250201","","126.5","","1249332.73"
"2025-02-06","2025-02-01","SF FuneralF1127409      250201","","126.5","","1249459.23"
"2025-02-06","2025-02-01","SF FuneralF1127510      250201","","126.5","","1249585.73"
"2025-02-06","2025-02-01","SF FuneralF1127822      250201","","126.5","","1249712.23"
"2025-02-06","2025-02-01","SF FuneralF1128248      250201","","126.5","","1249838.73"
"2025-02-06","2025-02-01","SF FuneralF1128250      250201","","126.5","","1249965.23"
"2025-02-06","2025-02-01","SF FuneralF1128702      250201","","126.5","","1250091.73"
"2025-02-06","2025-02-01","SF FuneralFDC0000000PWDX250201","","126.5","","1250218.23"
"2025-02-06","2025-02-01","SF FuneralF1128992      250201","","126.5","","1250344.73"
"2025-02-06","2025-02-01","SF FuneralF1129037      250201","","126.5","","1250471.23"
"2025-02-06","2025-02-01","SF FuneralFDC0000000PXF7250201","","126.5","","1250597.73"
"2025-02-06","2025-02-01","SF FuneralF1129198      250201","","126.5","","1250724.23"
"2025-02-06","2025-02-01","SF FuneralF1129383      250201","","126.5","","1250850.73"
"2025-02-06","2025-02-01","SF FuneralF1130292      250201","","126.5","","1250977.23"
"2025-02-06","2025-02-04","SF FuneralFDC0000000642K250204","","126.5","","1251103.73"
"2025-02-06","2025-02-04","SF FuneralFDC00000006430250204","","126.5","","1251230.23"
"2025-02-06","2025-02-04","SF FuneralF813130       250204","","63.25","","1251293.48"
"2025-02-06","2025-02-04","SF FuneralF814037       250204","","63.25","","1251356.73"
"2025-02-06","2025-02-04","SF FuneralF820830       250204","","63.25","","1251419.98"
"2025-02-06","2025-02-04","SF FuneralF830472       250204","","63.25","","1251483.23"
"2025-02-06","2025-02-04","SF FuneralF830587       250204","","63.25","","1251546.48"
"2025-02-06","2025-02-04","SF FuneralF834979       250204","","63.25","","1251609.73"
"2025-02-06","2025-02-04","SF FuneralF841866       250204","","63.25","","1251672.98"
"2025-02-06","2025-02-04","SF FuneralF842064       250204","","63.25","","1251736.23"
"2025-02-06","2025-02-04","SF FuneralFDC0000000G8FM250204","","278.31","","1252014.54"
"2025-02-06","2025-02-04","SF FuneralF900698       250204","","63.25","","1252077.79"
"2025-02-06","2025-02-04","SF FuneralFDC0000000HG11250204","","63.25","","1252141.04"
"2025-02-06","2025-02-04","SF FuneralF989170       250204","","63.25","","1252204.29"
"2025-02-06","2025-02-04","SF FuneralF989374       250204","","63.25","","1252267.54"
"2025-02-06","2025-02-04","SF FuneralFDC0000000J0D4250204","","63.25","","1252330.79"
"2025-02-06","2025-02-04","SF FuneralF1052673      250204","","63.25","","1252394.04"
"2025-02-06","2025-02-04","SF FuneralF1058712      250204","","126.5","","1252520.54"
"2025-02-06","2025-02-04","SF FuneralF1074818      250204","","63.25","","1252583.79"
"2025-02-06","2025-02-04","SF FuneralF1074821      250204","","63.25","","1252647.04"
"2025-02-06","2025-02-04","SF FuneralF900439       250204","","126.5","","1252773.54"
"2025-02-06","2025-02-04","SF FuneralFDC0000000M17C250204","","386.5","","1253160.04"
"2025-02-06","2025-02-04","SF FuneralF1117303      250204","","63.25","","1253223.29"
"2025-02-06","2025-02-04","SF FuneralFDC0000000P4SX250204","","95.75","","1253319.04"
"2025-02-06","2025-02-04","SF FuneralF1123426      250204","","95.75","","1253414.79"
"2025-02-06","2025-02-04","SF FuneralFDC0000000PVXC250204","","126.5","","1253541.29"
"2025-02-06","2025-02-04","SF FuneralFDC0000000PW5P250204","","126.5","","1253667.79"
"2025-02-06","2025-02-04","SF FuneralFDC0000000PW85250204","","126.5","","1253794.29"
"2025-02-06","2025-02-04","SF FuneralFDC0000000PWZG250204","","126.5","","1253920.79"
"2025-02-06","2025-02-04","SF FuneralFDC0000000PX0F250204","","126.5","","1254047.29"
"2025-02-06","2025-02-04","SF FuneralF1128929      250204","","63.25","","1254110.54"
"2025-02-06","2025-02-04","SF FuneralFDC0000000Q1HZ250204","","95.75","","1254206.29"
"2025-02-06","2025-02-05","SF FuneralF1123944      250205","","31.63","","1254237.92"
"2025-02-06","2025-01-29","SF FuneralFDC00000006QPV250129","","126.5","","1254364.42"
"2025-02-06","2025-01-29","SF FuneralF833196       250129","","126.5","","1254490.92"
"2025-02-06","2025-01-30","SF FuneralFDC000000077TX250130","","126.5","","1254617.42"
"2025-02-06","2025-01-31","SF FuneralFDC00000006QQ8250131","","126.5","","1254743.92"
"2025-02-06","2025-01-31","SF FuneralF901000       250202","","126.5","","1254870.42"
"2025-02-06","2025-01-31","SF FuneralF981319       250201","","126.5","","1254996.92"
"2025-02-06","2025-01-31","SF FuneralF986707       250201","","126.5","","1255123.42"
"2025-02-06","2025-01-31","SF FuneralF987178       250202","","126.5","","1255249.92"
"2025-02-06","2025-01-31","SF FuneralF987841       250201","","126.5","","1255376.42"
"2025-02-06","2025-01-31","SF FuneralF987895       250201","","126.5","","1255502.92"
"2025-02-06","2025-01-31","SF FuneralF987943       250201","","126.5","","1255629.42"
"2025-02-06","2025-01-31","SF FuneralF988297       250201","","126.5","","1255755.92"
"2025-02-06","2025-01-31","SF FuneralF988319       250201","","126.5","","1255882.42"
"2025-02-06","2025-01-31","SF FuneralF988939       250201","","126.5","","1256008.92"
"2025-02-06","2025-01-31","SF FuneralF989224       250201","","126.5","","1256135.42"
"2025-02-06","2025-01-31","SF FuneralF989435       250201","","126.5","","1256261.92"
"2025-02-06","2025-01-31","SF FuneralF989591       250202","","126.5","","1256388.42"
"2025-02-06","2025-01-31","SF FuneralF989915       250201","","126.5","","1256514.92"
"2025-02-06","2025-02-01","SF FuneralFDC00000002WFK250201","","220","","1256734.92"
"2025-02-06","2025-02-01","SF FuneralFDC00000005DQW250201","","191.5","","1256926.42"
"2025-02-06","2025-02-01","SF FuneralFDC00000006DQJ250201","","126.5","","1257052.92"
"2025-02-06","2025-02-01","SF FuneralFDC00000006F3Y250201","","126.5","","1257179.42"
"2025-02-06","2025-02-01","SF FuneralFDC00000006K7X250201","","126.5","","1257305.92"
"2025-02-06","2025-02-01","SF FuneralFDC00000006QWX250201","","126.5","","1257432.42"
"2025-02-06","2025-02-01","SF FuneralFDC00000007QPG250201","","126.5","","1257558.92"
"2025-02-06","2025-02-01","SF FuneralFDC00000007S5B250201","","126.5","","1257685.42"
"2025-02-06","2025-02-01","SF FuneralF798639       250201","","126.5","","1257811.92"
"2025-02-06","2025-02-01","SF FuneralF803544       250201","","126.5","","1257938.42"
"2025-02-06","2025-02-01","SF FuneralF808891       250201","","126.5","","1258064.92"
"2025-02-06","2025-02-01","SF FuneralF809177       250201","","126.5","","1258191.42"
"2025-02-06","2025-02-01","SF FuneralF810197       250201","","126.5","","1258317.92"
"2025-02-06","2025-02-01","SF FuneralF813075       250201","","126.5","","1258444.42"
"2025-02-06","2025-02-01","SF FuneralF816771       250201","","126.5","","1258570.92"
"2025-02-06","2025-02-01","SF FuneralF828503       250201","","126.5","","1258697.42"
"2025-02-06","2025-02-01","SF FuneralF830870       250201","","126.5","","1258823.92"
"2025-02-06","2025-02-01","SF FuneralF1021738      250201","","126.5","","1258950.42"
"2025-02-06","2025-02-01","SF FuneralF1021759      250201","","126.5","","1259076.92"
"2025-02-06","2025-02-01","SF FuneralF1052464      250201","","126.5","","1259203.42"
"2025-02-06","2025-02-01","SF FuneralF1066555      250201","","126.5","","1259329.92"
"2025-02-06","2025-02-01","SF FuneralF1067935      250201","","126.5","","1259456.42"
"2025-02-06","2025-02-01","SF FuneralF1068036      250201","","386.5","","1259842.92"
"2025-02-06","2025-02-01","SF FuneralFDC0000000LDQ0250201","","126.5","","1259969.42"
"2025-02-06","2025-02-01","SF FuneralF1078456      250201","","126.5","","1260095.92"
"2025-02-06","2025-02-01","SF FuneralF1078537      250201","","126.5","","1260222.42"
"2025-02-06","2025-02-01","SF FuneralF1084665      250201","","126.5","","1260348.92"
"2025-02-06","2025-02-01","SF FuneralFDC0000000LXL0250201","","126.5","","1260475.42"
"2025-02-06","2025-02-01","SF FuneralFDC0000000M0ZJ250201","","126.5","","1260601.92"
"2025-02-06","2025-02-01","SF FuneralFDC0000000MNDX250201","","126.5","","1260728.42"
"2025-02-06","2025-02-01","SF FuneralF1111909      250201","","126.5","","1260854.92"
"2025-02-06","2025-02-01","SF FuneralF1113261      250201","","126.5","","1260981.42"
"2025-02-06","2025-02-01","SF FuneralF1113956      250201","","126.5","","1261107.92"
"2025-02-06","2025-02-01","SF FuneralF1114387      250201","","126.5","","1261234.42"
"2025-02-06","2025-02-01","SF FuneralF1117326      250201","","126.5","","1261360.92"
"2025-02-06","2025-02-01","SF FuneralFDC0000000NMK3250201","","126.5","","1261487.42"
"2025-02-06","2025-02-01","SF FuneralFDC0000000P0V7250201","","126.5","","1261613.92"
"2025-02-06","2025-02-01","SF FuneralFDC0000000P0VQ250201","","126.5","","1261740.42"
"2025-02-06","2025-02-01","SF FuneralFDC0000000P0W1250201","","126.5","","1261866.92"
"2025-02-06","2025-02-01","SF FuneralFDC0000000P113250201","","126.5","","1261993.42"
"2025-02-06","2025-02-01","SF FuneralF1122349      250202","","126.5","","1262119.92"
"2025-02-06","2025-02-01","SF FuneralF1122807      250201","","126.5","","1262246.42"
"2025-02-06","2025-02-01","SF FuneralF1123398      250201","","126.5","","1262372.92"
"2025-02-06","2025-02-01","SF FuneralF1123937      250201","","126.5","","1262499.42"
"2025-02-06","2025-02-01","SF FuneralF1123983      250201","","126.5","","1262625.92"
"2025-02-06","2025-02-01","SF FuneralFDC0000000P74R250201","","126.5","","1262752.42"
"2025-02-06","2025-02-01","SF FuneralF1125769      250201","","126.5","","1262878.92"
"2025-02-06","2025-02-01","SF FuneralF1126062      250201","","126.5","","1263005.42"
"2025-02-06","2025-02-01","SF FuneralF1126929      250202","","126.5","","1263131.92"
"2025-02-06","2025-02-01","SF FuneralF1128039      250201","","126.5","","1263258.42"
"2025-02-06","2025-02-01","SF FuneralF1128045      250201","","126.5","","1263384.92"
"2025-02-06","2025-02-01","SF FuneralF1128184      250201","","126.5","","1263511.42"
"2025-02-06","2025-02-01","SF FuneralF1128193      250201","","126.5","","1263637.92"
"2025-02-06","2025-02-01","SF FuneralF1128216      250201","","126.5","","1263764.42"
"2025-02-06","2025-02-01","SF FuneralF1129090      250201","","126.5","","1263890.92"
"2025-02-06","2025-02-01","SF FuneralF1129216      250201","","191.5","","1264082.42"
"2025-02-06","2025-02-01","SF FuneralF1129362      250201","","126.5","","1264208.92"
"2025-02-06","2025-02-01","SF FuneralF1129492      250201","","126.5","","1264335.42"
"2025-02-06","2025-02-01","SF FuneralF1129873      250201","","126.5","","1264461.92"
"2025-02-06","2025-02-03","SF FuneralFDC00000003S1L250203","","55","","1264516.92"
"2025-02-06","2025-02-03","SF FuneralFDC00000005Z3L250203","","31.63","","1264548.55"
"2025-02-06","2025-02-03","SF FuneralFDC00000006GNR250203","","31.63","","1264580.18"
"2025-02-06","2025-02-03","SF FuneralFDC0000000BV0W250203","","63.25","","1264643.43"
"2025-02-06","2025-02-03","SF FuneralF1021004      250203","","31.63","","1264675.06"
"2025-02-06","2025-02-03","SF FuneralF1108536      250203","","126.5","","1264801.56"
"2025-02-06","2025-02-04","SF FuneralFDC00000002Y4M250204","","55","","1264856.56"
"2025-02-06","2025-02-04","SF FuneralFDC00000005P72250204","","63.25","","1264919.81"
"2025-02-06","2025-02-04","SF FuneralF821545       250204","","47.88","","1264967.69"
"2025-02-06","2025-02-04","SF FuneralF990232       250204","","31.63","","1264999.32"
"2025-02-06","2025-02-04","SF FuneralF1108251      250204","","31.63","","1265030.95"
"2025-02-06","2025-02-04","SF FuneralF981451       250204","","31.63","","1265062.58"
"2025-02-06","2025-02-06","SF FuneralFDC00000006CWT250206","","126.5","","1265189.08"
"2025-02-06","2025-02-01","SF FuneralFDC0000000M9BC250201","","126.5","","1265315.58"
"2025-02-06","2024-12-23","Rev SF FuneralF822592       241228","","-126.5","","1265189.08"
"2025-02-06","2025-02-01","Rev SF FuneralFDC00000006HZY250201","","-126.5","","1265062.58"
"2025-02-06","2025-01-06","Rev SF FuneralFDC000000069C5250106","","-31.63","","1265030.95"
"2025-02-06","2025-01-20","Rev SF FuneralFDC000000069C5250120","","-31.63","","1264999.32"
"2025-02-06","2024-12-30","Rev SF FuneralFDC000000069C5241230","","-31.63","","1264967.69"
"2025-02-06","2025-02-03","Rev SF FuneralFDC000000069C5250203","","-31.63","","1264936.06"
"2025-02-06","2024-12-17","Rev SF FuneralFDC000000069C5241216","","-31.63","","1264904.43"
"2025-02-06","2025-02-01","Rev SF FuneralFDC0000000KH3D250202","","-31.63","","1264872.8"
"2025-02-06","2025-02-03","Rev SF FuneralFDC00000005YNL250203","","-55","","1264817.8"
"2025-02-06","2025-02-01","Rev SF FuneralFDC0000000LNR4250202","","-31.63","","1264786.17"
"2025-02-06","2025-02-04","Rev SF FuneralFDC00000005PFJ250204","","-31.63","","1264754.54"
"2025-02-06","2025-01-13","Rev SF FuneralFDC000000069C5250113","","-31.63","","1264722.91"
"2025-02-06","2024-12-09","Rev SF FuneralFDC000000069C5241209","","-31.63","","1264691.28"
"2025-02-06","2025-01-31","Rev SF FuneralFDC00000007ZWN250131","","-31.63","","1264659.65"
"2025-02-06","2025-01-27","Rev SF FuneralFDC000000069C5250127","","-31.63","","1264628.02"
"2025-02-06","2025-01-31","Rev SF FuneralFDC00000006M5X250131","","-31.63","","1264596.39"
"2025-02-06","2025-01-31","Rev SF FuneralFDC00000006M60250131","","-31.63","","1264564.76"
"2025-02-06","2025-01-31","Rev SF FuneralFDC00000006M5S250131","","-31.63","","1264533.13"
"2025-02-06","2025-01-31","Rev SF FuneralFDC00000006M62250131","","-31.63","","1264501.5"
"2025-02-06","2025-01-31","Rev SF FuneralFDC00000006M5Y250131","","-31.63","","1264469.87"
"2025-02-06","2025-02-03","Rev SF FuneralFDC00000005YW3250203","","-31.63","","1264438.24"
"2025-02-06","2024-12-23","Rev SF FuneralFDC000000069C5241223","","-31.63","","1264406.61"
"2025-02-06","2025-02-03","Rev SF FuneralFDC00000007VS3250203","","-126.5","","1264280.11"
"2025-02-06","2025-02-04","Rev SF FuneralFDC00000006S4K250204","","-126.5","","1264153.61"
"2025-02-06","2025-02-04","SF FuneralF993719       250204","","31.63","","1264185.24"
"2025-02-06","2025-02-04","SF FuneralF1061865      250204","","31.63","","1264216.87"
"2025-02-06","2025-02-04","SF FuneralF1114433      250204","","31.63","","1264248.5"
"2025-02-06","2025-02-04","SF FuneralF1127346      250204","","31.63","","1264280.13"
"2025-02-06","2025-01-31","Rev SF FuneralFDC0000000HDST250201","","-126.5","","1264153.63"
"2025-02-06","2025-01-28","SF FuneralFDC0000000BHGP250128","","63.25","","1264216.88"
"2025-02-06","2025-02-03","SF FuneralFDC000000070Z5250202","","31.63","","1264248.51"
"2025-02-06","2025-02-03","SF FuneralF987096       250203","","63.25","","1264311.76"
"2025-02-06","2025-02-03","SF FuneralF1111949      250203","","63.25","","1264375.01"
"2025-02-06","2025-02-03","SF FuneralF1115957      250203","","31.63","","1264406.64"
"2025-02-06","2025-02-05","SF FuneralFDC00000005X1Y250205","","126.5","","1264533.14"
"2025-02-06","2025-02-06","Fee-Teller Transactions","","-11.91","","1264521.23"
"2025-02-06","2025-02-06","Dep-Cash-SFTAP20241102806","","126.5","11.91","1264647.73"
"2025-02-06","2025-01-31","SF FuneralF1079732      250131","","31.63","","1264679.36"
"2025-02-06","2025-02-03","SF FuneralFDC00000005RR8250203","","31.63","","1264710.99"
"2025-02-06","2025-02-03","SF FuneralF830266       250203","","31.63","","1264742.62"
"2025-02-06","2025-02-03","SF FuneralF1128200      250203","","31.63","","1264774.25"
"2025-02-06","2025-02-03","SF FuneralF1129904      250203","","31.63","","1264805.88"
"2025-02-06","2025-02-03","SF FuneralF1124140      250203","","31.63","","1264837.51"
"2025-02-06","2025-02-04","SF FuneralFDC0000000455X250204","","55","","1264892.51"
"2025-02-06","2025-02-04","SF FuneralF1111675      250204","","31.63","","1264924.14"
"2025-02-06","2025-02-04","SF FuneralFDC0000000N8G1250204","","31.63","","1264955.77"
"2025-02-06","2025-02-04","SF FuneralFDC0000000NT58250204","","31.63","","1264987.4"
"2025-02-06","2025-02-05","SF FuneralFDC0000000LG2D250205","","31.63","","1265019.03"
"2025-02-06","2025-02-05","SF FuneralF1078566      250205","","31.63","","1265050.66"
"2025-02-06","2025-02-06","SF FuneralF1123949      250206","","31.63","","1265082.29"
"2025-02-06","2025-02-03","SF FuneralF1128205      250203","","31.63","","1265113.92"
"2025-02-06","2025-02-05","SF FuneralF809260       250205","","63.25","","1265177.17"
"2025-02-06","2025-02-06","SF FuneralF1122718      250206","","31.63","","1265208.8"
"2025-02-06","2025-02-04","SF FuneralF1065982      250204","","31.63","","1265240.43"
"2025-02-06","2025-02-03","SF FuneralF1111332      250203","","31.63","","1265272.06"
"2025-02-06","2025-02-03","SF FuneralF1125487      250203","","31.63","","1265303.69"
"2025-02-06","2025-02-03","SF FuneralF1127505      250203","","31.63","","1265335.32"
"2025-02-06","2025-01-28","SF FuneralF795428       250128","","63.25","","1265398.57"
"2025-02-06","2025-02-01","SF FuneralF1125089      250201","","126.5","","1265525.07"
"2025-02-06","2025-02-04","SF FuneralF993729       250204","","126.5","","1265651.57"
"2025-02-06","2025-02-04","SF FuneralFDC0000000MK76250204","","63.25","","1265714.82"
"2025-02-06","2025-02-04","SF FuneralFDC0000000N8FK250204","","63.25","","1265778.07"
"2025-02-06","2025-01-31","SF FuneralFDC00000008GY4250131","","31.63","","1265809.7"
"2025-02-06","2025-02-03","SF FuneralFDC000000070PX250203","","31.63","","1265841.33"
"2025-02-06","2025-02-03","SF FuneralFDC00000007H6K250203","","31.63","","1265872.96"
"2025-02-06","2025-02-03","SF FuneralF800626       250203","","31.63","","1265904.59"
"2025-02-06","2025-02-03","SF FuneralFDC0000000918Q250203","","47.88","","1265952.47"
"2025-02-06","2025-02-03","SF FuneralF808988       250203","","31.63","","1265984.1"
"2025-02-06","2025-02-03","SF FuneralF843034       250203","","31.63","","1266015.73"
"2025-02-06","2025-02-03","SF FuneralF1017630      250203","","31.63","","1266047.36"
"2025-02-06","2025-02-03","SF FuneralF1117477      250203","","31.63","","1266078.99"
"2025-02-06","2025-02-03","SF FuneralF1125116      250203","","31.63","","1266110.62"
"2025-02-06","2025-02-04","SF FuneralFDC00000005H2H250204","","31.63","","1266142.25"
"2025-02-06","2025-02-04","SF FuneralFDC00000006H1Y250204","","31.63","","1266173.88"
"2025-02-06","2025-02-04","SF FuneralFDC000000088BV250204","","31.63","","1266205.51"
"2025-02-06","2025-02-04","SF FuneralF815955       250204","","31.63","","1266237.14"
"2025-02-06","2025-02-04","SF FuneralF831704       250204","","31.63","","1266268.77"
"2025-02-06","2025-02-04","SF FuneralF1102910      250204","","31.63","","1266300.4"
"2025-02-06","2025-02-04","SF FuneralF1123129      250204","","31.63","","1266332.03"
"2025-02-06","2025-02-04","SF FuneralF1126100      250204","","31.63","","1266363.66"
"2025-02-06","2025-02-05","SF FuneralFDC000000064GW250205","","31.63","","1266395.29"
"2025-02-06","2025-02-05","SF FuneralF844042       250205","","31.63","","1266426.92"
"2025-02-06","2025-01-24","Rev SF FuneralFDC00000006BNS250127","","-126.5","","1266300.42"
"2025-02-06","2025-01-30","Rev SF FuneralFDC0000000PXGC250130","","-126.5","","1266173.92"
"2025-02-06","2025-01-30","Rev SF FuneralFDC00000007BP4250130","","-126.5","","1266047.42"
"2025-02-06","2025-01-30","Rev SF FuneralFDC00000007D3P250130","","-126.5","","1265920.92"
"2025-02-06","2025-01-24","Rev SF FuneralFDC000000087QW250128","","-126.5","","1265794.42"
"2025-02-06","2025-01-22","Rev SF FuneralFDC00000007RJK250122","","-126.5","","1265667.92"
"2025-02-06","2025-02-04","Rev SF FuneralFDC0000000MK76250204","","-63.25","","1265604.67"
"2025-02-06","2024-12-11","Rev SF FuneralF1103753      241225","","-126.5","","1265478.17"
"2025-02-06","2025-02-01","Rev SF FuneralFDC0000000788C250201","","-126.5","","1265351.67"
"2025-02-06","2025-02-01","Rev SF FuneralFDC0000000NLXM250201","","-126.5","","1265225.17"
"2025-02-06","2025-02-01","Rev SF FuneralFDC000000075JH250201","","-126.5","","1265098.67"
"2025-02-06","2025-02-01","Rev SF FuneralFDC00000006G05250201","","-126.5","","1264972.17"
"2025-02-06","2025-02-01","Rev SF FuneralFDC00000006QWT250201","","-126.5","","1264845.67"
"2025-02-06","2025-02-03","Rev SF FuneralFDC0000000FCJY250203","","-31.63","","1264814.04"
"2025-02-06","2025-02-03","Rev SF FuneralFDC00000007GFX250202","","-31.63","","1264782.41"
"2025-02-06","2025-02-03","Rev SF FuneralFDC00000007GG1250202","","-31.63","","1264750.78"
"2025-02-06","2025-02-03","Rev SF FuneralFDC00000007H6K250203","","-31.63","","1264719.15"
"2025-02-06","2025-02-04","Rev SF FuneralFDC00000008365250204","","-31.63","","1264687.52"
"2025-02-06","2025-02-04","Rev SF FuneralFDC0000000N8G1250204","","-31.63","","1264655.89"
"2025-02-06","2025-01-31","Rev SF FuneralFDC00000007TC1250131","","-31.63","","1264624.26"
"2025-02-06","2025-02-04","Rev SF FuneralFDC0000000NRQK250204","","-31.63","","1264592.63"
"2025-02-06","2025-02-05","Rev SF FuneralFDC0000000JB70250205","","-126.5","","1264466.13"
"2025-02-06","2025-01-30","Rev SF FuneralFDC0000000LVNH250130","","-126.5","","1264339.63"
"2025-02-06","2025-02-06","Fee-Teller Transactions","","-11.91","","1264327.72"
"2025-02-06","2025-02-06","Dep-Cash-6809270506080","","126.5","11.91","1264454.22"
"2025-02-06","2025-02-05","SF FuneralF813578       250205","","63.25","","1264517.47"
"2025-02-06","2025-02-03","SF FuneralFDC0000000NNDF250203","","31.63","","1264549.1"
"2025-02-06","2025-01-29","SF FuneralF1102869      250129","","126.5","","1264675.6"
"2025-02-06","2025-02-04","SF FuneralF828892       250204","","63.25","","1264738.85"
"2025-02-06","2025-02-04","SF FuneralFDC0000000HQB5250204","","31.63","","1264770.48"
"2025-02-06","2025-02-04","SF FuneralF1118809      250204","","31.63","","1264802.11"
"2025-02-06","2025-02-04","SF FuneralF1118848      250204","","31.63","","1264833.74"
"2025-02-06","2025-02-04","SF FuneralF1118948      250204","","63.25","","1264896.99"
"2025-02-06","2025-02-05","SF FuneralFDC00000008X5B250205","","31.63","","1264928.62"
"2025-02-06","2025-02-05","SF FuneralF833010       250205","","126.5","","1265055.12"
"2025-02-06","2025-02-03","SF FuneralF823862       250203","","63.25","","1265118.37"
"2025-02-06","2025-02-04","SF FuneralF1068029      250204","","31.63","","1265150"
"2025-02-06","2025-02-04","SF FuneralF1127485      250204","","31.63","","1265181.63"
"2025-02-06","2025-01-28","SF FuneralF809796       250128","","63.25","","1265244.88"
"2025-02-06","2025-02-01","SF FuneralF1129188      250201","","126.5","","1265371.38"
"2025-02-06","2025-02-03","SF FuneralFDC00000005M4T250203","","63.25","","1265434.63"
"2025-02-06","2025-02-03","SF FuneralF1129089      250203","","63.25","","1265497.88"
"2025-02-06","2025-02-04","SF FuneralF796739       250204","","31.63","","1265529.51"
"2025-02-06","2025-02-04","SF FuneralF989212       250204","","63.25","","1265592.76"
"2025-02-06","2025-02-06","SF FuneralFDC00000006TH1250206","","63.25","","1265656.01"
"2025-02-06","2025-02-03","SF FuneralF811084       250203","","63.25","","1265719.26"
"2025-02-06","2025-02-03","SF FuneralF834614       250203","","31.63","","1265750.89"
"2025-02-06","2025-02-03","SF FuneralF844339       250203","","31.63","","1265782.52"
"2025-02-06","2025-02-03","SF FuneralF987492       250203","","31.63","","1265814.15"
"2025-02-06","2025-02-03","SF FuneralF791581       250203","","47.88","","1265862.03"
"2025-02-06","2025-02-03","SF FuneralF1100809      250203","","31.63","","1265893.66"
"2025-02-06","2025-02-03","SF FuneralF1102815      250203","","31.63","","1265925.29"
"2025-02-06","2025-02-03","SF FuneralF1102914      250203","","31.63","","1265956.92"
"2025-02-06","2025-02-03","SF FuneralF1113735      250203","","31.63","","1265988.55"
"2025-02-06","2025-02-01","SF FuneralF1114730      250202","","31.63","","1266020.18"
"2025-02-06","2025-02-01","SF FuneralF1120868      250201","","126.5","","1266146.68"
"2025-02-06","2025-02-03","Rev SF FuneralFDC00000007GXX250202","","-126.5","","1266020.18"
"2025-02-06","2024-12-23","Rev SF FuneralF808607       241223","","-126.5","","1265893.68"
"2025-02-06","2025-01-22","Rev SF FuneralFDC00000006K1J250122","","-126.5","","1265767.18"
"2025-02-06","2025-01-22","Rev SF FuneralFDC00000006K1V250122","","-126.5","","1265640.68"
"2025-02-06","2025-02-06","EFT-EFT DEBIT TRANSFERS 061071","","11262","","1276902.68"
"2025-02-07","2025-02-06","Supreme Refunds","","-25241.07","","1251661.61"
"2025-02-07","2025-02-06","Fee-Txn Notify E-Mail","","-1","","1251660.61"
"2025-02-07","2025-02-06","SF FuneralF1110763      250206","","31.63","","1251692.24"
"2025-02-07","2025-01-29","SF FuneralF820113       250129","","225.75","","1251917.99"
"2025-02-07","2025-01-29","SF FuneralF1020801      250129","","126.5","","1252044.49"
"2025-02-07","2025-02-03","SF FuneralFDC00000006BK1250203","","31.63","","1252076.12"
"2025-02-07","2025-02-03","SF FuneralFDC00000007GXS250203","","31.63","","1252107.75"
"2025-02-07","2025-02-03","SF FuneralFDC000000097F2250203","","63.25","","1252171"
"2025-02-07","2025-02-03","SF FuneralFDC000000097G6250203","","63.25","","1252234.25"
"2025-02-07","2025-02-03","SF FuneralF987157       250203","","63.25","","1252297.5"
"2025-02-07","2025-02-04","SF FuneralFDC000000072SM250204","","31.63","","1252329.13"
"2025-02-07","2025-02-04","SF FuneralFDC0000000776Q250204","","63.25","","1252392.38"
"2025-02-07","2025-02-04","SF FuneralF814465       250204","","31.63","","1252424.01"
"2025-02-07","2025-02-04","SF FuneralF818368       250204","","63.25","","1252487.26"
"2025-02-07","2025-02-04","SF FuneralFDC0000000J8LQ250204","","63.25","","1252550.51"
"2025-02-07","2025-02-04","SF FuneralFDC0000000JCMX250204","","126.5","","1252677.01"
"2025-02-07","2025-02-04","SF FuneralFDC0000000KFFJ250204","","31.63","","1252708.64"
"2025-02-07","2025-02-04","SF FuneralFDC0000000MWP0250204","","63.25","","1252771.89"
"2025-02-07","2025-02-04","SF FuneralF1111979      250204","","63.25","","1252835.14"
"2025-02-07","2025-02-04","SF FuneralF1112152      250204","","31.63","","1252866.77"
"2025-02-07","2025-02-04","SF FuneralF1114513      250204","","31.63","","1252898.4"
"2025-02-07","2025-02-04","SF FuneralF1130277      250204","","31.63","","1252930.03"
"2025-02-07","2025-02-05","SF FuneralFDC00000005V4Z250205","","31.63","","1252961.66"
"2025-02-07","2025-02-05","SF FuneralFDC0000000NR68250205","","63.25","","1253024.91"
"2025-02-07","2025-02-05","SF FuneralF1119016      250205","","95.75","","1253120.66"
"2025-02-07","2025-01-30","SF FuneralF831145       250130","","63.25","","1253183.91"
"2025-02-07","2025-02-01","SF FuneralF813564       250201","","126.5","","1253310.41"
"2025-02-07","2025-02-01","SF FuneralF1016646      250202","","63.25","","1253373.66"
"2025-02-07","2025-02-01","SF FuneralF1111595      250202","","31.63","","1253405.29"
"2025-02-07","2025-02-03","SF FuneralFDC00000004D3N250202","","220","","1253625.29"
"2025-02-07","2025-02-03","SF FuneralFDC00000005GH0250203","","31.63","","1253656.92"
"2025-02-07","2025-02-03","SF FuneralFDC00000005RR7250203","","31.63","","1253688.55"
"2025-02-07","2025-02-03","SF FuneralFDC00000006MPX250203","","126.5","","1253815.05"
"2025-02-07","2025-02-03","SF FuneralFDC000000074Y5250203","","55","","1253870.05"
"2025-02-07","2025-02-03","SF FuneralFDC00000007C9V250203","","63.25","","1253933.3"
"2025-02-07","2025-02-03","SF FuneralF816565       250203","","31.63","","1253964.93"
"2025-02-07","2025-02-03","SF FuneralF827602       250203","","31.63","","1253996.56"
"2025-02-07","2025-02-03","SF FuneralF834044       250203","","31.63","","1254028.19"
"2025-02-07","2025-02-03","SF FuneralF841850       250203","","31.63","","1254059.82"
"2025-02-07","2025-02-03","SF FuneralF843935       250203","","63.25","","1254123.07"
"2025-02-07","2025-02-03","SF FuneralF901184       250203","","31.63","","1254154.7"
"2025-02-07","2025-02-03","SF FuneralF986655       250203","","31.63","","1254186.33"
"2025-02-07","2025-02-03","SF FuneralF990276       250203","","31.63","","1254217.96"
"2025-02-07","2025-02-03","SF FuneralF993678       250203","","31.63","","1254249.59"
"2025-02-07","2025-02-03","SF FuneralF1016810      250203","","31.63","","1254281.22"
"2025-02-07","2025-02-03","SF FuneralF1073049      250203","","31.63","","1254312.85"
"2025-02-07","2025-02-03","SF FuneralF1084032      250203","","31.63","","1254344.48"
"2025-02-07","2025-02-03","SF FuneralF1102887      250203","","31.63","","1254376.11"
"2025-02-07","2025-02-03","SF FuneralF1103852      250203","","63.25","","1254439.36"
"2025-02-07","2025-02-03","SF FuneralFDC0000000ML65250203","","31.63","","1254470.99"
"2025-02-07","2025-02-03","SF FuneralFDC0000000N7Y7250203","","31.63","","1254502.62"
"2025-02-07","2025-02-03","SF FuneralF1115136      250203","","31.63","","1254534.25"
"2025-02-07","2025-02-03","SF FuneralF1118005      250203","","31.63","","1254565.88"
"2025-02-07","2025-02-03","SF FuneralF1123976      250203","","63.25","","1254629.13"
"2025-02-07","2025-02-04","SF FuneralFDC00000003BTC250204","","55","","1254684.13"
"2025-02-07","2025-02-04","SF FuneralFDC00000005LTH250204","","64.5","","1254748.63"
"2025-02-07","2025-02-04","SF FuneralFDC00000005P3L250204","","31.63","","1254780.26"
"2025-02-07","2025-02-04","SF FuneralFDC00000005P3Q250204","","31.63","","1254811.89"
"2025-02-07","2025-02-04","SF FuneralFDC000000079S6250204","","31.63","","1254843.52"
"2025-02-07","2025-02-04","SF FuneralFDC00000007DFS250204","","31.63","","1254875.15"
"2025-02-07","2025-02-04","SF FuneralFDC00000007KLD250204","","31.63","","1254906.78"
"2025-02-07","2025-02-04","SF FuneralFDC00000007ZH7250204","","31.63","","1254938.41"
"2025-02-07","2025-02-04","SF FuneralFDC00000008L2B250204","","63.25","","1255001.66"
"2025-02-07","2025-02-04","SF FuneralF810870       250204","","63.25","","1255064.91"
"2025-02-07","2025-02-04","SF FuneralF827707       250204","","31.63","","1255096.54"
"2025-02-07","2025-02-04","SF FuneralF981761       250204","","63.25","","1255159.79"
"2025-02-07","2025-02-04","SF FuneralFDC0000000J00M250204","","31.63","","1255191.42"
"2025-02-07","2025-02-04","SF FuneralFDC0000000JCZG250204","","63.25","","1255254.67"
"2025-02-07","2025-02-04","SF FuneralFDC0000000K22X250204","","31.63","","1255286.3"
"2025-02-07","2025-02-04","SF FuneralFDC0000000N526250204","","31.63","","1255317.93"
"2025-02-07","2025-02-04","SF FuneralF1118865      250204","","31.63","","1255349.56"
"2025-02-07","2025-02-04","SF FuneralF1123316      250204","","31.63","","1255381.19"
"2025-02-07","2025-02-04","SF FuneralF1123497      250204","","31.63","","1255412.82"
"2025-02-07","2025-02-04","SF FuneralF1125003      250204","","31.63","","1255444.45"
"2025-02-07","2025-02-04","SF FuneralF1127482      250204","","31.63","","1255476.08"
"2025-02-07","2025-02-04","SF FuneralF1127688      250204","","31.63","","1255507.71"
"2025-02-07","2025-02-04","SF FuneralF1127719      250204","","31.63","","1255539.34"
"2025-02-07","2025-02-04","SF FuneralF1128762      250204","","31.63","","1255570.97"
"2025-02-07","2025-02-05","SF FuneralFDC00000007GJV250205","","126.5","","1255697.47"
"2025-02-07","2025-02-05","SF FuneralF823094       250205","","31.63","","1255729.1"
"2025-02-07","2025-02-05","SF FuneralF993615       250205","","126.5","","1255855.6"
"2025-02-07","2025-02-05","SF FuneralF1124144      250205","","31.63","","1255887.23"
"2025-02-07","2025-02-06","SF FuneralFDC00000006P5B250206","","126.5","","1256013.73"
"2025-02-07","2025-01-31","SF FuneralF819674       250202","","31.63","","1256045.36"
"2025-02-07","2025-02-03","SF FuneralF820769       250203","","31.63","","1256076.99"
"2025-02-07","2025-02-03","SF FuneralF1072928      250203","","31.63","","1256108.62"
"2025-02-07","2025-02-03","SF FuneralF1079348      250203","","31.63","","1256140.25"
"2025-02-07","2025-02-03","SF FuneralF1112394      250203","","31.63","","1256171.88"
"2025-02-07","2025-02-03","SF FuneralF1118324      250203","","31.63","","1256203.51"
"2025-02-07","2025-02-04","SF FuneralFDC0000000BMW2250204","","31.63","","1256235.14"
"2025-02-07","2025-02-04","SF FuneralFDC0000000BT1S250204","","31.63","","1256266.77"
"2025-02-07","2025-02-05","SF FuneralF800771       250205","","31.63","","1256298.4"
"2025-02-07","2025-02-05","SF FuneralF1060919      250205","","31.63","","1256330.03"
"2025-02-07","2025-01-31","SF FuneralFDC0000000H5YY250202","","31.63","","1256361.66"
"2025-02-07","2025-02-03","SF FuneralFDC00000004NQM250202","","31.63","","1256393.29"
"2025-02-07","2025-02-03","SF FuneralFDC00000007WVJ250203","","31.63","","1256424.92"
"2025-02-07","2025-02-03","SF FuneralF802251       250203","","31.63","","1256456.55"
"2025-02-07","2025-02-03","SF FuneralF1073218      250203","","31.63","","1256488.18"
"2025-02-07","2025-02-03","SF FuneralF1104295      250203","","31.63","","1256519.81"
"2025-02-07","2025-02-03","SF FuneralF1128005      250203","","31.63","","1256551.44"
"2025-02-07","2025-02-04","SF FuneralFDC00000005R1B250204","","31.63","","1256583.07"
"2025-02-07","2025-02-04","SF FuneralF814180       250204","","31.63","","1256614.7"
"2025-02-07","2025-02-04","SF FuneralF1130942      250204","","31.63","","1256646.33"
"2025-02-07","2025-02-03","SF FuneralF801722       250203","","31.63","","1256677.96"
"2025-02-07","2025-02-03","SF FuneralF1072930      250203","","31.63","","1256709.59"
"2025-02-07","2025-02-04","SF FuneralF821837       250204","","47.88","","1256757.47"
"2025-02-07","2025-02-04","SF FuneralFDC0000000L0TL250204","","31.63","","1256789.1"
"2025-02-07","2025-02-05","SF FuneralF1124171      250205","","31.63","","1256820.73"
"2025-02-07","2025-02-06","SF FuneralFDC00000005P8B250206","","31.63","","1256852.36"
"2025-02-07","2025-02-04","SF FuneralFDC00000007LQC250204","","63.25","","1256915.61"
"2025-02-07","2025-02-04","SF FuneralFDC00000007LTS250204","","63.25","","1256978.86"
"2025-02-07","2025-02-04","SF FuneralFDC0000000BJ3M250204","","63.25","","1257042.11"
"2025-02-07","2025-02-04","SF FuneralF834077       250204","","63.25","","1257105.36"
"2025-02-07","2025-02-04","SF FuneralFDC0000000ML5T250204","","63.25","","1257168.61"
"2025-02-07","2025-02-04","SF FuneralF1111770      250204","","63.25","","1257231.86"
"2025-02-07","2025-02-04","SF FuneralF833912       250204","","63.25","","1257295.11"
"2025-02-07","2025-02-04","SF FuneralF1103986      250204","","31.63","","1257326.74"
"2025-02-07","2025-02-01","SF FuneralF820664       250201","","126.5","","1257453.24"
"2025-02-07","2025-02-01","SF FuneralF1114158      250201","","63.25","","1257516.49"
"2025-02-07","2025-02-03","SF FuneralF813239       250203","","63.25","","1257579.74"
"2025-02-07","2025-02-03","SF FuneralF838867       250203","","63.25","","1257642.99"
"2025-02-07","2025-02-03","SF FuneralF989102       250203","","63.25","","1257706.24"
"2025-02-07","2025-02-03","SF FuneralFDC0000000LJW6250203","","106.66","","1257812.9"
"2025-02-07","2025-02-04","SF FuneralF833247       250204","","63.25","","1257876.15"
"2025-02-07","2025-02-04","SF FuneralF842929       250204","","63.25","","1257939.4"
"2025-02-07","2025-02-04","SF FuneralF994050       250204","","63.25","","1258002.65"
"2025-02-07","2025-02-04","SF FuneralF1103647      250204","","63.25","","1258065.9"
"2025-02-07","2025-02-04","SF FuneralF1065745      250204","","63.25","","1258129.15"
"2025-02-07","2025-01-28","SF FuneralF1115170      250128","","63.25","","1258192.4"
"2025-02-07","2025-02-03","SF FuneralFDC00000007WPC250202","","126.5","","1258318.9"
"2025-02-07","2025-02-03","SF FuneralFDC000000092Y1250203","","63.25","","1258382.15"
"2025-02-07","2025-02-03","SF FuneralFDC0000000931H250203","","63.25","","1258445.4"
"2025-02-07","2025-02-03","SF FuneralF814420       250203","","63.25","","1258508.65"
"2025-02-07","2025-02-03","SF FuneralF820521       250203","","63.25","","1258571.9"
"2025-02-07","2025-02-03","SF FuneralF988900       250203","","95.75","","1258667.65"
"2025-02-07","2025-02-03","SF FuneralF1117683      250203","","63.25","","1258730.9"
"2025-02-07","2025-02-04","SF FuneralFDC00000008T3Y250204","","63.25","","1258794.15"
"2025-02-07","2025-02-04","SF FuneralF828969       250204","","63.25","","1258857.4"
"2025-02-07","2025-02-03","SF FuneralFDC00000005NR4250203","","31.63","","1258889.03"
"2025-02-07","2025-02-03","SF FuneralFDC00000005NT1250203","","31.63","","1258920.66"
"2025-02-07","2025-02-03","SF FuneralF813361       250203","","31.63","","1258952.29"
"2025-02-07","2025-02-03","SF FuneralF815144       250203","","31.63","","1258983.92"
"2025-02-07","2025-02-03","SF FuneralF986911       250203","","31.63","","1259015.55"
"2025-02-07","2025-02-03","SF FuneralF1118957      250203","","31.63","","1259047.18"
"2025-02-07","2025-02-03","SF FuneralF1108848      250203","","31.63","","1259078.81"
"2025-02-07","2025-02-04","SF FuneralFDC00000008CVJ250204","","31.63","","1259110.44"
"2025-02-07","2025-02-04","SF FuneralF802295       250204","","31.63","","1259142.07"
"2025-02-07","2025-02-04","SF FuneralF814063       250204","","31.63","","1259173.7"
"2025-02-07","2025-02-04","SF FuneralF830294       250204","","31.63","","1259205.33"
"2025-02-07","2025-02-04","SF FuneralF841781       250204","","31.63","","1259236.96"
"2025-02-07","2025-02-04","SF FuneralF1066227      250204","","31.63","","1259268.59"
"2025-02-07","2025-02-04","SF FuneralF1126262      250204","","31.63","","1259300.22"
"2025-02-07","2025-02-05","SF FuneralF1123321      250205","","31.63","","1259331.85"
"2025-02-07","2025-02-03","SF FuneralFDC000000063B7250203","","110","","1259441.85"
"2025-02-07","2025-02-03","SF FuneralF830749       250203","","126.5","","1259568.35"
"2025-02-07","2025-02-03","SF FuneralF1067883      250203","","63.25","","1259631.6"
"2025-02-07","2025-02-04","SF FuneralF809291       250204","","63.25","","1259694.85"
"2025-02-07","2025-02-04","SF FuneralF818508       250204","","63.25","","1259758.1"
"2025-02-07","2025-02-04","SF FuneralF821562       250204","","63.25","","1259821.35"
"2025-02-07","2025-01-28","SF FuneralF1117876      250128","","63.25","","1259884.6"
"2025-02-07","2025-02-03","SF FuneralF842252       250203","","63.25","","1259947.85"
"2025-02-07","2025-01-29","SF FuneralFDC0000000NBV2250129","","63.25","","1260011.1"
"2025-02-07","2025-01-29","SF FuneralF1115107      250129","","63.25","","1260074.35"
"2025-02-07","2025-02-01","SF FuneralF1117998      250202","","31.63","","1260105.98"
"2025-02-07","2025-02-01","SF FuneralF1122782      250201","","126.5","","1260232.48"
"2025-02-07","2025-02-04","SF FuneralF989177       250204","","31.63","","1260264.11"
"2025-02-07","2025-02-04","SF FuneralF1021467      250204","","31.63","","1260295.74"
"2025-02-07","2025-02-07","SF FuneralFDC00000007JNH250207","","31.63","","1260327.37"
"2025-02-07","2025-02-07","SF FuneralF797260       250207","","31.63","","1260359"
"2025-02-07","2025-02-07","SF FuneralF829118       250207","","31.63","","1260390.63"
"2025-02-07","2025-02-07","SF FuneralF1078056      250207","","31.63","","1260422.26"
"2025-02-07","2025-02-03","SF FuneralF1123291      250203","","31.63","","1260453.89"
"2025-02-07","2025-02-04","SF FuneralFDC00000007WH2250204","","47.88","","1260501.77"
"2025-02-07","2025-02-04","SF FuneralF1078493      250204","","31.63","","1260533.4"
"2025-02-07","2025-02-04","SF FuneralF1112298      250204","","31.63","","1260565.03"
"2025-02-07","2025-02-04","SF FuneralF1127863      250204","","31.63","","1260596.66"
"2025-02-07","2025-02-07","SF FuneralF843757       250207","","31.63","","1260628.29"
"2025-02-07","2025-02-07","SF FuneralF1079509      250207","","31.63","","1260659.92"
"2025-02-07","2025-02-07","SF FuneralF1079664      250207","","31.63","","1260691.55"
"2025-02-07","2025-02-07","SF FuneralFDC0000000PK3S250207","","31.63","","1260723.18"
"2025-02-07","2025-02-03","SF FuneralF1060944      250203","","31.63","","1260754.81"
"2025-02-07","2025-02-03","SF FuneralF1074954      250203","","31.63","","1260786.44"
"2025-02-07","2025-02-03","SF FuneralF1118416      250203","","31.63","","1260818.07"
"2025-02-07","2025-02-03","SF FuneralF1129452      250203","","31.63","","1260849.7"
"2025-02-07","2025-02-04","SF FuneralFDC00000006SSB250204","","31.63","","1260881.33"
"2025-02-07","2025-02-04","SF FuneralFDC00000006ST9250204","","31.63","","1260912.96"
"2025-02-07","2025-02-04","SF FuneralFDC00000006STJ250204","","31.63","","1260944.59"
"2025-02-07","2025-02-04","SF FuneralFDC00000007FBC250204","","31.63","","1260976.22"
"2025-02-07","2025-02-04","SF FuneralFDC00000007S9L250204","","31.63","","1261007.85"
"2025-02-07","2025-02-04","SF FuneralF811275       250204","","31.63","","1261039.48"
"2025-02-07","2025-02-04","SF FuneralF827761       250204","","31.63","","1261071.11"
"2025-02-07","2025-02-04","SF FuneralF834784       250204","","31.63","","1261102.74"
"2025-02-07","2025-02-04","SF FuneralF986709       250204","","31.63","","1261134.37"
"2025-02-07","2025-02-04","SF FuneralF993770       250204","","31.63","","1261166"
"2025-02-07","2025-02-04","SF FuneralF1020936      250204","","31.63","","1261197.63"
"2025-02-07","2025-02-04","SF FuneralF1066647      250204","","31.63","","1261229.26"
"2025-02-07","2025-02-04","SF FuneralFDC0000000L215250204","","31.63","","1261260.89"
"2025-02-07","2025-02-04","SF FuneralF1073828      250204","","31.63","","1261292.52"
"2025-02-07","2025-02-04","SF FuneralF1074647      250204","","31.63","","1261324.15"
"2025-02-07","2025-02-04","SF FuneralF1079331      250204","","31.63","","1261355.78"
"2025-02-07","2025-02-04","SF FuneralF1084860      250204","","31.63","","1261387.41"
"2025-02-07","2025-02-04","SF FuneralF1124780      250204","","31.63","","1261419.04"
"2025-02-07","2025-02-04","SF FuneralF1126072      250204","","31.63","","1261450.67"
"2025-02-07","2025-02-04","SF FuneralF1126086      250204","","31.63","","1261482.3"
"2025-02-07","2025-02-04","SF FuneralF1127480      250204","","31.63","","1261513.93"
"2025-02-07","2025-02-04","SF FuneralF1127528      250204","","31.63","","1261545.56"
"2025-02-07","2025-02-04","SF FuneralF1129409      250204","","31.63","","1261577.19"
"2025-02-07","2025-02-05","SF FuneralF1120754      250205","","31.63","","1261608.82"
"2025-02-07","2025-02-07","SF FuneralFDC00000005GY1250207","","31.63","","1261640.45"
"2025-02-07","2025-02-07","SF FuneralF805275       250207","","31.63","","1261672.08"
"2025-02-07","2025-02-07","SF FuneralF814064       250207","","31.63","","1261703.71"
"2025-02-07","2025-02-07","SF FuneralF1061782      250207","","31.63","","1261735.34"
"2025-02-07","2025-02-07","SF FuneralF1079691      250207","","31.63","","1261766.97"
"2025-02-07","2025-02-03","SF FuneralFDC0000000HS6H250203","","31.63","","1261798.6"
"2025-02-07","2025-02-03","SF FuneralFDC0000000J02Z250203","","126.5","","1261925.1"
"2025-02-07","2025-02-03","SF FuneralFDC0000000NC01250203","","63.25","","1261988.35"
"2025-02-07","2025-02-03","SF FuneralF1115130      250203","","63.25","","1262051.6"
"2025-02-07","2025-02-03","SF FuneralF1125114      250203","","31.63","","1262083.23"
"2025-02-07","2025-02-03","SF FuneralF1127801      250203","","31.63","","1262114.86"
"2025-02-07","2025-02-04","SF FuneralF814319       250204","","63.25","","1262178.11"
"2025-02-07","2025-02-06","SF FuneralFDC0000000GS5M250206","","126.5","","1262304.61"
"2025-02-07","2025-02-05","SF FuneralF1059424      250205","","31.63","","1262336.24"
"2025-02-07","2025-02-05","SF FuneralF1060723      250205","","126.5","","1262462.74"
"2025-02-07","2025-02-05","SF FuneralF1079269      250205","","31.63","","1262494.37"
"2025-02-07","2025-02-05","SF FuneralF1120815      250205","","31.63","","1262526"
"2025-02-07","2025-02-06","SF FuneralFDC00000005MJG250206","","126.5","","1262652.5"
"2025-02-07","2025-02-04","SF FuneralFDC000000051KX250204","","31.63","","1262684.13"
"2025-02-07","2025-02-04","SF FuneralFDC0000000690Q250204","","31.63","","1262715.76"
"2025-02-07","2025-02-04","SF FuneralF799673       250204","","31.63","","1262747.39"
"2025-02-07","2025-02-04","SF FuneralF801219       250204","","31.63","","1262779.02"
"2025-02-07","2025-02-04","SF FuneralF802169       250204","","31.63","","1262810.65"
"2025-02-07","2025-02-04","SF FuneralF822125       250204","","31.63","","1262842.28"
"2025-02-07","2025-02-04","SF FuneralF827812       250204","","31.63","","1262873.91"
"2025-02-07","2025-02-04","SF FuneralF1075122      250204","","31.63","","1262905.54"
"2025-02-07","2025-02-04","SF FuneralF1083692      250204","","31.63","","1262937.17"
"2025-02-07","2025-02-04","SF FuneralF1110509      250204","","31.63","","1262968.8"
"2025-02-07","2025-02-04","SF FuneralF1124052      250204","","31.63","","1263000.43"
"2025-02-07","2025-02-05","SF FuneralF1110314      250205","","31.63","","1263032.06"
"2025-02-07","2025-02-06","SF FuneralF1016768      250206","","31.63","","1263063.69"
"2025-02-07","2025-02-06","SF FuneralF1109029      250206","","31.63","","1263095.32"
"2025-02-07","2025-02-07","SF FuneralFDC00000007Q48250207","","31.63","","1263126.95"
"2025-02-07","2025-02-07","SF FuneralFDC0000000FQWF250207","","31.63","","1263158.58"
"2025-02-07","2025-02-07","SF FuneralFDC0000000HVXH250208","","31.63","","1263190.21"
"2025-02-07","2025-02-07","SF FuneralFDC0000000K8Y6250207","","31.63","","1263221.84"
"2025-02-07","2025-02-07","SF FuneralF1104243      250207","","31.63","","1263253.47"
"2025-02-07","2025-02-07","SF FuneralF1130222      250207","","31.63","","1263285.1"
"2025-02-07","2025-02-07","SF FuneralF1130338      250207","","31.63","","1263316.73"
"2025-02-07","2025-02-07","SF FuneralF1130684      250207","","31.63","","1263348.36"
"2025-02-07","2025-02-04","SF FuneralFDC000000072H2250204","","63.25","","1263411.61"
"2025-02-07","2025-02-04","SF FuneralF797055       250204","","31.63","","1263443.24"
"2025-02-07","2025-02-04","SF FuneralF844728       250204","","31.63","","1263474.87"
"2025-02-07","2025-02-04","SF FuneralFDC0000000HY0Q250204","","31.63","","1263506.5"
"2025-02-07","2025-02-04","SF FuneralFDC0000000HY0V250204","","31.63","","1263538.13"
"2025-02-07","2025-02-04","SF FuneralF1080165      250204","","31.63","","1263569.76"
"2025-02-07","2025-02-04","SF FuneralFDC0000000ML7D250204","","31.63","","1263601.39"
"2025-02-07","2025-02-04","SF FuneralF1111588      250204","","31.63","","1263633.02"
"2025-02-07","2025-02-04","SF FuneralF1118308      250204","","31.63","","1263664.65"
"2025-02-07","2025-02-04","SF FuneralFDC0000000NN7N250204","","31.63","","1263696.28"
"2025-02-07","2025-02-04","SF FuneralF1120129      250204","","31.63","","1263727.91"
"2025-02-07","2025-02-04","SF FuneralF1121768      250204","","63.25","","1263791.16"
"2025-02-07","2025-02-04","SF FuneralF1123132      250204","","31.63","","1263822.79"
"2025-02-07","2025-02-04","SF FuneralF1129255      250204","","63.25","","1263886.04"
"2025-02-07","2025-02-07","SF FuneralFDC0000000L8NN250207","","31.63","","1263917.67"
"2025-02-07","2025-02-03","SF FuneralF831218       250203","","63.25","","1263980.92"
"2025-02-07","2025-02-03","SF FuneralF843944       250203","","63.25","","1264044.17"
"2025-02-07","2025-02-03","SF FuneralF986985       250203","","63.25","","1264107.42"
"2025-02-07","2025-02-04","SF FuneralF1125287      250204","","63.25","","1264170.67"
"2025-02-07","2025-02-03","SF FuneralF794739       250203","","63.25","","1264233.92"
"2025-02-07","2025-02-03","SF FuneralF801671       250203","","63.25","","1264297.17"
"2025-02-07","2025-02-03","SF FuneralF1075155      250203","","63.25","","1264360.42"
"2025-02-07","2025-02-04","SF FuneralF843810       250204","","63.25","","1264423.67"
"2025-02-07","2025-02-04","SF FuneralF1102904      250204","","63.25","","1264486.92"
"2025-02-07","2025-02-04","SF FuneralF1124763      250204","","63.25","","1264550.17"
"2025-02-07","2025-02-04","SF FuneralF1129030      250204","","63.25","","1264613.42"
"2025-02-07","2025-02-04","SF FuneralF1129043      250204","","63.25","","1264676.67"
"2025-02-07","2025-02-04","SF FuneralF1129384      250204","","63.25","","1264739.92"
"2025-02-07","2025-02-07","SF FuneralFDC000000080KL250207","","126.5","","1264866.42"
"2025-02-07","2025-02-07","SF FuneralF843220       250207","","63.25","","1264929.67"
"2025-02-07","2025-02-07","SF FuneralFDC0000000N8V4250207","","126.5","","1265056.17"
"2025-02-07","2025-02-07","SF FuneralF1123272      250207","","126.5","","1265182.67"
"2025-02-07","2025-02-04","SF FuneralF822295       250204","","63.25","","1265245.92"
"2025-02-07","2025-02-05","SF FuneralFDC000000087RX250205","","126.5","","1265372.42"
"2025-02-07","2025-02-07","SF FuneralFDC0000000729G250207","","126.5","","1265498.92"
"2025-02-07","2025-02-07","SF FuneralFDC000000075L7250207","","63.25","","1265562.17"
"2025-02-07","2025-02-07","SF FuneralFDC00000007W5T250207","","126.5","","1265688.67"
"2025-02-07","2025-02-07","SF FuneralFDC0000000KY6Y250207","","126.5","","1265815.17"
"2025-02-07","2025-02-07","SF FuneralF803505       250207","","31.63","","1265846.8"
"2025-02-07","2025-02-07","SF FuneralFDC0000000L9LD250207","","126.5","","1265973.3"
"2025-02-07","2025-02-07","SF FuneralF1120573      250207","","31.63","","1266004.93"
"2025-02-07","2025-02-03","SF FuneralFDC0000000LGT5250203","","126.5","","1266131.43"
"2025-02-07","2025-02-03","SF FuneralF1078677      250203","","126.5","","1266257.93"
"2025-02-07","2025-02-03","SF FuneralF1123277      250203","","31.63","","1266289.56"
"2025-02-07","2025-02-04","SF FuneralFDC00000002QF4250204","","55","","1266344.56"
"2025-02-07","2025-02-04","SF FuneralF804091       250204","","31.63","","1266376.19"
"2025-02-07","2025-02-04","SF FuneralFDC00000009383250204","","31.63","","1266407.82"
"2025-02-07","2025-02-04","SF FuneralF809963       250204","","126.5","","1266534.32"
"2025-02-07","2025-02-04","SF FuneralF816158       250204","","63.25","","1266597.57"
"2025-02-07","2025-02-04","SF FuneralF991967       250204","","63.25","","1266660.82"
"2025-02-07","2025-02-04","SF FuneralF1078209      250204","","31.63","","1266692.45"
"2025-02-07","2025-02-04","SF FuneralF1118892      250204","","31.63","","1266724.08"
"2025-02-07","2025-02-07","SF FuneralF1127416      250207","","63.25","","1266787.33"
"2025-02-07","2025-02-01","SF FuneralF1084288      250201","","31.63","","1266818.96"
"2025-02-07","2025-02-03","SF FuneralF842916       250203","","63.25","","1266882.21"
"2025-02-07","2025-02-03","SF FuneralF1073127      250203","","31.63","","1266913.84"
"2025-02-07","2025-02-03","SF FuneralF1073862      250203","","31.63","","1266945.47"
"2025-02-07","2025-02-03","SF FuneralF1080529      250203","","31.63","","1266977.1"
"2025-02-07","2025-02-03","SF FuneralF1124114      250203","","31.63","","1267008.73"
"2025-02-07","2025-02-04","SF FuneralFDC00000006SLB250204","","126.5","","1267135.23"
"2025-02-07","2025-02-04","SF FuneralFDC00000007CPB250204","","31.63","","1267166.86"
"2025-02-07","2025-02-04","SF FuneralFDC000000080WH250204","","31.63","","1267198.49"
"2025-02-07","2025-02-04","SF FuneralFDC00000008851250204","","31.63","","1267230.12"
"2025-02-07","2025-02-04","SF FuneralF990255       250204","","31.63","","1267261.75"
"2025-02-07","2025-02-04","SF FuneralF1060950      250204","","31.63","","1267293.38"
"2025-02-07","2025-02-04","SF FuneralF1074649      250204","","31.63","","1267325.01"
"2025-02-07","2025-02-04","SF FuneralF1080286      250204","","31.63","","1267356.64"
"2025-02-07","2025-02-04","SF FuneralF1115105      250204","","31.63","","1267388.27"
"2025-02-07","2025-02-04","SF FuneralF1120768      250204","","63.25","","1267451.52"
"2025-02-07","2025-02-07","SF FuneralFDC0000000628F250207","","31.63","","1267483.15"
"2025-02-07","2025-02-07","SF FuneralFDC00000006P6D250207","","31.63","","1267514.78"
"2025-02-07","2025-02-07","SF FuneralFDC000000087TX250207","","126.5","","1267641.28"
"2025-02-07","2025-02-07","SF FuneralF814074       250207","","31.63","","1267672.91"
"2025-02-07","2025-02-07","SF FuneralF993809       250207","","31.63","","1267704.54"
"2025-02-07","2025-02-04","SF FuneralF831001       250204","","63.25","","1267767.79"
"2025-02-07","2025-02-05","Rev SF FuneralFDC00000005X1Y250205","","-126.5","","1267641.29"
"2025-02-07","2025-01-23","Rev SF FuneralFDC000000083Q9250123","","-126.5","","1267514.79"
"2025-02-07","2025-02-04","Rev SF FuneralFDC00000008TJ6250204","","-126.5","","1267388.29"
"2025-02-07","2025-02-07","Rev SF FuneralFDC0000000N8V4250207","","-126.5","","1267261.79"
"2025-02-07","2025-02-04","Rev SF FuneralFDC000000079S6250204","","-31.63","","1267230.16"
"2025-02-07","2025-01-28","Rev SF FuneralFDC00000007ZH7250128","","-31.63","","1267198.53"
"2025-02-07","2025-02-03","Rev SF FuneralFDC0000000F3H4250203","","-31.63","","1267166.9"
"2025-02-07","2025-02-03","Rev SF FuneralFDC0000000LJ60250203","","-31.63","","1267135.27"
"2025-02-07","2025-02-06","Rev SF FuneralFDC00000005P8B250206","","-31.63","","1267103.64"
"2025-02-07","2025-02-05","Rev SF FuneralFDC0000000LG2D250205","","-31.63","","1267072.01"
"2025-02-07","2025-01-24","Rev SF FuneralF816045       250127","","-126.5","","1266945.51"
"2025-02-07","2025-02-03","SF FuneralFDC00000006XFK250203","","31.63","","1266977.14"
"2025-02-07","2025-02-03","SF FuneralFDC00000006XFM250203","","31.63","","1267008.77"
"2025-02-07","2025-02-04","SF FuneralF800205       250204","","31.63","","1267040.4"
"2025-02-07","2025-02-04","SF FuneralF822587       250204","","31.63","","1267072.03"
"2025-02-07","2025-02-07","SF FuneralF1126874      250207","","31.63","","1267103.66"
"2025-02-07","2025-02-01","SF FuneralF992716       250202","","126.5","","1267230.16"
"2025-02-07","2025-02-01","SF FuneralF993500       250201","","126.5","","1267356.66"
"2025-02-07","2025-02-01","SF FuneralF1113145      250201","","126.5","","1267483.16"
"2025-02-07","2025-02-03","SF FuneralFDC00000009HK1250203","","63.25","","1267546.41"
"2025-02-07","2025-02-03","SF FuneralF830431       250203","","31.63","","1267578.04"
"2025-02-07","2025-02-03","SF FuneralFDC0000000FJ69250202","","256.5","","1267834.54"
"2025-02-07","2025-02-03","SF FuneralF1073425      250203","","31.63","","1267866.17"
"2025-02-07","2025-02-04","SF FuneralFDC00000005NFK250204","","31.63","","1267897.8"
"2025-02-07","2025-02-04","SF FuneralF831226       250204","","31.63","","1267929.43"
"2025-02-07","2025-02-04","SF FuneralF1079430      250204","","63.25","","1267992.68"
"2025-02-07","2025-02-04","SF FuneralF1122605      250204","","31.63","","1268024.31"
"2025-02-07","2025-02-04","SF FuneralF1127395      250204","","63.25","","1268087.56"
"2025-02-07","2025-02-07","SF FuneralF823750       250207","","31.63","","1268119.19"
"2025-02-07","2025-02-07","SF FuneralF841714       250207","","31.63","","1268150.82"
"2025-02-07","2025-02-07","SF FuneralFDC0000000J2Y1250208","","31.63","","1268182.45"
"2025-02-07","2025-02-07","SF FuneralF1022106      250207","","31.63","","1268214.08"
"2025-02-07","2025-02-07","SF FuneralFDC0000000JXK7250207","","31.63","","1268245.71"
"2025-02-07","2025-02-07","SF FuneralF1122941      250207","","31.63","","1268277.34"
"2025-02-07","2025-02-03","SF FuneralFDC00000006Q80250203","","31.63","","1268308.97"
"2025-02-07","2025-02-04","SF FuneralFDC00000006CWD250204","","55","","1268363.97"
"2025-02-07","2025-02-04","SF FuneralF1054618      250204","","31.63","","1268395.6"
"2025-02-07","2025-02-04","SF FuneralF1118693      250204","","63.25","","1268458.85"
"2025-02-07","2025-02-04","SF FuneralF1130346      250204","","31.63","","1268490.48"
"2025-02-07","2025-02-04","SF FuneralF811790       250204","","31.63","","1268522.11"
"2025-02-07","2025-02-04","SF FuneralF818338       250204","","63.25","","1268585.36"
"2025-02-07","2025-02-04","SF FuneralF819158       250204","","31.63","","1268616.99"
"2025-02-07","2025-02-04","SF FuneralF833363       250204","","31.63","","1268648.62"
"2025-02-07","2025-02-04","SF FuneralF1111967      250204","","63.25","","1268711.87"
"2025-02-07","2025-02-04","SF FuneralF1118335      250204","","31.63","","1268743.5"
"2025-02-07","2025-02-04","SF FuneralFDC0000000NTBQ250204","","31.63","","1268775.13"
"2025-02-07","2025-02-04","SF FuneralF1120133      250204","","31.63","","1268806.76"
"2025-02-07","2025-02-04","SF FuneralF1122767      250204","","63.25","","1268870.01"
"2025-02-07","2025-02-04","SF FuneralF1124420      250204","","63.25","","1268933.26"
"2025-02-07","2025-02-06","SF FuneralF1085168      250206","","31.63","","1268964.89"
"2025-02-07","2025-01-31","SF FuneralFDC00000006DH6250131","","126.5","","1269091.39"
"2025-02-07","2025-02-04","SF FuneralFDC000000086NT250204","","126.5","","1269217.89"
"2025-02-07","2025-02-04","SF FuneralF810630       250204","","63.25","","1269281.14"
"2025-02-07","2025-02-04","SF FuneralF798602       250204","","63.25","","1269344.39"
"2025-02-07","2025-02-04","SF FuneralF833229       250204","","63.25","","1269407.64"
"2025-02-07","2025-02-04","SF FuneralFDC0000000HTVZ250204","","63.25","","1269470.89"
"2025-02-07","2025-02-04","SF FuneralF991505       250204","","63.25","","1269534.14"
"2025-02-07","2025-02-04","SF FuneralF1066639      250204","","126.5","","1269660.64"
"2025-02-07","2025-02-04","SF FuneralF1078543      250204","","63.25","","1269723.89"
"2025-02-07","2025-02-04","SF FuneralF1078560      250204","","63.25","","1269787.14"
"2025-02-07","2025-02-04","SF FuneralF1129103      250204","","31.63","","1269818.77"
"2025-02-07","2025-02-07","Fee-Teller Transactions","","-11.91","","1269806.86"
"2025-02-07","2025-02-07","Dep-Cash-6211125651080","","126.5","11.91","1269933.36"
"2025-02-07","2025-02-07","Fee-Teller Transactions","","-11.91","","1269921.45"
"2025-02-07","2025-02-07","Dep-Cash-6010245805083","","126.5","11.91","1270047.95"
"2025-02-07","2025-02-07","Fee-Teller Transactions","","-11.91","","1270036.04"
"2025-02-07","2025-02-07","Dep-Cash-6010245805083","","126.5","11.91","1270162.54"
"2025-02-07","2025-02-07","Fee-Teller Transactions","","-11.91","","1270150.63"
"2025-02-07","2025-02-07","Dep-Cash-6010245805083","","126.5","11.91","1270277.13"
"2025-02-07","2025-01-29","Rev SF FuneralFDC000000073PX250129","","-126.5","","1270150.63"
"2025-02-07","2025-02-04","SF FuneralF1067949      250204","","126.5","","1270277.13"
"2025-02-07","2025-02-04","SF FuneralF1067978      250204","","31.63","","1270308.76"
"2025-02-07","2025-02-01","SF FuneralFDC00000002W28250201","","220","","1270528.76"
"2025-02-07","2025-02-01","SF FuneralF993094       250201","","126.5","","1270655.26"
"2025-02-07","2025-02-01","SF FuneralFDC0000000P51F250202","","95.75","","1270751.01"
"2025-02-07","2025-02-03","SF FuneralF986862       250203","","63.25","","1270814.26"
"2025-02-07","2025-02-04","SF FuneralF1121999      250204","","63.25","","1270877.51"
"2025-02-07","2025-02-04","SF FuneralFDC00000003V68250204","","55","","1270932.51"
"2025-02-07","2025-02-04","SF FuneralFDC00000005X2M250204","","31.63","","1270964.14"
"2025-02-07","2025-02-04","SF FuneralF991480       250204","","31.63","","1270995.77"
"2025-02-07","2025-02-04","SF FuneralF1066029      250204","","31.63","","1271027.4"
"2025-02-07","2025-02-04","SF FuneralF1079178      250204","","31.63","","1271059.03"
"2025-02-07","2025-02-04","SF FuneralF1118338      250204","","31.63","","1271090.66"
"2025-02-07","2025-02-04","SF FuneralF1118471      250204","","31.63","","1271122.29"
"2025-02-07","2025-02-07","SF FuneralF847452       250207","","31.63","","1271153.92"
"2025-02-07","2025-02-07","SF FuneralF1033704      250207","","31.63","","1271185.55"
"2025-02-07","2025-02-04","SF FuneralF989085       250204","","31.63","","1271217.18"
"2025-02-07","2025-02-04","SF FuneralF1112534      250204","","63.25","","1271280.43"
"2025-02-07","2025-02-04","SF FuneralF1113963      250204","","31.63","","1271312.06"
"2025-02-07","2025-02-03","SF FuneralFDC00000005NWL250203","","31.63","","1271343.69"
"2025-02-07","2025-02-03","SF FuneralFDC00000005NX7250203","","31.63","","1271375.32"
"2025-02-07","2025-02-04","SF FuneralF1052659      250204","","31.63","","1271406.95"
"2025-02-07","2025-02-04","SF FuneralFDC0000000CY56250204","","31.63","","1271438.58"
"2025-02-07","2025-02-04","SF FuneralF993778       250204","","63.25","","1271501.83"
"2025-02-07","2025-02-03","SF FuneralFDC00000007F83250202","","126.5","","1271628.33"
"2025-02-07","2025-02-03","SF FuneralF989598       250203","","63.25","","1271691.58"
"2025-02-07","2025-02-03","SF FuneralF1111352      250203","","63.25","","1271754.83"
"2025-02-07","2025-02-03","SF FuneralFDC0000000N77J250203","","126.5","","1271881.33"
"2025-02-07","2025-02-04","SF FuneralFDC00000006MV3250204","","63.25","","1271944.58"
"2025-02-07","2025-02-04","SF FuneralFDC000000078FZ250204","","31.63","","1271976.21"
"2025-02-07","2025-02-04","SF FuneralFDC00000007CY2250204","","63.25","","1272039.46"
"2025-02-07","2025-02-04","SF FuneralF798676       250204","","31.63","","1272071.09"
"2025-02-07","2025-02-04","SF FuneralF815933       250204","","63.25","","1272134.34"
"2025-02-07","2025-02-04","SF FuneralF820929       250204","","31.63","","1272165.97"
"2025-02-07","2025-02-04","SF FuneralF822306       250204","","63.25","","1272229.22"
"2025-02-07","2025-02-04","SF FuneralF823292       250204","","63.25","","1272292.47"
"2025-02-07","2025-02-04","SF FuneralF987466       250204","","63.25","","1272355.72"
"2025-02-07","2025-02-04","SF FuneralF988932       250204","","63.25","","1272418.97"
"2025-02-07","2025-02-04","SF FuneralF991415       250204","","31.63","","1272450.6"
"2025-02-07","2025-02-04","SF FuneralF1020608      250204","","31.63","","1272482.23"
"2025-02-07","2025-02-04","SF FuneralF1079259      250204","","31.63","","1272513.86"
"2025-02-07","2025-02-04","SF FuneralF1116010      250204","","31.63","","1272545.49"
"2025-02-07","2025-02-04","SF FuneralF1123402      250204","","63.25","","1272608.74"
"2025-02-07","2025-02-07","SF FuneralF740157       250207","","220","","1272828.74"
"2025-02-07","2025-02-04","SF FuneralFDC00000006QTN250204","","31.63","","1272860.37"
"2025-02-07","2025-02-04","SF FuneralF1062646      250204","","31.63","","1272892"
"2025-02-07","2025-02-04","SF FuneralFDC0000000LVMD250204","","31.63","","1272923.63"
"2025-02-07","2025-02-04","SF FuneralF1084842      250204","","31.63","","1272955.26"
"2025-02-07","2025-02-04","SF FuneralF1113987      250204","","31.63","","1272986.89"
"2025-02-07","2025-02-07","Fee-Txn Notify E-Mail","","-1","","1272985.89"
"2025-02-07","2025-02-07","Fee-Txn Notify E-Mail","","-1","","1272984.89"
"2025-02-07","2025-02-07","Rev SF FuneralFDC0000000729G250207","","-126.5","","1272858.39"
"2025-02-07","2025-01-13","Rev SF FuneralFDC0000000HZN0250113","","-63.25","","1272795.14"
"2025-02-07","2025-02-01","Rev SF FuneralFDC0000000PJ77250201","","-126.5","","1272668.64"
"2025-02-07","2025-01-24","Rev SF FuneralF842458       250127","","-126.5","","1272542.14"
"2025-02-07","2025-02-07","Rev SF FuneralFDC0000000JXK7250207","","-31.63","","1272510.51"
"2025-02-07","2025-02-07","Rev SF FuneralFDC0000000PK3S250207","","-31.63","","1272478.88"
"2025-02-07","2025-02-04","Rev SF FuneralFDC00000006ST9250204","","-31.63","","1272447.25"
"2025-02-07","2025-02-04","Rev SF FuneralFDC00000006STJ250204","","-31.63","","1272415.62"
"2025-02-07","2025-02-03","Rev SF FuneralFDC00000005NT1250203","","-31.63","","1272383.99"
"2025-02-07","2025-02-07","Rev SF FuneralFDC000000080KL250207","","-126.5","","1272257.49"
"2025-02-07","2025-01-22","Rev SF FuneralFDC000000094FC250122","","-126.5","","1272130.99"
"2025-02-07","2025-02-01","Rev SF FuneralFDC0000000751B250201","","-126.5","","1272004.49"
"2025-02-07","2025-02-03","Rev SF FuneralFDC0000000Q23M250203","","-126.5","","1271877.99"
"2025-02-07","2025-01-24","Rev SF FuneralFDC000000032G9250127","","-220","","1271657.99"
"2025-02-07","2025-02-04","Rev SF FuneralFDC0000000BJ3M250204","","-63.25","","1271594.74"
"2025-02-07","2024-12-11","Rev SF FuneralFDC00000006W0Z241213","","-126.5","","1271468.24"
"2025-02-07","2025-02-06","Rev SF FuneralFDC0000000GS5M250206","","-126.5","","1271341.74"
"2025-02-07","2025-01-27","Rev SF FuneralFDC0000000HZN0250127","","-63.25","","1271278.49"
"2025-02-07","2025-02-01","Rev SF FuneralFDC000000086MP250201","","-126.5","","1271151.99"
"2025-02-07","2025-02-01","Rev SF FuneralFDC000000086MQ250201","","-126.5","","1271025.49"
"2025-02-07","2025-02-04","SF FuneralFDC0000000N7JJ250204","","63.25","","1271088.74"
"2025-02-07","2025-02-04","SF FuneralFDC000000030DF250204","","55","","1271143.74"
"2025-02-07","2025-02-04","SF FuneralFDC000000061YD250204","","31.63","","1271175.37"
"2025-02-07","2025-02-04","SF FuneralF1033965      250204","","63.25","","1271238.62"
"2025-02-07","2025-02-05","SF FuneralF819111       250205","","31.63","","1271270.25"
"2025-02-07","2025-02-01","SF FuneralF793454       250201","","126.5","","1271396.75"
"2025-02-07","2025-02-03","SF FuneralFDC00000007FPS250203","","31.63","","1271428.38"
"2025-02-07","2025-02-04","SF FuneralFDC00000005P4K250204","","31.63","","1271460.01"
"2025-02-07","2025-02-04","SF FuneralF827810       250204","","63.25","","1271523.26"
"2025-02-07","2025-02-04","SF FuneralF830037       250204","","63.25","","1271586.51"
"2025-02-07","2025-02-04","SF FuneralF828946       250204","","63.25","","1271649.76"
"2025-02-07","2025-02-04","SF FuneralF1118898      250204","","63.25","","1271713.01"
"2025-02-07","2025-02-04","SF FuneralF1129006      250204","","31.63","","1271744.64"
"2025-02-07","2025-02-04","SF FuneralF806032       250204","","31.63","","1271776.27"
"2025-02-07","2025-02-04","SF FuneralF809435       250204","","31.63","","1271807.9"
"2025-02-07","2025-02-04","SF FuneralF829557       250204","","31.63","","1271839.53"
"2025-02-07","2025-02-04","SF FuneralF1022115      250204","","31.63","","1271871.16"
"2025-02-07","2025-02-04","SF FuneralF1052200      250204","","31.63","","1271902.79"
"2025-02-07","2025-02-04","SF FuneralF843649       250204","","31.63","","1271934.42"
"2025-02-07","2025-02-04","SF FuneralF1061075      250204","","31.63","","1271966.05"
"2025-02-07","2025-02-04","SF FuneralF1067943      250204","","126.5","","1272092.55"
"2025-02-07","2025-02-04","SF FuneralFDC0000000MCB7250204","","63.25","","1272155.8"
"2025-02-07","2025-02-04","SF FuneralF1117702      250204","","31.63","","1272187.43"
"2025-02-07","2025-02-04","SF FuneralF1123172      250204","","31.63","","1272219.06"
"2025-02-07","2025-02-04","SF FuneralF1125142      250204","","31.63","","1272250.69"
"2025-02-07","2025-02-04","SF FuneralF1127611      250204","","31.63","","1272282.32"
"2025-02-07","2025-02-04","SF FuneralF1130345      250204","","31.63","","1272313.95"
"2025-02-07","2025-01-29","SF FuneralF820290       250129","","126.5","","1272440.45"
"2025-02-07","2025-02-03","SF FuneralFDC0000000CSY7250203","","31.63","","1272472.08"
"2025-02-07","2025-02-03","SF FuneralF1119102      250203","","63.25","","1272535.33"
"2025-02-08","2025-02-08","Fee-Internet-Beneficiary","","-18.64","","1272516.69"
"2025-02-08","2025-02-08","Vision Direct Sanlam 7609","","-1154783.19","18.64","117733.5"
"2025-02-08","2025-02-03","SF FuneralFDC00000006XGF250203","","63.25","","117796.75"
"2025-02-08","2025-02-03","SF FuneralF1118033      250203","","31.63","","117828.38"
"2025-02-08","2025-02-04","SF FuneralFDC00000006Y7S250204","","31.63","","117860.01"
"2025-02-08","2025-02-04","SF FuneralFDC0000000722W250204","","63.25","","117923.26"
"2025-02-08","2025-02-04","SF FuneralFDC00000008P1H250204","","63.25","","117986.51"
"2025-02-08","2025-02-04","SF FuneralF815053       250204","","63.25","","118049.76"
"2025-02-08","2025-02-04","SF FuneralF821893       250204","","63.25","","118113.01"
"2025-02-08","2025-02-04","SF FuneralF833123       250204","","31.63","","118144.64"
"2025-02-08","2025-02-04","SF FuneralF834349       250204","","31.63","","118176.27"
"2025-02-08","2025-02-04","SF FuneralF834882       250204","","31.63","","118207.9"
"2025-02-08","2025-02-04","SF FuneralF834932       250204","","63.25","","118271.15"
"2025-02-08","2025-02-04","SF FuneralF993963       250204","","63.25","","118334.4"
"2025-02-08","2025-02-04","SF FuneralFDC0000000JJ2Y250204","","63.25","","118397.65"
"2025-02-08","2025-02-04","SF FuneralF1017537      250204","","63.25","","118460.9"
"2025-02-08","2025-02-04","SF FuneralF1017666      250204","","31.63","","118492.53"
"2025-02-08","2025-02-04","SF FuneralF1050698      250204","","31.63","","118524.16"
"2025-02-08","2025-02-04","SF FuneralF1060963      250204","","63.25","","118587.41"
"2025-02-08","2025-02-04","SF FuneralF1072724      250204","","31.63","","118619.04"
"2025-02-08","2025-02-04","SF FuneralF1073379      250204","","31.63","","118650.67"
"2025-02-08","2025-02-04","SF FuneralF1073746      250204","","31.63","","118682.3"
"2025-02-08","2025-02-04","SF FuneralF1074598      250204","","31.63","","118713.93"
"2025-02-08","2025-02-04","SF FuneralF1078491      250204","","63.25","","118777.18"
"2025-02-08","2025-02-04","SF FuneralF1079384      250204","","63.25","","118840.43"
"2025-02-08","2025-02-04","SF FuneralF1129064      250204","","31.63","","118872.06"
"2025-02-08","2025-02-04","SF FuneralF1129417      250204","","31.63","","118903.69"
"2025-02-08","2025-02-04","SF FuneralF1130748      250204","","63.25","","118966.94"
"2025-02-08","2025-02-05","SF FuneralF1129443      250205","","126.5","","119093.44"
"2025-02-08","2025-02-06","SF FuneralFDC0000000N9ZS250206","","126.5","","119219.94"
"2025-02-08","2025-02-06","SF FuneralF1122638      250206","","63.25","","119283.19"
"2025-02-08","2025-02-07","SF FuneralFDC00000007Q3J250207","","126.5","","119409.69"
"2025-02-08","2025-02-07","SF FuneralF1085226      250207","","126.5","","119536.19"
"2025-02-08","2025-02-07","SF FuneralF1114116      250207","","31.63","","119567.82"
"2025-02-08","2025-02-06","SF FuneralFDC000000077XQ250206","","126.5","","119694.32"
"2025-02-08","2025-02-04","SF FuneralFDC00000006B9G250204","","31.63","","119725.95"
"2025-02-08","2025-02-04","SF FuneralF816327       250204","","63.25","","119789.2"
"2025-02-08","2025-02-04","SF FuneralF1016973      250204","","31.63","","119820.83"
"2025-02-08","2025-02-04","SF FuneralF1122862      250204","","31.63","","119852.46"
"2025-02-08","2025-02-04","SF FuneralF1123027      250204","","31.63","","119884.09"
"2025-02-08","2025-02-04","SF FuneralF1123619      250204","","63.25","","119947.34"
"2025-02-08","2025-02-04","SF FuneralF1127818      250204","","31.63","","119978.97"
"2025-02-08","2025-02-01","SF FuneralF1114460      250202","","126.5","","120105.47"
"2025-02-08","2025-02-03","SF FuneralFDC000000071S5250203","","31.63","","120137.1"
"2025-02-08","2025-02-03","SF FuneralF1022240      250203","","126.5","","120263.6"
"2025-02-08","2025-02-03","SF FuneralF1079340      250203","","31.63","","120295.23"
"2025-02-08","2025-02-04","SF FuneralFDC00000005L57250204","","31.63","","120326.86"
"2025-02-08","2025-02-04","SF FuneralFDC000000064P9250204","","31.63","","120358.49"
"2025-02-08","2025-02-04","SF FuneralF799997       250204","","63.25","","120421.74"
"2025-02-08","2025-02-04","SF FuneralF810730       250204","","63.25","","120484.99"
"2025-02-08","2025-02-04","SF FuneralF814338       250204","","31.63","","120516.62"
"2025-02-08","2025-02-04","SF FuneralF817682       250204","","31.63","","120548.25"
"2025-02-08","2025-02-04","SF FuneralF817760       250204","","63.25","","120611.5"
"2025-02-08","2025-02-04","SF FuneralFDC0000000CWFK250204","","31.63","","120643.13"
"2025-02-08","2025-02-04","SF FuneralF989331       250204","","63.25","","120706.38"
"2025-02-08","2025-02-04","SF FuneralF1020683      250204","","31.63","","120738.01"
"2025-02-08","2025-02-04","SF FuneralF1033680      250204","","31.63","","120769.64"
"2025-02-08","2025-02-04","SF FuneralF1103795      250204","","31.63","","120801.27"
"2025-02-08","2025-02-04","SF FuneralF1114824      250204","","126.5","","120927.77"
"2025-02-08","2025-02-04","SF FuneralF1115225      250204","","31.63","","120959.4"
"2025-02-08","2025-02-04","SF FuneralFDC0000000NRVB250204","","31.63","","120991.03"
"2025-02-08","2025-02-04","SF FuneralF1123030      250204","","31.63","","121022.66"
"2025-02-08","2025-02-04","SF FuneralF1127417      250204","","31.63","","121054.29"
"2025-02-08","2025-02-04","SF FuneralF1128868      250204","","126.5","","121180.79"
"2025-02-08","2025-02-04","SF FuneralF1128976      250204","","63.25","","121244.04"
"2025-02-08","2025-02-04","SF FuneralF1130616      250204","","31.63","","121275.67"
"2025-02-08","2025-02-04","SF FuneralF743038       250204","","31.63","","121307.3"
"2025-02-08","2025-02-05","SF FuneralF1074875      250205","","126.5","","121433.8"
"2025-02-08","2025-02-05","SF FuneralF1083874      250205","","63.25","","121497.05"
"2025-02-08","2025-02-05","SF FuneralF1117934      250205","","126.5","","121623.55"
"2025-02-08","2025-02-05","SF FuneralF1123193      250205","","126.5","","121750.05"
"2025-02-08","2025-02-07","SF FuneralFDC000000078XC250207","","126.5","","121876.55"
"2025-02-08","2025-02-07","SF FuneralF774474       250207","","156.28","","122032.83"
"2025-02-08","2025-02-07","SF FuneralFDC000000070HM250207","","63.25","","122096.08"
"2025-02-08","2025-02-07","SF FuneralF798583       250207","","31.63","","122127.71"
"2025-02-08","2025-02-05","SF FuneralF1118016      250205","","126.5","","122254.21"
"2025-02-08","2025-02-04","SF FuneralFDC000000061NF250204","","31.63","","122285.84"
"2025-02-08","2025-02-04","SF FuneralFDC00000007CQV250204","","31.63","","122317.47"
"2025-02-08","2025-02-04","SF FuneralF812669       250204","","63.25","","122380.72"
"2025-02-08","2025-02-04","SF FuneralF1068023      250204","","31.63","","122412.35"
"2025-02-08","2025-02-04","SF FuneralF1118348      250204","","31.63","","122443.98"
"2025-02-08","2025-02-04","SF FuneralF820999       250204","","31.63","","122475.61"
"2025-02-08","2025-02-04","SF FuneralF1130344      250204","","31.63","","122507.24"
"2025-02-08","2025-02-03","SF FuneralFDC00000008LKQ250202","","126.5","","122633.74"
"2025-02-08","2025-02-03","SF FuneralF1020672      250203","","31.63","","122665.37"
"2025-02-08","2025-02-03","SF FuneralF1066625      250203","","126.5","","122791.87"
"2025-02-08","2025-01-29","SF FuneralFDC00000005PZ2250129","","126.5","","122918.37"
"2025-02-08","2025-02-06","SF FuneralF1079631      250206","","31.63","","122950"
"2025-02-08","2025-02-03","SF FuneralF1119088      250203","","31.63","","122981.63"
"2025-02-08","2025-02-04","SF FuneralF798846       250204","","31.63","","123013.26"
"2025-02-08","2025-02-04","SF FuneralFDC0000000JHBW250204","","31.63","","123044.89"
"2025-02-08","2025-02-04","SF FuneralF1104234      250204","","31.63","","123076.52"
"2025-02-08","2025-02-07","SF FuneralF1054780      250207","","31.63","","123108.15"
"2025-02-08","2025-02-08","SF FuneralFDC00000005KXR250208","","31.63","","123139.78"
"2025-02-08","2025-02-08","SF FuneralFDC00000005MWG250208","","31.63","","123171.41"
"2025-02-08","2025-02-08","SF FuneralFDC00000007GR6250208","","31.63","","123203.04"
"2025-02-08","2025-02-08","SF FuneralF832932       250208","","31.63","","123234.67"
"2025-02-08","2025-02-08","SF FuneralF1017512      250209","","31.63","","123266.3"
"2025-02-08","2025-02-08","SF FuneralF1079004      250209","","31.63","","123297.93"
"2025-02-08","2025-02-08","SF FuneralFDC0000000LNR4250209","","31.63","","123329.56"
"2025-02-08","2025-02-08","SF FuneralF1084539      250209","","31.63","","123361.19"
"2025-02-08","2025-02-08","SF FuneralFDC0000000MNF7250208","","31.63","","123392.82"
"2025-02-08","2025-02-08","SF FuneralF1120593      250209","","31.63","","123424.45"
"2025-02-08","2025-02-04","SF FuneralFDC0000000BG38250204","","126.5","","123550.95"
"2025-02-08","2025-02-04","SF FuneralF1073134      250204","","63.25","","123614.2"
"2025-02-08","2025-02-04","SF FuneralF1073139      250204","","63.25","","123677.45"
"2025-02-08","2025-02-08","SF FuneralF819348       250208","","63.25","","123740.7"
"2025-02-08","2025-02-08","SF FuneralF1118079      250208","","126.5","","123867.2"
"2025-02-08","2025-02-08","SF FuneralF1125397      250209","","126.5","","123993.7"
"2025-02-08","2025-02-08","SF FuneralFDC0000000JG27250209","","126.5","","124120.2"
"2025-02-08","2025-02-08","SF FuneralF1117998      250209","","31.63","","124151.83"
"2025-02-08","2025-02-04","SF FuneralF822239       250204","","31.63","","124183.46"
"2025-02-08","2025-02-04","SF FuneralF1022150      250204","","126.5","","124309.96"
"2025-02-08","2025-02-04","SF FuneralF1111603      250204","","31.63","","124341.59"
"2025-02-08","2025-02-04","SF FuneralF1122750      250204","","31.63","","124373.22"
"2025-02-08","2025-02-04","SF FuneralFDC00000002XZF250204","","110","","124483.22"
"2025-02-08","2025-02-04","SF FuneralFDC000000079QY250204","","31.63","","124514.85"
"2025-02-08","2025-02-04","SF FuneralF1054894      250204","","126.5","","124641.35"
"2025-02-08","2025-02-04","SF FuneralF1068221      250204","","31.63","","124672.98"
"2025-02-08","2025-02-04","SF FuneralF1123395      250204","","63.25","","124736.23"
"2025-02-08","2025-02-08","SF FuneralF1020601      250208","","31.63","","124767.86"
"2025-02-08","2025-02-08","SF FuneralF1104260      250209","","63.25","","124831.11"
"2025-02-08","2025-01-24","Rev SF FuneralFDC00000006MW9250124","","-126.5","","124704.61"
"2025-02-08","2024-12-31","Rev SF FuneralFDC0000000CSW4241231","","-63.25","","124641.36"
"2025-02-08","2025-02-04","Rev SF FuneralFDC0000000BG38250204","","-126.5","","124514.86"
"2025-02-08","2025-02-03","Rev SF FuneralFDC00000009HK1250203","","-63.25","","124451.61"
"2025-02-08","2025-02-04","SF FuneralF1022109      250204","","63.25","","124514.86"
"2025-02-08","2025-02-05","SF FuneralF842872       250205","","31.63","","124546.49"
"2025-02-08","2025-02-05","SF FuneralF1129376      250205","","31.63","","124578.12"
"2025-02-08","2025-02-08","SF FuneralF814211       250208","","31.63","","124609.75"
"2025-02-08","2025-02-08","SF FuneralF1054743      250209","","31.63","","124641.38"
"2025-02-08","2025-02-07","Rev SF FuneralFDC00000007Q3J250207","","-126.5","","124514.88"
"2025-02-08","2025-02-04","Rev SF FuneralFDC00000005L57250204","","-31.63","","124483.25"
"2025-02-08","2025-01-22","Rev SF FuneralFDC00000005FWB250122","","-126.5","","124356.75"
"2025-02-08","2025-02-01","Rev SF FuneralFDC0000000PL08250201","","-126.5","","124230.25"
"2025-02-08","2025-02-05","SF FuneralF844044       250205","","31.63","","124261.88"
"2025-02-08","2025-02-07","SF FuneralF1083710      250207","","63.25","","124325.13"
"2025-02-08","2025-02-02","SF FuneralF819229       250202","","31.63","","124356.76"
"2025-02-08","2025-02-04","SF FuneralFDC0000000788B250204","","31.63","","124388.39"
"2025-02-08","2025-02-03","SF FuneralF828177       250202","","126.5","","124514.89"
"2025-02-08","2025-02-04","SF FuneralF1118294      250204","","126.5","","124641.39"
"2025-02-09","2025-02-01","SF FuneralF1050665      250201","","126.5","","124767.89"
"2025-02-09","2025-02-03","SF FuneralF818869       250203","","63.25","","124831.14"
"2025-02-09","2025-02-07","SF FuneralF813030       250207","","31.63","","124862.77"
"2025-02-09","2025-02-08","SF FuneralF805805       250208","","126.5","","124989.27"
"2025-02-09","2025-02-09","SF FuneralF833253       250209","","31.63","","125020.9"
"2025-02-09","2025-02-06","SF FuneralF832011       250206","","63.25","","125084.15"
"2025-02-09","2025-02-01","SF FuneralF1120586      250201","","126.5","","125210.65"
"2025-02-09","2025-02-08","SF FuneralFDC0000000KH3D250209","","31.63","","125242.28"
"2025-02-09","2025-02-04","SF FuneralF1078878      250204","","126.5","","125368.78"
"2025-02-10","2025-02-05","SF FuneralFDC00000005R1F250205","","63.25","","125432.03"
"2025-02-10","2025-02-05","SF FuneralF987016       250205","","31.63","","125463.66"
"2025-02-10","2025-02-07","SF FuneralFDC00000006PSF250207","","31.63","","125495.29"
"2025-02-10","2025-02-07","SF FuneralFDC000000088H0250207","","126.5","","125621.79"
"2025-02-10","2025-02-07","SF FuneralF822267       250207","","31.63","","125653.42"
"2025-02-10","2025-02-07","SF FuneralFDC0000000L8B0250207","","31.63","","125685.05"
"2025-02-10","2025-02-07","SF FuneralF1118177      250207","","126.5","","125811.55"
"2025-02-10","2025-02-07","SF FuneralF1120280      250207","","31.63","","125843.18"
"2025-02-10","2025-02-07","SF FuneralF1122989      250207","","126.5","","125969.68"
"2025-02-10","2025-02-08","SF FuneralF1060968      250209","","31.63","","126001.31"
"2025-02-10","2025-02-10","SF FuneralFDC00000005H8J250209","","31.63","","126032.94"
"2025-02-10","2025-02-04","SF FuneralFDC000000062B9250204","","63.25","","126096.19"
"2025-02-10","2025-02-06","SF FuneralF843570       250206","","31.63","","126127.82"
"2025-02-10","2025-02-07","SF FuneralFDC00000005CSP250207","","63.25","","126191.07"
"2025-02-10","2025-02-07","SF FuneralFDC00000005PXF250207","","31.63","","126222.7"
"2025-02-10","2025-02-07","SF FuneralFDC00000005QCT250207","","31.63","","126254.33"
"2025-02-10","2025-02-07","SF FuneralFDC00000005V4S250207","","31.63","","126285.96"
"2025-02-10","2025-02-07","SF FuneralFDC000000069RZ250207","","31.63","","126317.59"
"2025-02-10","2025-02-07","SF FuneralFDC00000006FQ9250207","","31.63","","126349.22"
"2025-02-10","2025-02-07","SF FuneralFDC00000006R81250207","","31.63","","126380.85"
"2025-02-10","2025-02-07","SF FuneralFDC00000007MW5250207","","31.63","","126412.48"
"2025-02-10","2025-02-07","SF FuneralFDC00000007WJL250207","","31.63","","126444.11"
"2025-02-10","2025-02-07","SF FuneralF795812       250207","","31.63","","126475.74"
"2025-02-10","2025-02-07","SF FuneralFDC000000086Y9250207","","31.63","","126507.37"
"2025-02-10","2025-02-07","SF FuneralFDC00000008NYM250207","","31.63","","126539"
"2025-02-10","2025-02-07","SF FuneralF790399       250207","","47.88","","126586.88"
"2025-02-10","2025-02-07","SF FuneralF811119       250207","","31.63","","126618.51"
"2025-02-10","2025-02-07","SF FuneralF814303       250207","","31.63","","126650.14"
"2025-02-10","2025-02-07","SF FuneralF815340       250207","","31.63","","126681.77"
"2025-02-10","2025-02-07","SF FuneralF815510       250207","","31.63","","126713.4"
"2025-02-10","2025-02-07","SF FuneralF817463       250207","","31.63","","126745.03"
"2025-02-10","2025-02-07","SF FuneralF817655       250207","","31.63","","126776.66"
"2025-02-10","2025-02-07","SF FuneralFDC0000000B37Y250207","","31.63","","126808.29"
"2025-02-10","2025-02-07","SF FuneralF819497       250207","","31.63","","126839.92"
"2025-02-10","2025-02-07","SF FuneralF830931       250207","","31.63","","126871.55"
"2025-02-10","2025-02-07","SF FuneralF819053       250207","","31.63","","126903.18"
"2025-02-10","2025-02-07","SF FuneralFDC0000000J2XM250209","","31.63","","126934.81"
"2025-02-10","2025-02-07","SF FuneralF993478       250207","","31.63","","126966.44"
"2025-02-10","2025-02-07","SF FuneralFDC0000000JFC4250207","","31.63","","126998.07"
"2025-02-10","2025-02-07","SF FuneralFDC0000000K7CQ250207","","31.63","","127029.7"
"2025-02-10","2025-02-07","SF FuneralF1065649      250207","","31.63","","127061.33"
"2025-02-10","2025-02-07","SF FuneralF1073030      250207","","31.63","","127092.96"
"2025-02-10","2025-02-07","SF FuneralFDC0000000L3MT250207","","31.63","","127124.59"
"2025-02-10","2025-02-07","SF FuneralF1078457      250207","","31.63","","127156.22"
"2025-02-10","2025-02-07","SF FuneralF1084400      250207","","31.63","","127187.85"
"2025-02-10","2025-02-07","SF FuneralF1085355      250207","","31.63","","127219.48"
"2025-02-10","2025-02-07","SF FuneralF1104196      250207","","31.63","","127251.11"
"2025-02-10","2025-02-07","SF FuneralF1111672      250207","","31.63","","127282.74"
"2025-02-10","2025-02-07","SF FuneralFDC0000000N3BG250207","","31.63","","127314.37"
"2025-02-10","2025-02-07","SF FuneralF1115119      250207","","31.63","","127346"
"2025-02-10","2025-02-07","SF FuneralFDC0000000NNGY250207","","31.63","","127377.63"
"2025-02-10","2025-02-07","SF FuneralF1122752      250207","","31.63","","127409.26"
"2025-02-10","2025-02-07","SF FuneralF1123008      250207","","31.63","","127440.89"
"2025-02-10","2025-02-07","SF FuneralF1126287      250207","","31.63","","127472.52"
"2025-02-10","2025-02-07","SF FuneralF1127351      250207","","31.63","","127504.15"
"2025-02-10","2025-02-07","SF FuneralF1130369      250207","","31.63","","127535.78"
"2025-02-10","2025-02-08","SF FuneralFDC00000006HHY250208","","31.63","","127567.41"
"2025-02-10","2025-02-08","SF FuneralFDC00000007G0S250208","","31.63","","127599.04"
"2025-02-10","2025-02-08","SF FuneralF1060024      250208","","31.63","","127630.67"
"2025-02-10","2025-02-10","SF FuneralFDC0000000502G250210","","31.63","","127662.3"
"2025-02-10","2025-02-10","SF FuneralFDC00000005LQV250210","","31.63","","127693.93"
"2025-02-10","2025-02-10","SF FuneralFDC00000006RQ8250209","","31.63","","127725.56"
"2025-02-10","2025-02-10","SF FuneralFDC00000006SV7250209","","31.63","","127757.19"
"2025-02-10","2025-02-10","SF FuneralFDC000000070Z5250209","","31.63","","127788.82"
"2025-02-10","2025-02-10","SF FuneralFDC000000071S5250210","","31.63","","127820.45"
"2025-02-10","2025-02-10","SF FuneralFDC00000007GS9250210","","31.63","","127852.08"
"2025-02-10","2025-02-10","SF FuneralFDC000000086PW250209","","31.63","","127883.71"
"2025-02-10","2025-02-10","SF FuneralF801722       250210","","31.63","","127915.34"
"2025-02-10","2025-02-10","SF FuneralF803226       250210","","31.63","","127946.97"
"2025-02-10","2025-02-10","SF FuneralF831617       250210","","31.63","","127978.6"
"2025-02-10","2025-02-10","SF FuneralF1017111      250210","","31.63","","128010.23"
"2025-02-10","2025-02-10","SF FuneralF1017630      250210","","31.63","","128041.86"
"2025-02-10","2025-02-10","SF FuneralF1104295      250210","","31.63","","128073.49"
"2025-02-10","2025-02-10","SF FuneralF1118005      250210","","31.63","","128105.12"
"2025-02-10","2025-02-10","SF FuneralF1124411      250210","","31.63","","128136.75"
"2025-02-10","2025-02-10","SF FuneralFDC0000000PYVQ250210","","31.63","","128168.38"
"2025-02-10","2025-02-10","SF FuneralF1129402      250210","","31.63","","128200.01"
"2025-02-10","2025-02-10","SF FuneralF1129904      250210","","31.63","","128231.64"
"2025-02-10","2025-02-10","SF FuneralFDC000000069CL250210","","31.63","","128263.27"
"2025-02-10","2025-02-10","SF FuneralFDC0000000DGVD250210","","126.5","","128389.77"
"2025-02-10","2025-02-10","SF FuneralF1115794      250210","","31.63","","128421.4"
"2025-02-10","2025-02-04","SF FuneralF1104197      250204","","31.63","","128453.03"
"2025-02-10","2025-02-06","SF FuneralF1108113      250206","","31.63","","128484.66"
"2025-02-10","2025-02-07","SF FuneralF813620       250207","","126.5","","128611.16"
"2025-02-10","2025-02-07","SF FuneralF832185       250207","","31.63","","128642.79"
"2025-02-10","2025-02-07","SF FuneralF832777       250207","","31.63","","128674.42"
"2025-02-10","2025-02-07","SF FuneralF843596       250207","","31.63","","128706.05"
"2025-02-10","2025-02-07","SF FuneralF844636       250207","","31.63","","128737.68"
"2025-02-10","2025-02-07","SF FuneralF901122       250207","","31.63","","128769.31"
"2025-02-10","2025-02-07","SF FuneralFDC0000000HBD0250207","","31.63","","128800.94"
"2025-02-10","2025-02-07","SF FuneralF986934       250207","","31.63","","128832.57"
"2025-02-10","2025-02-07","SF FuneralFDC0000000HXHK250207","","47.88","","128880.45"
"2025-02-10","2025-02-07","SF FuneralF992752       250207","","31.63","","128912.08"
"2025-02-10","2025-02-07","SF FuneralF993205       250207","","31.63","","128943.71"
"2025-02-10","2025-02-07","SF FuneralF1033620      250207","","31.63","","128975.34"
"2025-02-10","2025-02-07","SF FuneralF1052348      250207","","31.63","","129006.97"
"2025-02-10","2025-02-07","SF FuneralFDC0000000KLCD250207","","31.63","","129038.6"
"2025-02-10","2025-02-07","SF FuneralF1061613      250207","","31.63","","129070.23"
"2025-02-10","2025-02-07","SF FuneralF1068145      250207","","31.63","","129101.86"
"2025-02-10","2025-02-07","SF FuneralF1072884      250207","","31.63","","129133.49"
"2025-02-10","2025-02-07","SF FuneralFDC0000000LMH8250207","","31.63","","129165.12"
"2025-02-10","2025-02-07","SF FuneralF1080183      250207","","31.63","","129196.75"
"2025-02-10","2025-02-07","SF FuneralF1104285      250207","","31.63","","129228.38"
"2025-02-10","2025-02-07","SF FuneralF1119753      250207","","31.63","","129260.01"
"2025-02-10","2025-02-07","SF FuneralF1120399      250207","","31.63","","129291.64"
"2025-02-10","2025-02-07","SF FuneralF1123947      250207","","31.63","","129323.27"
"2025-02-10","2025-02-07","SF FuneralF1131198      250207","","31.63","","129354.9"
"2025-02-10","2025-02-10","SF FuneralFDC000000086PX250209","","31.63","","129386.53"
"2025-02-10","2025-02-10","SF FuneralF804126       250210","","31.63","","129418.16"
"2025-02-10","2025-02-10","SF FuneralF828566       250210","","31.63","","129449.79"
"2025-02-10","2025-02-10","SF FuneralF844597       250210","","63.25","","129513.04"
"2025-02-10","2025-02-10","SF FuneralF987310       250210","","31.63","","129544.67"
"2025-02-10","2025-02-10","SF FuneralFDC0000000K09V250210","","31.63","","129576.3"
"2025-02-10","2025-02-10","SF FuneralF1052717      250210","","31.63","","129607.93"
"2025-02-10","2025-02-10","SF FuneralF1073218      250210","","31.63","","129639.56"
"2025-02-10","2025-02-10","SF FuneralF1118181      250210","","31.63","","129671.19"
"2025-02-10","2025-02-07","SF FuneralFDC00000007G54250207","","31.63","","129702.82"
"2025-02-10","2025-02-07","SF FuneralFDC000000080FL250207","","126.5","","129829.32"
"2025-02-10","2025-02-07","SF FuneralF805319       250207","","31.63","","129860.95"
"2025-02-10","2025-02-07","SF FuneralF821927       250207","","31.63","","129892.58"
"2025-02-10","2025-02-07","SF FuneralF822337       250207","","126.5","","130019.08"
"2025-02-10","2025-02-07","SF FuneralF981626       250207","","126.5","","130145.58"
"2025-02-10","2025-02-07","SF FuneralF994001       250207","","31.63","","130177.21"
"2025-02-10","2025-02-07","SF FuneralF1078955      250207","","31.63","","130208.84"
"2025-02-10","2025-02-07","SF FuneralF1126869      250207","","31.63","","130240.47"
"2025-02-10","2025-02-01","SF FuneralFDC00000007QRZ250201","","126.5","","130366.97"
"2025-02-10","2025-02-01","SF FuneralF1114691      250201","","126.5","","130493.47"
"2025-02-10","2025-02-07","SF FuneralFDC00000005HS9250207","","126.5","","130619.97"
"2025-02-10","2025-02-07","SF FuneralF990684       250207","","126.5","","130746.47"
"2025-02-10","2025-02-08","SF FuneralF1075095      250208","","126.5","","130872.97"
"2025-02-10","2025-02-10","SF FuneralFDC00000005ZZL250209","","126.5","","130999.47"
"2025-02-10","2025-02-03","SF FuneralFDC00000006ZGF250202","","126.5","","131125.97"
"2025-02-10","2025-02-07","SF FuneralF844458       250207","","126.5","","131252.47"
"2025-02-10","2025-02-10","SF FuneralFDC00000005PH9250210","","63.25","","131315.72"
"2025-02-10","2025-02-10","SF FuneralF827664       250210","","63.25","","131378.97"
"2025-02-10","2025-02-10","SF FuneralF1126313      250210","","63.25","","131442.22"
"2025-02-10","2025-02-10","SF FuneralFDC000000089G2250209","","31.63","","131473.85"
"2025-02-10","2025-02-10","SF FuneralFDC0000000MR2H250210","","31.63","","131505.48"
"2025-02-10","2025-02-10","SF FuneralF1124750      250210","","63.25","","131568.73"
"2025-02-10","2025-02-10","SF FuneralF1127801      250210","","31.63","","131600.36"
"2025-02-10","2025-02-07","SF FuneralFDC00000002WNP250207","","220","","131820.36"
"2025-02-10","2025-02-07","SF FuneralFDC00000005TX1250207","","31.63","","131851.99"
"2025-02-10","2025-02-07","SF FuneralFDC00000006NFW250207","","31.63","","131883.62"
"2025-02-10","2025-02-07","SF FuneralFDC00000007GX8250207","","126.5","","132010.12"
"2025-02-10","2025-02-07","SF FuneralF779346       250207","","31.63","","132041.75"
"2025-02-10","2025-02-01","SF FuneralFDC00000009XP3250201","","126.5","","132168.25"
"2025-02-10","2025-02-07","SF FuneralFDC00000005J39250207","","126.5","","132294.75"
"2025-02-10","2025-02-07","SF FuneralFDC000000070CD250207","","31.63","","132326.38"
"2025-02-10","2025-02-07","SF FuneralF842737       250207","","31.63","","132358.01"
"2025-02-10","2025-02-07","SF FuneralF993837       250207","","31.63","","132389.64"
"2025-02-10","2025-02-07","SF FuneralF1104255      250207","","31.63","","132421.27"
"2025-02-10","2025-02-07","SF FuneralF1126968      250207","","126.5","","132547.77"
"2025-02-10","2025-02-07","SF FuneralF1128672      250207","","31.63","","132579.4"
"2025-02-10","2025-02-10","SF FuneralFDC00000006GNR250210","","31.63","","132611.03"
"2025-02-10","2025-02-10","SF FuneralFDC00000006XFM250210","","31.63","","132642.66"
"2025-02-10","2025-02-10","SF FuneralF1073862      250210","","31.63","","132674.29"
"2025-02-10","2025-02-10","SF FuneralFDC0000000MSC7250210","","47.88","","132722.17"
"2025-02-10","2025-02-10","SF FuneralF1112136      250210","","31.63","","132753.8"
"2025-02-10","2025-02-08","Rev SF FuneralFDC0000000LNR4250209","","-31.63","","132722.17"
"2025-02-10","2025-01-24","Rev SF FuneralFDC00000006S7C250128","","-126.5","","132595.67"
"2025-02-10","2025-01-24","Rev SF FuneralFDC0000000JBQD250127","","-126.5","","132469.17"
"2025-02-10","2025-02-08","Rev SF FuneralFDC0000000KH3D250209","","-31.63","","132437.54"
"2025-02-10","2025-02-04","Rev SF FuneralFDC00000007ZH7250204","","-31.63","","132405.91"
"2025-02-10","2024-12-11","Rev SF FuneralFDC0000000774H241226","","-126.5","","132279.41"
"2025-02-10","2025-01-24","Rev SF FuneralFDC00000005N1F250128","","-126.5","","132152.91"
"2025-02-10","2025-02-04","Rev SF FuneralFDC0000000NRVB250204","","-31.63","","132121.28"
"2025-02-10","2025-02-01","Rev SF FuneralFDC00000008LKW250201","","-191.5","","131929.78"
"2025-02-10","2025-01-24","Rev SF FuneralFDC00000005WZH250127","","-220","","131709.78"
"2025-02-10","2025-01-24","Rev SF FuneralFDC0000000BP51250127","","-126.5","","131583.28"
"2025-02-10","2025-01-24","Rev SF FuneralFDC00000006S79250128","","-126.5","","131456.78"
"2025-02-10","2025-01-24","Rev SF FuneralF1118274      250128","","-126.5","","131330.28"
"2025-02-10","2025-02-08","SF FuneralF1125662      250208","","31.63","","131361.91"
"2025-02-10","2025-02-01","SF FuneralF1118271      250202","","126.5","","131488.41"
"2025-02-10","2025-02-07","SF FuneralFDC00000006NRD250207","","126.5","","131614.91"
"2025-02-10","2025-02-07","SF FuneralF1130754      250207","","31.63","","131646.54"
"2025-02-10","2025-02-10","SF FuneralF1059325      250210","","63.25","","131709.79"
"2025-02-10","2025-02-10","SF FuneralF1131541      250210","","31.63","","131741.42"
"2025-02-10","2025-01-13","Rev SF FuneralFDC0000000600K250112","","-126.5","","131614.92"
"2025-02-10","2025-02-07","SF FuneralFDC00000004LL7250207","","220","","131834.92"
"2025-02-10","2025-02-07","SF FuneralFDC0000000P3HN250207","","126.5","","131961.42"
"2025-02-10","2025-02-07","SF FuneralF1123108      250207","","126.5","","132087.92"
"2025-02-10","2025-02-01","SF FuneralFDC00000007RQ9250201","","126.5","","132214.42"
"2025-02-10","2025-02-04","SF FuneralF988236       250204","","31.63","","132246.05"
"2025-02-10","2025-02-07","SF FuneralFDC00000003LJJ250207","","110","","132356.05"
"2025-02-10","2025-02-07","SF FuneralF1121971      250207","","31.63","","132387.68"
"2025-02-10","2025-02-04","SF FuneralF1060316      250204","","31.63","","132419.31"
"2025-02-10","2025-02-07","SF FuneralFDC00000005QYG250207","","63.25","","132482.56"
"2025-02-10","2025-02-07","SF FuneralFDC00000007WBL250207","","31.63","","132514.19"
"2025-02-10","2025-02-07","SF FuneralF900608       250207","","31.63","","132545.82"
"2025-02-10","2025-02-10","SF FuneralFDC00000008JY9250210","","63.25","","132609.07"
"2025-02-10","2025-02-10","SF FuneralFDC00000008JYB250210","","63.25","","132672.32"
"2025-02-10","2025-02-10","SF FuneralF820769       250210","","31.63","","132703.95"
"2025-02-10","2025-02-07","Rev SF FuneralFDC000000069RZ250207","","-31.63","","132672.32"
"2025-02-10","2025-02-07","Rev SF FuneralFDC0000000KLCD250207","","-31.63","","132640.69"
"2025-02-10","2025-02-07","Rev SF FuneralFDC0000000JFC4250207","","-31.63","","132609.06"
"2025-02-10","2025-02-07","Rev SF FuneralFDC0000000B37Y250207","","-31.63","","132577.43"
"2025-02-10","2025-02-07","Rev SF FuneralFDC0000000NNGY250207","","-31.63","","132545.8"
"2025-02-10","2025-02-07","Rev SF FuneralFDC00000003LJJ250207","","-110","","132435.8"
"2025-02-10","2025-02-07","Rev SF FuneralFDC000000075L7250207","","-63.25","","132372.55"
"2025-02-10","2025-02-07","SF FuneralF1079112      250207","","126.5","","132499.05"
"2025-02-10","2025-01-24","Rev SF FuneralFDC00000007TPG250125","","-126.5","","132372.55"
"2025-02-10","2024-11-28","Rev SF FuneralFDC0000000DZLN241128","","-126.5","","132246.05"
"2025-02-10","2024-12-23","Rev SF FuneralFDC0000000DZLN241228","","-126.5","","132119.55"
"2025-02-10","2025-01-24","Rev SF FuneralFDC0000000DZLN250128","","-126.5","","131993.05"
"2025-02-11","2025-02-07","SF FuneralFDC0000000HX7W250207","","31.63","","132024.68"
"2025-02-11","2025-02-07","SF FuneralF1125492      250207","","31.63","","132056.31"
"2025-02-11","2025-02-10","SF FuneralFDC00000005Z06250210","","31.63","","132087.94"
"2025-02-11","2025-02-10","SF FuneralFDC00000005Z12250210","","31.63","","132119.57"
"2025-02-11","2025-02-10","SF FuneralFDC00000005Z25250210","","31.63","","132151.2"
"2025-02-11","2025-02-10","SF FuneralFDC00000009DX3250209","","31.63","","132182.83"
"2025-02-11","2025-02-10","SF FuneralF1085023      250210","","63.25","","132246.08"
"2025-02-11","2025-02-01","SF FuneralF1066369      250201","","126.5","","132372.58"
"2025-02-11","2025-02-01","SF FuneralF1084341      250201","","126.5","","132499.08"
"2025-02-11","2025-02-03","SF FuneralFDC00000007M2D250202","","63.25","","132562.33"
"2025-02-11","2025-02-07","SF FuneralF834544       250207","","31.63","","132593.96"
"2025-02-11","2025-02-07","SF FuneralFDC0000000JXHW250207","","126.5","","132720.46"
"2025-02-11","2025-02-07","SF FuneralF1022172      250207","","126.5","","132846.96"
"2025-02-11","2025-02-07","SF FuneralF1073818      250207","","31.63","","132878.59"
"2025-02-11","2025-02-07","SF FuneralFDC0000000Q00G250207","","126.5","","133005.09"
"2025-02-11","2025-02-08","SF FuneralFDC00000006W3S250208","","126.5","","133131.59"
"2025-02-11","2025-02-08","SF FuneralF1054925      250209","","31.63","","133163.22"
"2025-02-11","2025-02-10","SF FuneralFDC00000007DSV250210","","31.63","","133194.85"
"2025-02-11","2025-02-10","SF FuneralFDC0000000F3H4250210","","31.63","","133226.48"
"2025-02-11","2025-02-10","SF FuneralFDC0000000HZN0250210","","63.25","","133289.73"
"2025-02-11","2025-02-07","SF FuneralF1060095      250207","","63.25","","133352.98"
"2025-02-11","2025-02-07","SF FuneralF840580       250207","","31.63","","133384.61"
"2025-02-11","2025-02-07","SF FuneralF981788       250207","","31.63","","133416.24"
"2025-02-11","2025-02-11","SF FuneralFDC00000006QXL250211","","126.5","","133542.74"
"2025-02-11","2025-02-11","SF FuneralFDC000000072YQ250211","","63.25","","133605.99"
"2025-02-11","2025-02-11","SF FuneralF823118       250211","","63.25","","133669.24"
"2025-02-11","2025-02-11","SF FuneralF831757       250211","","63.25","","133732.49"
"2025-02-11","2025-02-11","SF FuneralF1111516      250211","","63.25","","133795.74"
"2025-02-11","2025-02-11","SF FuneralF1111528      250211","","63.25","","133858.99"
"2025-02-11","2025-02-11","SF FuneralF1120906      250211","","63.25","","133922.24"
"2025-02-11","2025-02-11","SF FuneralF1127477      250211","","63.25","","133985.49"
"2025-02-11","2025-02-11","SF FuneralFDC00000006NCH250211","","63.25","","134048.74"
"2025-02-11","2025-02-11","SF FuneralFDC000000078FZ250211","","31.63","","134080.37"
"2025-02-11","2025-02-11","SF FuneralF811401       250211","","31.63","","134112"
"2025-02-11","2025-02-11","SF FuneralF817293       250211","","31.63","","134143.63"
"2025-02-11","2025-02-11","SF FuneralF834203       250211","","31.63","","134175.26"
"2025-02-11","2025-02-11","SF FuneralFDC0000000G5YG250211","","126.5","","134301.76"
"2025-02-11","2025-02-11","SF FuneralF1020936      250211","","31.63","","134333.39"
"2025-02-11","2025-02-11","SF FuneralF1021427      250211","","63.25","","134396.64"
"2025-02-11","2025-02-11","SF FuneralFDC0000000KFZP250211","","63.25","","134459.89"
"2025-02-11","2025-02-11","SF FuneralF1060528      250211","","63.25","","134523.14"
"2025-02-11","2025-02-11","SF FuneralF1072719      250211","","126.5","","134649.64"
"2025-02-11","2025-02-11","SF FuneralFDC0000000L0TM250211","","31.63","","134681.27"
"2025-02-11","2025-02-11","SF FuneralF1080246      250211","","31.63","","134712.9"
"2025-02-11","2025-02-11","SF FuneralF1085179      250211","","31.63","","134744.53"
"2025-02-11","2025-02-11","SF FuneralF1104197      250211","","31.63","","134776.16"
"2025-02-11","2025-02-11","SF FuneralF1112093      250211","","63.25","","134839.41"
"2025-02-11","2025-02-11","SF FuneralFDC0000000NRVB250211","","31.63","","134871.04"
"2025-02-11","2025-02-11","SF FuneralF1124787      250211","","63.25","","134934.29"
"2025-02-11","2025-02-11","SF FuneralF1128762      250211","","31.63","","134965.92"
"2025-02-11","2025-02-11","SF FuneralF1130870      250211","","31.63","","134997.55"
"2025-02-11","2025-02-07","SF FuneralF1103821      250207","","31.63","","135029.18"
"2025-02-11","2025-02-11","SF FuneralFDC0000000455X250211","","55","","135084.18"
"2025-02-11","2025-02-11","SF FuneralFDC00000005L57250211","","31.63","","135115.81"
"2025-02-11","2025-02-11","SF FuneralFDC00000005P3Q250211","","31.63","","135147.44"
"2025-02-11","2025-02-11","SF FuneralFDC00000007X30250211","","31.63","","135179.07"
"2025-02-11","2025-02-11","SF FuneralFDC00000007X31250211","","31.63","","135210.7"
"2025-02-11","2025-02-11","SF FuneralFDC00000007YH4250211","","31.63","","135242.33"
"2025-02-11","2025-02-11","SF FuneralFDC00000007YZB250211","","31.63","","135273.96"
"2025-02-11","2025-02-11","SF FuneralF798676       250211","","31.63","","135305.59"
"2025-02-11","2025-02-11","SF FuneralF801219       250211","","31.63","","135337.22"
"2025-02-11","2025-02-11","SF FuneralFDC00000008H47250211","","31.63","","135368.85"
"2025-02-11","2025-02-11","SF FuneralF802295       250211","","31.63","","135400.48"
"2025-02-11","2025-02-11","SF FuneralF805662       250211","","31.63","","135432.11"
"2025-02-11","2025-02-11","SF FuneralFDC00000008YCZ250211","","31.63","","135463.74"
"2025-02-11","2025-02-11","SF FuneralFDC0000000HK7D250211","","31.63","","135495.37"
"2025-02-11","2025-02-11","SF FuneralFDC0000000HN9N250211","","31.63","","135527"
"2025-02-11","2025-02-11","SF FuneralF988236       250211","","31.63","","135558.63"
"2025-02-11","2025-02-11","SF FuneralFDC0000000HXY2250211","","31.63","","135590.26"
"2025-02-11","2025-02-11","SF FuneralF1066029      250211","","31.63","","135621.89"
"2025-02-11","2025-02-11","SF FuneralF1066647      250211","","31.63","","135653.52"
"2025-02-11","2025-02-11","SF FuneralF1068212      250211","","31.63","","135685.15"
"2025-02-11","2025-02-11","SF FuneralF1073801      250211","","31.63","","135716.78"
"2025-02-11","2025-02-11","SF FuneralF1073828      250211","","31.63","","135748.41"
"2025-02-11","2025-02-11","SF FuneralF1112035      250211","","31.63","","135780.04"
"2025-02-11","2025-02-11","SF FuneralF1118335      250211","","31.63","","135811.67"
"2025-02-11","2025-02-11","SF FuneralF1129064      250211","","31.63","","135843.3"
"2025-02-11","2025-02-11","SF FuneralF1130733      250211","","31.63","","135874.93"
"2025-02-11","2025-02-11","SF FuneralF743038       250211","","31.63","","135906.56"
"2025-02-11","2025-02-11","SF FuneralF1131495      250211","","31.63","","135938.19"
"2025-02-11","2025-02-11","SF FuneralF1129464      250211","","31.63","","135969.82"
"2025-02-11","2025-02-11","SF FuneralFDC000000072SM250211","","31.63","","136001.45"
"2025-02-11","2025-02-11","SF FuneralF801331       250211","","31.63","","136033.08"
"2025-02-11","2025-02-11","SF FuneralFDC000000095C0250211","","126.5","","136159.58"
"2025-02-11","2025-02-11","SF FuneralFDC0000000CY56250211","","31.63","","136191.21"
"2025-02-11","2025-02-11","SF FuneralF1127818      250211","","31.63","","136222.84"
"2025-02-11","2025-02-07","SF FuneralFDC0000000B34M250207","","126.5","","136349.34"
"2025-02-11","2025-02-07","SF FuneralF833636       250207","","126.5","","136475.84"
"2025-02-11","2025-02-11","SF FuneralFDC00000006L9F250211","","31.63","","136507.47"
"2025-02-11","2025-02-11","SF FuneralFDC000000071GF250211","","63.25","","136570.72"
"2025-02-11","2025-02-11","SF FuneralF806032       250211","","31.63","","136602.35"
"2025-02-11","2025-02-11","SF FuneralFDC0000000BP65250211","","63.25","","136665.6"
"2025-02-11","2025-02-11","SF FuneralFDC0000000HQB5250211","","31.63","","136697.23"
"2025-02-11","2025-02-10","SF FuneralFDC0000000PYQW250210","","126.5","","136823.73"
"2025-02-11","2025-02-11","SF FuneralFDC000000079QY250211","","31.63","","136855.36"
"2025-02-11","2025-02-11","SF FuneralFDC000000080WH250211","","31.63","","136886.99"
"2025-02-11","2025-02-11","SF FuneralF802375       250211","","31.63","","136918.62"
"2025-02-11","2025-02-11","SF FuneralF816802       250211","","31.63","","136950.25"
"2025-02-11","2025-02-11","SF FuneralF831106       250211","","31.63","","136981.88"
"2025-02-11","2025-02-11","SF FuneralF990232       250211","","31.63","","137013.51"
"2025-02-11","2025-02-11","SF FuneralFDC0000000KQ5F250211","","31.63","","137045.14"
"2025-02-11","2025-02-11","SF FuneralF1065982      250211","","31.63","","137076.77"
"2025-02-11","2025-02-11","SF FuneralF1068221      250211","","31.63","","137108.4"
"2025-02-11","2025-02-11","SF FuneralF1074649      250211","","31.63","","137140.03"
"2025-02-11","2025-02-11","SF FuneralF1080280      250211","","63.25","","137203.28"
"2025-02-11","2025-02-11","SF FuneralF1020916      250211","","31.63","","137234.91"
"2025-02-11","2025-02-11","SF FuneralF1115126      250211","","63.25","","137298.16"
"2025-02-11","2025-02-11","SF FuneralF1127485      250211","","31.63","","137329.79"
"2025-02-11","2025-02-11","SF FuneralF1129103      250211","","31.63","","137361.42"
"2025-02-11","2025-02-07","SF FuneralF986938       250207","","126.5","","137487.92"
"2025-02-11","2025-02-10","SF FuneralF790662       250210","","126.5","","137614.42"
"2025-02-11","2025-02-11","SF FuneralF804091       250211","","31.63","","137646.05"
"2025-02-11","2025-02-11","SF FuneralF1061069      250211","","31.63","","137677.68"
"2025-02-11","2025-02-11","SF FuneralF1111603      250211","","31.63","","137709.31"
"2025-02-11","2025-02-11","SF FuneralF1123455      250211","","126.5","","137835.81"
"2025-02-11","2025-02-07","Rev SF FuneralFDC0000000L3MT250207","","-31.63","","137804.18"
"2025-02-11","2025-02-07","Rev SF FuneralFDC00000007MW5250207","","-31.63","","137772.55"
"2025-02-11","2025-02-10","Rev SF FuneralFDC0000000F3H4250210","","-31.63","","137740.92"
"2025-02-11","2025-02-07","Rev SF FuneralFDC00000007WBL250207","","-31.63","","137709.29"
"2025-02-11","2025-02-04","Rev SF FuneralFDC0000000JHBW250204","","-31.63","","137677.66"
"2025-02-11","2025-02-07","Rev SF FuneralFDC0000000JXHW250207","","-126.5","","137551.16"
"2025-02-11","2025-02-01","Rev SF FuneralFDC00000007W2J250201","","-126.5","","137424.66"
"2025-02-11","2025-02-03","Rev SF FuneralFDC00000007M2D250202","","-63.25","","137361.41"
"2025-02-11","2025-02-10","SF FuneralFDC00000005F1K250210","","31.63","","137393.04"
"2025-02-11","2025-02-10","SF FuneralF831977       250209","","126.5","","137519.54"
"2025-02-11","2025-02-11","SF FuneralFDC00000006SSB250211","","31.63","","137551.17"
"2025-02-11","2025-02-11","SF FuneralFDC00000006ST9250211","","31.63","","137582.8"
"2025-02-11","2025-02-11","SF FuneralFDC00000006STJ250211","","31.63","","137614.43"
"2025-02-11","2025-01-22","Rev SF FuneralFDC0000000B4NX250122","","-126.5","","137487.93"
"2025-02-11","2025-02-11","SF FuneralFDC00000005PFJ250211","","31.63","","137519.56"
"2025-02-11","2025-02-11","SF FuneralF981451       250211","","31.63","","137551.19"
"2025-02-11","2025-02-11","Fee-Teller Transactions","","-9.96","","137541.23"
"2025-02-11","2025-02-11","Dep-Cash-6010245805083","","63.5","9.96","137604.73"
"2025-02-11","2025-02-03","SF FuneralF994127       250203","","63.25","","137667.98"
"2025-02-11","2025-02-04","SF FuneralF1118364      250204","","63.25","","137731.23"
"2025-02-11","2025-02-06","SF FuneralFDC00000006Q3V250206","","31.63","","137762.86"
"2025-02-11","2025-02-07","SF FuneralFDC000000072CV250207","","126.5","","137889.36"
"2025-02-11","2025-02-08","SF FuneralFDC00000005FXR250208","","63.25","","137952.61"
"2025-02-11","2025-02-08","SF FuneralFDC00000007445250208","","63.25","","138015.86"
"2025-02-11","2025-02-08","SF FuneralFDC0000000NLY9250208","","31.63","","138047.49"
"2025-02-11","2025-02-08","SF FuneralF1117993      250208","","31.63","","138079.12"
"2025-02-11","2025-02-10","SF FuneralF819085       250210","","63.25","","138142.37"
"2025-02-11","2025-02-07","SF FuneralF990787       250208","","31.63","","138174"
"2025-02-11","2025-02-08","SF FuneralF1123126      250208","","31.63","","138205.63"
"2025-02-11","2025-02-11","SF FuneralF834400       250211","","126.5","","138332.13"
"2025-02-11","2025-02-11","Rev SF FuneralFDC00000005L57250211","","-31.63","","138300.5"
"2025-02-11","2025-02-11","Rev SF FuneralFDC00000005PFJ250211","","-31.63","","138268.87"
"2025-02-11","2025-02-11","Rev SF FuneralFDC00000006ST9250211","","-31.63","","138237.24"
"2025-02-11","2025-02-07","Rev SF FuneralFDC0000000K7CQ250207","","-31.63","","138205.61"
"2025-02-11","2025-02-11","Rev SF FuneralFDC00000006STJ250211","","-31.63","","138173.98"
"2025-02-11","2025-02-11","Rev SF FuneralFDC0000000HN9N250211","","-31.63","","138142.35"
"2025-02-11","2024-12-19","Rev SF FuneralFDC00000007HMX241219","","-126.5","","138015.85"
"2025-02-11","2025-01-24","Rev SF FuneralF1119068      250127","","-126.5","","137889.35"
"2025-02-11","2025-01-24","Rev SF FuneralF1123611      250127","","-126.5","","137762.85"
"2025-02-11","2024-12-11","Rev SF FuneralF1119068      241227","","-126.5","","137636.35"
"2025-02-11","2025-02-11","Rev SF FuneralFDC0000000G5YG250211","","-126.5","","137509.85"
"2025-02-11","2025-02-08","Rev SF FuneralFDC00000005FXR250208","","-63.25","","137446.6"
"2025-02-11","2025-02-07","Rev SF FuneralFDC000000072CV250207","","-126.5","","137320.1"
"2025-02-11","2025-02-10","SF FuneralFDC0000000P5BP250210","","126.5","","137446.6"
"2025-02-11","2025-01-24","Rev SF FuneralFDC00000006921250128","","-213.31","","137233.29"
