"Txn date","Effective","Description","Truncated card number","Amount","Charges","Balance"
"2025-02-23","2025-02-17","SF FuneralF1068208      250217","","126.5","","438797.91"
"2025-02-23","2025-02-17","SF FuneralFDC0000000LJ60250217","","31.63","","438829.54"
"2025-02-23","2025-02-18","SF FuneralFDC0000000317Z250218","","220","","439049.54"
"2025-02-23","2025-02-18","SF FuneralF831226       250218","","31.63","","439081.17"
"2025-02-23","2025-02-21","SF FuneralFDC00000006Z5Z250221","","126.5","","439207.67"
"2025-02-23","2025-02-21","SF FuneralF900608       250221","","31.63","","439239.3"
"2025-02-23","2025-02-21","SF FuneralF1073760      250221","","126.5","","439365.8"
"2025-02-23","2025-02-22","SF FuneralFDC00000006105250222","","126.5","","439492.3"
"2025-02-23","2025-02-22","SF FuneralFDC000000061GM250222","","126.5","","439618.8"
"2025-02-23","2025-02-22","SF FuneralFDC000000063FL250222","","126.5","","439745.3"
"2025-02-23","2025-02-22","SF FuneralFDC00000007L73250222","","126.5","","439871.8"
"2025-02-23","2025-02-22","SF FuneralFDC00000007RT9250222","","126.5","","439998.3"
"2025-02-23","2025-02-22","SF FuneralFDC000000080Y6250222","","126.5","","440124.8"
"2025-02-23","2025-02-22","SF FuneralF799644       250222","","126.5","","440251.3"
"2025-02-23","2025-02-22","SF FuneralF810047       250222","","126.5","","440377.8"
"2025-02-23","2025-02-22","SF FuneralF814925       250222","","126.5","","440504.3"
"2025-02-23","2025-02-22","SF FuneralFDC0000000C4G1250222","","126.5","","440630.8"
"2025-02-23","2025-02-22","SF FuneralF1017658      250222","","126.5","","440757.3"
"2025-02-23","2025-02-22","SF FuneralF1080302      250222","","126.5","","440883.8"
"2025-02-23","2025-02-22","SF FuneralF787638       250222","","191.5","","441075.3"
"2025-02-23","2025-02-22","SF FuneralFDC0000000NQZN250222","","126.5","","441201.8"
"2025-02-23","2025-02-22","SF FuneralF1125301      250222","","126.5","","441328.3"
"2025-02-23","2025-02-22","SF FuneralF1127627      250222","","126.5","","441454.8"
"2025-02-23","2025-02-22","SF FuneralF1130679      250222","","126.5","","441581.3"
"2025-02-23","2025-02-17","SF FuneralF819080       250217","","126.5","","441707.8"
"2025-02-23","2025-02-18","SF FuneralF1117887      250218","","126.5","","441834.3"
"2025-02-23","2025-02-20","SF FuneralFDC00000005RTM250220","","220","","442054.3"
"2025-02-23","2025-02-20","SF FuneralF1054882      250220","","126.5","","442180.8"
"2025-02-23","2025-02-21","SF FuneralFDC000000082WP250221","","126.5","","442307.3"
"2025-02-23","2025-02-21","SF FuneralF842750       250221","","126.5","","442433.8"
"2025-02-23","2025-02-21","SF FuneralFDC0000000J4YX250223","","126.5","","442560.3"
"2025-02-23","2025-02-22","SF FuneralFDC000000060Y7250222","","126.5","","442686.8"
"2025-02-23","2025-02-22","SF FuneralFDC00000006239250222","","126.5","","442813.3"
"2025-02-23","2025-02-22","SF FuneralFDC0000000645Q250222","","126.5","","442939.8"
"2025-02-23","2025-02-22","SF FuneralFDC00000007JRW250222","","126.5","","443066.3"
"2025-02-23","2025-02-22","SF FuneralFDC00000007S3V250222","","126.5","","443192.8"
"2025-02-23","2025-02-22","SF FuneralFDC000000085JP250222","","126.5","","443319.3"
"2025-02-23","2025-02-22","SF FuneralF800657       250222","","126.5","","443445.8"
"2025-02-23","2025-02-22","SF FuneralFDC00000008H1L250222","","126.5","","443572.3"
"2025-02-23","2025-02-22","SF FuneralFDC00000008H1M250222","","126.5","","443698.8"
"2025-02-23","2025-02-22","SF FuneralFDC00000008TQS250222","","126.5","","443825.3"
"2025-02-23","2025-02-22","SF FuneralF810029       250222","","126.5","","443951.8"
"2025-02-23","2025-02-22","SF FuneralF812459       250222","","126.5","","444078.3"
"2025-02-23","2025-02-22","SF FuneralFDC00000009H4P250222","","126.5","","444204.8"
"2025-02-23","2025-02-22","SF FuneralF1074447      250222","","126.5","","444331.3"
"2025-02-23","2025-02-22","SF FuneralFDC0000000L9D1250222","","126.5","","444457.8"
"2025-02-23","2025-02-22","SF FuneralF1113796      250223","","126.5","","444584.3"
"2025-02-23","2025-02-22","SF FuneralF1116719      250222","","126.5","","444710.8"
"2025-02-23","2025-02-22","SF FuneralF1119891      250222","","126.5","","444837.3"
"2025-02-23","2025-02-22","SF FuneralF1132093      250222","","126.5","","444963.8"
"2025-02-23","2025-02-20","SF FuneralF1079649      250220","","126.5","","445090.3"
"2025-02-23","2025-02-22","SF FuneralFDC000000039N2250222","","220","","445310.3"
"2025-02-23","2025-02-22","SF FuneralFDC00000005LX4250222","","126.5","","445436.8"
"2025-02-23","2025-02-22","SF FuneralFDC00000007KSY250222","","126.5","","445563.3"
"2025-02-23","2025-02-22","SF FuneralF801328       250222","","126.5","","445689.8"
"2025-02-23","2025-02-22","SF FuneralF801823       250222","","126.5","","445816.3"
"2025-02-23","2025-02-22","SF FuneralF805495       250222","","126.5","","445942.8"
"2025-02-23","2025-02-22","SF FuneralF831142       250222","","126.5","","446069.3"
"2025-02-23","2025-02-22","SF FuneralF1061821      250222","","126.5","","446195.8"
"2025-02-23","2025-02-22","SF FuneralF1075052      250222","","126.5","","446322.3"
"2025-02-23","2025-02-22","SF FuneralFDC00000005SB0250222","","126.5","","446448.8"
"2025-02-23","2025-02-22","SF FuneralFDC00000006WK6250222","","126.5","","446575.3"
"2025-02-23","2025-02-22","SF FuneralF801335       250222","","126.5","","446701.8"
"2025-02-23","2025-02-22","SF FuneralF805946       250222","","126.5","","446828.3"
"2025-02-23","2025-02-22","SF FuneralF815673       250222","","126.5","","446954.8"
"2025-02-23","2025-02-22","SF FuneralF1116702      250222","","126.5","","447081.3"
"2025-02-23","2025-02-22","SF FuneralF1122295      250223","","31.63","","447112.93"
"2025-02-23","2025-02-22","SF FuneralF1128782      250222","","126.5","","447239.43"
"2025-02-23","2025-02-23","SF FuneralF815217       250223","","126.5","","447365.93"
"2025-02-23","2025-02-23","SF FuneralF833253       250223","","31.63","","447397.56"
"2025-02-23","2025-02-19","SF FuneralF1054817      250219","","126.5","","447524.06"
"2025-02-23","2025-02-22","SF FuneralFDC000000072RJ250222","","126.5","","447650.56"
"2025-02-23","2025-02-17","SF FuneralFDC00000006YHX250216","","126.5","","447777.06"
"2025-02-23","2025-02-20","SF FuneralF832011       250220","","63.25","","447840.31"
"2025-02-23","2025-02-21","SF FuneralFDC00000005ZDV250221","","126.5","","447966.81"
"2025-02-23","2025-02-21","SF FuneralF988622       250222","","126.5","","448093.31"
"2025-02-23","2025-02-21","SF FuneralFDC0000000HYGH250222","","126.5","","448219.81"
"2025-02-23","2025-02-21","SF FuneralF989474       250222","","126.5","","448346.31"
"2025-02-23","2025-02-22","SF FuneralFDC00000005K6L250222","","126.5","","448472.81"
"2025-02-23","2025-02-22","SF FuneralFDC00000006JRS250222","","126.5","","448599.31"
"2025-02-23","2025-02-22","SF FuneralFDC00000006T7F250222","","126.5","","448725.81"
"2025-02-23","2025-02-22","SF FuneralFDC00000006YY1250222","","126.5","","448852.31"
"2025-02-23","2025-02-22","SF FuneralFDC0000000J589250222","","126.5","","448978.81"
"2025-02-23","2025-02-22","SF FuneralFDC0000000J5BL250222","","126.5","","449105.31"
"2025-02-23","2025-02-22","SF FuneralFDC0000000J5CV250222","","126.5","","449231.81"
"2025-02-23","2025-02-22","SF FuneralF1122378      250223","","126.5","","449358.31"
"2025-02-23","2025-02-22","SF FuneralF1131347      250222","","126.5","","449484.81"
"2025-02-23","2025-02-22","SF FuneralF1132319      250223","","126.5","","449611.31"
"2025-02-23","2025-02-22","SF FuneralF1124369      250223","","126.5","","449737.81"
"2025-02-23","2025-02-22","SF FuneralF833223       250222","","126.5","","449864.31"
"2025-02-24","2025-02-22","SF FuneralFDC00000005YFY250222","","126.5","","449990.81"
"2025-02-24","2025-02-22","SF FuneralFDC00000005YMD250222","","126.5","","450117.31"
"2025-02-24","2025-02-22","SF FuneralFDC0000000CV68250222","","126.5","","450243.81"
"2025-02-24","2025-02-22","SF FuneralF1123201      250222","","126.5","","450370.31"
"2025-02-24","2025-02-22","SF FuneralFDC00000005YYY250222","","126.5","","450496.81"
"2025-02-24","2025-02-22","SF FuneralFDC000000069FB250222","","126.5","","450623.31"
"2025-02-24","2025-02-22","SF FuneralF1062674      250222","","126.5","","450749.81"
"2025-02-24","2025-02-22","SF FuneralF1124196      250222","","126.5","","450876.31"
"2025-02-24","2025-02-20","SF FuneralF1124328      250220","","31.63","","450907.94"
"2025-02-24","2025-02-22","SF FuneralF805460       250222","","126.5","","451034.44"
"2025-02-24","2025-02-22","SF FuneralF1132291      250222","","126.5","","451160.94"
"2025-02-24","2025-02-21","SF FuneralF814745       250221","","126.5","","451287.44"
"2025-02-24","2025-02-19","SF FuneralF806026       250219","","126.5","","451413.94"
"2025-02-24","2025-02-22","SF FuneralFDC00000008HLZ250222","","126.5","","451540.44"
"2025-02-24","2025-02-18","SF FuneralF1104197      250218","","31.63","","451572.07"
"2025-02-24","2025-02-20","SF FuneralF1085168      250220","","31.63","","451603.7"
"2025-02-24","2025-02-20","SF FuneralF1108113      250220","","31.63","","451635.33"
"2025-02-24","2025-02-21","SF FuneralFDC00000005GY1250221","","31.63","","451666.96"
"2025-02-24","2025-02-21","SF FuneralFDC00000005PXF250221","","31.63","","451698.59"
"2025-02-24","2025-02-21","SF FuneralFDC00000005QCT250221","","31.63","","451730.22"
"2025-02-24","2025-02-21","SF FuneralFDC00000005V4S250221","","31.63","","451761.85"
"2025-02-24","2025-02-21","SF FuneralFDC000000069RZ250221","","31.63","","451793.48"
"2025-02-24","2025-02-21","SF FuneralFDC00000006FQ9250221","","31.63","","451825.11"
"2025-02-24","2025-02-21","SF FuneralFDC00000006R81250221","","31.63","","451856.74"
"2025-02-24","2025-02-21","SF FuneralFDC00000007WBL250221","","31.63","","451888.37"
"2025-02-24","2025-02-21","SF FuneralFDC00000007WJL250221","","31.63","","451920"
"2025-02-24","2025-02-21","SF FuneralF795812       250221","","31.63","","451951.63"
"2025-02-24","2025-02-21","SF FuneralFDC000000086Y9250221","","31.63","","451983.26"
"2025-02-24","2025-02-21","SF FuneralF790399       250221","","47.88","","452031.14"
"2025-02-24","2025-02-21","SF FuneralF811119       250221","","31.63","","452062.77"
"2025-02-24","2025-02-21","SF FuneralF815340       250221","","31.63","","452094.4"
"2025-02-24","2025-02-21","SF FuneralF815510       250221","","31.63","","452126.03"
"2025-02-24","2025-02-21","SF FuneralF817463       250221","","31.63","","452157.66"
"2025-02-24","2025-02-21","SF FuneralFDC0000000B37Y250221","","31.63","","452189.29"
"2025-02-24","2025-02-21","SF FuneralF823750       250221","","31.63","","452220.92"
"2025-02-24","2025-02-21","SF FuneralF829118       250221","","31.63","","452252.55"
"2025-02-24","2025-02-21","SF FuneralF830931       250221","","31.63","","452284.18"
"2025-02-24","2025-02-21","SF FuneralF832185       250221","","31.63","","452315.81"
"2025-02-24","2025-02-21","SF FuneralF832777       250221","","31.63","","452347.44"
"2025-02-24","2025-02-21","SF FuneralF819053       250221","","31.63","","452379.07"
"2025-02-24","2025-02-21","SF FuneralF843596       250221","","31.63","","452410.7"
"2025-02-24","2025-02-21","SF FuneralFDC0000000FQWF250221","","31.63","","452442.33"
"2025-02-24","2025-02-21","SF FuneralF844636       250221","","31.63","","452473.96"
"2025-02-24","2025-02-21","SF FuneralFDC0000000HBD0250221","","31.63","","452505.59"
"2025-02-24","2025-02-21","SF FuneralF774474       250221","","156.28","","452661.87"
"2025-02-24","2025-02-21","SF FuneralFDC0000000HXHK250221","","47.88","","452709.75"
"2025-02-24","2025-02-21","SF FuneralFDC0000000J2XM250223","","31.63","","452741.38"
"2025-02-24","2025-02-21","SF FuneralF992752       250221","","31.63","","452773.01"
"2025-02-24","2025-02-21","SF FuneralFDC0000000JFC4250221","","31.63","","452804.64"
"2025-02-24","2025-02-21","SF FuneralF1033620      250221","","31.63","","452836.27"
"2025-02-24","2025-02-21","SF FuneralF1052348      250221","","31.63","","452867.9"
"2025-02-24","2025-02-21","SF FuneralFDC0000000K7CQ250221","","31.63","","452899.53"
"2025-02-24","2025-02-21","SF FuneralFDC0000000KLCD250221","","31.63","","452931.16"
"2025-02-24","2025-02-21","SF FuneralF1061613      250221","","31.63","","452962.79"
"2025-02-24","2025-02-21","SF FuneralF1065649      250221","","31.63","","452994.42"
"2025-02-24","2025-02-21","SF FuneralF1068145      250221","","31.63","","453026.05"
"2025-02-24","2025-02-21","SF FuneralF1072884      250221","","31.63","","453057.68"
"2025-02-24","2025-02-21","SF FuneralF1073030      250221","","31.63","","453089.31"
"2025-02-24","2025-02-21","SF FuneralFDC0000000L3MT250221","","31.63","","453120.94"
"2025-02-24","2025-02-21","SF FuneralF1078056      250221","","31.63","","453152.57"
"2025-02-24","2025-02-21","SF FuneralFDC0000000LMH8250221","","31.63","","453184.2"
"2025-02-24","2025-02-21","SF FuneralF1080183      250221","","31.63","","453215.83"
"2025-02-24","2025-02-21","SF FuneralF1084400      250221","","31.63","","453247.46"
"2025-02-24","2025-02-21","SF FuneralF1085355      250221","","31.63","","453279.09"
"2025-02-24","2025-02-21","SF FuneralF1104196      250221","","31.63","","453310.72"
"2025-02-24","2025-02-21","SF FuneralF1104243      250221","","31.63","","453342.35"
"2025-02-24","2025-02-21","SF FuneralF1104285      250221","","31.63","","453373.98"
"2025-02-24","2025-02-21","SF FuneralF1111672      250221","","31.63","","453405.61"
"2025-02-24","2025-02-21","SF FuneralFDC0000000N3BG250221","","31.63","","453437.24"
"2025-02-24","2025-02-21","SF FuneralF1115119      250221","","31.63","","453468.87"
"2025-02-24","2025-02-21","SF FuneralF1120399      250221","","31.63","","453500.5"
"2025-02-24","2025-02-21","SF FuneralF1122752      250221","","31.63","","453532.13"
"2025-02-24","2025-02-21","SF FuneralF1123008      250221","","31.63","","453563.76"
"2025-02-24","2025-02-21","SF FuneralF1123947      250221","","31.63","","453595.39"
"2025-02-24","2025-02-21","SF FuneralF1126287      250221","","31.63","","453627.02"
"2025-02-24","2025-02-21","SF FuneralF1127351      250221","","31.63","","453658.65"
"2025-02-24","2025-02-21","SF FuneralF1130222      250221","","31.63","","453690.28"
"2025-02-24","2025-02-21","SF FuneralF1130338      250221","","31.63","","453721.91"
"2025-02-24","2025-02-21","SF FuneralF1130369      250221","","31.63","","453753.54"
"2025-02-24","2025-02-21","SF FuneralF1130684      250221","","31.63","","453785.17"
"2025-02-24","2025-02-21","SF FuneralF1131924      250221","","31.63","","453816.8"
"2025-02-24","2025-02-21","SF FuneralFDC0000000Q7FQ250221","","31.63","","453848.43"
"2025-02-24","2025-02-21","SF FuneralF1132194      250221","","31.63","","453880.06"
"2025-02-24","2025-02-21","SF FuneralF1132265      250221","","31.63","","453911.69"
"2025-02-24","2025-02-22","SF FuneralFDC00000006HHY250222","","31.63","","453943.32"
"2025-02-24","2025-02-22","SF FuneralFDC00000007G0S250222","","31.63","","453974.95"
"2025-02-24","2025-02-22","SF FuneralF1060024      250222","","31.63","","454006.58"
"2025-02-24","2025-02-24","SF FuneralFDC00000005LS9250224","","31.63","","454038.21"
"2025-02-24","2025-02-24","SF FuneralFDC00000005N4P250224","","31.63","","454069.84"
"2025-02-24","2025-02-24","SF FuneralFDC00000005RZQ250224","","31.63","","454101.47"
"2025-02-24","2025-02-24","SF FuneralFDC00000007GS9250224","","31.63","","454133.1"
"2025-02-24","2025-02-24","SF FuneralF986911       250224","","31.63","","454164.73"
"2025-02-24","2025-02-24","SF FuneralF987310       250224","","31.63","","454196.36"
"2025-02-24","2025-02-24","SF FuneralF1017111      250224","","31.63","","454227.99"
"2025-02-24","2025-02-24","SF FuneralF1052717      250224","","31.63","","454259.62"
"2025-02-24","2025-02-24","SF FuneralF1117412      250224","","31.63","","454291.25"
"2025-02-24","2025-02-24","SF FuneralF1117767      250224","","31.63","","454322.88"
"2025-02-24","2025-02-24","SF FuneralF1118181      250224","","31.63","","454354.51"
"2025-02-24","2025-02-24","SF FuneralF1124411      250224","","31.63","","454386.14"
"2025-02-24","2025-02-24","SF FuneralF1129452      250224","","31.63","","454417.77"
"2025-02-24","2025-02-24","SF FuneralFDC0000000376D250224","","55","","454472.77"
"2025-02-24","2025-02-24","SF FuneralFDC00000005F1K250224","","31.63","","454504.4"
"2025-02-24","2025-02-24","SF FuneralFDC00000005NT1250224","","31.63","","454536.03"
"2025-02-24","2025-02-24","SF FuneralFDC00000007BGG250223","","31.63","","454567.66"
"2025-02-24","2025-02-24","SF FuneralFDC000000086PW250223","","31.63","","454599.29"
"2025-02-24","2025-02-24","SF FuneralFDC000000086PX250223","","31.63","","454630.92"
"2025-02-24","2025-02-24","SF FuneralF831617       250224","","31.63","","454662.55"
"2025-02-24","2025-02-24","SF FuneralF1108567      250224","","31.63","","454694.18"
"2025-02-24","2025-02-24","SF FuneralF1117477      250224","","31.63","","454725.81"
"2025-02-24","2025-02-24","SF FuneralF1128005      250224","","31.63","","454757.44"
"2025-02-24","2025-02-24","SF FuneralF987064       250224","","126.5","","454883.94"
"2025-02-24","2025-02-24","SF FuneralFDC0000000JC4J250224","","126.5","","455010.44"
"2025-02-24","2025-02-24","SF FuneralF1112428      250224","","126.5","","455136.94"
"2025-02-24","2025-02-24","SF FuneralF1132067      250224","","63.25","","455200.19"
"2025-02-24","2025-02-17","SF FuneralFDC00000005R60250217","","126.5","","455326.69"
"2025-02-24","2025-02-17","SF FuneralFDC0000000PHBH250217","","126.5","","455453.19"
"2025-02-24","2025-02-19","SF FuneralF980614       250219","","126.5","","455579.69"
"2025-02-24","2025-02-20","SF FuneralFDC00000005XTB250220","","126.5","","455706.19"
"2025-02-24","2025-02-20","SF FuneralFDC00000005XWD250220","","126.5","","455832.69"
"2025-02-24","2025-02-20","SF FuneralFDC00000005YBX250220","","126.5","","455959.19"
"2025-02-24","2025-02-20","SF FuneralFDC00000005ZWQ250220","","126.5","","456085.69"
"2025-02-24","2025-02-20","SF FuneralFDC00000006571250220","","126.5","","456212.19"
"2025-02-24","2025-02-20","SF FuneralFDC00000006NRK250220","","191.5","","456403.69"
"2025-02-24","2025-02-20","SF FuneralFDC00000007TDY250220","","126.5","","456530.19"
"2025-02-24","2025-02-20","SF FuneralFDC000000081LH250220","","126.5","","456656.69"
"2025-02-24","2025-02-20","SF FuneralFDC00000008HV1250220","","126.5","","456783.19"
"2025-02-24","2025-02-20","SF FuneralFDC00000008VQQ250220","","126.5","","456909.69"
"2025-02-24","2025-02-20","SF FuneralFDC00000008X0L250220","","126.5","","457036.19"
"2025-02-24","2025-02-20","SF FuneralFDC0000000B3QN250220","","126.5","","457162.69"
"2025-02-24","2025-02-20","SF FuneralF901253       250220","","126.5","","457289.19"
"2025-02-24","2025-02-20","SF FuneralF1108151      250220","","126.5","","457415.69"
"2025-02-24","2025-02-20","SF FuneralF1108922      250220","","126.5","","457542.19"
"2025-02-24","2025-02-20","SF FuneralF1112198      250220","","126.5","","457668.69"
"2025-02-24","2025-02-20","SF FuneralF1124829      250220","","126.5","","457795.19"
"2025-02-24","2025-02-21","SF FuneralFDC000000030TV250221","","220","","458015.19"
"2025-02-24","2025-02-21","SF FuneralFDC0000000387Y250221","","220","","458235.19"
"2025-02-24","2025-02-21","SF FuneralFDC00000005YCK250221","","126.5","","458361.69"
"2025-02-24","2025-02-21","SF FuneralFDC000000061BF250221","","126.5","","458488.19"
"2025-02-24","2025-02-21","SF FuneralFDC00000007QP1250221","","126.5","","458614.69"
"2025-02-24","2025-02-21","SF FuneralFDC000000087ZF250221","","126.5","","458741.19"
"2025-02-24","2025-02-21","SF FuneralF812915       250221","","126.5","","458867.69"
"2025-02-24","2025-02-21","SF FuneralF785875       250221","","451.5","","459319.19"
"2025-02-24","2025-02-21","SF FuneralFDC0000000BH7D250221","","126.5","","459445.69"
"2025-02-24","2025-02-21","SF FuneralF989666       250222","","126.5","","459572.19"
"2025-02-24","2025-02-21","SF FuneralF1111957      250221","","126.5","","459698.69"
"2025-02-24","2025-02-21","SF FuneralFDC0000000N3BQ250221","","126.5","","459825.19"
"2025-02-24","2025-02-21","SF FuneralF1112578      250221","","126.5","","459951.69"
"2025-02-24","2025-02-21","SF FuneralF1115784      250221","","126.5","","460078.19"
"2025-02-24","2025-02-21","SF FuneralF1130767      250221","","126.5","","460204.69"
"2025-02-24","2025-02-21","SF FuneralF1132250      250221","","126.5","","460331.19"
"2025-02-24","2025-02-22","SF FuneralFDC0000000308B250222","","220","","460551.19"
"2025-02-24","2025-02-22","SF FuneralFDC00000005FXR250222","","63.25","","460614.44"
"2025-02-24","2025-02-22","SF FuneralFDC00000005ZTF250222","","126.5","","460740.94"
"2025-02-24","2025-02-22","SF FuneralFDC00000006CQ6250222","","126.5","","460867.44"
"2025-02-24","2025-02-22","SF FuneralFDC00000006SVG250222","","126.5","","460993.94"
"2025-02-24","2025-02-22","SF FuneralFDC00000007592250222","","126.5","","461120.44"
"2025-02-24","2025-02-22","SF FuneralFDC00000008FPT250222","","126.5","","461246.94"
"2025-02-24","2025-02-22","SF FuneralF778086       250222","","191.5","","461438.44"
"2025-02-24","2025-02-22","SF FuneralF830666       250222","","126.5","","461564.94"
"2025-02-24","2025-02-22","SF FuneralF1052647      250222","","126.5","","461691.44"
"2025-02-24","2025-02-22","SF FuneralF1112188      250222","","126.5","","461817.94"
"2025-02-24","2025-02-22","SF FuneralFDC0000000NFML250222","","126.5","","461944.44"
"2025-02-24","2025-02-22","SF FuneralFDC0000000NVD4250222","","126.5","","462070.94"
"2025-02-24","2025-02-22","SF FuneralF1124390      250222","","126.5","","462197.44"
"2025-02-24","2025-02-22","SF FuneralF1131125      250222","","126.5","","462323.94"
"2025-02-24","2025-02-24","SF FuneralFDC00000005P9W250224","","126.5","","462450.44"
"2025-02-24","2025-02-24","SF FuneralFDC00000006K1N250223","","126.5","","462576.94"
"2025-02-24","2025-02-24","SF FuneralF813256       250224","","126.5","","462703.44"
"2025-02-24","2025-02-24","SF FuneralF819950       250224","","63.25","","462766.69"
"2025-02-24","2025-02-24","SF FuneralF1104033      250224","","63.25","","462829.94"
"2025-02-24","2025-02-24","SF FuneralFDC0000000M9K6250224","","63.25","","462893.19"
"2025-02-24","2025-02-24","SF FuneralFDC000000050LT250223","","126.5","","463019.69"
"2025-02-24","2025-02-24","SF FuneralFDC0000000570D250224","","126.5","","463146.19"
"2025-02-24","2025-02-24","SF FuneralFDC00000006Z5F250224","","126.5","","463272.69"
"2025-02-24","2025-02-24","SF FuneralFDC00000007L44250224","","126.5","","463399.19"
"2025-02-24","2025-02-24","SF FuneralF794288       250224","","126.5","","463525.69"
"2025-02-24","2025-02-24","SF FuneralF801478       250223","","126.5","","463652.19"
"2025-02-24","2025-02-24","SF FuneralF805058       250223","","126.5","","463778.69"
"2025-02-24","2025-02-24","SF FuneralF805647       250223","","126.5","","463905.19"
"2025-02-24","2025-02-24","SF FuneralF823087       250224","","126.5","","464031.69"
"2025-02-24","2025-02-24","SF FuneralF844118       250222","","126.5","","464158.19"
"2025-02-24","2025-02-24","SF FuneralF981550       250224","","126.5","","464284.69"
"2025-02-24","2025-02-24","SF FuneralF992458       250224","","126.5","","464411.19"
"2025-02-24","2025-02-24","SF FuneralF992520       250224","","126.5","","464537.69"
"2025-02-24","2025-02-24","SF FuneralFDC000000060QL250223","","126.5","","464664.19"
"2025-02-24","2025-02-24","SF FuneralF834561       250224","","126.5","","464790.69"
"2025-02-24","2025-02-24","SF FuneralFDC00000006KCD250223","","126.5","","464917.19"
"2025-02-24","2025-02-24","SF FuneralFDC00000006R21250224","","126.5","","465043.69"
"2025-02-24","2025-02-24","SF FuneralFDC00000006VRS250224","","126.5","","465170.19"
"2025-02-24","2025-02-24","SF FuneralFDC000000076M4250223","","126.5","","465296.69"
"2025-02-24","2025-02-24","SF FuneralFDC00000007F0W250224","","126.5","","465423.19"
"2025-02-24","2025-02-24","SF FuneralFDC00000007NXK250224","","126.5","","465549.69"
"2025-02-24","2025-02-24","SF FuneralF1108586      250224","","126.5","","465676.19"
"2025-02-24","2025-02-24","SF FuneralFDC0000000NBRX250224","","126.5","","465802.69"
"2025-02-24","2025-02-24","SF FuneralF1115885      250224","","126.5","","465929.19"
"2025-02-24","2025-02-24","SF FuneralFDC0000000NLPN250224","","63.25","","465992.44"
"2025-02-24","2025-02-24","SF FuneralFDC0000000LF3C250224","","126.5","","466118.94"
"2025-02-24","2025-02-21","SF FuneralFDC00000005CSP250221","","63.25","","466182.19"
"2025-02-24","2025-02-24","SF FuneralF805990       250224","","126.5","","466308.69"
"2025-02-24","2025-02-24","SF FuneralFDC00000009PLP250223","","191.5","","466500.19"
"2025-02-24","2025-02-24","SF FuneralF1132407      250224","","126.5","","466626.69"
"2025-02-24","2025-02-20","SF FuneralF815134       250220","","126.5","","466753.19"
"2025-02-24","2025-02-20","SF FuneralF1020456      250220","","126.5","","466879.69"
"2025-02-24","2025-02-20","SF FuneralF1061510      250220","","126.5","","467006.19"
"2025-02-24","2025-02-20","SF FuneralF1120926      250220","","126.5","","467132.69"
"2025-02-24","2025-02-24","SF FuneralF787015       250224","","126.5","","467259.19"
"2025-02-24","2025-02-24","SF FuneralFDC0000000MR2H250224","","31.63","","467290.82"
"2025-02-24","2025-02-22","SF FuneralF1054602      250222","","126.5","","467417.32"
"2025-02-24","2025-02-22","SF FuneralFDC0000000KJN0250222","","126.5","","467543.82"
"2025-02-24","2025-02-22","SF FuneralF1060948      250222","","126.5","","467670.32"
"2025-02-24","2025-02-21","SF FuneralFDC00000005TX1250221","","31.63","","467701.95"
"2025-02-24","2025-02-21","SF FuneralFDC00000005XWC250221","","126.5","","467828.45"
"2025-02-24","2025-02-21","SF FuneralFDC00000006NFW250221","","31.63","","467860.08"
"2025-02-24","2025-02-21","SF FuneralFDC00000006NJG250221","","126.5","","467986.58"
"2025-02-24","2025-02-21","SF FuneralF779346       250221","","31.63","","468018.21"
"2025-02-24","2025-02-21","SF FuneralF980425       250222","","126.5","","468144.71"
"2025-02-24","2025-02-21","SF FuneralF987777       250221","","126.5","","468271.21"
"2025-02-24","2025-02-21","SF FuneralFDC0000000L8NN250221","","31.63","","468302.84"
"2025-02-24","2025-02-24","SF FuneralFDC000000096XP250223","","126.5","","468429.34"
"2025-02-24","2025-02-24","SF FuneralF840907       250224","","126.5","","468555.84"
"2025-02-24","2025-02-24","SF FuneralF844597       250224","","63.25","","468619.09"
"2025-02-24","2025-02-24","SF FuneralFDC0000000G827250222","","126.5","","468745.59"
"2025-02-24","2025-02-24","SF FuneralF1061017      250224","","126.5","","468872.09"
"2025-02-24","2025-02-24","SF FuneralF1131274      250224","","126.5","","468998.59"
"2025-02-24","2025-02-24","SF FuneralFDC000000060ZT250223","","126.5","","469125.09"
"2025-02-24","2025-02-24","SF FuneralFDC00000006354250224","","126.5","","469251.59"
"2025-02-24","2025-02-24","SF FuneralFDC000000089G2250223","","31.63","","469283.22"
"2025-02-24","2025-02-24","SF FuneralF814476       250224","","126.5","","469409.72"
"2025-02-24","2025-02-24","SF FuneralF1125114      250224","","31.63","","469441.35"
"2025-02-24","2025-02-24","SF FuneralF1127801      250224","","31.63","","469472.98"
"2025-02-24","2025-02-24","SF FuneralFDC00000006CWF250223","","126.5","","469599.48"
"2025-02-24","2025-02-19","SF FuneralFDC000000030VF250219","","220","","469819.48"
"2025-02-24","2025-02-20","SF FuneralFDC0000000830B250220","","126.5","","469945.98"
"2025-02-24","2025-02-20","SF FuneralF810906       250220","","126.5","","470072.48"
"2025-02-24","2025-02-20","SF FuneralF1060162      250220","","126.5","","470198.98"
"2025-02-24","2025-02-21","SF FuneralFDC00000007Q2S250221","","126.5","","470325.48"
"2025-02-24","2025-02-21","SF FuneralF842737       250221","","31.63","","470357.11"
"2025-02-24","2025-02-21","SF FuneralF1104255      250221","","31.63","","470388.74"
"2025-02-24","2025-02-21","SF FuneralF1128672      250221","","31.63","","470420.37"
"2025-02-24","2025-02-21","SF FuneralF1130638      250221","","126.5","","470546.87"
"2025-02-24","2025-02-24","SF FuneralFDC00000005HHV250224","","126.5","","470673.37"
"2025-02-24","2025-02-24","SF FuneralFDC00000005NX7250224","","31.63","","470705"
"2025-02-24","2025-02-24","SF FuneralFDC00000005S9C250224","","126.5","","470831.5"
"2025-02-24","2025-02-24","SF FuneralFDC00000005YF9250224","","126.5","","470958"
"2025-02-24","2025-02-24","SF FuneralFDC00000005Z3L250224","","31.63","","470989.63"
"2025-02-24","2025-02-24","SF FuneralFDC00000006GNR250224","","31.63","","471021.26"
"2025-02-24","2025-02-24","SF FuneralFDC00000006X6B250223","","126.5","","471147.76"
"2025-02-24","2025-02-24","SF FuneralFDC00000006XFK250224","","31.63","","471179.39"
"2025-02-24","2025-02-24","SF FuneralFDC000000072XR250224","","126.5","","471305.89"
"2025-02-24","2025-02-24","SF FuneralFDC00000007CJH250224","","126.5","","471432.39"
"2025-02-24","2025-02-24","SF FuneralFDC00000007F3C250223","","126.5","","471558.89"
"2025-02-24","2025-02-24","SF FuneralF900703       250223","","126.5","","471685.39"
"2025-02-24","2025-02-24","SF FuneralF1020845      250224","","126.5","","471811.89"
"2025-02-24","2025-02-24","SF FuneralF1073862      250224","","31.63","","471843.52"
"2025-02-24","2025-02-24","SF FuneralF1112136      250224","","31.63","","471875.15"
"2025-02-24","2025-02-24","SF FuneralF1124114      250224","","31.63","","471906.78"
"2025-02-24","2025-02-21","SF FuneralFDC00000005YCR250221","","126.5","","472033.28"
"2025-02-24","2025-02-21","SF FuneralFDC00000005YDH250221","","126.5","","472159.78"
"2025-02-24","2025-02-21","SF FuneralFDC00000007G54250221","","31.63","","472191.41"
"2025-02-24","2025-02-21","SF FuneralF805319       250221","","31.63","","472223.04"
"2025-02-24","2025-02-21","SF FuneralF821927       250221","","31.63","","472254.67"
"2025-02-24","2025-02-21","SF FuneralF827636       250221","","31.63","","472286.3"
"2025-02-24","2025-02-21","SF FuneralFDC0000000HX7W250221","","31.63","","472317.93"
"2025-02-24","2025-02-21","SF FuneralF1033849      250221","","126.5","","472444.43"
"2025-02-24","2025-02-21","SF FuneralF1123167      250221","","31.63","","472476.06"
"2025-02-24","2025-02-21","SF FuneralF1126869      250221","","31.63","","472507.69"
"2025-02-24","2025-02-24","SF FuneralFDC00000005LWP250223","","31.63","","472539.32"
"2025-02-24","2025-02-24","SF FuneralFDC000000062NY250223","","126.5","","472665.82"
"2025-02-24","2025-02-24","SF FuneralFDC0000000650X250224","","126.5","","472792.32"
"2025-02-24","2025-02-24","SF FuneralFDC000000069CL250224","","31.63","","472823.95"
"2025-02-24","2025-02-24","SF FuneralFDC00000007BF0250223","","126.5","","472950.45"
"2025-02-24","2025-02-24","SF FuneralFDC00000007CP9250223","","126.5","","473076.95"
"2025-02-24","2025-02-24","SF FuneralFDC00000008X5Z250223","","126.5","","473203.45"
"2025-02-24","2025-02-20","SF FuneralFDC00000007N8T250220","","126.5","","473329.95"
"2025-02-24","2025-02-20","SF FuneralF993140       250220","","126.5","","473456.45"
"2025-02-24","2025-02-20","SF FuneralF1083745      250220","","126.5","","473582.95"
"2025-02-24","2025-02-20","SF FuneralF1114550      250220","","126.5","","473709.45"
"2025-02-24","2025-02-20","SF FuneralF1120154      250220","","126.5","","473835.95"
"2025-02-24","2025-02-20","SF FuneralF1124014      250220","","126.5","","473962.45"
"2025-02-24","2025-02-20","SF FuneralF1128958      250220","","126.5","","474088.95"
"2025-02-24","2025-02-19","SF FuneralFDC0000000PZX0250219","","126.5","","474215.45"
"2025-02-24","2025-02-24","SF FuneralFDC00000006KG7250223","","126.5","","474341.95"
"2025-02-24","2025-02-24","SF FuneralFDC00000006W2R250224","","126.5","","474468.45"
"2025-02-24","2025-02-24","SF FuneralF812202       250224","","31.63","","474500.08"
"2025-02-24","2025-02-24","SF FuneralF847241       250222","","126.5","","474626.58"
"2025-02-24","2025-02-24","SF FuneralF1125487      250224","","31.63","","474658.21"
"2025-02-24","2025-02-19","SF FuneralFDC0000000PQ6W250219","","126.5","","474784.71"
"2025-02-24","2025-02-20","SF FuneralFDC00000007W6P250220","","126.5","","474911.21"
"2025-02-24","2025-02-20","SF FuneralF831016       250220","","126.5","","475037.71"
"2025-02-24","2025-02-20","SF FuneralF834045       250220","","126.5","","475164.21"
"2025-02-24","2025-02-21","SF FuneralFDC00000003XLZ250221","","220","","475384.21"
"2025-02-24","2025-02-21","SF FuneralFDC00000005YVL250221","","126.5","","475510.71"
"2025-02-24","2025-02-21","SF FuneralFDC00000006095250221","","126.5","","475637.21"
"2025-02-24","2025-02-21","SF FuneralFDC00000006PSF250221","","31.63","","475668.84"
"2025-02-24","2025-02-21","SF FuneralFDC00000007L1F250221","","126.5","","475795.34"
"2025-02-24","2025-02-21","SF FuneralF822267       250221","","31.63","","475826.97"
"2025-02-24","2025-02-21","SF FuneralFDC0000000L8B0250221","","31.63","","475858.6"
"2025-02-24","2025-02-21","SF FuneralF1126874      250221","","31.63","","475890.23"
"2025-02-24","2025-02-22","SF FuneralFDC00000004C5R250222","","220","","476110.23"
"2025-02-24","2025-02-22","SF FuneralFDC000000060P0250222","","126.5","","476236.73"
"2025-02-24","2025-02-22","SF FuneralF805597       250222","","126.5","","476363.23"
"2025-02-24","2025-02-22","SF FuneralF1073758      250222","","126.5","","476489.73"
"2025-02-24","2025-02-22","SF FuneralF1114549      250222","","126.5","","476616.23"
"2025-02-24","2025-02-22","SF FuneralF1123195      250223","","126.5","","476742.73"
"2025-02-24","2025-02-22","SF FuneralF1124371      250222","","126.5","","476869.23"
"2025-02-24","2025-02-24","SF FuneralFDC000000036YQ250224","","220","","477089.23"
"2025-02-24","2025-02-24","SF FuneralFDC00000005F2L250223","","126.5","","477215.73"
"2025-02-24","2025-02-24","SF FuneralFDC00000005H8J250223","","31.63","","477247.36"
"2025-02-24","2025-02-24","SF FuneralFDC00000007MJH250224","","126.5","","477373.86"
"2025-02-24","2025-02-24","SF FuneralF789266       250224","","126.5","","477500.36"
"2025-02-24","2025-02-24","SF FuneralF843497       250222","","126.5","","477626.86"
"2025-02-24","2025-02-24","SF FuneralF1122772      250224","","126.5","","477753.36"
"2025-02-24","2025-02-20","Rev SF FuneralFDC0000000807N250220","","-126.5","","477626.86"
"2025-02-24","2025-02-21","Rev SF FuneralFDC00000007MLR250221","","-126.5","","477500.36"
"2025-02-24","2025-02-12","Rev SF FuneralFDC00000006997250212","","-126.5","","477373.86"
"2025-02-24","2025-02-12","Rev SF FuneralFDC00000006998250212","","-126.5","","477247.36"
"2025-02-24","2024-12-11","Rev SF FuneralF1122675      241222","","-126.5","","477120.86"
"2025-02-24","2025-02-21","Rev SF FuneralFDC0000000D8C4250221","","-126.5","","476994.36"
"2025-02-24","2025-02-18","Rev SF FuneralFDC00000005XGZ250218","","-126.5","","476867.86"
"2025-02-24","2025-02-22","Rev SF FuneralFDC00000005FWB250222","","-126.5","","476741.36"
"2025-02-24","2025-02-22","Rev SF FuneralFDC00000008TQS250222","","-126.5","","476614.86"
"2025-02-24","2025-02-22","Rev SF FuneralFDC0000000645Q250222","","-126.5","","476488.36"
"2025-02-24","2025-02-22","Rev SF FuneralFDC0000000NQZN250222","","-126.5","","476361.86"
"2025-02-24","2025-02-22","Rev SF FuneralFDC00000007JR4250222","","-126.5","","476235.36"
"2025-02-24","2025-02-22","Rev SF FuneralFDC00000008H1L250222","","-126.5","","476108.86"
"2025-02-24","2025-02-22","Rev SF FuneralFDC000000080Y6250222","","-126.5","","475982.36"
"2025-02-24","2025-02-22","Rev SF FuneralFDC00000008H1M250222","","-126.5","","475855.86"
"2025-02-24","2025-02-22","Rev SF FuneralFDC000000085JP250222","","-126.5","","475729.36"
"2025-02-24","2025-02-22","Rev SF FuneralFDC00000009H4P250222","","-126.5","","475602.86"
"2025-02-24","2025-02-22","Rev SF FuneralFDC00000007S3V250222","","-126.5","","475476.36"
"2025-02-24","2025-01-24","Rev SF FuneralFDC000000076JB250128","","-126.5","","475349.86"
"2025-02-24","2025-02-18","Rev SF FuneralFDC0000000NRVB250218","","-31.63","","475318.23"
"2025-02-24","2025-02-17","Rev SF FuneralFDC0000000LJ60250217","","-31.63","","475286.6"
"2025-02-24","2025-02-18","Rev SF FuneralFDC0000000BJ3M250218","","-63.25","","475223.35"
"2025-02-24","2025-02-21","Rev SF FuneralFDC0000000HRQH250222","","-126.5","","475096.85"
"2025-02-24","2025-02-21","Rev SF FuneralFDC0000000HYGH250222","","-126.5","","474970.35"
"2025-02-24","2025-02-22","Rev SF FuneralFDC0000000J589250222","","-126.5","","474843.85"
"2025-02-24","2025-02-22","Rev SF FuneralFDC0000000KDK6250222","","-126.5","","474717.35"
"2025-02-24","2025-02-22","Rev SF FuneralFDC000000063FL250222","","-126.5","","474590.85"
"2025-02-24","2025-02-22","Rev SF FuneralFDC00000006T7F250222","","-126.5","","474464.35"
"2025-02-24","2025-02-22","Rev SF FuneralFDC00000005SB0250222","","-126.5","","474337.85"
"2025-02-24","2025-02-22","Rev SF FuneralFDC00000006YY1250222","","-126.5","","474211.35"
"2025-02-24","2025-02-22","Rev SF FuneralFDC0000000J5BL250222","","-126.5","","474084.85"
"2025-02-24","2025-02-22","Rev SF FuneralFDC0000000J5CV250222","","-126.5","","473958.35"
"2025-02-24","2025-02-22","Rev SF FuneralFDC00000007DYW250222","","-126.5","","473831.85"
"2025-02-24","2025-02-22","Rev SF FuneralFDC0000000NVD4250222","","-126.5","","473705.35"
"2025-02-24","2025-02-20","Rev SF FuneralFDC00000005WC5250220","","-126.5","","473578.85"
"2025-02-24","2025-02-20","Rev SF FuneralFDC00000005RTM250220","","-220","","473358.85"
"2025-02-24","2025-02-22","SF FuneralFDC00000008M85250222","","126.5","","473485.35"
"2025-02-24","2025-02-21","SF FuneralF1124386      250221","","126.5","","473611.85"
"2025-02-24","2025-02-15","SF FuneralFDC000000036YT250215","","220","","473831.85"
"2025-02-24","2025-02-17","SF FuneralFDC0000000Q451250217","","126.5","","473958.35"
"2025-02-24","2025-02-21","SF FuneralFDC00000007KFP250221","","126.5","","474084.85"
"2025-02-24","2025-02-22","SF FuneralFDC000000060KM250222","","126.5","","474211.35"
"2025-02-24","2025-02-22","SF FuneralFDC000000081Y8250222","","126.5","","474337.85"
"2025-02-24","2025-02-22","SF FuneralF815402       250222","","126.5","","474464.35"
"2025-02-24","2025-02-22","SF FuneralF830990       250222","","126.5","","474590.85"
"2025-02-24","2025-02-22","SF FuneralF842381       250222","","126.5","","474717.35"
"2025-02-24","2025-02-22","SF FuneralF993080       250222","","126.5","","474843.85"
"2025-02-24","2025-02-22","SF FuneralF1033627      250222","","126.5","","474970.35"
"2025-02-24","2025-02-22","SF FuneralF1054796      250222","","126.5","","475096.85"
"2025-02-24","2025-02-22","SF FuneralF1065838      250222","","126.5","","475223.35"
"2025-02-24","2025-02-22","SF FuneralF1073736      250222","","126.5","","475349.85"
"2025-02-24","2025-02-22","SF FuneralF1079718      250222","","126.5","","475476.35"
"2025-02-24","2025-02-22","SF FuneralF782860       250223","","126.5","","475602.85"
"2025-02-24","2025-02-22","SF FuneralF1083724      250222","","126.5","","475729.35"
"2025-02-24","2025-02-22","SF FuneralF1084041      250223","","126.5","","475855.85"
"2025-02-24","2025-02-22","SF FuneralF1124460      250223","","126.5","","475982.35"
"2025-02-24","2025-02-22","SF FuneralFDC0000000PFLM250222","","126.5","","476108.85"
"2025-02-24","2025-02-24","SF FuneralFDC0000000609G250224","","126.5","","476235.35"
"2025-02-24","2025-02-24","SF FuneralFDC00000006N35250224","","126.5","","476361.85"
"2025-02-24","2025-02-24","SF FuneralF841712       250224","","126.5","","476488.35"
"2025-02-24","2025-02-18","SF FuneralFDC00000008YCZ250218","","31.63","","476519.98"
"2025-02-24","2025-02-18","SF FuneralF1103795      250218","","31.63","","476551.61"
"2025-02-24","2025-02-21","SF FuneralFDC0000000382P250221","","220","","476771.61"
"2025-02-24","2025-02-21","SF FuneralF989974       250222","","126.5","","476898.11"
"2025-02-24","2025-02-21","SF FuneralFDC0000000J4L3250222","","126.5","","477024.61"
"2025-02-24","2025-02-21","SF FuneralF1130754      250221","","31.63","","477056.24"
"2025-02-24","2025-02-22","SF FuneralFDC000000063T6250222","","126.5","","477182.74"
"2025-02-24","2025-02-22","SF FuneralFDC00000006WX4250222","","126.5","","477309.24"
"2025-02-24","2025-02-22","SF FuneralFDC000000084HP250222","","126.5","","477435.74"
"2025-02-24","2025-02-22","SF FuneralF802296       250222","","126.5","","477562.24"
"2025-02-24","2025-02-22","SF FuneralF810304       250222","","126.5","","477688.74"
"2025-02-24","2025-02-22","SF FuneralF813583       250222","","126.5","","477815.24"
"2025-02-24","2025-02-22","SF FuneralF816124       250222","","126.5","","477941.74"
"2025-02-24","2025-02-22","SF FuneralF823979       250222","","126.5","","478068.24"
"2025-02-24","2025-02-22","SF FuneralF1020826      250222","","126.5","","478194.74"
"2025-02-24","2025-02-22","SF FuneralF1054797      250222","","126.5","","478321.24"
"2025-02-24","2025-02-22","SF FuneralF1115734      250222","","126.5","","478447.74"
"2025-02-24","2025-02-24","SF FuneralFDC0000000622W250224","","126.5","","478574.24"
"2025-02-24","2025-02-24","SF FuneralFDC00000006WGQ250224","","126.5","","478700.74"
"2025-02-24","2025-02-24","SF FuneralF810046       250224","","126.5","","478827.24"
"2025-02-24","2025-02-24","SF FuneralF991529       250224","","126.5","","478953.74"
"2025-02-24","2025-02-22","SF FuneralF1078534      250222","","126.5","","479080.24"
"2025-02-24","2025-02-17","Rev SF FuneralFDC00000005Q9X250217","","-126.5","","478953.74"
"2025-02-24","2025-02-18","SF FuneralF1118312      250218","","63.25","","479016.99"
"2025-02-24","2025-02-22","SF FuneralF807917       250222","","126.5","","479143.49"
"2025-02-24","2025-02-22","SF FuneralF811877       250222","","126.5","","479269.99"
"2025-02-24","2025-02-22","SF FuneralF818163       250222","","126.5","","479396.49"
"2025-02-24","2025-02-24","SF FuneralF834476       250224","","126.5","","479522.99"
"2025-02-24","2025-02-24","SF FuneralF992194       250224","","126.5","","479649.49"
"2025-02-24","2025-02-24","SF FuneralFDC0000000JCQP250224","","126.5","","479775.99"
"2025-02-24","2025-02-22","SF FuneralFDC0000000JB1L250222","","126.5","","479902.49"
"2025-02-24","2025-02-22","SF FuneralF1103932      250222","","126.5","","480028.99"
"2025-02-24","2025-02-21","SF FuneralF811537       250221","","126.5","","480155.49"
"2025-02-24","2025-02-22","SF FuneralF1084268      250222","","126.5","","480281.99"
"2025-02-24","2025-02-22","SF FuneralFDC0000000NGY6250222","","126.5","","480408.49"
"2025-02-24","2025-02-22","SF FuneralF1131748      250222","","126.5","","480534.99"
"2025-02-24","2025-02-19","SF FuneralFDC00000005VH8250219","","126.5","","480661.49"
"2025-02-24","2025-02-19","SF FuneralF980675       250219","","126.5","","480787.99"
"2025-02-24","2025-02-20","SF FuneralFDC000000064MN250220","","126.5","","480914.49"
"2025-02-24","2025-02-20","SF FuneralFDC0000000N8Q4250220","","126.5","","481040.99"
"2025-02-24","2025-02-20","SF FuneralF1124295      250220","","126.5","","481167.49"
"2025-02-24","2025-02-20","SF FuneralF1128160      250220","","126.5","","481293.99"
"2025-02-24","2025-02-21","SF FuneralF1132536      250221","","63.25","","481357.24"
"2025-02-24","2025-02-22","SF FuneralF811284       250222","","126.5","","481483.74"
"2025-02-24","2025-02-22","SF FuneralFDC00000009CNZ250222","","126.5","","481610.24"
"2025-02-24","2025-02-22","SF FuneralF829855       250222","","126.5","","481736.74"
"2025-02-24","2025-02-22","SF FuneralFDC0000000CH50250222","","126.5","","481863.24"
"2025-02-24","2025-02-22","SF FuneralF840932       250222","","126.5","","481989.74"
"2025-02-24","2025-02-22","SF FuneralF1065704      250222","","126.5","","482116.24"
"2025-02-24","2025-02-22","SF FuneralF1073840      250222","","126.5","","482242.74"
"2025-02-24","2025-02-22","SF FuneralF1074484      250223","","126.5","","482369.24"
"2025-02-24","2025-02-22","SF FuneralF1065756      250222","","126.5","","482495.74"
"2025-02-24","2025-02-22","SF FuneralF1112121      250222","","126.5","","482622.24"
"2025-02-24","2025-02-22","SF FuneralF1115732      250222","","126.5","","482748.74"
"2025-02-24","2025-02-22","SF FuneralFDC0000000ND49250222","","220","","482968.74"
"2025-02-24","2025-02-22","SF FuneralF1125868      250222","","126.5","","483095.24"
"2025-02-24","2025-02-22","SF FuneralF1128028      250222","","126.5","","483221.74"
"2025-02-24","2025-02-22","SF FuneralF1131544      250222","","126.5","","483348.24"
"2025-02-24","2025-02-24","SF FuneralFDC00000006CXF250223","","126.5","","483474.74"
"2025-02-24","2025-02-24","SF FuneralF844685       250222","","126.5","","483601.24"
"2025-02-24","2025-02-24","SF FuneralF1131684      250224","","126.5","","483727.74"
"2025-02-24","2025-02-18","SF FuneralF805662       250218","","31.63","","483759.37"
"2025-02-24","2025-02-21","SF FuneralF812966       250221","","126.5","","483885.87"
"2025-02-24","2025-02-21","SF FuneralF843757       250221","","31.63","","483917.5"
"2025-02-24","2025-02-21","SF FuneralF1073818      250221","","31.63","","483949.13"
"2025-02-24","2025-02-21","SF FuneralF1054780      250221","","31.63","","483980.76"
"2025-02-24","2025-02-21","SF FuneralF1121971      250221","","31.63","","484012.39"
"2025-02-24","2025-02-21","SF FuneralF1127614      250221","","31.63","","484044.02"
"2025-02-24","2025-02-22","SF FuneralFDC0000000K3JW250222","","191.5","","484235.52"
"2025-02-24","2025-02-22","SF FuneralFDC0000000K4YT250222","","126.5","","484362.02"
"2025-02-24","2025-02-22","SF FuneralF1054773      250222","","126.5","","484488.52"
"2025-02-24","2025-02-22","SF FuneralF1054925      250223","","31.63","","484520.15"
"2025-02-24","2025-02-22","SF FuneralF1108238      250222","","126.5","","484646.65"
"2025-02-24","2025-02-22","SF FuneralF1125140      250222","","126.5","","484773.15"
"2025-02-24","2025-02-24","SF FuneralF816565       250224","","31.63","","484804.78"
"2025-02-24","2025-02-21","SF FuneralF988465       250221","","126.5","","484931.28"
"2025-02-24","2025-02-22","SF FuneralF805718       250222","","126.5","","485057.78"
"2025-02-24","2025-02-22","SF FuneralF823219       250222","","126.5","","485184.28"
"2025-02-24","2025-02-22","SF FuneralF1072916      250222","","126.5","","485310.78"
"2025-02-24","2025-02-21","SF FuneralF990865       250222","","126.5","","485437.28"
"2025-02-24","2025-02-22","SF FuneralFDC00000006S9M250222","","126.5","","485563.78"
"2025-02-24","2025-02-22","SF FuneralFDC000000078V1250222","","126.5","","485690.28"
"2025-02-24","2025-02-22","SF FuneralF805395       250222","","126.5","","485816.78"
"2025-02-24","2025-02-22","SF FuneralF805665       250222","","126.5","","485943.28"
"2025-02-24","2025-02-22","SF FuneralF830932       250222","","126.5","","486069.78"
"2025-02-24","2025-02-22","SF FuneralF831349       250222","","126.5","","486196.28"
"2025-02-24","2025-02-22","SF FuneralF1124545      250222","","126.5","","486322.78"
"2025-02-24","2025-02-21","SF FuneralFDC00000005QYG250221","","63.25","","486386.03"
"2025-02-24","2025-02-21","SF FuneralFDC00000007K2Y250221","","126.5","","486512.53"
"2025-02-24","2025-02-22","SF FuneralFDC00000005MQ8250222","","126.5","","486639.03"
"2025-02-24","2025-02-22","SF FuneralF818384       250222","","126.5","","486765.53"
"2025-02-24","2025-02-22","SF FuneralF829644       250222","","126.5","","486892.03"
"2025-02-24","2025-02-22","SF FuneralF1110507      250222","","126.5","","487018.53"
"2025-02-24","2025-02-17","SF FuneralFDC00000005YVB250217","","126.5","","487145.03"
"2025-02-24","2025-02-21","SF FuneralF834544       250221","","31.63","","487176.66"
"2025-02-24","2025-02-21","SF FuneralF847452       250221","","31.63","","487208.29"
"2025-02-24","2025-02-21","SF FuneralF819674       250223","","31.63","","487239.92"
"2025-02-24","2025-02-21","SF FuneralFDC0000000NNGY250221","","31.63","","487271.55"
"2025-02-24","2025-02-22","SF FuneralFDC00000005X1Q250222","","220","","487491.55"
"2025-02-24","2025-02-22","SF FuneralFDC0000000M3WM250222","","256.5","","487748.05"
"2025-02-24","2025-02-24","SF FuneralF841615       250224","","31.63","","487779.68"
"2025-02-24","2025-02-24","SF FuneralF1060944      250224","","31.63","","487811.31"
"2025-02-24","2025-02-17","SF FuneralF818152       250217","","63.25","","487874.56"
"2025-02-24","2025-02-20","SF FuneralFDC0000000NFWS250220","","126.5","","488001.06"
"2025-02-24","2025-02-20","SF FuneralF1116001      250220","","126.5","","488127.56"
"2025-02-24","2025-02-20","SF FuneralF1116706      250220","","126.5","","488254.06"
"2025-02-24","2025-02-20","SF FuneralF1120647      250220","","126.5","","488380.56"
"2025-02-24","2025-02-21","SF FuneralFDC00000005LJL250221","","126.5","","488507.06"
"2025-02-24","2025-02-22","SF FuneralFDC00000006092250222","","126.5","","488633.56"
"2025-02-24","2025-02-22","SF FuneralFDC000000063WK250222","","126.5","","488760.06"
"2025-02-24","2025-02-22","SF FuneralFDC00000007SZ9250222","","126.5","","488886.56"
"2025-02-24","2025-02-22","SF FuneralF811389       250222","","126.5","","489013.06"
"2025-02-24","2025-02-22","SF FuneralF811918       250222","","126.5","","489139.56"
"2025-02-24","2025-02-22","SF FuneralF812562       250222","","126.5","","489266.06"
"2025-02-24","2025-02-22","SF FuneralF815120       250222","","126.5","","489392.56"
"2025-02-24","2025-02-22","SF FuneralF820331       250222","","126.5","","489519.06"
"2025-02-24","2025-02-22","SF FuneralF823452       250222","","126.5","","489645.56"
"2025-02-24","2025-02-22","SF FuneralF823718       250222","","126.5","","489772.06"
"2025-02-24","2025-02-22","SF FuneralF840931       250222","","126.5","","489898.56"
"2025-02-24","2025-02-22","SF FuneralF841190       250222","","126.5","","490025.06"
"2025-02-24","2025-02-22","SF FuneralF1017710      250222","","126.5","","490151.56"
"2025-02-24","2025-02-22","SF FuneralF1017839      250222","","126.5","","490278.06"
"2025-02-24","2025-02-22","SF FuneralFDC0000000KJB9250222","","126.5","","490404.56"
"2025-02-24","2025-02-22","SF FuneralF1072786      250222","","126.5","","490531.06"
"2025-02-24","2025-02-22","SF FuneralFDC0000000L3LS250222","","126.5","","490657.56"
"2025-02-24","2025-02-22","SF FuneralF1073405      250222","","126.5","","490784.06"
"2025-02-24","2025-02-22","SF FuneralF1108236      250222","","126.5","","490910.56"
"2025-02-24","2025-02-22","SF FuneralFDC0000000MHGN250222","","126.5","","491037.06"
"2025-02-24","2025-02-22","SF FuneralF1115897      250222","","126.5","","491163.56"
"2025-02-24","2025-02-22","SF FuneralF1126236      250222","","126.5","","491290.06"
"2025-02-24","2025-02-22","SF FuneralF1127664      250222","","126.5","","491416.56"
"2025-02-24","2025-02-22","SF FuneralF1127988      250222","","126.5","","491543.06"
"2025-02-24","2025-02-24","SF FuneralFDC0000000606G250223","","126.5","","491669.56"
"2025-02-24","2025-02-24","SF FuneralFDC000000082NL250223","","126.5","","491796.06"
"2025-02-24","2025-02-24","SF FuneralF987913       250224","","126.5","","491922.56"
"2025-02-24","2025-02-17","Rev SF FuneralFDC00000005R60250217","","-126.5","","491796.06"
"2025-02-24","2025-02-24","Rev SF FuneralFDC00000006WGQ250224","","-126.5","","491669.56"
"2025-02-24","2025-02-24","Rev SF FuneralFDC000000096XP250223","","-126.5","","491543.06"
"2025-02-24","2025-02-21","Rev SF FuneralFDC0000000N3BQ250221","","-126.5","","491416.56"
"2025-02-24","2025-02-21","Rev SF FuneralFDC0000000BH7D250221","","-126.5","","491290.06"
"2025-02-24","2025-02-22","Rev SF FuneralFDC00000005FXR250222","","-63.25","","491226.81"
"2025-02-24","2025-02-01","Rev SF FuneralFDC00000009LQN250201","","-126.5","","491100.31"
"2025-02-24","2025-02-22","Rev SF FuneralFDC00000005X1Q250222","","-220","","490880.31"
"2025-02-24","2025-02-12","Rev SF FuneralFDC00000006MK7250212","","-126.5","","490753.81"
"2025-02-24","2025-02-22","Rev SF FuneralFDC00000008HLZ250222","","-126.5","","490627.31"
"2025-02-24","2025-02-19","Rev SF FuneralFDC00000006W2Y250219","","-126.5","","490500.81"
"2025-02-24","2025-02-21","Rev SF FuneralFDC000000069RZ250221","","-31.63","","490469.18"
"2025-02-24","2025-02-20","Rev SF FuneralFDC00000005P8B250220","","-31.63","","490437.55"
"2025-02-24","2025-02-21","Rev SF FuneralFDC0000000JFC4250221","","-31.63","","490405.92"
"2025-02-24","2025-02-24","Rev SF FuneralFDC00000005NT1250224","","-31.63","","490374.29"
"2025-02-24","2025-02-13","Rev SF FuneralFDC00000005P8B250213","","-31.63","","490342.66"
"2025-02-24","2025-02-21","Rev SF FuneralFDC0000000B37Y250221","","-31.63","","490311.03"
"2025-02-24","2025-02-21","Rev SF FuneralFDC0000000KLCD250221","","-31.63","","490279.4"
"2025-02-24","2025-02-21","Rev SF FuneralFDC00000007WBL250221","","-31.63","","490247.77"
"2025-02-24","2025-02-21","SF FuneralF990692       250222","","126.5","","490374.27"
"2025-02-24","2025-02-21","SF FuneralF811276       250221","","126.5","","490500.77"
"2025-02-24","2025-02-21","SF FuneralFDC0000000NCR8250221","","213.31","","490714.08"
"2025-02-24","2025-02-22","SF FuneralFDC000000068X9250222","","126.5","","490840.58"
"2025-02-24","2025-02-22","SF FuneralFDC00000006G4S250222","","126.5","","490967.08"
"2025-02-24","2025-02-22","SF FuneralF822383       250222","","126.5","","491093.58"
"2025-02-24","2025-02-22","SF FuneralF1120387      250222","","126.5","","491220.08"
"2025-02-24","2025-02-22","SF FuneralFDC0000000PL2B250222","","126.5","","491346.58"
"2025-02-24","2025-02-22","SF FuneralF1126298      250222","","126.5","","491473.08"
"2025-02-24","2025-02-22","SF FuneralFDC0000000PL5R250222","","126.5","","491599.58"
"2025-02-24","2025-02-22","SF FuneralF1127591      250222","","126.5","","491726.08"
"2025-02-24","2025-02-22","SF FuneralFDC000000061M2250222","","126.5","","491852.58"
"2025-02-24","2025-02-22","SF FuneralFDC000000061R7250222","","126.5","","491979.08"
"2025-02-24","2025-02-22","SF FuneralFDC00000006XTQ250222","","126.5","","492105.58"
"2025-02-24","2025-02-22","SF FuneralFDC00000006ZQ6250222","","126.5","","492232.08"
"2025-02-24","2025-02-22","SF FuneralFDC00000006ZQJ250222","","126.5","","492358.58"
"2025-02-24","2025-02-22","SF FuneralFDC00000007187250222","","126.5","","492485.08"
"2025-02-24","2025-02-22","SF FuneralFDC00000007604250222","","126.5","","492611.58"
"2025-02-24","2025-02-22","SF FuneralFDC00000008VGN250222","","126.5","","492738.08"
"2025-02-24","2025-02-22","SF FuneralF819588       250222","","126.5","","492864.58"
"2025-02-24","2025-02-22","SF FuneralF788778       250222","","126.5","","492991.08"
"2025-02-24","2025-02-22","SF FuneralFDC0000000DPHH250222","","126.5","","493117.58"
"2025-02-24","2025-02-22","SF FuneralFDC0000000JS95250222","","126.5","","493244.08"
"2025-02-24","2025-02-22","SF FuneralF1052903      250222","","126.5","","493370.58"
"2025-02-24","2025-02-22","SF FuneralF1074880      250222","","126.5","","493497.08"
"2025-02-24","2025-02-22","SF FuneralF788991       250222","","213.31","","493710.39"
"2025-02-24","2025-02-22","SF FuneralFDC0000000MJDP250222","","126.5","","493836.89"
"2025-02-24","2025-02-22","SF FuneralF1120540      250222","","126.5","","493963.39"
"2025-02-24","2025-02-22","SF FuneralF1122877      250222","","126.5","","494089.89"
"2025-02-24","2025-02-22","SF FuneralF1125995      250222","","126.5","","494216.39"
"2025-02-24","2025-02-22","SF FuneralF1127931      250222","","126.5","","494342.89"
"2025-02-24","2025-02-22","SF FuneralF1128862      250222","","126.5","","494469.39"
"2025-02-24","2025-02-22","SF FuneralF1129456      250223","","126.5","","494595.89"
"2025-02-24","2025-02-22","SF FuneralF1130997      250222","","126.5","","494722.39"
"2025-02-24","2025-02-24","SF FuneralF987492       250224","","31.63","","494754.02"
"2025-02-24","2025-02-21","SF FuneralFDC00000006ZWS250221","","126.5","","494880.52"
"2025-02-24","2025-02-21","SF FuneralFDC00000007MLZ250221","","126.5","","495007.02"
"2025-02-24","2025-02-21","SF FuneralF1127316      250221","","126.5","","495133.52"
"2025-02-24","2025-02-19","SF FuneralF1127568      250219","","126.5","","495260.02"
"2025-02-24","2025-02-22","SF FuneralF801362       250222","","126.5","","495386.52"
"2025-02-24","2025-02-22","SF FuneralF1118375      250222","","126.5","","495513.02"
"2025-02-25","2025-02-20","SF FuneralFDC0000000614D250220","","126.5","","495639.52"
"2025-02-25","2025-02-20","SF FuneralF1124762      250220","","126.5","","495766.02"
"2025-02-25","2025-02-21","SF FuneralFDC00000008SHW250221","","126.5","","495892.52"
"2025-02-25","2025-02-21","SF FuneralF987790       250221","","126.5","","496019.02"
"2025-02-25","2025-02-21","SF FuneralFDC0000000PY8K250221","","126.5","","496145.52"
"2025-02-25","2025-02-22","SF FuneralFDC00000005Z00250222","","126.5","","496272.02"
"2025-02-25","2025-02-22","SF FuneralFDC0000000678T250222","","126.5","","496398.52"
"2025-02-25","2025-02-22","SF FuneralFDC00000006XTC250222","","126.5","","496525.02"
"2025-02-25","2025-02-22","SF FuneralFDC00000007VJR250222","","126.5","","496651.52"
"2025-02-25","2025-02-22","SF FuneralF812515       250222","","126.5","","496778.02"
"2025-02-25","2025-02-22","SF FuneralF815204       250222","","126.5","","496904.52"
"2025-02-25","2025-02-22","SF FuneralF815977       250222","","126.5","","497031.02"
"2025-02-25","2025-02-22","SF FuneralF823005       250222","","126.5","","497157.52"
"2025-02-25","2025-02-22","SF FuneralF829541       250222","","126.5","","497284.02"
"2025-02-25","2025-02-22","SF FuneralF831844       250222","","126.5","","497410.52"
"2025-02-25","2025-02-22","SF FuneralFDC0000000CLXS250222","","126.5","","497537.02"
"2025-02-25","2025-02-22","SF FuneralF1050703      250222","","126.5","","497663.52"
"2025-02-25","2025-02-22","SF FuneralF1054702      250222","","126.5","","497790.02"
"2025-02-25","2025-02-22","SF FuneralF1058854      250222","","126.5","","497916.52"
"2025-02-25","2025-02-22","SF FuneralF1074591      250222","","126.5","","498043.02"
"2025-02-25","2025-02-22","SF FuneralFDC0000000LH7P250222","","126.5","","498169.52"
"2025-02-25","2025-02-22","SF FuneralF1108157      250222","","126.5","","498296.02"
"2025-02-25","2025-02-22","SF FuneralF1112281      250222","","191.5","","498487.52"
"2025-02-25","2025-02-22","SF FuneralF1116743      250222","","126.5","","498614.02"
"2025-02-25","2025-02-22","SF FuneralF1118507      250222","","126.5","","498740.52"
"2025-02-25","2025-02-22","SF FuneralF1124381      250223","","126.5","","498867.02"
"2025-02-25","2025-02-22","SF FuneralF1124765      250222","","126.5","","498993.52"
"2025-02-25","2025-02-22","SF FuneralF1127754      250222","","126.5","","499120.02"
"2025-02-25","2025-02-22","SF FuneralF1131591      250222","","126.5","","499246.52"
"2025-02-25","2025-02-24","SF FuneralF831806       250224","","126.5","","499373.02"
"2025-02-25","2025-02-24","SF FuneralF1066573      250224","","126.5","","499499.52"
"2025-02-25","2025-02-22","SF FuneralFDC00000005L7Z250222","","126.5","","499626.02"
"2025-02-25","2025-02-22","SF FuneralFDC00000005X71250222","","126.5","","499752.52"
"2025-02-25","2025-02-18","SF FuneralF900893       250218","","126.5","","499879.02"
"2025-02-25","2025-02-21","SF FuneralFDC00000005G5L250221","","126.5","","500005.52"
"2025-02-25","2025-02-21","SF FuneralFDC00000008LFM250221","","126.5","","500132.02"
"2025-02-25","2025-02-21","SF FuneralFDC00000008TX4250221","","126.5","","500258.52"
"2025-02-25","2025-02-21","SF FuneralF808654       250221","","126.5","","500385.02"
"2025-02-25","2025-02-21","SF FuneralF981094       250222","","126.5","","500511.52"
"2025-02-25","2025-02-21","SF FuneralF1054770      250221","","126.5","","500638.02"
"2025-02-25","2025-02-21","SF FuneralF1127765      250221","","126.5","","500764.52"
"2025-02-25","2025-02-22","SF FuneralFDC00000005J5B250222","","126.5","","500891.02"
"2025-02-25","2025-02-22","SF FuneralFDC00000006LK0250222","","126.5","","501017.52"
"2025-02-25","2025-02-22","SF FuneralFDC00000006XTN250222","","126.5","","501144.02"
"2025-02-25","2025-02-22","SF FuneralF808972       250222","","126.5","","501270.52"
"2025-02-25","2025-02-22","SF FuneralF816160       250222","","126.5","","501397.02"
"2025-02-25","2025-02-22","SF FuneralFDC0000000B8MW250222","","126.5","","501523.52"
"2025-02-25","2025-02-22","SF FuneralF1079740      250222","","126.5","","501650.02"
"2025-02-25","2025-02-22","SF FuneralF1120233      250222","","126.5","","501776.52"
"2025-02-25","2025-02-22","SF FuneralF1129448      250222","","126.5","","501903.02"
"2025-02-25","2025-02-22","SF FuneralF1130765      250222","","126.5","","502029.52"
"2025-02-25","2025-02-22","SF FuneralFDC0000000Q3LN250222","","126.5","","502156.02"
"2025-02-25","2025-02-22","SF FuneralFDC0000000Q3LQ250222","","126.5","","502282.52"
"2025-02-25","2025-02-24","SF FuneralFDC000000063HV250223","","126.5","","502409.02"
"2025-02-25","2025-02-24","SF FuneralFDC000000072K8250224","","63.25","","502472.27"
"2025-02-25","2025-02-24","SF FuneralFDC0000000B1ZX250224","","126.5","","502598.77"
"2025-02-25","2025-02-24","SF FuneralF823675       250223","","126.5","","502725.27"
"2025-02-25","2025-02-24","SF FuneralF991106       250224","","126.5","","502851.77"
"2025-02-25","2025-02-24","SF FuneralF1129279      250224","","126.5","","502978.27"
"2025-02-25","2025-02-17","SF FuneralF900540       250217","","126.5","","503104.77"
"2025-02-25","2025-02-18","SF FuneralFDC00000008TLN250218","","63.25","","503168.02"
"2025-02-25","2025-02-19","SF FuneralFDC000000064QR250219","","126.5","","503294.52"
"2025-02-25","2025-02-20","SF FuneralF823669       250220","","126.5","","503421.02"
"2025-02-25","2025-02-21","SF FuneralFDC00000003132250221","","220","","503641.02"
"2025-02-25","2025-02-21","SF FuneralFDC00000006MCZ250221","","126.5","","503767.52"
"2025-02-25","2025-02-21","SF FuneralFDC00000006Y54250221","","126.5","","503894.02"
"2025-02-25","2025-02-21","SF FuneralFDC0000000773W250221","","126.5","","504020.52"
"2025-02-25","2025-02-21","SF FuneralF901362       250221","","126.5","","504147.02"
"2025-02-25","2025-02-21","SF FuneralF1116021      250221","","126.5","","504273.52"
"2025-02-25","2025-02-22","SF FuneralFDC00000002RJP250222","","220","","504493.52"
"2025-02-25","2025-02-22","SF FuneralFDC000000037HW250222","","220","","504713.52"
"2025-02-25","2025-02-22","SF FuneralFDC000000056SL250222","","126.5","","504840.02"
"2025-02-25","2025-02-22","SF FuneralFDC00000005Z4D250222","","126.5","","504966.52"
"2025-02-25","2025-02-22","SF FuneralFDC000000060C3250222","","126.5","","505093.02"
"2025-02-25","2025-02-22","SF FuneralFDC00000006551250222","","126.5","","505219.52"
"2025-02-25","2025-02-22","SF FuneralFDC00000006RZ9250222","","126.5","","505346.02"
"2025-02-25","2025-02-22","SF FuneralFDC000000073CR250222","","126.5","","505472.52"
"2025-02-25","2025-02-22","SF FuneralFDC00000007543250222","","126.5","","505599.02"
"2025-02-25","2025-02-22","SF FuneralFDC0000000754G250222","","126.5","","505725.52"
"2025-02-25","2025-02-22","SF FuneralFDC000000081VZ250222","","126.5","","505852.02"
"2025-02-25","2025-02-22","SF FuneralFDC00000008HR0250222","","126.5","","505978.52"
"2025-02-25","2025-02-22","SF FuneralFDC00000008MBH250222","","126.5","","506105.02"
"2025-02-25","2025-02-22","SF FuneralF808231       250222","","126.5","","506231.52"
"2025-02-25","2025-02-22","SF FuneralF815451       250222","","126.5","","506358.02"
"2025-02-25","2025-02-22","SF FuneralF818958       250222","","126.5","","506484.52"
"2025-02-25","2025-02-22","SF FuneralF819388       250222","","126.5","","506611.02"
"2025-02-25","2025-02-22","SF FuneralF821281       250222","","126.5","","506737.52"
"2025-02-25","2025-02-22","SF FuneralF821886       250222","","126.5","","506864.02"
"2025-02-25","2025-02-22","SF FuneralF842634       250222","","126.5","","506990.52"
"2025-02-25","2025-02-22","SF FuneralF1054758      250222","","126.5","","507117.02"
"2025-02-25","2025-02-22","SF FuneralF1060768      250222","","126.5","","507243.52"
"2025-02-25","2025-02-22","SF FuneralF1061659      250222","","126.5","","507370.02"
"2025-02-25","2025-02-22","SF FuneralF1074476      250222","","126.5","","507496.52"
"2025-02-25","2025-02-22","SF FuneralF1074570      250222","","126.5","","507623.02"
"2025-02-25","2025-02-22","SF FuneralF1080464      250222","","126.5","","507749.52"
"2025-02-25","2025-02-22","SF FuneralFDC0000000LPZW250222","","126.5","","507876.02"
"2025-02-25","2025-02-22","SF FuneralFDC0000000M6GH250222","","126.5","","508002.52"
"2025-02-25","2025-02-22","SF FuneralF1124556      250222","","126.5","","508129.02"
"2025-02-25","2025-02-22","SF FuneralF1128982      250222","","126.5","","508255.52"
"2025-02-25","2025-02-22","SF FuneralFDC0000000Q1V8250222","","126.5","","508382.02"
"2025-02-25","2025-02-24","SF FuneralFDC000000060YY250223","","126.5","","508508.52"
"2025-02-25","2025-02-24","SF FuneralF831118       250223","","126.5","","508635.02"
"2025-02-25","2025-02-20","SF FuneralFDC00000005MSW250220","","126.5","","508761.52"
"2025-02-25","2025-02-21","SF FuneralF840686       250221","","126.5","","508888.02"
"2025-02-25","2025-02-21","SF FuneralF987350       250222","","126.5","","509014.52"
"2025-02-25","2025-02-21","SF FuneralF991519       250221","","126.5","","509141.02"
"2025-02-25","2025-02-21","SF FuneralF1113985      250221","","126.5","","509267.52"
"2025-02-25","2025-02-22","SF FuneralFDC000000043W1250222","","220","","509487.52"
"2025-02-25","2025-02-22","SF FuneralFDC00000005LS1250222","","126.5","","509614.02"
"2025-02-25","2025-02-22","SF FuneralFDC00000006Z9T250222","","126.5","","509740.52"
"2025-02-25","2025-02-22","SF FuneralFDC00000006ZBN250222","","126.5","","509867.02"
"2025-02-25","2025-02-22","SF FuneralFDC000000075DT250222","","126.5","","509993.52"
"2025-02-25","2025-02-22","SF FuneralFDC000000075DV250222","","126.5","","510120.02"
"2025-02-25","2025-02-22","SF FuneralFDC00000008JYC250222","","126.5","","510246.52"
"2025-02-25","2025-02-22","SF FuneralF802278       250222","","126.5","","510373.02"
"2025-02-25","2025-02-22","SF FuneralF819859       250222","","126.5","","510499.52"
"2025-02-25","2025-02-22","SF FuneralF832934       250222","","126.5","","510626.02"
"2025-02-25","2025-02-22","SF FuneralFDC0000000JV7V250222","","126.5","","510752.52"
"2025-02-25","2025-02-22","SF FuneralF1054731      250222","","126.5","","510879.02"
"2025-02-25","2025-02-22","SF FuneralF1060053      250222","","126.5","","511005.52"
"2025-02-25","2025-02-22","SF FuneralF1074438      250222","","126.5","","511132.02"
"2025-02-25","2025-02-22","SF FuneralF1124823      250222","","126.5","","511258.52"
"2025-02-25","2025-02-22","SF FuneralF1125992      250222","","126.5","","511385.02"
"2025-02-25","2025-02-22","SF FuneralF1130509      250222","","126.5","","511511.52"
"2025-02-25","2025-02-22","SF FuneralF1130985      250222","","126.5","","511638.02"
"2025-02-25","2025-02-24","SF FuneralFDC0000000DCGV250224","","126.5","","511764.52"
"2025-02-25","2025-02-24","SF FuneralF844566       250222","","126.5","","511891.02"
"2025-02-25","2025-02-24","SF FuneralFDC0000000HZN0250224","","63.25","","511954.27"
"2025-02-25","2025-02-24","SF FuneralFDC00000005WTC250224","","55","","512009.27"
"2025-02-25","2025-02-24","SF FuneralFDC000000071S5250224","","31.63","","512040.9"
"2025-02-25","2025-02-24","SF FuneralF802331       250224","","31.63","","512072.53"
"2025-02-25","2025-02-18","SF FuneralFDC000000039W0250218","","55","","512127.53"
"2025-02-25","2025-02-18","SF FuneralF812316       250218","","31.63","","512159.16"
"2025-02-25","2025-02-21","SF FuneralFDC0000000HSSY250222","","126.5","","512285.66"
"2025-02-25","2025-02-21","SF FuneralF987619       250222","","126.5","","512412.16"
"2025-02-25","2025-02-22","SF FuneralFDC00000003BYY250222","","220","","512632.16"
"2025-02-25","2025-02-22","SF FuneralFDC00000005ZFL250222","","126.5","","512758.66"
"2025-02-25","2025-02-22","SF FuneralFDC000000089DN250222","","126.5","","512885.16"
"2025-02-25","2025-02-22","SF FuneralF802161       250222","","126.5","","513011.66"
"2025-02-25","2025-02-22","SF FuneralF832932       250222","","31.63","","513043.29"
"2025-02-25","2025-02-22","SF FuneralF1083831      250222","","126.5","","513169.79"
"2025-02-25","2025-02-22","SF FuneralF1127556      250222","","126.5","","513296.29"
"2025-02-25","2025-02-22","SF FuneralFDC0000000PY8V250222","","126.5","","513422.79"
"2025-02-25","2025-02-22","SF FuneralFDC0000000Q1VB250222","","126.5","","513549.29"
"2025-02-25","2025-02-24","SF FuneralFDC0000000617K250223","","126.5","","513675.79"
"2025-02-25","2025-02-24","SF FuneralF1103857      250224","","31.63","","513707.42"
"2025-02-25","2025-02-19","SF FuneralFDC0000000622N250219","","126.5","","513833.92"
"2025-02-25","2025-02-20","SF FuneralF815090       250220","","126.5","","513960.42"
"2025-02-25","2025-02-21","SF FuneralFDC00000007N00250221","","126.5","","514086.92"
"2025-02-25","2025-02-21","SF FuneralFDC000000081XT250221","","126.5","","514213.42"
"2025-02-25","2025-02-21","SF FuneralFDC0000000FHS8250221","","126.5","","514339.92"
"2025-02-25","2025-02-21","SF FuneralF1062692      250221","","126.5","","514466.42"
"2025-02-25","2025-02-21","SF FuneralF1128916      250221","","126.5","","514592.92"
"2025-02-25","2025-02-22","SF FuneralFDC00000005S4P250222","","126.5","","514719.42"
"2025-02-25","2025-02-22","SF FuneralFDC00000005S9G250222","","126.5","","514845.92"
"2025-02-25","2025-02-22","SF FuneralFDC00000005V6K250222","","191.5","","515037.42"
"2025-02-25","2025-02-22","SF FuneralFDC000000062Q0250222","","126.5","","515163.92"
"2025-02-25","2025-02-22","SF FuneralFDC000000066PF250222","","126.5","","515290.42"
"2025-02-25","2025-02-22","SF FuneralFDC0000000678S250222","","126.5","","515416.92"
"2025-02-25","2025-02-22","SF FuneralFDC000000073YF250222","","126.5","","515543.42"
"2025-02-25","2025-02-22","SF FuneralFDC000000078NN250222","","126.5","","515669.92"
"2025-02-25","2025-02-22","SF FuneralFDC00000007DWP250222","","126.5","","515796.42"
"2025-02-25","2025-02-22","SF FuneralF797296       250222","","126.5","","515922.92"
"2025-02-25","2025-02-22","SF FuneralFDC0000000836V250222","","126.5","","516049.42"
"2025-02-25","2025-02-22","SF FuneralFDC0000000836W250222","","126.5","","516175.92"
"2025-02-25","2025-02-22","SF FuneralF811295       250222","","126.5","","516302.42"
"2025-02-25","2025-02-22","SF FuneralF818137       250222","","126.5","","516428.92"
"2025-02-25","2025-02-22","SF FuneralF820095       250222","","126.5","","516555.42"
"2025-02-25","2025-02-22","SF FuneralF1017837      250222","","126.5","","516681.92"
"2025-02-25","2025-02-22","SF FuneralF785200       250222","","256.5","","516938.42"
"2025-02-25","2025-02-22","SF FuneralF1021981      250222","","126.5","","517064.92"
"2025-02-25","2025-02-22","SF FuneralF1074816      250222","","126.5","","517191.42"
"2025-02-25","2025-02-22","SF FuneralFDC0000000LRYK250222","","126.5","","517317.92"
"2025-02-25","2025-02-22","SF FuneralFDC0000000LYM0250222","","126.5","","517444.42"
"2025-02-25","2025-02-22","SF FuneralF1108351      250222","","126.5","","517570.92"
"2025-02-25","2025-02-22","SF FuneralF1128333      250222","","126.5","","517697.42"
"2025-02-25","2025-02-22","SF FuneralF1130661      250222","","126.5","","517823.92"
"2025-02-25","2025-02-22","SF FuneralFDC0000000Q3LK250222","","126.5","","517950.42"
"2025-02-25","2025-02-24","SF FuneralF779205       250224","","191.5","","518141.92"
"2025-02-25","2025-02-24","SF FuneralF820801       250224","","126.5","","518268.42"
"2025-02-25","2025-02-24","SF FuneralF822455       250224","","126.5","","518394.92"
"2025-02-25","2025-02-24","SF FuneralF1132776      250224","","126.5","","518521.42"
"2025-02-25","2025-02-20","SF FuneralFDC00000006339250220","","126.5","","518647.92"
"2025-02-25","2025-02-21","SF FuneralFDC000000098T8250221","","126.5","","518774.42"
"2025-02-25","2025-02-21","SF FuneralF819409       250221","","126.5","","518900.92"
"2025-02-25","2025-02-21","SF FuneralFDC0000000FFH8250221","","126.5","","519027.42"
"2025-02-25","2025-02-21","SF FuneralF988007       250222","","126.5","","519153.92"
"2025-02-25","2025-02-21","SF FuneralF1108833      250221","","126.5","","519280.42"
"2025-02-25","2025-02-21","SF FuneralF1112338      250221","","126.5","","519406.92"
"2025-02-25","2025-02-22","SF FuneralFDC0000000645B250222","","126.5","","519533.42"
"2025-02-25","2025-02-22","SF FuneralFDC00000006C48250222","","126.5","","519659.92"
"2025-02-25","2025-02-22","SF FuneralFDC00000006LK1250222","","126.5","","519786.42"
"2025-02-25","2025-02-22","SF FuneralFDC00000006XKG250222","","126.5","","519912.92"
"2025-02-25","2025-02-22","SF FuneralFDC00000006XLJ250222","","126.5","","520039.42"
"2025-02-25","2025-02-22","SF FuneralFDC00000007JK4250222","","126.5","","520165.92"
"2025-02-25","2025-02-22","SF FuneralFDC00000007JVL250222","","126.5","","520292.42"
"2025-02-25","2025-02-22","SF FuneralFDC00000007K6M250222","","126.5","","520418.92"
"2025-02-25","2025-02-22","SF FuneralF798344       250222","","126.5","","520545.42"
"2025-02-25","2025-02-22","SF FuneralF808564       250222","","126.5","","520671.92"
"2025-02-25","2025-02-22","SF FuneralF808577       250222","","126.5","","520798.42"
"2025-02-25","2025-02-22","SF FuneralF822641       250222","","126.5","","520924.92"
"2025-02-25","2025-02-22","SF FuneralFDC0000000CS3Z250222","","126.5","","521051.42"
"2025-02-25","2025-02-22","SF FuneralF778512       250222","","126.5","","521177.92"
"2025-02-25","2025-02-22","SF FuneralF1073850      250222","","126.5","","521304.42"
"2025-02-25","2025-02-22","SF FuneralF1083731      250222","","126.5","","521430.92"
"2025-02-25","2025-02-22","SF FuneralF1083911      250222","","126.5","","521557.42"
"2025-02-25","2025-02-22","SF FuneralF1112000      250222","","126.5","","521683.92"
"2025-02-25","2025-02-22","SF FuneralFDC0000000NTYT250222","","126.5","","521810.42"
"2025-02-25","2025-02-22","SF FuneralFDC0000000PBRL250222","","126.5","","521936.92"
"2025-02-25","2025-02-22","SF FuneralF1131867      250222","","126.5","","522063.42"
"2025-02-25","2025-02-24","SF FuneralF841782       250223","","126.5","","522189.92"
"2025-02-25","2025-02-24","SF FuneralF900613       250222","","126.5","","522316.42"
"2025-02-25","2025-02-24","SF FuneralFDC0000000JNPL250224","","126.5","","522442.92"
"2025-02-25","2025-02-17","SF FuneralF1124373      250217","","126.5","","522569.42"
"2025-02-25","2025-02-19","SF FuneralFDC00000006PWT250219","","126.5","","522695.92"
"2025-02-25","2025-02-19","SF FuneralF844621       250219","","126.5","","522822.42"
"2025-02-25","2025-02-20","SF FuneralFDC000000061SB250220","","126.5","","522948.92"
"2025-02-25","2025-02-20","SF FuneralFDC0000000MM4X250220","","126.5","","523075.42"
"2025-02-25","2025-02-20","SF FuneralF1112400      250220","","126.5","","523201.92"
"2025-02-25","2025-02-21","SF FuneralF1083868      250221","","126.5","","523328.42"
"2025-02-25","2025-02-21","SF FuneralF1124354      250221","","126.5","","523454.92"
"2025-02-25","2025-02-22","SF FuneralFDC00000005XG7250222","","126.5","","523581.42"
"2025-02-25","2025-02-22","SF FuneralFDC0000000607F250222","","126.5","","523707.92"
"2025-02-25","2025-02-22","SF FuneralFDC00000006096250222","","126.5","","523834.42"
"2025-02-25","2025-02-22","SF FuneralFDC00000006192250222","","126.5","","523960.92"
"2025-02-25","2025-02-22","SF FuneralFDC000000069GJ250222","","126.5","","524087.42"
"2025-02-25","2025-02-22","SF FuneralFDC00000006WQS250222","","126.5","","524213.92"
"2025-02-25","2025-02-22","SF FuneralFDC00000007C2D250222","","126.5","","524340.42"
"2025-02-25","2025-02-22","SF FuneralFDC00000007JC7250222","","126.5","","524466.92"
"2025-02-25","2025-02-22","SF FuneralFDC00000007MP6250222","","126.5","","524593.42"
"2025-02-25","2025-02-22","SF FuneralFDC00000007N22250222","","126.5","","524719.92"
"2025-02-25","2025-02-22","SF FuneralFDC00000007N30250222","","191.5","","524911.42"
"2025-02-25","2025-02-22","SF FuneralF831217       250222","","126.5","","525037.92"
"2025-02-25","2025-02-22","SF FuneralFDC0000000CPY7250222","","126.5","","525164.42"
"2025-02-25","2025-02-22","SF FuneralFDC0000000D6PQ250222","","126.5","","525290.92"
"2025-02-25","2025-02-22","SF FuneralFDC0000000KSYY250222","","126.5","","525417.42"
"2025-02-25","2025-02-22","SF FuneralF1066152      250222","","126.5","","525543.92"
"2025-02-25","2025-02-22","SF FuneralFDC0000000L6ST250222","","126.5","","525670.42"
"2025-02-25","2025-02-22","SF FuneralFDC0000000LRHQ250222","","126.5","","525796.92"
"2025-02-25","2025-02-22","SF FuneralF1083737      250222","","126.5","","525923.42"
"2025-02-25","2025-02-22","SF FuneralF1104172      250222","","126.5","","526049.92"
"2025-02-25","2025-02-22","SF FuneralF1110708      250222","","126.5","","526176.42"
"2025-02-25","2025-02-22","SF FuneralF989130       250222","","126.5","","526302.92"
"2025-02-25","2025-02-22","SF FuneralF1130660      250222","","126.5","","526429.42"
"2025-02-25","2025-02-22","SF FuneralF1130837      250222","","191.5","","526620.92"
"2025-02-25","2025-02-24","SF FuneralFDC000000031HJ250223","","220","","526840.92"
"2025-02-25","2025-02-24","SF FuneralF900366       250222","","126.5","","526967.42"
"2025-02-25","2025-02-17","SF FuneralFDC0000000620Z250217","","126.5","","527093.92"
"2025-02-25","2025-02-21","SF FuneralFDC00000006KR2250221","","126.5","","527220.42"
"2025-02-25","2025-02-21","SF FuneralFDC00000006LGX250221","","126.5","","527346.92"
"2025-02-25","2025-02-22","SF FuneralFDC000000031NC250222","","220","","527566.92"
"2025-02-25","2025-02-22","SF FuneralFDC00000005ZLJ250222","","126.5","","527693.42"
"2025-02-25","2025-02-22","SF FuneralFDC000000061N0250222","","126.5","","527819.92"
"2025-02-25","2025-02-22","SF FuneralFDC00000007445250222","","63.25","","527883.17"
"2025-02-25","2025-02-22","SF FuneralFDC00000007RJK250222","","126.5","","528009.67"
"2025-02-25","2025-02-22","SF FuneralFDC00000007XVV250222","","126.5","","528136.17"
"2025-02-25","2025-02-22","SF FuneralF801952       250222","","126.5","","528262.67"
"2025-02-25","2025-02-22","SF FuneralFDC00000008T2Z250222","","126.5","","528389.17"
"2025-02-25","2025-02-22","SF FuneralF818403       250222","","126.5","","528515.67"
"2025-02-25","2025-02-22","SF FuneralF823968       250222","","126.5","","528642.17"
"2025-02-25","2025-02-22","SF FuneralF831374       250222","","126.5","","528768.67"
"2025-02-25","2025-02-22","SF FuneralF838890       250222","","126.5","","528895.17"
"2025-02-25","2025-02-22","SF FuneralF1022295      250222","","191.5","","529086.67"
"2025-02-25","2025-02-22","SF FuneralF1052821      250222","","126.5","","529213.17"
"2025-02-25","2025-02-22","SF FuneralFDC0000000N6M4250222","","126.5","","529339.67"
"2025-02-25","2025-02-22","SF FuneralF1120288      250222","","126.5","","529466.17"
"2025-02-25","2025-02-22","SF FuneralF1130385      250222","","126.5","","529592.67"
"2025-02-25","2025-02-22","SF FuneralFDC0000000Q46H250222","","126.5","","529719.17"
"2025-02-25","2025-02-22","SF FuneralF1132384      250222","","126.5","","529845.67"
"2025-02-25","2025-02-24","SF FuneralFDC00000006W3K250223","","126.5","","529972.17"
"2025-02-25","2025-02-24","SF FuneralF831366       250224","","126.5","","530098.67"
"2025-02-25","2025-02-21","SF FuneralF840786       250221","","126.5","","530225.17"
"2025-02-25","2025-02-21","SF FuneralF989714       250221","","126.5","","530351.67"
"2025-02-25","2025-02-22","SF FuneralFDC00000005SKB250222","","126.5","","530478.17"
"2025-02-25","2025-02-22","SF FuneralFDC000000063V7250222","","126.5","","530604.67"
"2025-02-25","2025-02-22","SF FuneralFDC00000007937250222","","126.5","","530731.17"
"2025-02-25","2025-02-22","SF FuneralFDC00000007XVF250222","","126.5","","530857.67"
"2025-02-25","2025-02-22","SF FuneralFDC00000007XW4250222","","126.5","","530984.17"
"2025-02-25","2025-02-22","SF FuneralF805851       250222","","126.5","","531110.67"
"2025-02-25","2025-02-22","SF FuneralF823331       250222","","126.5","","531237.17"
"2025-02-25","2025-02-22","SF FuneralF831128       250222","","126.5","","531363.67"
"2025-02-25","2025-02-22","SF FuneralF1073558      250222","","126.5","","531490.17"
"2025-02-25","2025-02-22","SF FuneralF1118112      250222","","126.5","","531616.67"
"2025-02-25","2025-02-21","SF FuneralF981788       250221","","31.63","","531648.3"
"2025-02-25","2025-02-21","SF FuneralF1022106      250221","","31.63","","531679.93"
"2025-02-25","2025-02-21","SF FuneralFDC0000000JXK7250221","","31.63","","531711.56"
"2025-02-25","2025-02-22","SF FuneralFDC00000006YV4250222","","126.5","","531838.06"
"2025-02-25","2025-02-22","SF FuneralF808318       250222","","126.5","","531964.56"
"2025-02-25","2025-02-22","SF FuneralF1112585      250222","","126.5","","532091.06"
"2025-02-25","2025-02-24","SF FuneralF1112118      250224","","126.5","","532217.56"
"2025-02-25","2025-02-20","SF FuneralF1054689      250220","","126.5","","532344.06"
"2025-02-25","2025-02-20","SF FuneralF1061734      250220","","126.5","","532470.56"
"2025-02-25","2025-02-21","SF FuneralFDC00000006WY7250221","","126.5","","532597.06"
"2025-02-25","2025-02-21","SF FuneralFDC0000000J30B250222","","126.5","","532723.56"
"2025-02-25","2025-02-22","SF FuneralFDC00000006YD9250222","","126.5","","532850.06"
"2025-02-25","2025-02-22","SF FuneralFDC00000008G8J250222","","126.5","","532976.56"
"2025-02-25","2025-02-22","SF FuneralF801527       250222","","126.5","","533103.06"
"2025-02-25","2025-02-22","SF FuneralFDC00000008RHF250222","","126.5","","533229.56"
"2025-02-25","2025-02-22","SF FuneralF810368       250222","","126.5","","533356.06"
"2025-02-25","2025-02-22","SF FuneralFDC0000000D548250222","","126.5","","533482.56"
"2025-02-25","2025-02-22","SF FuneralF838813       250222","","126.5","","533609.06"
"2025-02-25","2025-02-22","SF FuneralF1060943      250222","","126.5","","533735.56"
"2025-02-25","2025-02-22","SF FuneralF1074714      250222","","126.5","","533862.06"
"2025-02-25","2025-02-22","SF FuneralF1078238      250222","","126.5","","533988.56"
"2025-02-25","2025-02-22","SF FuneralF1120803      250222","","126.5","","534115.06"
"2025-02-25","2025-02-22","SF FuneralF1127606      250222","","126.5","","534241.56"
"2025-02-25","2025-02-18","SF FuneralF829052       250218","","63.25","","534304.81"
"2025-02-25","2025-02-18","SF FuneralF994050       250218","","63.25","","534368.06"
"2025-02-25","2025-02-20","SF FuneralF1122619      250220","","126.5","","534494.56"
"2025-02-25","2025-02-21","SF FuneralF1129491      250221","","126.5","","534621.06"
"2025-02-25","2025-02-21","SF FuneralF1132260      250221","","126.5","","534747.56"
"2025-02-25","2025-02-22","SF FuneralFDC00000006WHC250222","","126.5","","534874.06"
"2025-02-25","2025-02-22","SF FuneralFDC00000007F8P250222","","126.5","","535000.56"
"2025-02-25","2025-02-22","SF FuneralFDC00000007JVD250222","","126.5","","535127.06"
"2025-02-25","2025-02-22","SF FuneralFDC00000007XVH250222","","126.5","","535253.56"
"2025-02-25","2025-02-22","SF FuneralFDC00000007XVM250222","","126.5","","535380.06"
"2025-02-25","2025-02-22","SF FuneralFDC00000007XVR250222","","126.5","","535506.56"
"2025-02-25","2025-02-22","SF FuneralF803703       250222","","126.5","","535633.06"
"2025-02-25","2025-02-22","SF FuneralFDC0000000996J250222","","126.5","","535759.56"
"2025-02-25","2025-02-22","SF FuneralF823280       250222","","126.5","","535886.06"
"2025-02-25","2025-02-22","SF FuneralF840502       250222","","126.5","","536012.56"
"2025-02-25","2025-02-22","SF FuneralF993357       250222","","126.5","","536139.06"
"2025-02-25","2025-02-22","SF FuneralF1073813      250222","","126.5","","536265.56"
"2025-02-25","2025-02-22","SF FuneralF1115989      250222","","126.5","","536392.06"
"2025-02-25","2025-02-22","SF FuneralFDC0000000NJV2250222","","126.5","","536518.56"
"2025-02-25","2025-02-22","SF FuneralFDC0000000NL55250222","","126.5","","536645.06"
"2025-02-25","2025-02-22","SF FuneralF1128983      250222","","126.5","","536771.56"
"2025-02-25","2025-02-22","SF FuneralFDC0000000PX26250222","","126.5","","536898.06"
"2025-02-25","2025-02-24","SF FuneralF900552       250222","","126.5","","537024.56"
"2025-02-25","2025-02-21","SF FuneralFDC000000082HZ250221","","126.5","","537151.06"
"2025-02-25","2025-02-21","SF FuneralF1085013      250221","","126.5","","537277.56"
"2025-02-25","2025-02-21","SF FuneralF1108341      250221","","126.5","","537404.06"
"2025-02-25","2025-02-21","SF FuneralF1129053      250221","","126.5","","537530.56"
"2025-02-25","2025-02-22","SF FuneralFDC000000061B9250222","","126.5","","537657.06"
"2025-02-25","2025-02-22","SF FuneralFDC00000006583250222","","126.5","","537783.56"
"2025-02-25","2025-02-22","SF FuneralFDC000000073JX250222","","126.5","","537910.06"
"2025-02-25","2025-02-22","SF FuneralFDC00000007M57250222","","126.5","","538036.56"
"2025-02-25","2025-02-22","SF FuneralF813946       250222","","126.5","","538163.06"
"2025-02-25","2025-02-22","SF FuneralF1074483      250222","","126.5","","538289.56"
"2025-02-25","2025-02-22","SF FuneralFDC0000000LF6T250222","","126.5","","538416.06"
"2025-02-25","2025-02-22","SF FuneralF1085031      250222","","126.5","","538542.56"
"2025-02-25","2025-02-22","SF FuneralFDC0000000N9R4250222","","126.5","","538669.06"
"2025-02-25","2025-02-22","SF FuneralF1115788      250222","","126.5","","538795.56"
"2025-02-25","2025-02-22","SF FuneralF1130330      250222","","126.5","","538922.06"
"2025-02-25","2025-02-21","SF FuneralF808922       250221","","126.5","","539048.56"
"2025-02-25","2025-02-21","SF FuneralF1060095      250221","","63.25","","539111.81"
"2025-02-25","2025-02-21","SF FuneralF1124428      250221","","126.5","","539238.31"
"2025-02-25","2025-02-22","SF FuneralF823845       250222","","126.5","","539364.81"
"2025-02-25","2025-02-22","SF FuneralF823874       250222","","126.5","","539491.31"
"2025-02-25","2025-02-22","SF FuneralF829547       250222","","126.5","","539617.81"
"2025-02-25","2025-02-22","SF FuneralFDC0000000DFN2250222","","126.5","","539744.31"
"2025-02-25","2025-02-22","SF FuneralF842693       250222","","126.5","","539870.81"
"2025-02-25","2025-02-22","SF FuneralF1114981      250222","","126.5","","539997.31"
"2025-02-25","2025-02-22","SF FuneralF1117700      250223","","126.5","","540123.81"
"2025-02-25","2025-02-22","SF FuneralFDC0000000NXVF250223","","126.5","","540250.31"
"2025-02-25","2025-02-22","SF FuneralF1120649      250223","","126.5","","540376.81"
"2025-02-25","2025-02-22","SF FuneralFDC0000000PB3V250222","","321.5","","540698.31"
"2025-02-25","2025-02-22","SF FuneralF1124595      250222","","126.5","","540824.81"
"2025-02-25","2025-02-22","SF FuneralFDC0000000PSHX250222","","126.5","","540951.31"
"2025-02-25","2025-02-22","SF FuneralF1128980      250222","","126.5","","541077.81"
"2025-02-25","2025-02-22","SF FuneralF1130331      250222","","126.5","","541204.31"
"2025-02-25","2025-02-22","SF FuneralF1130446      250222","","126.5","","541330.81"
"2025-02-25","2025-02-22","SF FuneralFDC0000000Q246250222","","126.5","","541457.31"
"2025-02-25","2025-02-22","SF FuneralF1131012      250222","","126.5","","541583.81"
"2025-02-25","2025-02-22","SF FuneralF1132486      250222","","126.5","","541710.31"
"2025-02-25","2025-02-24","SF FuneralFDC000000079BQ250223","","126.5","","541836.81"
"2025-02-25","2025-02-24","SF FuneralF1080419      250224","","126.5","","541963.31"
"2025-02-25","2025-02-20","SF FuneralFDC00000007JZ0250220","","126.5","","542089.81"
"2025-02-25","2025-02-21","SF FuneralF813672       250221","","126.5","","542216.31"
"2025-02-25","2025-02-22","SF FuneralFDC000000034HX250222","","220","","542436.31"
"2025-02-25","2025-02-22","SF FuneralFDC000000061KK250222","","126.5","","542562.81"
"2025-02-25","2025-02-22","SF FuneralFDC0000000688W250222","","126.5","","542689.31"
"2025-02-25","2025-02-22","SF FuneralFDC00000006Z9F250222","","126.5","","542815.81"
"2025-02-25","2025-02-22","SF FuneralFDC00000006ZX8250222","","126.5","","542942.31"
"2025-02-25","2025-02-22","SF FuneralFDC000000072JN250222","","126.5","","543068.81"
"2025-02-25","2025-02-22","SF FuneralFDC000000072NG250222","","126.5","","543195.31"
"2025-02-25","2025-02-22","SF FuneralFDC00000007JVC250222","","126.5","","543321.81"
"2025-02-25","2025-02-22","SF FuneralF815478       250222","","126.5","","543448.31"
"2025-02-25","2025-02-22","SF FuneralF819398       250222","","126.5","","543574.81"
"2025-02-25","2025-02-22","SF FuneralF820542       250222","","126.5","","543701.31"
"2025-02-25","2025-02-22","SF FuneralF830827       250222","","126.5","","543827.81"
"2025-02-25","2025-02-22","SF FuneralF1052794      250222","","126.5","","543954.31"
"2025-02-25","2025-02-22","SF FuneralF988454       250222","","126.5","","544080.81"
"2025-02-25","2025-02-22","SF FuneralF823216       250222","","126.5","","544207.31"
"2025-02-25","2025-02-22","SF FuneralFDC0000000MGPJ250222","","126.5","","544333.81"
"2025-02-25","2025-02-22","SF FuneralF1123606      250222","","126.5","","544460.31"
"2025-02-25","2025-02-22","SF FuneralF1130645      250222","","126.5","","544586.81"
"2025-02-25","2025-02-24","SF FuneralF1127890      250224","","126.5","","544713.31"
"2025-02-25","2025-02-21","SF FuneralFDC00000003GZH250221","","220","","544933.31"
"2025-02-25","2025-02-21","SF FuneralF987036       250222","","126.5","","545059.81"
"2025-02-25","2025-02-21","SF FuneralF987250       250222","","126.5","","545186.31"
"2025-02-25","2025-02-21","SF FuneralF987493       250222","","126.5","","545312.81"
"2025-02-25","2025-02-21","SF FuneralF1108392      250221","","126.5","","545439.31"
"2025-02-25","2025-02-22","SF FuneralFDC00000005K7F250222","","126.5","","545565.81"
"2025-02-25","2025-02-22","SF FuneralFDC00000005V5F250222","","126.5","","545692.31"
"2025-02-25","2025-02-22","SF FuneralFDC00000006BQJ250222","","126.5","","545818.81"
"2025-02-25","2025-02-22","SF FuneralFDC00000006M8K250222","","126.5","","545945.31"
"2025-02-25","2025-02-22","SF FuneralFDC00000006Z1Z250222","","126.5","","546071.81"
"2025-02-25","2025-02-22","SF FuneralFDC00000007MJB250222","","126.5","","546198.31"
"2025-02-25","2025-02-22","SF FuneralFDC000000085TB250222","","126.5","","546324.81"
"2025-02-25","2025-02-22","SF FuneralFDC00000008639250222","","126.5","","546451.31"
"2025-02-25","2025-02-22","SF FuneralF811599       250222","","126.5","","546577.81"
"2025-02-25","2025-02-22","SF FuneralF815138       250222","","126.5","","546704.31"
"2025-02-25","2025-02-22","SF FuneralF819486       250222","","126.5","","546830.81"
"2025-02-25","2025-02-22","SF FuneralFDC0000000BCVB250222","","126.5","","546957.31"
"2025-02-25","2025-02-22","SF FuneralF823181       250222","","126.5","","547083.81"
"2025-02-25","2025-02-22","SF FuneralF823473       250222","","126.5","","547210.31"
"2025-02-25","2025-02-22","SF FuneralF832775       250222","","126.5","","547336.81"
"2025-02-25","2025-02-22","SF FuneralFDC0000000CPY3250222","","126.5","","547463.31"
"2025-02-25","2025-02-22","SF FuneralF992037       250222","","126.5","","547589.81"
"2025-02-25","2025-02-22","SF FuneralF1016665      250222","","126.5","","547716.31"
"2025-02-25","2025-02-22","SF FuneralF1108264      250222","","126.5","","547842.81"
"2025-02-25","2025-02-22","SF FuneralFDC0000000N928250222","","126.5","","547969.31"
"2025-02-25","2025-02-22","SF FuneralFDC0000000N92F250222","","126.5","","548095.81"
"2025-02-25","2025-02-22","SF FuneralF1115776      250222","","126.5","","548222.31"
"2025-02-25","2025-02-22","SF FuneralFDC0000000PX1W250222","","126.5","","548348.81"
"2025-02-25","2025-02-24","SF FuneralFDC00000003XTD250223","","220","","548568.81"
"2025-02-25","2025-02-22","SF FuneralFDC00000005G9T250222","","126.5","","548695.31"
"2025-02-25","2025-02-22","SF FuneralFDC00000005P75250222","","126.5","","548821.81"
"2025-02-25","2025-02-22","SF FuneralFDC000000060TK250222","","220","","549041.81"
"2025-02-25","2025-02-22","SF FuneralFDC000000062HJ250222","","126.5","","549168.31"
"2025-02-25","2025-02-22","SF FuneralFDC000000078QJ250222","","126.5","","549294.81"
"2025-02-25","2025-02-22","SF FuneralFDC00000007K8M250222","","126.5","","549421.31"
"2025-02-25","2025-02-22","SF FuneralF1054608      250223","","126.5","","549547.81"
"2025-02-25","2025-02-22","SF FuneralF1083701      250222","","126.5","","549674.31"
"2025-02-25","2025-02-22","SF FuneralF1110306      250222","","126.5","","549800.81"
"2025-02-25","2025-02-22","SF FuneralF1130667      250222","","126.5","","549927.31"
"2025-02-25","2025-02-21","SF FuneralFDC000000067WF250221","","126.5","","550053.81"
"2025-02-25","2025-02-21","SF FuneralF1115955      250221","","126.5","","550180.31"
"2025-02-25","2025-02-21","SF FuneralF1126933      250221","","126.5","","550306.81"
"2025-02-25","2025-02-21","SF FuneralFDC0000000PW3C250221","","126.5","","550433.31"
"2025-02-25","2025-02-24","SF FuneralFDC00000009DX3250223","","31.63","","550464.94"
"2025-02-25","2025-02-24","SF FuneralFDC0000000B723250224","","126.5","","550591.44"
"2025-02-25","2025-02-18","SF FuneralF843976       250218","","31.63","","550623.07"
"2025-02-25","2025-02-17","SF FuneralF816474       250217","","126.5","","550749.57"
"2025-02-25","2025-02-17","SF FuneralF1124998      250217","","126.5","","550876.07"
"2025-02-25","2025-02-24","SF FuneralFDC00000005VYT250223","","126.5","","551002.57"
"2025-02-25","2025-02-24","SF FuneralF900559       250222","","126.5","","551129.07"
"2025-02-25","2025-02-20","SF FuneralF1129028      250220","","126.5","","551255.57"
"2025-02-25","2025-02-22","SF FuneralFDC00000002QS9250222","","220","","551475.57"
"2025-02-25","2025-02-22","SF FuneralFDC00000005JZV250222","","126.5","","551602.07"
"2025-02-25","2025-02-22","SF FuneralFDC000000062V3250222","","126.5","","551728.57"
"2025-02-25","2025-02-22","SF FuneralFDC0000000641R250222","","126.5","","551855.07"
"2025-02-25","2025-02-22","SF FuneralFDC00000006CRV250222","","126.5","","551981.57"
"2025-02-25","2025-02-22","SF FuneralFDC00000006X3Y250222","","126.5","","552108.07"
"2025-02-25","2025-02-22","SF FuneralFDC00000006YM3250222","","126.5","","552234.57"
"2025-02-25","2025-02-22","SF FuneralFDC000000072FV250222","","126.5","","552361.07"
"2025-02-25","2025-02-22","SF FuneralFDC00000007K9C250222","","126.5","","552487.57"
"2025-02-25","2025-02-22","SF FuneralF796481       250222","","126.5","","552614.07"
"2025-02-25","2025-02-22","SF FuneralF805801       250222","","126.5","","552740.57"
"2025-02-25","2025-02-22","SF FuneralFDC00000009HXP250222","","126.5","","552867.07"
"2025-02-25","2025-02-22","SF FuneralF815605       250222","","126.5","","552993.57"
"2025-02-25","2025-02-22","SF FuneralF819261       250222","","126.5","","553120.07"
"2025-02-25","2025-02-22","SF FuneralF819702       250222","","126.5","","553246.57"
"2025-02-25","2025-02-22","SF FuneralF823729       250222","","126.5","","553373.07"
"2025-02-25","2025-02-22","SF FuneralF840617       250222","","126.5","","553499.57"
"2025-02-25","2025-02-22","SF FuneralF841796       250222","","126.5","","553626.07"
"2025-02-25","2025-02-22","SF FuneralF781872       250222","","126.5","","553752.57"
"2025-02-25","2025-02-22","SF FuneralF1052840      250222","","126.5","","553879.07"
"2025-02-25","2025-02-22","SF FuneralF1054917      250222","","126.5","","554005.57"
"2025-02-25","2025-02-22","SF FuneralF1055257      250222","","126.5","","554132.07"
"2025-02-25","2025-02-22","SF FuneralF1060864      250222","","126.5","","554258.57"
"2025-02-25","2025-02-22","SF FuneralF1066018      250222","","126.5","","554385.07"
"2025-02-25","2025-02-22","SF FuneralF1073832      250222","","126.5","","554511.57"
"2025-02-25","2025-02-22","SF FuneralFDC0000000LMPJ250222","","126.5","","554638.07"
"2025-02-25","2025-02-22","SF FuneralF1080449      250222","","126.5","","554764.57"
"2025-02-25","2025-02-22","SF FuneralF1102847      250222","","126.5","","554891.07"
"2025-02-25","2025-02-22","SF FuneralF1108593      250222","","126.5","","555017.57"
"2025-02-25","2025-02-22","SF FuneralF1114302      250222","","126.5","","555144.07"
"2025-02-25","2025-02-22","SF FuneralF1120339      250223","","126.5","","555270.57"
"2025-02-25","2025-02-22","SF FuneralF1122894      250222","","126.5","","555397.07"
"2025-02-25","2025-02-22","SF FuneralFDC0000000P8Q8250222","","126.5","","555523.57"
"2025-02-25","2025-02-22","SF FuneralF1124282      250222","","126.5","","555650.07"
"2025-02-25","2025-02-22","SF FuneralF1124438      250222","","126.5","","555776.57"
"2025-02-25","2025-02-22","SF FuneralF1112376      250222","","126.5","","555903.07"
"2025-02-25","2025-02-22","SF FuneralF1127971      250222","","126.5","","556029.57"
"2025-02-25","2025-02-22","SF FuneralF1129172      250222","","126.5","","556156.07"
"2025-02-25","2025-02-22","SF FuneralF1131597      250222","","126.5","","556282.57"
"2025-02-25","2025-02-21","SF FuneralFDC00000005VPZ250221","","31.63","","556314.2"
"2025-02-25","2025-02-21","SF FuneralFDC0000000888H250221","","126.5","","556440.7"
"2025-02-25","2025-02-21","SF FuneralFDC0000000888L250221","","126.5","","556567.2"
"2025-02-25","2025-02-21","SF FuneralF803570       250221","","126.5","","556693.7"
"2025-02-25","2025-02-21","SF FuneralF809767       250221","","126.5","","556820.2"
"2025-02-25","2025-02-21","SF FuneralF817416       250221","","126.5","","556946.7"
"2025-02-25","2025-02-21","SF FuneralF840953       250221","","126.5","","557073.2"
"2025-02-25","2025-02-21","SF FuneralF989868       250222","","126.5","","557199.7"
"2025-02-25","2025-02-21","SF FuneralF991276       250222","","126.5","","557326.2"
"2025-02-25","2025-02-21","SF FuneralF1062695      250221","","126.5","","557452.7"
"2025-02-25","2025-02-21","SF FuneralF1127968      250221","","126.5","","557579.2"
"2025-02-25","2025-02-21","SF FuneralF1129945      250221","","31.63","","557610.83"
"2025-02-25","2025-02-20","SF FuneralFDC00000005GLY250220","","126.5","","557737.33"
"2025-02-25","2025-02-20","SF FuneralFDC00000006CVR250220","","126.5","","557863.83"
"2025-02-25","2025-02-21","SF FuneralFDC000000067VB250221","","126.5","","557990.33"
"2025-02-25","2025-02-21","SF FuneralFDC00000009FRV250221","","126.5","","558116.83"
"2025-02-25","2025-02-21","SF FuneralF820027       250221","","126.5","","558243.33"
"2025-02-25","2025-02-21","SF FuneralF987411       250222","","126.5","","558369.83"
"2025-02-25","2025-02-21","SF FuneralF989551       250222","","126.5","","558496.33"
"2025-02-25","2025-02-24","SF FuneralFDC00000003XCX250223","","220","","558716.33"
"2025-02-25","2025-02-24","SF FuneralFDC00000005Z06250224","","31.63","","558747.96"
"2025-02-25","2025-02-24","SF FuneralFDC00000005Z12250224","","31.63","","558779.59"
"2025-02-25","2025-02-24","SF FuneralFDC00000005Z25250224","","31.63","","558811.22"
"2025-02-25","2025-02-24","SF FuneralFDC000000060Y2250223","","126.5","","558937.72"
"2025-02-25","2025-02-24","SF FuneralFDC000000081VT250223","","126.5","","559064.22"
"2025-02-25","2025-02-24","SF FuneralFDC000000081VY250223","","126.5","","559190.72"
"2025-02-25","2025-02-24","SF FuneralF805633       250224","","126.5","","559317.22"
"2025-02-25","2025-02-24","SF FuneralF847239       250222","","126.5","","559443.72"
"2025-02-25","2025-02-24","SF FuneralFDC0000000GJWB250222","","126.5","","559570.22"
"2025-02-25","2025-02-24","SF FuneralF1085335      250224","","126.5","","559696.72"
"2025-02-25","2025-02-24","SF FuneralF1124769      250224","","126.5","","559823.22"
"2025-02-25","2025-02-17","SF FuneralF1125045      250217","","126.5","","559949.72"
"2025-02-25","2025-02-15","SF FuneralF829060       250215","","126.5","","560076.22"
"2025-02-25","2025-02-22","SF FuneralFDC00000003GPW250222","","220","","560296.22"
"2025-02-25","2025-02-22","SF FuneralFDC00000003H19250222","","220.01","","560516.23"
"2025-02-25","2025-02-22","SF FuneralFDC00000003M35250222","","220","","560736.23"
"2025-02-25","2025-02-22","SF FuneralFDC000000042Q8250222","","220","","560956.23"
"2025-02-25","2025-02-22","SF FuneralFDC00000004G0C250222","","220","","561176.23"
"2025-02-25","2025-02-22","SF FuneralFDC00000005LKL250222","","126.5","","561302.73"
"2025-02-25","2025-02-22","SF FuneralFDC00000005Z6D250222","","126.5","","561429.23"
"2025-02-25","2025-02-22","SF FuneralFDC00000005ZQ9250222","","126.5","","561555.73"
"2025-02-25","2025-02-22","SF FuneralFDC0000000640W250222","","126.5","","561682.23"
"2025-02-25","2025-02-22","SF FuneralFDC0000000654J250222","","126.5","","561808.73"
"2025-02-25","2025-02-22","SF FuneralFDC000000065GY250222","","126.5","","561935.23"
"2025-02-25","2025-02-22","SF FuneralFDC000000065N4250222","","126.5","","562061.73"
"2025-02-25","2025-02-22","SF FuneralFDC0000000667R250222","","126.5","","562188.23"
"2025-02-25","2025-02-22","SF FuneralFDC00000006684250222","","126.5","","562314.73"
"2025-02-25","2025-02-22","SF FuneralFDC0000000670V250222","","126.5","","562441.23"
"2025-02-25","2025-02-22","SF FuneralFDC0000000686W250222","","126.5","","562567.73"
"2025-02-25","2025-02-22","SF FuneralFDC000000068SG250222","","126.5","","562694.23"
"2025-02-25","2025-02-22","SF FuneralFDC00000006D61250222","","126.5","","562820.73"
"2025-02-25","2025-02-22","SF FuneralFDC00000006F4X250222","","126.5","","562947.23"
"2025-02-25","2025-02-22","SF FuneralFDC00000006FJD250222","","126.5","","563073.73"
"2025-02-25","2025-02-22","SF FuneralFDC00000006PKT250222","","126.5","","563200.23"
"2025-02-25","2025-02-22","SF FuneralFDC00000006Q2B250222","","126.5","","563326.73"
"2025-02-25","2025-02-22","SF FuneralFDC00000006T66250222","","126.5","","563453.23"
"2025-02-25","2025-02-22","SF FuneralFDC000000070RF250222","","126.5","","563579.73"
"2025-02-25","2025-02-22","SF FuneralFDC000000071D4250222","","126.5","","563706.23"
"2025-02-25","2025-02-22","SF FuneralFDC000000072D4250222","","126.5","","563832.73"
"2025-02-25","2025-02-22","SF FuneralFDC000000072ND250222","","126.5","","563959.23"
"2025-02-25","2025-02-22","SF FuneralFDC000000073LB250222","","126.5","","564085.73"
"2025-02-25","2025-02-22","SF FuneralFDC000000077WM250222","","126.5","","564212.23"
"2025-02-25","2025-02-22","SF FuneralFDC000000077X8250222","","126.5","","564338.73"
"2025-02-25","2025-02-22","SF FuneralFDC00000007FBP250222","","126.5","","564465.23"
"2025-02-25","2025-02-22","SF FuneralFDC00000007KYM250222","","220","","564685.23"
"2025-02-25","2025-02-22","SF FuneralFDC00000007M08250222","","126.5","","564811.73"
"2025-02-25","2025-02-22","SF FuneralFDC00000007M71250222","","126.5","","564938.23"
"2025-02-25","2025-02-22","SF FuneralFDC00000007QBZ250222","","126.5","","565064.73"
"2025-02-25","2025-02-22","SF FuneralFDC00000007TN9250222","","126.5","","565191.23"
"2025-02-25","2025-02-22","SF FuneralFDC00000008112250222","","126.5","","565317.73"
"2025-02-25","2025-02-22","SF FuneralFDC000000081T7250222","","126.5","","565444.23"
"2025-02-25","2025-02-22","SF FuneralFDC000000081T8250222","","126.5","","565570.73"
"2025-02-25","2025-02-22","SF FuneralFDC000000081TT250222","","126.5","","565697.23"
"2025-02-25","2025-02-22","SF FuneralFDC000000081VB250222","","126.5","","565823.73"
"2025-02-25","2025-02-22","SF FuneralFDC000000081YN250222","","126.5","","565950.23"
"2025-02-25","2025-02-22","SF FuneralF802419       250222","","126.5","","566076.73"
"2025-02-25","2025-02-22","SF FuneralFDC00000008NN8250222","","126.5","","566203.23"
"2025-02-25","2025-02-22","SF FuneralF803763       250222","","126.5","","566329.73"
"2025-02-25","2025-02-22","SF FuneralF804128       250222","","126.5","","566456.23"
"2025-02-25","2025-02-22","SF FuneralF804134       250222","","126.5","","566582.73"
"2025-02-25","2025-02-22","SF FuneralFDC00000008TZK250222","","126.5","","566709.23"
"2025-02-25","2025-02-22","SF FuneralF808946       250222","","126.5","","566835.73"
"2025-02-25","2025-02-22","SF FuneralF809686       250222","","126.5","","566962.23"
"2025-02-25","2025-02-22","SF FuneralFDC000000095VP250222","","126.5","","567088.73"
"2025-02-25","2025-02-22","SF FuneralF812846       250222","","126.5","","567215.23"
"2025-02-25","2025-02-22","SF FuneralF813381       250222","","126.5","","567341.73"
"2025-02-25","2025-02-22","SF FuneralF798152       250222","","126.5","","567468.23"
"2025-02-25","2025-02-22","SF FuneralF815856       250222","","126.5","","567594.73"
"2025-02-25","2025-02-22","SF FuneralFDC00000009XXT250222","","126.5","","567721.23"
"2025-02-25","2025-02-22","SF FuneralFDC0000000B410250222","","126.5","","567847.73"
"2025-02-25","2025-02-22","SF FuneralF821539       250222","","126.5","","567974.23"
"2025-02-25","2025-02-22","SF FuneralF821957       250222","","126.5","","568100.73"
"2025-02-25","2025-02-22","SF FuneralF828106       250222","","126.5","","568227.23"
"2025-02-25","2025-02-22","SF FuneralF830985       250222","","126.5","","568353.73"
"2025-02-25","2025-02-22","SF FuneralF832267       250222","","126.5","","568480.23"
"2025-02-25","2025-02-22","SF FuneralF833186       250222","","126.5","","568606.73"
"2025-02-25","2025-02-22","SF FuneralF834524       250222","","126.5","","568733.23"
"2025-02-25","2025-02-22","SF FuneralF834545       250222","","126.5","","568859.73"
"2025-02-25","2025-02-22","SF FuneralFDC0000000DHQ3250222","","126.5","","568986.23"
"2025-02-25","2025-02-22","SF FuneralF842514       250222","","126.5","","569112.73"
"2025-02-25","2025-02-22","SF FuneralF842878       250222","","126.5","","569239.23"
"2025-02-25","2025-02-22","SF FuneralF1020532      250222","","126.5","","569365.73"
"2025-02-25","2025-02-22","SF FuneralF1021876      250222","","126.5","","569492.23"
"2025-02-25","2025-02-22","SF FuneralF1050735      250222","","126.5","","569618.73"
"2025-02-25","2025-02-22","SF FuneralF1054909      250222","","126.5","","569745.23"
"2025-02-25","2025-02-22","SF FuneralF1055001      250222","","126.5","","569871.73"
"2025-02-25","2025-02-22","SF FuneralF1055116      250222","","126.5","","569998.23"
"2025-02-25","2025-02-22","SF FuneralF1060391      250222","","126.5","","570124.73"
"2025-02-25","2025-02-22","SF FuneralF1061767      250222","","126.5","","570251.23"
"2025-02-25","2025-02-22","SF FuneralF1061884      250222","","126.5","","570377.73"
"2025-02-25","2025-02-22","SF FuneralFDC0000000KPHD250222","","126.5","","570504.23"
"2025-02-25","2025-02-22","SF FuneralFDC0000000KQ0M250222","","126.5","","570630.73"
"2025-02-25","2025-02-22","SF FuneralF1066051      250223","","126.5","","570757.23"
"2025-02-25","2025-02-22","SF FuneralF1066396      250223","","126.5","","570883.73"
"2025-02-25","2025-02-22","SF FuneralF1066723      250222","","126.5","","571010.23"
"2025-02-25","2025-02-22","SF FuneralF1066964      250222","","126.5","","571136.73"
"2025-02-25","2025-02-22","SF FuneralF1067973      250222","","126.5","","571263.23"
"2025-02-25","2025-02-22","SF FuneralF1068177      250222","","126.5","","571389.73"
"2025-02-25","2025-02-22","SF FuneralF1073207      250222","","126.5","","571516.23"
"2025-02-25","2025-02-22","SF FuneralFDC0000000L24R250222","","126.5","","571642.73"
"2025-02-25","2025-02-22","SF FuneralFDC0000000L24X250222","","126.5","","571769.23"
"2025-02-25","2025-02-22","SF FuneralF1073222      250222","","126.5","","571895.73"
"2025-02-25","2025-02-22","SF FuneralF1074465      250222","","126.5","","572022.23"
"2025-02-25","2025-02-22","SF FuneralF1074820      250222","","126.5","","572148.73"
"2025-02-25","2025-02-22","SF FuneralF1078504      250222","","126.5","","572275.23"
"2025-02-25","2025-02-22","SF FuneralF1079244      250222","","126.5","","572401.73"
"2025-02-25","2025-02-22","SF FuneralF1083936      250222","","126.5","","572528.23"
"2025-02-25","2025-02-22","SF FuneralF1084283      250222","","126.5","","572654.73"
"2025-02-25","2025-02-22","SF FuneralF1085288      250223","","126.5","","572781.23"
"2025-02-25","2025-02-22","SF FuneralF1108024      250222","","126.5","","572907.73"
"2025-02-25","2025-02-22","SF FuneralF1108045      250222","","126.5","","573034.23"
"2025-02-25","2025-02-22","SF FuneralF1108706      250222","","126.5","","573160.73"
"2025-02-25","2025-02-22","SF FuneralF1108875      250222","","126.5","","573287.23"
"2025-02-25","2025-02-22","SF FuneralF1109837      250223","","126.5","","573413.73"
"2025-02-25","2025-02-22","SF FuneralFDC0000000MZR6250222","","126.5","","573540.23"
"2025-02-25","2025-02-22","SF FuneralF1112244      250222","","126.5","","573666.73"
"2025-02-25","2025-02-22","SF FuneralF1113899      250222","","126.5","","573793.23"
"2025-02-25","2025-02-22","SF FuneralF1114925      250222","","126.5","","573919.73"
"2025-02-25","2025-02-22","SF FuneralFDC0000000NLY4250222","","126.5","","574046.23"
"2025-02-25","2025-02-22","SF FuneralF1118287      250222","","126.5","","574172.73"
"2025-02-25","2025-02-22","SF FuneralFDC0000000NPS6250222","","126.5","","574299.23"
"2025-02-25","2025-02-22","SF FuneralF1120161      250222","","126.5","","574425.73"
"2025-02-25","2025-02-22","SF FuneralFDC0000000NVZY250222","","256.5","","574682.23"
"2025-02-25","2025-02-22","SF FuneralF1120424      250222","","126.5","","574808.73"
"2025-02-25","2025-02-22","SF FuneralFDC0000000P0Z1250222","","126.5","","574935.23"
"2025-02-25","2025-02-22","SF FuneralFDC0000000P0Z9250222","","126.5","","575061.73"
"2025-02-25","2025-02-22","SF FuneralF1122947      250222","","126.5","","575188.23"
"2025-02-25","2025-02-22","SF FuneralF1124596      250222","","126.5","","575314.73"
"2025-02-25","2025-02-22","SF FuneralFDC0000000PH6H250222","","126.5","","575441.23"
"2025-02-25","2025-02-22","SF FuneralF1127365      250222","","126.5","","575567.73"
"2025-02-25","2025-02-22","SF FuneralF1127549      250222","","126.5","","575694.23"
"2025-02-25","2025-02-22","SF FuneralFDC0000000PVMR250222","","126.5","","575820.73"
"2025-02-25","2025-02-22","SF FuneralF1129200      250222","","126.5","","575947.23"
"2025-02-25","2025-02-22","SF FuneralFDC0000000Q390250222","","126.5","","576073.73"
"2025-02-25","2025-02-22","SF FuneralF1131018      250222","","126.5","","576200.23"
"2025-02-25","2025-02-22","SF FuneralF1132068      250222","","126.5","","576326.73"
"2025-02-25","2025-02-25","SF FuneralFDC00000007MQ0250225","","126.5","","576453.23"
"2025-02-25","2025-02-25","SF FuneralFDC00000007QQ4250225","","126.5","","576579.73"
"2025-02-25","2025-02-25","SF FuneralF811733       250225","","31.63","","576611.36"
"2025-02-25","2025-02-25","SF FuneralFDC0000000NN7N250225","","31.63","","576642.99"
"2025-02-25","2025-02-25","SF FuneralF830273       250225","","126.5","","576769.49"
"2025-02-25","2025-02-25","SF FuneralF1078284      250225","","126.5","","576895.99"
"2025-02-25","2025-02-25","SF FuneralF1116023      250225","","126.5","","577022.49"
"2025-02-25","2025-02-21","SF FuneralF830936       250222","","126.5","","577148.99"
"2025-02-25","2025-02-21","SF FuneralF988943       250222","","126.5","","577275.49"
"2025-02-25","2025-02-21","SF FuneralFDC0000000HZKZ250222","","126.5","","577401.99"
"2025-02-25","2025-02-21","SF FuneralF991069       250222","","126.5","","577528.49"
"2025-02-25","2025-02-21","SF FuneralF991399       250222","","126.5","","577654.99"
"2025-02-25","2025-02-20","SF FuneralFDC00000002VFK250220","","220","","577874.99"
"2025-02-25","2025-02-20","SF FuneralF818016       250220","","126.5","","578001.49"
"2025-02-25","2025-02-20","SF FuneralF1124293      250220","","126.5","","578127.99"
"2025-02-25","2025-02-22","SF FuneralFDC0000000498S250222","","220","","578347.99"
"2025-02-25","2025-02-22","SF FuneralFDC00000005M9Q250222","","126.5","","578474.49"
"2025-02-25","2025-02-22","SF FuneralFDC00000005YMX250222","","126.5","","578600.99"
"2025-02-25","2025-02-22","SF FuneralFDC00000005Z24250222","","126.5","","578727.49"
"2025-02-25","2025-02-22","SF FuneralFDC0000000610Y250222","","126.5","","578853.99"
"2025-02-25","2025-02-22","SF FuneralFDC00000006TPV250222","","126.5","","578980.49"
"2025-02-25","2025-02-22","SF FuneralFDC00000007BF7250222","","126.5","","579106.99"
"2025-02-25","2025-02-22","SF FuneralFDC00000007KS7250222","","126.5","","579233.49"
"2025-02-25","2025-02-22","SF FuneralF798145       250222","","126.5","","579359.99"
"2025-02-25","2025-02-22","SF FuneralF798710       250222","","126.5","","579486.49"
"2025-02-25","2025-02-22","SF FuneralF804701       250222","","126.5","","579612.99"
"2025-02-25","2025-02-22","SF FuneralFDC00000008SF1250222","","126.5","","579739.49"
"2025-02-25","2025-02-22","SF FuneralF805615       250222","","126.5","","579865.99"
"2025-02-25","2025-02-22","SF FuneralF811771       250222","","126.5","","579992.49"
"2025-02-25","2025-02-22","SF FuneralF812164       250222","","126.5","","580118.99"
"2025-02-25","2025-02-22","SF FuneralF785624       250222","","126.5","","580245.49"
"2025-02-25","2025-02-22","SF FuneralF831231       250222","","126.5","","580371.99"
"2025-02-25","2025-02-22","SF FuneralF833546       250222","","126.5","","580498.49"
"2025-02-25","2025-02-22","SF FuneralF838858       250222","","126.5","","580624.99"
"2025-02-25","2025-02-22","SF FuneralF841651       250222","","126.5","","580751.49"
"2025-02-25","2025-02-22","SF FuneralF841874       250222","","126.5","","580877.99"
"2025-02-25","2025-02-22","SF FuneralF1020453      250222","","126.5","","581004.49"
"2025-02-25","2025-02-22","SF FuneralF1022174      250222","","126.5","","581130.99"
"2025-02-25","2025-02-22","SF FuneralF1054799      250222","","126.5","","581257.49"
"2025-02-25","2025-02-22","SF FuneralF1061687      250222","","126.5","","581383.99"
"2025-02-25","2025-02-22","SF FuneralF991470       250222","","126.5","","581510.49"
"2025-02-25","2025-02-22","SF FuneralFDC0000000LPQQ250222","","126.5","","581636.99"
"2025-02-25","2025-02-22","SF FuneralF1108330      250222","","126.5","","581763.49"
"2025-02-25","2025-02-22","SF FuneralF1108498      250222","","126.5","","581889.99"
"2025-02-25","2025-02-22","SF FuneralF1113577      250222","","126.5","","582016.49"
"2025-02-25","2025-02-22","SF FuneralF1114429      250222","","126.5","","582142.99"
"2025-02-25","2025-02-22","SF FuneralF1114597      250222","","126.5","","582269.49"
"2025-02-25","2025-02-22","SF FuneralF1119884      250222","","126.5","","582395.99"
"2025-02-25","2025-02-22","SF FuneralF1120609      250222","","126.5","","582522.49"
"2025-02-25","2025-02-22","SF FuneralF1120627      250222","","126.5","","582648.99"
"2025-02-25","2025-02-22","SF FuneralF1122743      250222","","126.5","","582775.49"
"2025-02-25","2025-02-22","SF FuneralF1124349      250222","","126.5","","582901.99"
"2025-02-25","2025-02-22","SF FuneralF1124623      250222","","126.5","","583028.49"
"2025-02-25","2025-02-22","SF FuneralF1124835      250222","","126.5","","583154.99"
"2025-02-25","2025-02-22","SF FuneralF1126870      250222","","126.5","","583281.49"
"2025-02-25","2025-02-22","SF FuneralF1127579      250222","","126.5","","583407.99"
"2025-02-25","2025-02-22","SF FuneralF1127665      250222","","126.5","","583534.49"
"2025-02-25","2025-02-22","SF FuneralF1130027      250222","","126.5","","583660.99"
"2025-02-25","2025-02-22","SF FuneralF1130547      250222","","126.5","","583787.49"
"2025-02-25","2025-02-22","SF FuneralF1130718      250222","","126.5","","583913.99"
"2025-02-25","2025-02-22","SF FuneralF1131678      250222","","126.5","","584040.49"
"2025-02-25","2025-02-24","SF FuneralFDC0000000GC91250222","","126.5","","584166.99"
"2025-02-25","2025-02-24","SF FuneralFDC0000000GC9V250222","","126.5","","584293.49"
"2025-02-25","2025-02-24","SF FuneralF1066050      250224","","126.5","","584419.99"
"2025-02-25","2025-02-22","SF FuneralF823570       250222","","126.5","","584546.49"
"2025-02-25","2025-02-25","SF FuneralFDC00000006L9F250225","","31.63","","584578.12"
"2025-02-25","2025-02-25","SF FuneralFDC0000000BP65250225","","63.25","","584641.37"
"2025-02-25","2025-02-19","SF FuneralFDC00000007K1G250219","","126.5","","584767.87"
"2025-02-25","2025-02-20","SF FuneralFDC0000000643W250220","","126.5","","584894.37"
"2025-02-25","2025-02-20","SF FuneralF991496       250220","","126.5","","585020.87"
"2025-02-25","2025-02-20","SF FuneralF992036       250220","","126.5","","585147.37"
"2025-02-25","2025-02-20","SF FuneralF1124394      250220","","126.5","","585273.87"
"2025-02-25","2025-02-21","SF FuneralFDC00000005YKS250221","","126.5","","585400.37"
"2025-02-25","2025-02-21","SF FuneralFDC00000005YMQ250221","","126.5","","585526.87"
"2025-02-25","2025-02-21","SF FuneralFDC00000005YQ4250221","","126.5","","585653.37"
"2025-02-25","2025-02-21","SF FuneralF831577       250221","","126.5","","585779.87"
"2025-02-25","2025-02-21","SF FuneralF980697       250222","","126.5","","585906.37"
"2025-02-25","2025-02-21","SF FuneralF987539       250221","","126.5","","586032.87"
"2025-02-25","2025-02-21","SF FuneralF991009       250222","","191.5","","586224.37"
"2025-02-25","2025-02-21","SF FuneralFDC0000000J418250222","","126.5","","586350.87"
"2025-02-25","2025-02-21","SF FuneralF991358       250222","","126.5","","586477.37"
"2025-02-25","2025-02-21","SF FuneralF991430       250222","","126.5","","586603.87"
"2025-02-25","2025-02-21","SF FuneralF1017796      250221","","126.5","","586730.37"
"2025-02-25","2025-02-22","SF FuneralFDC0000000375G250222","","220","","586950.37"
"2025-02-25","2025-02-22","SF FuneralFDC0000000375T250222","","220","","587170.37"
"2025-02-25","2025-02-22","SF FuneralFDC0000000578N250222","","126.5","","587296.87"
"2025-02-25","2025-02-22","SF FuneralFDC00000005G1T250222","","126.5","","587423.37"
"2025-02-25","2025-02-22","SF FuneralFDC00000005Z47250222","","126.5","","587549.87"
"2025-02-25","2025-02-22","SF FuneralFDC00000005ZP0250222","","126.5","","587676.37"
"2025-02-25","2025-02-22","SF FuneralFDC00000005ZRZ250222","","126.5","","587802.87"
"2025-02-25","2025-02-22","SF FuneralFDC00000005ZX0250222","","126.5","","587929.37"
"2025-02-25","2025-02-22","SF FuneralFDC000000060QF250222","","126.5","","588055.87"
"2025-02-25","2025-02-22","SF FuneralFDC00000006237250222","","126.5","","588182.37"
"2025-02-25","2025-02-22","SF FuneralFDC0000000631V250222","","126.5","","588308.87"
"2025-02-25","2025-02-22","SF FuneralFDC000000063Z0250222","","126.5","","588435.37"
"2025-02-25","2025-02-22","SF FuneralFDC0000000642B250222","","126.5","","588561.87"
"2025-02-25","2025-02-22","SF FuneralFDC0000000653J250222","","126.5","","588688.37"
"2025-02-25","2025-02-22","SF FuneralFDC00000006QY1250222","","126.5","","588814.87"
"2025-02-25","2025-02-22","SF FuneralFDC00000006SC3250222","","126.5","","588941.37"
"2025-02-25","2025-02-22","SF FuneralFDC00000006X9C250222","","126.5","","589067.87"
"2025-02-25","2025-02-22","SF FuneralFDC00000006XL8250222","","126.5","","589194.37"
"2025-02-25","2025-02-22","SF FuneralFDC00000006YCN250222","","126.5","","589320.87"
"2025-02-25","2025-02-22","SF FuneralFDC00000006YCZ250222","","126.5","","589447.37"
"2025-02-25","2025-02-22","SF FuneralFDC000000072JP250222","","126.5","","589573.87"
"2025-02-25","2025-02-22","SF FuneralFDC000000078GX250222","","126.5","","589700.37"
"2025-02-25","2025-02-22","SF FuneralFDC00000007JQ2250222","","126.5","","589826.87"
"2025-02-25","2025-02-22","SF FuneralFDC00000007K4N250222","","126.5","","589953.37"
"2025-02-25","2025-02-22","SF FuneralFDC00000007KX0250222","","126.5","","590079.87"
"2025-02-25","2025-02-22","SF FuneralFDC000000080YG250222","","126.5","","590206.37"
"2025-02-25","2025-02-22","SF FuneralFDC00000008BXT250222","","126.5","","590332.87"
"2025-02-25","2025-02-22","SF FuneralFDC00000008GS7250222","","126.5","","590459.37"
"2025-02-25","2025-02-22","SF FuneralF802189       250222","","126.5","","590585.87"
"2025-02-25","2025-02-22","SF FuneralF803477       250222","","126.5","","590712.37"
"2025-02-25","2025-02-22","SF FuneralF804564       250222","","126.5","","590838.87"
"2025-02-25","2025-02-22","SF FuneralFDC00000008TWD250222","","126.5","","590965.37"
"2025-02-25","2025-02-22","SF FuneralFDC00000008XBH250222","","126.5","","591091.87"
"2025-02-25","2025-02-22","SF FuneralF811207       250222","","126.5","","591218.37"
"2025-02-25","2025-02-22","SF FuneralF811233       250222","","126.5","","591344.87"
"2025-02-25","2025-02-22","SF FuneralF811454       250222","","126.5","","591471.37"
"2025-02-25","2025-02-22","SF FuneralF811798       250222","","126.5","","591597.87"
"2025-02-25","2025-02-22","SF FuneralF818350       250222","","126.5","","591724.37"
"2025-02-25","2025-02-22","SF FuneralF830639       250222","","126.5","","591850.87"
"2025-02-25","2025-02-22","SF FuneralF833055       250222","","126.5","","591977.37"
"2025-02-25","2025-02-22","SF FuneralF833263       250222","","126.5","","592103.87"
"2025-02-25","2025-02-22","SF FuneralF833898       250222","","126.5","","592230.37"
"2025-02-25","2025-02-22","SF FuneralFDC0000000D90L250222","","126.5","","592356.87"
"2025-02-25","2025-02-22","SF FuneralF840741       250222","","191.5","","592548.37"
"2025-02-25","2025-02-22","SF FuneralF992162       250222","","126.5","","592674.87"
"2025-02-25","2025-02-22","SF FuneralF992782       250222","","126.5","","592801.37"
"2025-02-25","2025-02-22","SF FuneralF993517       250222","","126.5","","592927.87"
"2025-02-25","2025-02-22","SF FuneralF1020447      250222","","126.5","","593054.37"
"2025-02-25","2025-02-22","SF FuneralF1054932      250222","","126.5","","593180.87"
"2025-02-25","2025-02-22","SF FuneralFDC0000000KH35250222","","126.5","","593307.37"
"2025-02-25","2025-02-22","SF FuneralF1065708      250222","","126.5","","593433.87"
"2025-02-25","2025-02-22","SF FuneralF1074613      250222","","126.5","","593560.37"
"2025-02-25","2025-02-22","SF FuneralFDC0000000LMSF250222","","126.5","","593686.87"
"2025-02-25","2025-02-22","SF FuneralF1080303      250222","","126.5","","593813.37"
"2025-02-25","2025-02-22","SF FuneralF1080557      250222","","126.5","","593939.87"
"2025-02-25","2025-02-22","SF FuneralF1084651      250222","","126.5","","594066.37"
"2025-02-25","2025-02-22","SF FuneralF1102955      250223","","126.5","","594192.87"
"2025-02-25","2025-02-22","SF FuneralF1108370      250222","","126.5","","594319.37"
"2025-02-25","2025-02-22","SF FuneralF1108865      250222","","126.5","","594445.87"
"2025-02-25","2025-02-22","SF FuneralF1110499      250222","","126.5","","594572.37"
"2025-02-25","2025-02-22","SF FuneralF1110514      250222","","126.5","","594698.87"
"2025-02-25","2025-02-22","SF FuneralF1112015      250222","","126.5","","594825.37"
"2025-02-25","2025-02-22","SF FuneralF1112034      250222","","126.5","","594951.87"
"2025-02-25","2025-02-22","SF FuneralF1113994      250222","","126.5","","595078.37"
"2025-02-25","2025-02-22","SF FuneralFDC0000000N7YR250222","","126.5","","595204.87"
"2025-02-25","2025-02-22","SF FuneralFDC0000000NCZB250222","","126.5","","595331.37"
"2025-02-25","2025-02-22","SF FuneralF1116783      250222","","126.5","","595457.87"
"2025-02-25","2025-02-22","SF FuneralFDC0000000NNYB250222","","126.5","","595584.37"
"2025-02-25","2025-02-22","SF FuneralF1118936      250222","","126.5","","595710.87"
"2025-02-25","2025-02-22","SF FuneralF1120137      250222","","126.5","","595837.37"
"2025-02-25","2025-02-22","SF FuneralF1120140      250222","","126.5","","595963.87"
"2025-02-25","2025-02-22","SF FuneralFDC0000000NV5D250222","","126.5","","596090.37"
"2025-02-25","2025-02-22","SF FuneralF1120579      250222","","126.5","","596216.87"
"2025-02-25","2025-02-22","SF FuneralF1120817      250222","","126.5","","596343.37"
"2025-02-25","2025-02-22","SF FuneralF1122667      250222","","126.5","","596469.87"
"2025-02-25","2025-02-22","SF FuneralFDC0000000P3MC250223","","126.5","","596596.37"
"2025-02-25","2025-02-22","SF FuneralFDC0000000P7VJ250222","","321.5","","596917.87"
"2025-02-25","2025-02-22","SF FuneralF1124170      250222","","126.5","","597044.37"
"2025-02-25","2025-02-22","SF FuneralF1124208      250222","","126.5","","597170.87"
"2025-02-25","2025-02-22","SF FuneralFDC0000000P937250222","","126.5","","597297.37"
"2025-02-25","2025-02-22","SF FuneralFDC0000000P93F250222","","126.5","","597423.87"
"2025-02-25","2025-02-22","SF FuneralF1124535      250222","","126.5","","597550.37"
"2025-02-25","2025-02-22","SF FuneralF1125662      250222","","31.63","","597582"
"2025-02-25","2025-02-22","SF FuneralF1130489      250222","","126.5","","597708.5"
"2025-02-25","2025-02-22","SF FuneralF1130544      250223","","126.5","","597835"
"2025-02-25","2025-02-22","SF FuneralF1132452      250222","","126.5","","597961.5"
"2025-02-25","2025-02-23","SF FuneralF815399       250223","","126.5","","598088"
"2025-02-25","2025-02-23","SF FuneralF841825       250223","","126.5","","598214.5"
"2025-02-25","2025-02-24","SF FuneralF843508       250222","","126.5","","598341"
"2025-02-25","2025-02-24","SF FuneralF900389       250222","","126.5","","598467.5"
"2025-02-25","2025-02-24","SF FuneralF1124416      250224","","126.5","","598594"
"2025-02-25","2025-02-25","SF FuneralFDC000000030DF250225","","55","","598649"
"2025-02-25","2025-02-25","SF FuneralFDC00000007KDF250225","","126.5","","598775.5"
"2025-02-25","2025-02-25","SF FuneralFDC00000007NLH250225","","126.5","","598902"
"2025-02-25","2025-02-25","SF FuneralF793907       250225","","126.5","","599028.5"
"2025-02-25","2025-02-25","SF FuneralFDC00000007XJ5250225","","126.5","","599155"
"2025-02-25","2025-02-25","SF FuneralF796010       250225","","256.5","","599411.5"
"2025-02-25","2025-02-25","SF FuneralF802375       250225","","31.63","","599443.13"
"2025-02-25","2025-02-25","SF FuneralFDC00000008LM6250225","","126.5","","599569.63"
"2025-02-25","2025-02-25","SF FuneralF815108       250225","","63.25","","599632.88"
"2025-02-25","2025-02-25","SF FuneralF831106       250225","","31.63","","599664.51"
"2025-02-25","2025-02-25","SF FuneralFDC0000000HL8F250225","","126.5","","599791.01"
"2025-02-25","2025-02-25","SF FuneralF986863       250225","","126.5","","599917.51"
"2025-02-25","2025-02-25","SF FuneralF990232       250225","","31.63","","599949.14"
"2025-02-25","2025-02-25","SF FuneralF991420       250225","","126.5","","600075.64"
"2025-02-25","2025-02-25","SF FuneralF1020916      250225","","31.63","","600107.27"
"2025-02-25","2025-02-25","SF FuneralF1065982      250225","","31.63","","600138.9"
"2025-02-25","2025-02-25","SF FuneralF1068029      250225","","31.63","","600170.53"
"2025-02-25","2025-02-25","SF FuneralF1074649      250225","","31.63","","600202.16"
"2025-02-25","2025-02-25","SF FuneralF1079371      250225","","126.5","","600328.66"
"2025-02-25","2025-02-25","SF FuneralF1112210      250225","","126.5","","600455.16"
"2025-02-25","2025-02-25","SF FuneralF1115105      250225","","31.63","","600486.79"
"2025-02-25","2025-02-25","SF FuneralF1115126      250225","","63.25","","600550.04"
"2025-02-25","2025-02-25","SF FuneralF1115749      250225","","31.63","","600581.67"
"2025-02-25","2025-02-25","SF FuneralF1120169      250225","","126.5","","600708.17"
"2025-02-25","2025-02-25","SF FuneralF1129103      250225","","31.63","","600739.8"
"2025-02-25","2025-02-25","SF FuneralF1130807      250225","","126.5","","600866.3"
"2025-02-25","2025-02-25","SF FuneralF1132314      250225","","31.63","","600897.93"
"2025-02-25","2025-02-25","SF FuneralFDC00000005DGT250225","","191.5","","601089.43"
"2025-02-25","2025-02-25","SF FuneralF802404       250225","","126.5","","601215.93"
"2025-02-25","2025-02-25","SF FuneralF1130742      250225","","126.5","","601342.43"
"2025-02-25","2025-02-25","SF FuneralF823277       250225","","126.5","","601468.93"
"2025-02-25","2025-02-25","SF FuneralF831061       250225","","63.25","","601532.18"
"2025-02-25","2025-02-25","SF FuneralF843976       250225","","31.63","","601563.81"
"2025-02-25","2025-02-22","SF FuneralF1017589      250222","","126.5","","601690.31"
"2025-02-25","2025-02-25","SF FuneralFDC00000005PJW250225","","126.5","","601816.81"
"2025-02-25","2025-02-25","SF FuneralF812358       250225","","126.5","","601943.31"
"2025-02-25","2025-02-22","SF FuneralFDC00000005S21250222","","126.5","","602069.81"
"2025-02-25","2025-02-24","SF FuneralF847314       250222","","126.5","","602196.31"
"2025-02-25","2025-02-25","SF FuneralFDC000000065V2250225","","126.5","","602322.81"
"2025-02-25","2025-02-25","SF FuneralFDC0000000HQB5250225","","31.63","","602354.44"
"2025-02-25","2025-02-22","SF FuneralFDC00000008BSZ250222","","126.5","","602480.94"
"2025-02-25","2025-02-22","SF FuneralFDC00000008FL2250222","","126.5","","602607.44"
"2025-02-25","2025-02-22","SF FuneralFDC00000008G01250222","","126.5","","602733.94"
"2025-02-25","2025-02-22","SF FuneralFDC00000008HJY250222","","126.5","","602860.44"
"2025-02-25","2025-02-22","SF FuneralFDC00000008HYN250222","","126.5","","602986.94"
"2025-02-25","2025-02-22","SF FuneralFDC00000008HZX250222","","126.5","","603113.44"
"2025-02-25","2025-02-22","SF FuneralF809750       250222","","126.5","","603239.94"
"2025-02-25","2025-02-22","SF FuneralFDC000000094FC250222","","126.5","","603366.44"
"2025-02-25","2025-02-22","SF FuneralF811424       250222","","126.5","","603492.94"
"2025-02-25","2025-02-22","SF FuneralF813949       250222","","126.5","","603619.44"
"2025-02-25","2025-02-22","SF FuneralF842001       250222","","126.5","","603745.94"
"2025-02-25","2025-02-22","SF FuneralF993610       250222","","126.5","","603872.44"
"2025-02-25","2025-02-22","SF FuneralF993648       250222","","126.5","","603998.94"
"2025-02-25","2025-02-22","SF FuneralF801464       250222","","126.5","","604125.44"
"2025-02-25","2025-02-22","SF FuneralF1054496      250222","","126.5","","604251.94"
"2025-02-25","2025-02-22","SF FuneralF1060638      250222","","126.5","","604378.44"
"2025-02-25","2025-02-22","SF FuneralF792102       250222","","191.5","","604569.94"
"2025-02-25","2025-02-22","SF FuneralFDC0000000KLMP250222","","126.5","","604696.44"
"2025-02-25","2025-02-22","SF FuneralF1073720      250222","","126.5","","604822.94"
"2025-02-25","2025-02-22","SF FuneralF1074759      250222","","126.5","","604949.44"
"2025-02-25","2025-02-22","SF FuneralFDC0000000ND5V250222","","126.5","","605075.94"
"2025-02-25","2025-02-22","SF FuneralF1116728      250222","","126.5","","605202.44"
"2025-02-25","2025-02-22","SF FuneralF1119886      250222","","126.5","","605328.94"
"2025-02-25","2025-02-22","SF FuneralF1119887      250222","","126.5","","605455.44"
"2025-02-25","2025-02-22","SF FuneralFDC0000000NV3X250222","","126.5","","605581.94"
"2025-02-25","2025-02-22","SF FuneralF1123117      250222","","126.5","","605708.44"
"2025-02-25","2025-02-22","SF FuneralF1124329      250222","","126.5","","605834.94"
"2025-02-25","2025-02-22","SF FuneralF1124471      250222","","126.5","","605961.44"
"2025-02-25","2025-02-22","SF FuneralF1125136      250222","","126.5","","606087.94"
"2025-02-25","2025-02-22","SF FuneralF1125814      250222","","126.5","","606214.44"
"2025-02-25","2025-02-22","SF FuneralF1130051      250222","","126.5","","606340.94"
"2025-02-25","2025-02-22","SF FuneralF1130251      250222","","126.5","","606467.44"
"2025-02-25","2025-02-22","SF FuneralF1130395      250222","","126.5","","606593.94"
"2025-02-25","2025-02-17","SF FuneralF1130863      250217","","126.5","","606720.44"
"2025-02-25","2025-02-20","SF FuneralFDC000000063ZZ250220","","126.5","","606846.94"
"2025-02-25","2025-02-20","SF FuneralFDC000000064DJ250220","","126.5","","606973.44"
"2025-02-25","2025-02-20","SF FuneralF1124376      250220","","126.5","","607099.94"
"2025-02-25","2025-02-22","SF FuneralFDC00000002XZ4250222","","220","","607319.94"
"2025-02-25","2025-02-22","SF FuneralFDC000000039MC250222","","220","","607539.94"
"2025-02-25","2025-02-22","SF FuneralFDC00000004CKZ250222","","220","","607759.94"
"2025-02-25","2025-02-22","SF FuneralFDC00000005JNR250222","","126.5","","607886.44"
"2025-02-25","2025-02-22","SF FuneralFDC000000079WK250222","","126.5","","608012.94"
"2025-02-25","2025-02-22","SF FuneralF801422       250222","","126.5","","608139.44"
"2025-02-25","2025-02-22","SF FuneralF801566       250222","","126.5","","608265.94"
"2025-02-25","2025-02-22","SF FuneralF805618       250222","","126.5","","608392.44"
"2025-02-25","2025-02-22","SF FuneralF815165       250222","","126.5","","608518.94"
"2025-02-25","2025-02-22","SF FuneralF819618       250222","","126.5","","608645.44"
"2025-02-25","2025-02-22","SF FuneralFDC0000000B59R250222","","126.5","","608771.94"
"2025-02-25","2025-02-22","SF FuneralF823509       250222","","126.5","","608898.44"
"2025-02-25","2025-02-22","SF FuneralF1054953      250222","","126.5","","609024.94"
"2025-02-25","2025-02-22","SF FuneralF1074444      250222","","126.5","","609151.44"
"2025-02-25","2025-02-22","SF FuneralF797148       250222","","126.5","","609277.94"
"2025-02-25","2025-02-22","SF FuneralF1083758      250222","","126.5","","609404.44"
"2025-02-25","2025-02-22","SF FuneralF1102834      250223","","126.5","","609530.94"
"2025-02-25","2025-02-22","SF FuneralF1110432      250222","","126.5","","609657.44"
"2025-02-25","2025-02-22","SF FuneralF1111519      250222","","126.5","","609783.94"
"2025-02-25","2025-02-22","SF FuneralF1117248      250222","","126.5","","609910.44"
"2025-02-25","2025-02-22","SF FuneralF1120777      250222","","126.5","","610036.94"
"2025-02-25","2025-02-22","SF FuneralF1128355      250222","","126.5","","610163.44"
"2025-02-25","2025-02-22","SF FuneralF1129129      250222","","126.5","","610289.94"
"2025-02-25","2025-02-21","SF FuneralF981846       250222","","126.5","","610416.44"
"2025-02-25","2025-02-24","SF FuneralF1132115      250224","","31.63","","610448.07"
"2025-02-25","2025-02-19","SF FuneralFDC00000007DMT250219","","31.63","","610479.7"
"2025-02-25","2025-02-22","SF FuneralF1130618      250222","","126.5","","610606.2"
"2025-02-25","2025-02-22","SF FuneralF1130631      250222","","126.5","","610732.7"
"2025-02-25","2025-02-22","SF FuneralF1122321      250222","","126.5","","610859.2"
"2025-02-25","2025-02-22","SF FuneralF1130668      250222","","126.5","","610985.7"
"2025-02-25","2025-02-22","SF FuneralFDC0000000Q28Q250222","","126.5","","611112.2"
"2025-02-25","2025-02-22","SF FuneralF1130759      250222","","126.5","","611238.7"
"2025-02-25","2025-02-22","SF FuneralF1130781      250222","","126.5","","611365.2"
"2025-02-25","2025-02-22","SF FuneralF1131331      250222","","126.5","","611491.7"
"2025-02-25","2025-02-22","SF FuneralF1131486      250222","","126.5","","611618.2"
"2025-02-25","2025-02-22","SF FuneralF1131712      250222","","126.5","","611744.7"
"2025-02-25","2025-02-22","SF FuneralF1131763      250222","","126.5","","611871.2"
"2025-02-25","2025-02-22","SF FuneralF1131764      250223","","126.5","","611997.7"
"2025-02-25","2025-02-22","SF FuneralF1131914      250222","","126.5","","612124.2"
"2025-02-25","2025-02-22","SF FuneralF1131945      250222","","126.5","","612250.7"
"2025-02-25","2025-02-22","SF FuneralF1132056      250222","","126.5","","612377.2"
"2025-02-25","2025-02-22","SF FuneralF1132322      250222","","126.5","","612503.7"
"2025-02-25","2025-02-22","SF FuneralF1132494      250222","","126.5","","612630.2"
"2025-02-25","2025-02-22","SF FuneralF1132498      250222","","126.5","","612756.7"
"2025-02-25","2025-02-21","SF FuneralFDC00000003JFB250221","","220","","612976.7"
"2025-02-25","2025-02-21","SF FuneralFDC00000003X1F250221","","220","","613196.7"
"2025-02-25","2025-02-21","SF FuneralFDC00000005ZYK250221","","126.5","","613323.2"
"2025-02-25","2025-02-21","SF FuneralFDC00000006PVN250221","","126.5","","613449.7"
"2025-02-25","2025-02-21","SF FuneralFDC00000006XRT250221","","126.5","","613576.2"
"2025-02-25","2025-02-21","SF FuneralFDC0000000748R250221","","126.5","","613702.7"
"2025-02-25","2025-02-21","SF FuneralFDC00000007B6H250221","","126.5","","613829.2"
"2025-02-25","2025-02-21","SF FuneralFDC00000007VGY250221","","126.5","","613955.7"
"2025-02-25","2025-02-21","SF FuneralF815732       250221","","126.5","","614082.2"
"2025-02-25","2025-02-21","SF FuneralF831377       250221","","126.5","","614208.7"
"2025-02-25","2025-02-21","SF FuneralF901336       250222","","126.5","","614335.2"
"2025-02-25","2025-02-21","SF FuneralF980694       250222","","126.5","","614461.7"
"2025-02-25","2025-02-21","SF FuneralF981476       250222","","126.5","","614588.2"
"2025-02-25","2025-02-21","SF FuneralF981844       250222","","126.5","","614714.7"
"2025-02-25","2025-02-21","SF FuneralF986710       250222","","126.5","","614841.2"
"2025-02-25","2025-02-21","SF FuneralF986906       250222","","126.5","","614967.7"
"2025-02-25","2025-02-21","SF FuneralF987085       250222","","126.5","","615094.2"
"2025-02-25","2025-02-21","SF FuneralF987128       250222","","126.5","","615220.7"
"2025-02-25","2025-02-21","SF FuneralF779244       250222","","126.5","","615347.2"
"2025-02-25","2025-02-21","SF FuneralF987143       250222","","126.5","","615473.7"
"2025-02-25","2025-02-21","SF FuneralF987205       250222","","126.5","","615600.2"
"2025-02-25","2025-02-21","SF FuneralF987251       250222","","126.5","","615726.7"
"2025-02-25","2025-02-21","SF FuneralF987393       250222","","126.5","","615853.2"
"2025-02-25","2025-02-21","SF FuneralF987538       250222","","126.5","","615979.7"
"2025-02-25","2025-02-21","SF FuneralF988778       250222","","126.5","","616106.2"
"2025-02-25","2025-02-21","SF FuneralFDC0000000HXDG250223","","126.5","","616232.7"
"2025-02-25","2025-02-21","SF FuneralF988843       250222","","126.5","","616359.2"
"2025-02-25","2025-02-21","SF FuneralF989011       250222","","126.5","","616485.7"
"2025-02-25","2025-02-21","SF FuneralF989259       250222","","126.5","","616612.2"
"2025-02-25","2025-02-21","SF FuneralF989333       250222","","126.5","","616738.7"
"2025-02-25","2025-02-21","SF FuneralF989453       250222","","126.5","","616865.2"
"2025-02-25","2025-02-21","SF FuneralF989543       250222","","126.5","","616991.7"
"2025-02-25","2025-02-21","SF FuneralF990044       250222","","126.5","","617118.2"
"2025-02-25","2025-02-21","SF FuneralF991113       250222","","126.5","","617244.7"
"2025-02-25","2025-02-21","SF FuneralF991427       250222","","126.5","","617371.2"
"2025-02-25","2025-02-21","SF FuneralF991554       250222","","126.5","","617497.7"
"2025-02-25","2025-02-21","SF FuneralFDC0000000JHG4250221","","126.5","","617624.2"
"2025-02-25","2025-02-21","SF FuneralF1021234      250221","","126.5","","617750.7"
"2025-02-25","2025-02-21","SF FuneralF1073655      250221","","126.5","","617877.2"
"2025-02-25","2025-02-21","SF FuneralF1112127      250221","","126.5","","618003.7"
"2025-02-25","2025-02-21","SF FuneralF815715       250221","","126.5","","618130.2"
"2025-02-25","2025-02-21","SF FuneralF1127639      250221","","126.5","","618256.7"
"2025-02-25","2025-02-21","SF FuneralF1127903      250221","","126.5","","618383.2"
"2025-02-25","2025-02-21","SF FuneralF792792       250221","","220","","618603.2"
"2025-02-25","2025-02-21","SF FuneralF1130279      250221","","126.5","","618729.7"
"2025-02-25","2025-02-24","SF FuneralFDC00000002TWX250223","","220","","618949.7"
"2025-02-25","2025-02-24","SF FuneralFDC00000005V61250223","","126.5","","619076.2"
"2025-02-25","2025-02-24","SF FuneralFDC00000006MYR250223","","126.5","","619202.7"
"2025-02-25","2025-02-24","SF FuneralFDC000000070Q9250224","","126.5","","619329.2"
"2025-02-25","2025-02-24","SF FuneralFDC0000000731B250223","","126.5","","619455.7"
"2025-02-25","2025-02-24","SF FuneralFDC000000076MT250223","","126.5","","619582.2"
"2025-02-25","2025-02-24","SF FuneralF793393       250224","","126.5","","619708.7"
"2025-02-25","2025-02-24","SF FuneralF799138       250223","","126.5","","619835.2"
"2025-02-25","2025-02-24","SF FuneralF799455       250223","","126.5","","619961.7"
"2025-02-25","2025-02-24","SF FuneralFDC00000008XD4250223","","126.5","","620088.2"
"2025-02-25","2025-02-24","SF FuneralF809626       250224","","126.5","","620214.7"
"2025-02-25","2025-02-24","SF FuneralF821840       250224","","126.5","","620341.2"
"2025-02-25","2025-02-24","SF FuneralF823608       250224","","126.5","","620467.7"
"2025-02-25","2025-02-24","SF FuneralFDC0000000BKXY250223","","126.5","","620594.2"
"2025-02-25","2025-02-24","SF FuneralF823827       250224","","126.5","","620720.7"
"2025-02-25","2025-02-24","SF FuneralF838881       250223","","126.5","","620847.2"
"2025-02-25","2025-02-24","SF FuneralF840681       250224","","126.5","","620973.7"
"2025-02-25","2025-02-24","SF FuneralF843389       250222","","126.5","","621100.2"
"2025-02-25","2025-02-24","SF FuneralF843985       250222","","126.5","","621226.7"
"2025-02-25","2025-02-24","SF FuneralF844571       250222","","126.5","","621353.2"
"2025-02-25","2025-02-24","SF FuneralF844677       250222","","126.5","","621479.7"
"2025-02-25","2025-02-24","SF FuneralF785041       250222","","321.5","","621801.2"
"2025-02-25","2025-02-24","SF FuneralF844762       250222","","126.5","","621927.7"
"2025-02-25","2025-02-24","SF FuneralF847327       250222","","126.5","","622054.2"
"2025-02-25","2025-02-24","SF FuneralF847364       250222","","126.5","","622180.7"
"2025-02-25","2025-02-24","SF FuneralF900449       250222","","126.5","","622307.2"
"2025-02-25","2025-02-24","SF FuneralFDC0000000H03Y250222","","126.5","","622433.7"
"2025-02-25","2025-02-24","SF FuneralF986646       250224","","126.5","","622560.2"
"2025-02-25","2025-02-24","SF FuneralF988978       250224","","126.5","","622686.7"
"2025-02-25","2025-02-24","SF FuneralF1066140      250224","","126.5","","622813.2"
"2025-02-25","2025-02-24","SF FuneralF1083940      250224","","126.5","","622939.7"
"2025-02-25","2025-02-24","SF FuneralF1108006      250224","","126.5","","623066.2"
"2025-02-25","2025-02-24","SF FuneralF1130823      250224","","126.5","","623192.7"
"2025-02-25","2025-02-21","SF FuneralFDC00000007TC1250221","","31.63","","623224.33"
"2025-02-25","2025-02-25","SF FuneralFDC0000000455X250225","","55","","623279.33"
"2025-02-25","2025-02-25","SF FuneralFDC00000005P3L250225","","31.63","","623310.96"
"2025-02-25","2025-02-25","SF FuneralFDC00000005P3Q250225","","31.63","","623342.59"
"2025-02-25","2025-02-25","SF FuneralFDC00000006QTN250225","","31.63","","623374.22"
"2025-02-25","2025-02-25","SF FuneralFDC00000007X30250225","","31.63","","623405.85"
"2025-02-25","2025-02-25","SF FuneralFDC00000007X31250225","","31.63","","623437.48"
"2025-02-25","2025-02-25","SF FuneralFDC00000007YH4250225","","31.63","","623469.11"
"2025-02-25","2025-02-25","SF FuneralFDC00000008H47250225","","31.63","","623500.74"
"2025-02-25","2025-02-25","SF FuneralFDC00000008YCZ250225","","31.63","","623532.37"
"2025-02-25","2025-02-25","SF FuneralF811401       250225","","31.63","","623564"
"2025-02-25","2025-02-25","SF FuneralF811790       250225","","31.63","","623595.63"
"2025-02-25","2025-02-25","SF FuneralF812125       250225","","31.63","","623627.26"
"2025-02-25","2025-02-25","SF FuneralF814431       250225","","31.63","","623658.89"
"2025-02-25","2025-02-25","SF FuneralF817293       250225","","31.63","","623690.52"
"2025-02-25","2025-02-25","SF FuneralFDC0000000BWTD250225","","31.63","","623722.15"
"2025-02-25","2025-02-25","SF FuneralF833123       250225","","31.63","","623753.78"
"2025-02-25","2025-02-25","SF FuneralF834203       250225","","31.63","","623785.41"
"2025-02-25","2025-02-25","SF FuneralFDC0000000HK7D250225","","31.63","","623817.04"
"2025-02-25","2025-02-25","SF FuneralFDC0000000HXY2250225","","31.63","","623848.67"
"2025-02-25","2025-02-25","SF FuneralF989177       250225","","31.63","","623880.3"
"2025-02-25","2025-02-25","SF FuneralF1020936      250225","","31.63","","623911.93"
"2025-02-25","2025-02-25","SF FuneralF1050833      250225","","31.63","","623943.56"
"2025-02-25","2025-02-25","SF FuneralF1021467      250225","","31.63","","623975.19"
"2025-02-25","2025-02-25","SF FuneralF1066029      250225","","31.63","","624006.82"
"2025-02-25","2025-02-25","SF FuneralF1068027      250225","","31.63","","624038.45"
"2025-02-25","2025-02-25","SF FuneralF1068212      250225","","31.63","","624070.08"
"2025-02-25","2025-02-25","SF FuneralFDC0000000L0TL250225","","31.63","","624101.71"
"2025-02-25","2025-02-25","SF FuneralFDC0000000L0TM250225","","31.63","","624133.34"
"2025-02-25","2025-02-25","SF FuneralF1073801      250225","","31.63","","624164.97"
"2025-02-25","2025-02-25","SF FuneralF1080246      250225","","31.63","","624196.6"
"2025-02-25","2025-02-25","SF FuneralF1083692      250225","","31.63","","624228.23"
"2025-02-25","2025-02-25","SF FuneralF1085179      250225","","31.63","","624259.86"
"2025-02-25","2025-02-25","SF FuneralF1102938      250225","","31.63","","624291.49"
"2025-02-25","2025-02-25","SF FuneralF1112035      250225","","31.63","","624323.12"
"2025-02-25","2025-02-25","SF FuneralF1113741      250225","","31.63","","624354.75"
"2025-02-25","2025-02-25","SF FuneralFDC0000000N8G1250225","","31.63","","624386.38"
"2025-02-25","2025-02-25","SF FuneralFDC0000000NBRM250225","","31.63","","624418.01"
"2025-02-25","2025-02-25","SF FuneralF1118335      250225","","31.63","","624449.64"
"2025-02-25","2025-02-25","SF FuneralF1118420      250225","","31.63","","624481.27"
"2025-02-25","2025-02-25","SF FuneralFDC0000000NT58250225","","31.63","","624512.9"
"2025-02-25","2025-02-25","SF FuneralF1128762      250225","","31.63","","624544.53"
"2025-02-25","2025-02-25","SF FuneralF1129064      250225","","31.63","","624576.16"
"2025-02-25","2025-02-25","SF FuneralF1129356      250225","","31.63","","624607.79"
"2025-02-25","2025-02-25","SF FuneralF1130870      250225","","31.63","","624639.42"
"2025-02-25","2025-02-25","SF FuneralF1131798      250225","","31.63","","624671.05"
"2025-02-25","2025-02-25","SF FuneralF1132366      250225","","31.63","","624702.68"
"2025-02-25","2025-02-17","SF FuneralFDC00000005PBP250217","","126.5","","624829.18"
"2025-02-25","2025-02-17","SF FuneralFDC00000005TL3250217","","126.5","","624955.68"
"2025-02-25","2025-02-17","SF FuneralFDC00000005Z9N250217","","126.5","","625082.18"
"2025-02-25","2025-02-17","SF FuneralF829881       250217","","126.5","","625208.68"
"2025-02-25","2025-02-17","SF FuneralF830609       250217","","126.5","","625335.18"
"2025-02-25","2025-02-17","SF FuneralF844712       250217","","126.5","","625461.68"
"2025-02-25","2025-02-17","SF FuneralFDC0000000PBBT250217","","126.5","","625588.18"
"2025-02-25","2025-02-17","SF FuneralF1125299      250217","","126.5","","625714.68"
"2025-02-25","2025-02-18","SF FuneralFDC00000005YRX250218","","126.5","","625841.18"
"2025-02-25","2025-02-18","SF FuneralF1124327      250218","","126.5","","625967.68"
"2025-02-25","2025-02-19","SF FuneralFDC000000060CN250219","","126.5","","626094.18"
"2025-02-25","2025-02-19","SF FuneralFDC00000006PQ2250219","","126.5","","626220.68"
"2025-02-25","2025-02-19","SF FuneralF811769       250219","","126.5","","626347.18"
"2025-02-25","2025-02-19","SF FuneralF1021092      250219","","126.5","","626473.68"
"2025-02-25","2025-02-21","SF FuneralFDC00000007WGF250221","","126.5","","626600.18"
"2025-02-25","2025-02-21","SF FuneralF987150       250222","","126.5","","626726.68"
"2025-02-25","2025-02-22","SF FuneralFDC00000005ZGF250222","","126.5","","626853.18"
"2025-02-25","2025-02-22","SF FuneralFDC000000062BF250222","","126.5","","626979.68"
"2025-02-25","2025-02-22","SF FuneralFDC00000006S2R250222","","220","","627199.68"
"2025-02-25","2025-02-22","SF FuneralFDC00000008FY8250222","","126.5","","627326.18"
"2025-02-25","2025-02-22","SF FuneralF805670       250222","","126.5","","627452.68"
"2025-02-25","2025-02-22","SF FuneralF805952       250222","","126.5","","627579.18"
"2025-02-25","2025-02-22","SF FuneralF805450       250222","","126.5","","627705.68"
"2025-02-25","2025-02-22","SF FuneralFDC0000000B4JK250222","","126.5","","627832.18"
"2025-02-25","2025-02-22","SF FuneralF832019       250222","","126.5","","627958.68"
"2025-02-25","2025-02-22","SF FuneralFDC0000000L72K250222","","126.5","","628085.18"
"2025-02-25","2025-02-22","SF FuneralF1075086      250222","","126.5","","628211.68"
"2025-02-25","2025-02-22","SF FuneralF1102866      250222","","126.5","","628338.18"
"2025-02-25","2025-02-22","SF FuneralF1112220      250222","","126.5","","628464.68"
"2025-02-25","2025-02-22","SF FuneralF1129067      250222","","126.5","","628591.18"
"2025-02-25","2025-02-22","SF FuneralFDC0000000Q18B250222","","126.5","","628717.68"
"2025-02-25","2025-02-22","SF FuneralFDC0000000Q1GF250222","","126.5","","628844.18"
"2025-02-25","2025-02-22","SF FuneralFDC0000000Q1GH250222","","126.5","","628970.68"
"2025-02-25","2025-02-24","SF FuneralF815537       250224","","126.5","","629097.18"
"2025-02-25","2025-02-24","SF FuneralFDC0000000L98R250224","","126.5","","629223.68"
"2025-02-25","2025-02-20","SF FuneralFDC00000005ZZ6250220","","126.5","","629350.18"
"2025-02-25","2025-02-20","SF FuneralFDC00000006GR0250220","","126.5","","629476.68"
"2025-02-25","2025-02-20","SF FuneralF986642       250220","","126.5","","629603.18"
"2025-02-25","2025-02-20","SF FuneralF1080460      250220","","126.5","","629729.68"
"2025-02-25","2025-02-20","SF FuneralF1104054      250220","","126.5","","629856.18"
"2025-02-25","2025-02-20","SF FuneralF1110166      250220","","126.5","","629982.68"
"2025-02-25","2025-02-22","SF FuneralFDC00000002T32250222","","220","","630202.68"
"2025-02-25","2025-02-22","SF FuneralFDC00000002X18250222","","220","","630422.68"
"2025-02-25","2025-02-22","SF FuneralFDC00000003085250222","","220","","630642.68"
"2025-02-25","2025-02-22","SF FuneralFDC000000030QM250222","","220","","630862.68"
"2025-02-25","2025-02-22","SF FuneralFDC000000031BT250222","","220","","631082.68"
"2025-02-25","2025-02-22","SF FuneralFDC000000031C3250222","","220","","631302.68"
"2025-02-25","2025-02-22","SF FuneralFDC0000000340D250222","","220","","631522.68"
"2025-02-25","2025-02-22","SF FuneralFDC000000037LR250222","","220","","631742.68"
"2025-02-25","2025-02-22","SF FuneralFDC000000037LS250222","","220","","631962.68"
"2025-02-25","2025-02-22","SF FuneralFDC000000037ZP250222","","220","","632182.68"
"2025-02-25","2025-02-22","SF FuneralFDC00000003CVT250222","","220","","632402.68"
"2025-02-25","2025-02-22","SF FuneralFDC00000003D66250222","","220","","632622.68"
"2025-02-25","2025-02-22","SF FuneralFDC00000005GWY250222","","126.5","","632749.18"
"2025-02-25","2025-02-22","SF FuneralFDC00000005HCN250222","","126.5","","632875.68"
"2025-02-25","2025-02-22","SF FuneralFDC00000005JNX250222","","126.5","","633002.18"
"2025-02-25","2025-02-22","SF FuneralFDC00000005PBH250222","","126.5","","633128.68"
"2025-02-25","2025-02-22","SF FuneralFDC00000005SD7250222","","126.5","","633255.18"
"2025-02-25","2025-02-22","SF FuneralFDC00000005SKV250222","","126.5","","633381.68"
"2025-02-25","2025-02-22","SF FuneralFDC00000005TFL250222","","126.5","","633508.18"
"2025-02-25","2025-02-22","SF FuneralFDC00000005V39250222","","126.5","","633634.68"
"2025-02-25","2025-02-22","SF FuneralFDC00000005V69250222","","191.5","","633826.18"
"2025-02-25","2025-02-22","SF FuneralFDC00000005XBY250222","","220","","634046.18"
"2025-02-25","2025-02-22","SF FuneralFDC00000005XWT250222","","126.5","","634172.68"
"2025-02-25","2025-02-22","SF FuneralFDC00000005Z3G250222","","126.5","","634299.18"
"2025-02-25","2025-02-22","SF FuneralFDC00000005Z3H250222","","126.5","","634425.68"
"2025-02-25","2025-02-22","SF FuneralFDC00000005ZL2250222","","126.5","","634552.18"
"2025-02-25","2025-02-22","SF FuneralFDC00000005ZMJ250222","","126.5","","634678.68"
"2025-02-25","2025-02-22","SF FuneralFDC00000005ZQ8250222","","126.5","","634805.18"
"2025-02-25","2025-02-22","SF FuneralFDC00000005ZVB250222","","126.5","","634931.68"
"2025-02-25","2025-02-22","SF FuneralFDC00000005ZX8250222","","126.5","","635058.18"
"2025-02-25","2025-02-22","SF FuneralFDC000000060BW250222","","126.5","","635184.68"
"2025-02-25","2025-02-22","SF FuneralFDC000000060L2250222","","126.5","","635311.18"
"2025-02-25","2025-02-22","SF FuneralFDC000000060Q0250222","","126.5","","635437.68"
"2025-02-25","2025-02-22","SF FuneralFDC000000060TX250222","","126.5","","635564.18"
"2025-02-25","2025-02-22","SF FuneralFDC0000000611J250222","","126.5","","635690.68"
"2025-02-25","2025-02-22","SF FuneralFDC000000061JM250222","","126.5","","635817.18"
"2025-02-25","2025-02-22","SF FuneralFDC000000061YT250222","","126.5","","635943.68"
"2025-02-25","2025-02-22","SF FuneralFDC0000000627W250222","","126.5","","636070.18"
"2025-02-25","2025-02-22","SF FuneralFDC000000062JQ250222","","126.5","","636196.68"
"2025-02-25","2025-02-22","SF FuneralFDC000000062YG250222","","126.5","","636323.18"
"2025-02-25","2025-02-22","SF FuneralFDC000000063C5250222","","126.5","","636449.68"
"2025-02-25","2025-02-22","SF FuneralFDC000000063GH250222","","126.5","","636576.18"
"2025-02-25","2025-02-22","SF FuneralFDC000000063MY250222","","126.5","","636702.68"
"2025-02-25","2025-02-22","SF FuneralFDC00000006438250222","","126.5","","636829.18"
"2025-02-25","2025-02-22","SF FuneralFDC000000064F5250222","","126.5","","636955.68"
"2025-02-25","2025-02-22","SF FuneralFDC000000064HB250222","","126.5","","637082.18"
"2025-02-25","2025-02-22","SF FuneralFDC000000064RH250222","","126.5","","637208.68"
"2025-02-25","2025-02-22","SF FuneralFDC0000000659H250222","","126.5","","637335.18"
"2025-02-25","2025-02-22","SF FuneralFDC000000065H2250222","","126.5","","637461.68"
"2025-02-25","2025-02-22","SF FuneralFDC000000065NY250222","","126.5","","637588.18"
"2025-02-25","2025-02-22","SF FuneralFDC00000006625250222","","126.5","","637714.68"
"2025-02-25","2025-02-22","SF FuneralFDC00000006686250222","","126.5","","637841.18"
"2025-02-25","2025-02-22","SF FuneralFDC000000068DS250222","","126.5","","637967.68"
"2025-02-25","2025-02-22","SF FuneralFDC000000068FH250222","","126.5","","638094.18"
"2025-02-25","2025-02-22","SF FuneralFDC00000006947250222","","126.5","","638220.68"
"2025-02-25","2025-02-22","SF FuneralFDC0000000698S250222","","126.5","","638347.18"
"2025-02-25","2025-02-22","SF FuneralFDC000000069RG250222","","126.5","","638473.68"
"2025-02-25","2025-02-22","SF FuneralFDC00000006BCN250222","","126.5","","638600.18"
"2025-02-25","2025-02-22","SF FuneralFDC00000006BLQ250222","","126.5","","638726.68"
"2025-02-25","2025-02-22","SF FuneralFDC00000006CZP250222","","126.5","","638853.18"
"2025-02-25","2025-02-22","SF FuneralFDC00000006FNG250222","","126.5","","638979.68"
"2025-02-25","2025-02-22","SF FuneralFDC00000006HYD250222","","126.5","","639106.18"
"2025-02-25","2025-02-22","SF FuneralFDC00000006J1C250222","","126.5","","639232.68"
"2025-02-25","2025-02-22","SF FuneralFDC00000006KF1250222","","126.5","","639359.18"
"2025-02-25","2025-02-22","SF FuneralFDC00000006KKP250222","","126.5","","639485.68"
"2025-02-25","2025-02-22","SF FuneralFDC00000006MDH250222","","126.5","","639612.18"
"2025-02-25","2025-02-22","SF FuneralFDC00000006MPK250222","","126.5","","639738.68"
"2025-02-25","2025-02-22","SF FuneralFDC00000006MQC250222","","126.5","","639865.18"
"2025-02-25","2025-02-22","SF FuneralFDC00000006PS8250222","","126.5","","639991.68"
"2025-02-25","2025-02-22","SF FuneralFDC00000006PSD250222","","126.5","","640118.18"
"2025-02-25","2025-02-22","SF FuneralFDC00000006R8Y250222","","126.5","","640244.68"
"2025-02-25","2025-02-22","SF FuneralFDC00000006RLZ250222","","126.5","","640371.18"
"2025-02-25","2025-02-22","SF FuneralFDC00000006SHH250222","","126.5","","640497.68"
"2025-02-25","2025-02-22","SF FuneralFDC00000006T4X250222","","126.5","","640624.18"
"2025-02-25","2025-02-22","SF FuneralFDC00000006T86250222","","126.5","","640750.68"
"2025-02-25","2025-02-22","SF FuneralFDC00000006TSY250222","","220","","640970.68"
"2025-02-25","2025-02-22","SF FuneralFDC00000006V60250222","","126.5","","641097.18"
"2025-02-25","2025-02-22","SF FuneralFDC00000006V63250222","","126.5","","641223.68"
"2025-02-25","2025-02-22","SF FuneralFDC00000006VBB250222","","126.5","","641350.18"
"2025-02-25","2025-02-22","SF FuneralFDC00000006VP1250222","","126.5","","641476.68"
"2025-02-25","2025-02-22","SF FuneralFDC00000006VP2250222","","126.5","","641603.18"
"2025-02-25","2025-02-22","SF FuneralFDC00000006W6N250222","","126.5","","641729.68"
"2025-02-25","2025-02-22","SF FuneralFDC00000006W6P250222","","126.5","","641856.18"
"2025-02-25","2025-02-22","SF FuneralFDC00000006WYR250222","","126.5","","641982.68"
"2025-02-25","2025-02-22","SF FuneralFDC00000006WYX250222","","126.5","","642109.18"
"2025-02-25","2025-02-22","SF FuneralFDC00000006X0G250222","","126.5","","642235.68"
"2025-02-25","2025-02-22","SF FuneralFDC00000006XJF250222","","126.5","","642362.18"
"2025-02-25","2025-02-22","SF FuneralFDC00000006XKD250222","","126.5","","642488.68"
"2025-02-25","2025-02-22","SF FuneralFDC00000006YDY250222","","126.5","","642615.18"
"2025-02-25","2025-02-22","SF FuneralFDC00000006YJN250222","","126.5","","642741.68"
"2025-02-25","2025-02-22","SF FuneralFDC00000006YKK250222","","126.5","","642868.18"
"2025-02-25","2025-02-22","SF FuneralFDC00000006YQF250222","","220","","643088.18"
"2025-02-25","2025-02-22","SF FuneralFDC00000006Z7C250222","","126.5","","643214.68"
"2025-02-25","2025-02-22","SF FuneralFDC00000006Z7G250222","","126.5","","643341.18"
"2025-02-25","2025-02-22","SF FuneralFDC00000006ZX0250222","","126.5","","643467.68"
"2025-02-25","2025-02-22","SF FuneralFDC0000000711K250222","","126.5","","643594.18"
"2025-02-25","2025-02-22","SF FuneralFDC0000000720Q250222","","126.5","","643720.68"
"2025-02-25","2025-02-22","SF FuneralFDC0000000733P250222","","126.5","","643847.18"
"2025-02-25","2025-02-22","SF FuneralFDC000000074S4250222","","126.5","","643973.68"
"2025-02-25","2025-02-22","SF FuneralFDC000000074VG250222","","126.5","","644100.18"
"2025-02-25","2025-02-22","SF FuneralFDC000000074ZC250222","","126.5","","644226.68"
"2025-02-25","2025-02-22","SF FuneralFDC000000076LX250222","","126.5","","644353.18"
"2025-02-25","2025-02-22","SF FuneralFDC000000076RT250222","","126.5","","644479.68"
"2025-02-25","2025-02-22","SF FuneralFDC000000076RZ250222","","126.5","","644606.18"
"2025-02-25","2025-02-22","SF FuneralFDC000000079BG250222","","126.5","","644732.68"
"2025-02-25","2025-02-22","SF FuneralFDC00000007B3K250222","","126.5","","644859.18"
"2025-02-25","2025-02-22","SF FuneralFDC00000007FC0250222","","126.5","","644985.68"
"2025-02-25","2025-02-22","SF FuneralFDC00000007HJ6250222","","126.5","","645112.18"
"2025-02-25","2025-02-22","SF FuneralFDC00000007HYF250222","","126.5","","645238.68"
"2025-02-25","2025-02-22","SF FuneralFDC00000007J0Y250222","","126.5","","645365.18"
"2025-02-25","2025-02-22","SF FuneralFDC00000007J7N250222","","126.5","","645491.68"
"2025-02-25","2025-02-22","SF FuneralFDC00000007JGM250222","","126.5","","645618.18"
"2025-02-25","2025-02-22","SF FuneralFDC00000007JTK250222","","126.5","","645744.68"
"2025-02-25","2025-02-22","SF FuneralFDC00000007JX2250222","","126.5","","645871.18"
"2025-02-25","2025-02-22","SF FuneralFDC00000007JXZ250222","","126.5","","645997.68"
"2025-02-25","2025-02-22","SF FuneralFDC00000007KDV250222","","126.5","","646124.18"
"2025-02-25","2025-02-22","SF FuneralFDC00000007L4J250222","","126.5","","646250.68"
"2025-02-25","2025-02-22","SF FuneralFDC00000007LJP250222","","126.5","","646377.18"
"2025-02-25","2025-02-22","SF FuneralFDC00000007M5L250222","","126.5","","646503.68"
"2025-02-25","2025-02-22","SF FuneralFDC00000007MH8250222","","126.5","","646630.18"
"2025-02-25","2025-02-22","SF FuneralFDC00000007MW0250222","","126.5","","646756.68"
"2025-02-25","2025-02-22","SF FuneralFDC00000007Q3Z250222","","126.5","","646883.18"
"2025-02-25","2025-02-22","SF FuneralFDC00000007RR4250222","","126.5","","647009.68"
"2025-02-25","2025-02-22","SF FuneralF794522       250222","","126.5","","647136.18"
"2025-02-25","2025-02-22","SF FuneralF794751       250222","","126.5","","647262.68"
"2025-02-25","2025-02-22","SF FuneralFDC00000007VSR250222","","126.5","","647389.18"
"2025-02-25","2025-02-22","SF FuneralFDC00000007W03250222","","126.5","","647515.68"
"2025-02-25","2025-02-22","SF FuneralFDC00000007W65250222","","126.5","","647642.18"
"2025-02-25","2025-02-22","SF FuneralFDC00000007YHN250222","","126.5","","647768.68"
"2025-02-25","2025-02-22","SF FuneralFDC00000007YVT250222","","126.5","","647895.18"
"2025-02-25","2025-02-22","SF FuneralFDC00000007ZWC250222","","126.5","","648021.68"
"2025-02-25","2025-02-22","SF FuneralFDC00000008136250222","","126.5","","648148.18"
"2025-02-25","2025-02-22","SF FuneralFDC000000081DZ250222","","126.5","","648274.68"
"2025-02-25","2025-02-22","SF FuneralFDC00000008284250222","","126.5","","648401.18"
"2025-02-25","2025-02-22","SF FuneralFDC000000082DL250222","","126.5","","648527.68"
"2025-02-25","2025-02-22","SF FuneralFDC000000083D2250222","","126.5","","648654.18"
"2025-02-25","2025-02-22","SF FuneralF798370       250222","","126.5","","648780.68"
"2025-02-25","2025-02-22","SF FuneralFDC000000086MN250222","","126.5","","648907.18"
"2025-02-25","2025-02-22","SF FuneralF801210       250222","","126.5","","649033.68"
"2025-02-25","2025-02-22","SF FuneralF801266       250222","","126.5","","649160.18"
"2025-02-25","2025-02-22","SF FuneralF801424       250222","","126.5","","649286.68"
"2025-02-25","2025-02-22","SF FuneralF801475       250222","","126.5","","649413.18"
"2025-02-25","2025-02-22","SF FuneralF801543       250222","","126.5","","649539.68"
"2025-02-25","2025-02-22","SF FuneralF802087       250222","","126.5","","649666.18"
"2025-02-25","2025-02-22","SF FuneralFDC00000008JC4250222","","126.5","","649792.68"
"2025-02-25","2025-02-22","SF FuneralF802207       250222","","126.5","","649919.18"
"2025-02-25","2025-02-22","SF FuneralF803151       250222","","126.5","","650045.68"
"2025-02-25","2025-02-22","SF FuneralF803286       250222","","126.5","","650172.18"
"2025-02-25","2025-02-22","SF FuneralF803364       250222","","126.5","","650298.68"
"2025-02-25","2025-02-22","SF FuneralFDC00000008N5F250222","","126.5","","650425.18"
"2025-02-25","2025-02-22","SF FuneralF804239       250222","","126.5","","650551.68"
"2025-02-25","2025-02-22","SF FuneralF805416       250222","","126.5","","650678.18"
"2025-02-25","2025-02-22","SF FuneralF805490       250222","","126.5","","650804.68"
"2025-02-25","2025-02-22","SF FuneralFDC00000008V7W250222","","126.5","","650931.18"
"2025-02-25","2025-02-22","SF FuneralF805765       250222","","126.5","","651057.68"
"2025-02-25","2025-02-22","SF FuneralF805799       250222","","126.5","","651184.18"
"2025-02-25","2025-02-22","SF FuneralF805865       250222","","126.5","","651310.68"
"2025-02-25","2025-02-22","SF FuneralFDC00000008W9F250222","","126.5","","651437.18"
"2025-02-25","2025-02-22","SF FuneralF808123       250222","","126.5","","651563.68"
"2025-02-25","2025-02-22","SF FuneralF808139       250222","","126.5","","651690.18"
"2025-02-25","2025-02-22","SF FuneralFDC00000008ZMS250222","","126.5","","651816.68"
"2025-02-25","2025-02-22","SF FuneralF809915       250222","","126.5","","651943.18"
"2025-02-25","2025-02-22","SF FuneralFDC000000096MY250222","","126.5","","652069.68"
"2025-02-25","2025-02-22","SF FuneralF811177       250222","","126.5","","652196.18"
"2025-02-25","2025-02-22","SF FuneralF811197       250222","","126.5","","652322.68"
"2025-02-25","2025-02-22","SF FuneralF811354       250222","","126.5","","652449.18"
"2025-02-25","2025-02-22","SF FuneralF811407       250222","","126.5","","652575.68"
"2025-02-25","2025-02-22","SF FuneralF811573       250222","","126.5","","652702.18"
"2025-02-25","2025-02-22","SF FuneralF811647       250222","","126.5","","652828.68"
"2025-02-25","2025-02-22","SF FuneralF811774       250222","","126.5","","652955.18"
"2025-02-25","2025-02-22","SF FuneralF811787       250222","","126.5","","653081.68"
"2025-02-25","2025-02-22","SF FuneralF812034       250222","","126.5","","653208.18"
"2025-02-25","2025-02-22","SF FuneralF812630       250222","","126.5","","653334.68"
"2025-02-25","2025-02-22","SF FuneralF813548       250222","","126.5","","653461.18"
"2025-02-25","2025-02-22","SF FuneralF794097       250222","","191.5","","653652.68"
"2025-02-25","2025-02-22","SF FuneralF815101       250222","","126.5","","653779.18"
"2025-02-25","2025-02-22","SF FuneralF815157       250222","","126.5","","653905.68"
"2025-02-25","2025-02-22","SF FuneralF815174       250222","","126.5","","654032.18"
"2025-02-25","2025-02-22","SF FuneralF815307       250222","","126.5","","654158.68"
"2025-02-25","2025-02-22","SF FuneralF815321       250222","","126.5","","654285.18"
"2025-02-25","2025-02-22","SF FuneralF815322       250222","","126.5","","654411.68"
"2025-02-25","2025-02-22","SF FuneralF815418       250222","","126.5","","654538.18"
"2025-02-25","2025-02-22","SF FuneralF815541       250222","","126.5","","654664.68"
"2025-02-25","2025-02-22","SF FuneralF815770       250222","","126.5","","654791.18"
"2025-02-25","2025-02-22","SF FuneralF815831       250222","","126.5","","654917.68"
"2025-02-25","2025-02-22","SF FuneralF817024       250222","","126.5","","655044.18"
"2025-02-25","2025-02-22","SF FuneralF817624       250222","","126.5","","655170.68"
"2025-02-25","2025-02-22","SF FuneralF817881       250222","","126.5","","655297.18"
"2025-02-25","2025-02-22","SF FuneralF818146       250222","","126.5","","655423.68"
"2025-02-25","2025-02-22","SF FuneralF818830       250222","","126.5","","655550.18"
"2025-02-25","2025-02-22","SF FuneralF819315       250222","","126.5","","655676.68"
"2025-02-25","2025-02-22","SF FuneralF819323       250222","","126.5","","655803.18"
"2025-02-25","2025-02-22","SF FuneralF819537       250222","","126.5","","655929.68"
"2025-02-25","2025-02-22","SF FuneralF819543       250222","","126.5","","656056.18"
"2025-02-25","2025-02-22","SF FuneralF819611       250222","","126.5","","656182.68"
"2025-02-25","2025-02-22","SF FuneralF819625       250222","","126.5","","656309.18"
"2025-02-25","2025-02-22","SF FuneralF819878       250222","","126.5","","656435.68"
"2025-02-25","2025-02-22","SF FuneralFDC0000000B6F9250222","","126.5","","656562.18"
"2025-02-25","2025-02-22","SF FuneralF820527       250222","","126.5","","656688.68"
"2025-02-25","2025-02-22","SF FuneralFDC0000000B8VT250222","","126.5","","656815.18"
"2025-02-25","2025-02-22","SF FuneralF821017       250222","","126.5","","656941.68"
"2025-02-25","2025-02-22","SF FuneralF821117       250222","","126.5","","657068.18"
"2025-02-25","2025-02-22","SF FuneralF821147       250222","","126.5","","657194.68"
"2025-02-25","2025-02-22","SF FuneralF821178       250222","","126.5","","657321.18"
"2025-02-25","2025-02-22","SF FuneralF821476       250222","","126.5","","657447.68"
"2025-02-25","2025-02-22","SF FuneralFDC0000000BBCW250222","","126.5","","657574.18"
"2025-02-25","2025-02-22","SF FuneralFDC0000000BBY2250222","","126.5","","657700.68"
"2025-02-25","2025-02-22","SF FuneralFDC0000000BFNN250222","","126.5","","657827.18"
"2025-02-25","2025-02-22","SF FuneralF819634       250222","","126.5","","657953.68"
"2025-02-25","2025-02-22","SF FuneralF822667       250222","","126.5","","658080.18"
"2025-02-25","2025-02-22","SF FuneralF823062       250222","","126.5","","658206.68"
"2025-02-25","2025-02-22","SF FuneralF823169       250222","","126.5","","658333.18"
"2025-02-25","2025-02-22","SF FuneralF823179       250222","","126.5","","658459.68"
"2025-02-25","2025-02-22","SF FuneralF823218       250222","","126.5","","658586.18"
"2025-02-25","2025-02-22","SF FuneralF823276       250222","","126.5","","658712.68"
"2025-02-25","2025-02-22","SF FuneralF823282       250222","","126.5","","658839.18"
"2025-02-25","2025-02-22","SF FuneralF823413       250222","","126.5","","658965.68"
"2025-02-25","2025-02-22","SF FuneralF823643       250222","","126.5","","659092.18"
"2025-02-25","2025-02-22","SF FuneralF823944       250222","","126.5","","659218.68"
"2025-02-25","2025-02-22","SF FuneralFDC0000000BMH8250222","","126.5","","659345.18"
"2025-02-25","2025-02-22","SF FuneralF827727       250222","","126.5","","659471.68"
"2025-02-25","2025-02-22","SF FuneralF828166       250222","","126.5","","659598.18"
"2025-02-25","2025-02-22","SF FuneralF828797       250222","","126.5","","659724.68"
"2025-02-25","2025-02-22","SF FuneralF829525       250222","","126.5","","659851.18"
"2025-02-25","2025-02-22","SF FuneralF829925       250222","","126.5","","659977.68"
"2025-02-25","2025-02-22","SF FuneralF830821       250222","","126.5","","660104.18"
"2025-02-25","2025-02-22","SF FuneralF830834       250222","","126.5","","660230.68"
"2025-02-25","2025-02-22","SF FuneralF830848       250222","","126.5","","660357.18"
"2025-02-25","2025-02-22","SF FuneralF831034       250222","","126.5","","660483.68"
"2025-02-25","2025-02-22","SF FuneralF831843       250222","","126.5","","660610.18"
"2025-02-25","2025-02-22","SF FuneralF832094       250222","","126.5","","660736.68"
"2025-02-25","2025-02-22","SF FuneralF832232       250222","","126.5","","660863.18"
"2025-02-25","2025-02-22","SF FuneralF832336       250222","","126.5","","660989.68"
"2025-02-25","2025-02-22","SF FuneralFDC0000000CKHP250222","","126.5","","661116.18"
"2025-02-25","2025-02-22","SF FuneralF833210       250222","","126.5","","661242.68"
"2025-02-25","2025-02-22","SF FuneralF833495       250222","","126.5","","661369.18"
"2025-02-25","2025-02-22","SF FuneralF833825       250222","","126.5","","661495.68"
"2025-02-25","2025-02-22","SF FuneralF833877       250222","","126.5","","661622.18"
"2025-02-25","2025-02-22","SF FuneralF834015       250222","","126.5","","661748.68"
"2025-02-25","2025-02-22","SF FuneralF834070       250222","","126.5","","661875.18"
"2025-02-25","2025-02-22","SF FuneralF838818       250222","","126.5","","662001.68"
"2025-02-25","2025-02-22","SF FuneralFDC0000000D6CZ250222","","126.5","","662128.18"
"2025-02-25","2025-02-22","SF FuneralF838844       250222","","126.5","","662254.68"
"2025-02-25","2025-02-22","SF FuneralF838869       250222","","126.5","","662381.18"
"2025-02-25","2025-02-22","SF FuneralF840713       250222","","126.5","","662507.68"
"2025-02-25","2025-02-22","SF FuneralF840764       250222","","126.5","","662634.18"
"2025-02-25","2025-02-22","SF FuneralF840778       250222","","126.5","","662760.68"
"2025-02-25","2025-02-22","SF FuneralF840888       250222","","126.5","","662887.18"
"2025-02-25","2025-02-22","SF FuneralF840954       250222","","126.5","","663013.68"
"2025-02-25","2025-02-22","SF FuneralF840959       250222","","126.5","","663140.18"
"2025-02-25","2025-02-22","SF FuneralF841059       250222","","126.5","","663266.68"
"2025-02-25","2025-02-22","SF FuneralF841228       250222","","126.5","","663393.18"
"2025-02-25","2025-02-22","SF FuneralF841829       250222","","126.5","","663519.68"
"2025-02-25","2025-02-22","SF FuneralF991644       250222","","126.5","","663646.18"
"2025-02-25","2025-02-22","SF FuneralF991749       250222","","126.5","","663772.68"
"2025-02-25","2025-02-22","SF FuneralFDC0000000JB8Y250222","","126.5","","663899.18"
"2025-02-25","2025-02-22","SF FuneralF1016987      250222","","126.5","","664025.68"
"2025-02-25","2025-02-22","SF FuneralF1017641      250222","","126.5","","664152.18"
"2025-02-25","2025-02-22","SF FuneralF1017656      250222","","126.5","","664278.68"
"2025-02-25","2025-02-22","SF FuneralF1017779      250222","","126.5","","664405.18"
"2025-02-25","2025-02-22","SF FuneralF1017809      250222","","126.5","","664531.68"
"2025-02-25","2025-02-22","SF FuneralF1020444      250222","","126.5","","664658.18"
"2025-02-25","2025-02-22","SF FuneralFDC0000000JN0G250222","","126.5","","664784.68"
"2025-02-25","2025-02-22","SF FuneralF1020596      250222","","126.5","","664911.18"
"2025-02-25","2025-02-22","SF FuneralF1020667      250222","","126.5","","665037.68"
"2025-02-25","2025-02-22","SF FuneralF1021394      250222","","126.5","","665164.18"
"2025-02-25","2025-02-22","SF FuneralFDC0000000K3QC250222","","126.5","","665290.68"
"2025-02-25","2025-02-22","SF FuneralFDC0000000K3QT250222","","126.5","","665417.18"
"2025-02-25","2025-02-22","SF FuneralF1054774      250222","","126.5","","665543.68"
"2025-02-25","2025-02-22","SF FuneralFDC0000000K6N6250222","","126.5","","665670.18"
"2025-02-25","2025-02-22","SF FuneralF1055271      250222","","126.5","","665796.68"
"2025-02-25","2025-02-22","SF FuneralF1055302      250222","","126.5","","665923.18"
"2025-02-25","2025-02-22","SF FuneralF1058861      250222","","126.5","","666049.68"
"2025-02-25","2025-02-22","SF FuneralFDC0000000KC34250222","","126.5","","666176.18"
"2025-02-25","2025-02-22","SF FuneralF1059873      250222","","126.5","","666302.68"
"2025-02-25","2025-02-22","SF FuneralF1060375      250222","","126.5","","666429.18"
"2025-02-25","2025-02-22","SF FuneralF1060543      250222","","126.5","","666555.68"
"2025-02-25","2025-02-22","SF FuneralF1061773      250222","","126.5","","666682.18"
"2025-02-25","2025-02-22","SF FuneralF1061910      250222","","126.5","","666808.68"
"2025-02-25","2025-02-22","SF FuneralF1062679      250222","","126.5","","666935.18"
"2025-02-25","2025-02-22","SF FuneralF1065715      250222","","126.5","","667061.68"
"2025-02-25","2025-02-22","SF FuneralF1065744      250222","","126.5","","667188.18"
"2025-02-25","2025-02-22","SF FuneralF1066155      250222","","126.5","","667314.68"
"2025-02-25","2025-02-22","SF FuneralF1066675      250222","","126.5","","667441.18"
"2025-02-25","2025-02-22","SF FuneralF1067919      250222","","126.5","","667567.68"
"2025-02-25","2025-02-22","SF FuneralF1067929      250222","","126.5","","667694.18"
"2025-02-25","2025-02-22","SF FuneralF1067956      250222","","126.5","","667820.68"
"2025-02-25","2025-02-22","SF FuneralFDC0000000L0CC250222","","126.5","","667947.18"
"2025-02-25","2025-02-22","SF FuneralF1073810      250222","","126.5","","668073.68"
"2025-02-25","2025-02-22","SF FuneralF1074446      250222","","126.5","","668200.18"
"2025-02-25","2025-02-22","SF FuneralF1074578      250222","","126.5","","668326.68"
"2025-02-25","2025-02-22","SF FuneralFDC0000000L9Q5250222","","126.5","","668453.18"
"2025-02-25","2025-02-22","SF FuneralF1075192      250222","","126.5","","668579.68"
"2025-02-25","2025-02-22","SF FuneralF1078643      250222","","126.5","","668706.18"
"2025-02-25","2025-02-22","SF FuneralF1079301      250222","","126.5","","668832.68"
"2025-02-25","2025-02-22","SF FuneralFDC0000000LLFP250222","","126.5","","668959.18"
"2025-02-25","2025-02-22","SF FuneralFDC0000000LLFT250222","","126.5","","669085.68"
"2025-02-25","2025-02-22","SF FuneralFDC0000000LMX4250222","","126.5","","669212.18"
"2025-02-25","2025-02-22","SF FuneralF1080420      250222","","126.5","","669338.68"
"2025-02-25","2025-02-22","SF FuneralF778543       250222","","126.5","","669465.18"
"2025-02-25","2025-02-22","SF FuneralF900692       250222","","126.5","","669591.68"
"2025-02-25","2025-02-22","SF FuneralF1080534      250223","","126.5","","669718.18"
"2025-02-25","2025-02-22","SF FuneralF1080539      250223","","126.5","","669844.68"
"2025-02-25","2025-02-22","SF FuneralF1083938      250222","","126.5","","669971.18"
"2025-02-25","2025-02-22","SF FuneralF1084352      250222","","126.5","","670097.68"
"2025-02-25","2025-02-22","SF FuneralF1102831      250222","","126.5","","670224.18"
"2025-02-25","2025-02-22","SF FuneralF1103786      250222","","126.5","","670350.68"
"2025-02-25","2025-02-22","SF FuneralF1104094      250222","","126.5","","670477.18"
"2025-02-25","2025-02-22","SF FuneralF782768       250222","","126.5","","670603.68"
"2025-02-25","2025-02-22","SF FuneralF1107999      250222","","126.5","","670730.18"
"2025-02-25","2025-02-22","SF FuneralF1108138      250222","","126.5","","670856.68"
"2025-02-25","2025-02-22","SF FuneralF1108153      250223","","126.5","","670983.18"
"2025-02-25","2025-02-22","SF FuneralF1108244      250222","","126.5","","671109.68"
"2025-02-25","2025-02-22","SF FuneralF1108352      250222","","126.5","","671236.18"
"2025-02-25","2025-02-22","SF FuneralF1108364      250222","","126.5","","671362.68"
"2025-02-25","2025-02-22","SF FuneralF1108523      250222","","126.5","","671489.18"
"2025-02-25","2025-02-22","SF FuneralF1108643      250222","","126.5","","671615.68"
"2025-02-25","2025-02-22","SF FuneralF1108676      250222","","126.5","","671742.18"
"2025-02-25","2025-02-22","SF FuneralF1108721      250222","","126.5","","671868.68"
"2025-02-25","2025-02-22","SF FuneralF1108730      250222","","126.5","","671995.18"
"2025-02-25","2025-02-22","SF FuneralF1108906      250222","","126.5","","672121.68"
"2025-02-25","2025-02-22","SF FuneralF1109885      250222","","126.5","","672248.18"
"2025-02-25","2025-02-22","SF FuneralFDC0000000MLCS250222","","191.5","","672439.68"
"2025-02-25","2025-02-22","SF FuneralFDC0000000MLZ6250222","","126.5","","672566.18"
"2025-02-25","2025-02-22","SF FuneralF1110697      250222","","126.5","","672692.68"
"2025-02-25","2025-02-22","SF FuneralF1110808      250222","","126.5","","672819.18"
"2025-02-25","2025-02-22","SF FuneralFDC0000000MS44250222","","126.5","","672945.68"
"2025-02-25","2025-02-22","SF FuneralF1111991      250222","","126.5","","673072.18"
"2025-02-25","2025-02-22","SF FuneralF1112016      250222","","126.5","","673198.68"
"2025-02-25","2025-02-22","SF FuneralF1112167      250222","","126.5","","673325.18"
"2025-02-25","2025-02-22","SF FuneralF1112248      250222","","126.5","","673451.68"
"2025-02-25","2025-02-22","SF FuneralF1112257      250222","","126.5","","673578.18"
"2025-02-25","2025-02-22","SF FuneralFDC0000000MZV8250222","","126.5","","673704.68"
"2025-02-25","2025-02-22","SF FuneralF1112371      250222","","126.5","","673831.18"
"2025-02-25","2025-02-22","SF FuneralF1112576      250222","","126.5","","673957.68"
"2025-02-25","2025-02-22","SF FuneralF1113176      250222","","126.5","","674084.18"
"2025-02-25","2025-02-22","SF FuneralF1113125      250222","","126.5","","674210.68"
"2025-02-25","2025-02-22","SF FuneralF792923       250222","","126.5","","674337.18"
"2025-02-25","2025-02-22","SF FuneralFDC0000000N6H4250222","","126.5","","674463.68"
"2025-02-25","2025-02-22","SF FuneralF1114245      250222","","126.5","","674590.18"
"2025-02-25","2025-02-22","SF FuneralF1114404      250222","","126.5","","674716.68"
"2025-02-25","2025-02-22","SF FuneralFDC0000000N8M9250222","","126.5","","674843.18"
"2025-02-25","2025-02-22","SF FuneralF1114640      250222","","126.5","","674969.68"
"2025-02-25","2025-02-22","SF FuneralFDC0000000N9D8250222","","126.5","","675096.18"
"2025-02-25","2025-02-22","SF FuneralF1114836      250222","","126.5","","675222.68"
"2025-02-25","2025-02-22","SF FuneralF1114945      250222","","126.5","","675349.18"
"2025-02-25","2025-02-22","SF FuneralF783490       250222","","126.5","","675475.68"
"2025-02-25","2025-02-22","SF FuneralF1115728      250222","","126.5","","675602.18"
"2025-02-25","2025-02-22","SF FuneralFDC0000000NCQ5250222","","126.5","","675728.68"
"2025-02-25","2025-02-22","SF FuneralF1115731      250222","","126.5","","675855.18"
"2025-02-25","2025-02-22","SF FuneralF1115839      250222","","126.5","","675981.68"
"2025-02-25","2025-02-22","SF FuneralF1115846      250222","","126.5","","676108.18"
"2025-02-25","2025-02-22","SF FuneralFDC0000000NDR3250222","","126.5","","676234.68"
"2025-02-25","2025-02-22","SF FuneralFDC0000000NFTV250222","","126.5","","676361.18"
"2025-02-25","2025-02-22","SF FuneralF1115996      250222","","126.5","","676487.68"
"2025-02-25","2025-02-22","SF FuneralF1116046      250222","","126.5","","676614.18"
"2025-02-25","2025-02-22","SF FuneralF787947       250222","","126.5","","676740.68"
"2025-02-25","2025-02-22","SF FuneralF1116085      250222","","126.5","","676867.18"
"2025-02-25","2025-02-22","SF FuneralF1116094      250222","","126.5","","676993.68"
"2025-02-25","2025-02-22","SF FuneralF1116118      250222","","126.5","","677120.18"
"2025-02-25","2025-02-22","SF FuneralF1117343      250222","","126.5","","677246.68"
"2025-02-25","2025-02-22","SF FuneralF1117582      250222","","126.5","","677373.18"
"2025-02-25","2025-02-22","SF FuneralF1117877      250222","","126.5","","677499.68"
"2025-02-25","2025-02-22","SF FuneralF1118000      250222","","126.5","","677626.18"
"2025-02-25","2025-02-22","SF FuneralF1118065      250222","","126.5","","677752.68"
"2025-02-25","2025-02-22","SF FuneralF1118303      250222","","126.5","","677879.18"
"2025-02-25","2025-02-22","SF FuneralF1118400      250222","","126.5","","678005.68"
"2025-02-25","2025-02-22","SF FuneralFDC0000000NPH3250222","","126.5","","678132.18"
"2025-02-25","2025-02-22","SF FuneralF1118890      250222","","126.5","","678258.68"
"2025-02-25","2025-02-22","SF FuneralF1118917      250222","","126.5","","678385.18"
"2025-02-25","2025-02-22","SF FuneralF1119866      250222","","126.5","","678511.68"
"2025-02-25","2025-02-22","SF FuneralFDC0000000NSNR250222","","191.5","","678703.18"
"2025-02-25","2025-02-22","SF FuneralFDC0000000NT5V250222","","126.5","","678829.68"
"2025-02-25","2025-02-22","SF FuneralF1120136      250222","","126.5","","678956.18"
"2025-02-25","2025-02-22","SF FuneralF1120184      250222","","126.5","","679082.68"
"2025-02-25","2025-02-22","SF FuneralFDC0000000NV7X250222","","126.5","","679209.18"
"2025-02-25","2025-02-22","SF FuneralF1120271      250222","","126.5","","679335.68"
"2025-02-25","2025-02-22","SF FuneralFDC0000000NVMY250222","","126.5","","679462.18"
"2025-02-25","2025-02-22","SF FuneralF1120275      250222","","126.5","","679588.68"
"2025-02-25","2025-02-22","SF FuneralF1120279      250222","","126.5","","679715.18"
"2025-02-25","2025-02-22","SF FuneralF1120835      250222","","126.5","","679841.68"
"2025-02-25","2025-02-22","SF FuneralF1120935      250222","","126.5","","679968.18"
"2025-02-25","2025-02-22","SF FuneralFDC0000000P09G250222","","126.5","","680094.68"
"2025-02-25","2025-02-22","SF FuneralF1122333      250222","","126.5","","680221.18"
"2025-02-25","2025-02-22","SF FuneralFDC0000000P18M250222","","126.5","","680347.68"
"2025-02-25","2025-02-22","SF FuneralF1122938      250222","","126.5","","680474.18"
"2025-02-25","2025-02-22","SF FuneralF1122993      250222","","126.5","","680600.68"
"2025-02-25","2025-02-22","SF FuneralFDC0000000P32C250222","","126.5","","680727.18"
"2025-02-25","2025-02-22","SF FuneralF1123040      250222","","126.5","","680853.68"
"2025-02-25","2025-02-22","SF FuneralF1124198      250222","","126.5","","680980.18"
"2025-02-25","2025-02-22","SF FuneralF1124203      250222","","126.5","","681106.68"
"2025-02-25","2025-02-22","SF FuneralF1124439      250222","","126.5","","681233.18"
"2025-02-25","2025-02-22","SF FuneralF1124538      250222","","126.5","","681359.68"
"2025-02-25","2025-02-22","SF FuneralF1125041      250222","","126.5","","681486.18"
"2025-02-25","2025-02-22","SF FuneralF1125846      250222","","126.5","","681612.68"
"2025-02-25","2025-02-22","SF FuneralFDC0000000PKLP250222","","126.5","","681739.18"
"2025-02-25","2025-02-22","SF FuneralF1126178      250222","","126.5","","681865.68"
"2025-02-25","2025-02-22","SF FuneralF1126875      250222","","126.5","","681992.18"
"2025-02-25","2025-02-22","SF FuneralF830840       250222","","126.5","","682118.68"
"2025-02-25","2025-02-22","SF FuneralFDC0000000PNT6250222","","126.5","","682245.18"
"2025-02-25","2025-02-22","SF FuneralF1127448      250222","","126.5","","682371.68"
"2025-02-25","2025-02-22","SF FuneralF1127527      250222","","126.5","","682498.18"
"2025-02-25","2025-02-22","SF FuneralF1127536      250222","","126.5","","682624.68"
"2025-02-25","2025-02-22","SF FuneralF1127540      250222","","126.5","","682751.18"
"2025-02-25","2025-02-22","SF FuneralF1127605      250222","","126.5","","682877.68"
"2025-02-25","2025-02-22","SF FuneralF1127624      250222","","126.5","","683004.18"
"2025-02-25","2025-02-22","SF FuneralF1127862      250222","","126.5","","683130.68"
"2025-02-25","2025-02-22","SF FuneralF1128009      250222","","126.5","","683257.18"
"2025-02-25","2025-02-22","SF FuneralF1128014      250222","","126.5","","683383.68"
"2025-02-25","2025-02-22","SF FuneralF1128783      250222","","126.5","","683510.18"
"2025-02-25","2025-02-22","SF FuneralF1128785      250222","","126.5","","683636.68"
"2025-02-25","2025-02-22","SF FuneralF1129084      250222","","126.5","","683763.18"
"2025-02-25","2025-02-22","SF FuneralF1129101      250222","","126.5","","683889.68"
"2025-02-25","2025-02-22","SF FuneralF1129165      250222","","126.5","","684016.18"
"2025-02-25","2025-02-22","SF FuneralF1129272      250222","","126.5","","684142.68"
"2025-02-25","2025-02-22","SF FuneralF1129334      250222","","126.5","","684269.18"
"2025-02-25","2025-02-22","SF FuneralFDC0000000PZ72250222","","126.5","","684395.68"
"2025-02-25","2025-02-22","SF FuneralF1130312      250222","","126.5","","684522.18"
"2025-02-25","2025-02-22","SF FuneralFDC0000000Q5B6250222","","126.5","","684648.68"
"2025-02-25","2025-02-25","SF FuneralFDC0000000PWW4250225","","126.5","","684775.18"
"2025-02-25","2025-02-25","SF FuneralF1130740      250225","","126.5","","684901.68"
"2025-02-25","2025-02-25","SF FuneralF1130830      250225","","126.5","","685028.18"
"2025-02-25","2025-02-25","SF FuneralFDC0000000Q5XZ250225","","126.5","","685154.68"
"2025-02-25","2025-02-25","SF FuneralF1131920      250225","","126.5","","685281.18"
"2025-02-25","2025-02-25","SF FuneralFDC0000000Q6VY250225","","126.5","","685407.68"
"2025-02-25","2025-02-25","SF FuneralFDC0000000Q6W2250225","","126.5","","685534.18"
"2025-02-25","2025-02-25","SF FuneralF1132048      250225","","126.5","","685660.68"
"2025-02-25","2025-02-25","SF FuneralFDC0000000Q7SH250225","","126.5","","685787.18"
"2025-02-25","2025-02-25","SF FuneralFDC0000000Q81W250225","","126.5","","685913.68"
"2025-02-25","2025-02-25","SF FuneralFDC0000000Q820250225","","126.5","","686040.18"
"2025-02-25","2025-02-25","SF FuneralF1132796      250225","","126.5","","686166.68"
"2025-02-25","2025-02-25","SF FuneralF1132834      250225","","126.5","","686293.18"
"2025-02-25","2025-02-25","SF FuneralFDC0000000Q9HM250225","","126.5","","686419.68"
"2025-02-25","2025-02-25","SF FuneralFDC00000003JXZ250225","","220","","686639.68"
"2025-02-25","2025-02-25","SF FuneralFDC00000005LS0250225","","126.5","","686766.18"
"2025-02-25","2025-02-25","SF FuneralFDC00000005VXN250225","","126.5","","686892.68"
"2025-02-25","2025-02-25","SF FuneralFDC000000062FD250225","","220","","687112.68"
"2025-02-25","2025-02-25","SF FuneralFDC00000006WBT250225","","191.5","","687304.18"
"2025-02-25","2025-02-25","SF FuneralFDC00000007RGL250225","","126.5","","687430.68"
"2025-02-25","2025-02-25","SF FuneralFDC0000000800P250225","","126.5","","687557.18"
"2025-02-25","2025-02-25","SF FuneralFDC0000000800S250225","","126.5","","687683.68"
"2025-02-25","2025-02-25","SF FuneralF803694       250225","","126.5","","687810.18"
"2025-02-25","2025-02-25","SF FuneralFDC00000008NR5250225","","126.5","","687936.68"
"2025-02-25","2025-02-25","SF FuneralF808312       250225","","63.25","","687999.93"
"2025-02-25","2025-02-25","SF FuneralF815997       250225","","126.5","","688126.43"
"2025-02-25","2025-02-25","SF FuneralF827804       250225","","126.5","","688252.93"
"2025-02-25","2025-02-25","SF FuneralF829999       250225","","126.5","","688379.43"
"2025-02-25","2025-02-25","SF FuneralF986879       250225","","126.5","","688505.93"
"2025-02-25","2025-02-25","SF FuneralF1016772      250225","","126.5","","688632.43"
"2025-02-25","2025-02-25","SF FuneralF1017097      250225","","126.5","","688758.93"
"2025-02-25","2025-02-25","SF FuneralF1078559      250225","","126.5","","688885.43"
"2025-02-25","2025-02-25","SF FuneralFDC0000000LQTG250225","","126.5","","689011.93"
"2025-02-25","2025-02-25","SF FuneralF1083636      250225","","63.25","","689075.18"
"2025-02-25","2025-02-25","SF FuneralF1108107      250225","","126.5","","689201.68"
"2025-02-25","2025-02-25","SF FuneralF1119069      250225","","126.5","","689328.18"
"2025-02-25","2025-02-25","SF FuneralF1124772      250225","","126.5","","689454.68"
"2025-02-25","2025-02-25","SF FuneralFDC0000000Q0MD250225","","126.5","","689581.18"
"2025-02-25","2025-02-25","SF FuneralF1130494      250225","","126.5","","689707.68"
"2025-02-25","2025-02-25","SF FuneralF1131936      250225","","126.5","","689834.18"
"2025-02-25","2025-02-25","SF FuneralF1132875      250225","","126.5","","689960.68"
"2025-02-25","2025-02-25","SF FuneralFDC00000005GLS250225","","126.5","","690087.18"
"2025-02-25","2025-02-25","SF FuneralFDC00000006FKH250225","","63.25","","690150.43"
"2025-02-25","2025-02-25","SF FuneralFDC00000006MYN250225","","126.5","","690276.93"
"2025-02-25","2025-02-25","SF FuneralFDC00000006QZC250225","","126.5","","690403.43"
"2025-02-25","2025-02-25","SF FuneralFDC000000072Q2250225","","126.5","","690529.93"
"2025-02-25","2025-02-25","SF FuneralFDC000000072YQ250225","","63.25","","690593.18"
"2025-02-25","2025-02-25","SF FuneralFDC000000078QF250225","","126.5","","690719.68"
"2025-02-25","2025-02-25","SF FuneralFDC000000077PK250225","","126.5","","690846.18"
"2025-02-25","2025-02-25","SF FuneralFDC00000007F33250225","","126.5","","690972.68"
"2025-02-25","2025-02-25","SF FuneralFDC00000007MXH250225","","126.5","","691099.18"
"2025-02-25","2025-02-25","SF FuneralFDC00000007P5T250225","","126.5","","691225.68"
"2025-02-25","2025-02-25","SF FuneralFDC00000007V50250225","","126.5","","691352.18"
"2025-02-25","2025-02-25","SF FuneralFDC00000007XJV250225","","126.5","","691478.68"
"2025-02-25","2025-02-25","SF FuneralF800702       250225","","126.5","","691605.18"
"2025-02-25","2025-02-25","SF FuneralFDC00000008J9J250225","","126.5","","691731.68"
"2025-02-25","2025-02-25","SF FuneralFDC00000008MDL250225","","126.5","","691858.18"
"2025-02-25","2025-02-25","SF FuneralF800660       250225","","126.5","","691984.68"
"2025-02-25","2025-02-25","SF FuneralF781301       250225","","126.5","","692111.18"
"2025-02-25","2025-02-25","SF FuneralF819799       250225","","126.5","","692237.68"
"2025-02-25","2025-02-25","SF FuneralF821871       250225","","63.25","","692300.93"
"2025-02-25","2025-02-25","SF FuneralF830076       250225","","63.25","","692364.18"
"2025-02-25","2025-02-25","SF FuneralFDC0000000D21J250225","","126.5","","692490.68"
"2025-02-25","2025-02-25","SF FuneralF840708       250225","","126.5","","692617.18"
"2025-02-25","2025-02-25","SF FuneralF840751       250225","","126.5","","692743.68"
"2025-02-25","2025-02-25","SF FuneralF981132       250225","","126.5","","692870.18"
"2025-02-25","2025-02-25","SF FuneralF990246       250225","","63.25","","692933.43"
"2025-02-25","2025-02-25","SF FuneralF992514       250225","","126.5","","693059.93"
"2025-02-25","2025-02-25","SF FuneralF992859       250225","","126.5","","693186.43"
"2025-02-25","2025-02-25","SF FuneralFDC0000000JKF4250225","","126.5","","693312.93"
"2025-02-25","2025-02-25","SF FuneralF804790       250225","","256.5","","693569.43"
"2025-02-25","2025-02-25","SF FuneralF1020521      250225","","126.5","","693695.93"
"2025-02-25","2025-02-25","SF FuneralF1021121      250225","","126.5","","693822.43"
"2025-02-25","2025-02-25","SF FuneralF1021427      250225","","63.25","","693885.68"
"2025-02-25","2025-02-25","SF FuneralF1033783      250225","","126.5","","694012.18"
"2025-02-25","2025-02-25","SF FuneralF1058651      250225","","126.5","","694138.68"
"2025-02-25","2025-02-25","SF FuneralF1060916      250225","","126.5","","694265.18"
"2025-02-25","2025-02-25","SF FuneralF1074546      250225","","126.5","","694391.68"
"2025-02-25","2025-02-25","SF FuneralF1080231      250225","","126.5","","694518.18"
"2025-02-25","2025-02-25","SF FuneralFDC0000000LN0Q250225","","126.5","","694644.68"
"2025-02-25","2025-02-25","SF FuneralFDC0000000LPJZ250225","","191.5","","694836.18"
"2025-02-25","2025-02-25","SF FuneralF1103542      250225","","126.5","","694962.68"
"2025-02-25","2025-02-25","SF FuneralF1112093      250225","","63.25","","695025.93"
"2025-02-25","2025-02-25","SF FuneralFDC0000000N2L7250225","","63.25","","695089.18"
"2025-02-25","2025-02-25","SF FuneralF1112459      250225","","63.25","","695152.43"
"2025-02-25","2025-02-25","SF FuneralF1117955      250225","","63.25","","695215.68"
"2025-02-25","2025-02-25","SF FuneralF1120281      250225","","126.5","","695342.18"
"2025-02-25","2025-02-25","SF FuneralF1120559      250225","","126.5","","695468.68"
"2025-02-25","2025-02-25","SF FuneralF1121874      250225","","126.5","","695595.18"
"2025-02-25","2025-02-24","SF FuneralFDC000000056ZW250223","","126.5","","695721.68"
"2025-02-25","2025-02-24","SF FuneralFDC0000000610R250224","","126.5","","695848.18"
"2025-02-25","2025-02-24","SF FuneralFDC000000066CH250223","","126.5","","695974.68"
"2025-02-25","2025-02-24","SF FuneralFDC000000066DB250223","","126.5","","696101.18"
"2025-02-25","2025-02-24","SF FuneralFDC00000007Y7J250223","","126.5","","696227.68"
"2025-02-25","2025-02-24","SF FuneralF808801       250223","","126.5","","696354.18"
"2025-02-25","2025-02-24","SF FuneralF843208       250222","","126.5","","696480.68"
"2025-02-25","2025-02-24","SF FuneralF844553       250222","","126.5","","696607.18"
"2025-02-25","2025-02-24","SF FuneralF900589       250222","","126.5","","696733.68"
"2025-02-25","2025-02-21","SF FuneralFDC00000007007250221","","126.5","","696860.18"
"2025-02-25","2025-02-21","SF FuneralFDC00000008H5F250221","","126.5","","696986.68"
"2025-02-25","2025-02-21","SF FuneralFDC00000008H5J250221","","126.5","","697113.18"
"2025-02-25","2025-02-21","SF FuneralFDC00000008J08250221","","126.5","","697239.68"
"2025-02-25","2025-02-21","SF FuneralF801930       250221","","126.5","","697366.18"
"2025-02-25","2025-02-21","SF FuneralF802703       250221","","126.5","","697492.68"
"2025-02-25","2025-02-21","SF FuneralF817209       250221","","126.5","","697619.18"
"2025-02-25","2025-02-21","SF FuneralFDC0000000B0HR250221","","126.5","","697745.68"
"2025-02-25","2025-02-21","SF FuneralF831763       250221","","126.5","","697872.18"
"2025-02-25","2025-02-21","SF FuneralF834741       250221","","126.5","","697998.68"
"2025-02-25","2025-02-21","SF FuneralF980794       250222","","126.5","","698125.18"
"2025-02-25","2025-02-21","SF FuneralF987379       250222","","126.5","","698251.68"
"2025-02-25","2025-02-21","SF FuneralF987419       250222","","126.5","","698378.18"
"2025-02-25","2025-02-21","SF FuneralF988006       250222","","126.5","","698504.68"
"2025-02-25","2025-02-21","SF FuneralF991017       250222","","126.5","","698631.18"
"2025-02-25","2025-02-21","SF FuneralF1066246      250221","","126.5","","698757.68"
"2025-02-25","2025-02-21","SF FuneralF1122345      250221","","126.5","","698884.18"
"2025-02-25","2025-02-22","SF FuneralFDC000000031G5250222","","220","","699104.18"
"2025-02-25","2025-02-22","SF FuneralFDC000000031X6250222","","220","","699324.18"
"2025-02-25","2025-02-22","SF FuneralFDC00000005C4S250222","","126.5","","699450.68"
"2025-02-25","2025-02-22","SF FuneralFDC00000005DDD250222","","126.5","","699577.18"
"2025-02-25","2025-02-22","SF FuneralFDC00000005DWJ250222","","126.5","","699703.68"
"2025-02-25","2025-02-22","SF FuneralFDC00000005FX5250222","","126.5","","699830.18"
"2025-02-25","2025-02-22","SF FuneralFDC00000005ZLV250222","","126.5","","699956.68"
"2025-02-25","2025-02-22","SF FuneralFDC000000060BH250222","","126.5","","700083.18"
"2025-02-25","2025-02-22","SF FuneralFDC000000060PZ250222","","126.5","","700209.68"
"2025-02-25","2025-02-22","SF FuneralFDC000000060TZ250222","","126.5","","700336.18"
"2025-02-25","2025-02-22","SF FuneralFDC000000061QZ250222","","126.5","","700462.68"
"2025-02-25","2025-02-22","SF FuneralFDC000000061ZF250222","","126.5","","700589.18"
"2025-02-25","2025-02-22","SF FuneralFDC000000062S9250222","","126.5","","700715.68"
"2025-02-25","2025-02-22","SF FuneralFDC000000062V6250222","","126.5","","700842.18"
"2025-02-25","2025-02-22","SF FuneralFDC000000062XV250222","","126.5","","700968.68"
"2025-02-25","2025-02-22","SF FuneralFDC000000063S6250222","","126.5","","701095.18"
"2025-02-25","2025-02-22","SF FuneralFDC000000064RW250222","","126.5","","701221.68"
"2025-02-25","2025-02-22","SF FuneralFDC000000066KD250222","","126.5","","701348.18"
"2025-02-25","2025-02-22","SF FuneralFDC000000069H1250222","","126.5","","701474.68"
"2025-02-25","2025-02-22","SF FuneralFDC00000006CW1250222","","126.5","","701601.18"
"2025-02-25","2025-02-22","SF FuneralFDC00000006CWM250222","","126.5","","701727.68"
"2025-02-25","2025-02-22","SF FuneralFDC00000006CZ4250222","","126.5","","701854.18"
"2025-02-25","2025-02-22","SF FuneralFDC00000006DRC250222","","126.5","","701980.68"
"2025-02-25","2025-02-22","SF FuneralFDC00000006FZW250222","","126.5","","702107.18"
"2025-02-25","2025-02-22","SF FuneralFDC00000006GQ0250222","","126.5","","702233.68"
"2025-02-25","2025-02-22","SF FuneralFDC00000006N9D250222","","126.5","","702360.18"
"2025-02-25","2025-02-22","SF FuneralFDC00000006NLB250222","","126.5","","702486.68"
"2025-02-25","2025-02-22","SF FuneralFDC00000006QR8250222","","126.5","","702613.18"
"2025-02-25","2025-02-22","SF FuneralFDC00000006QRH250222","","126.5","","702739.68"
"2025-02-25","2025-02-22","SF FuneralFDC00000006S3P250222","","126.5","","702866.18"
"2025-02-25","2025-02-22","SF FuneralFDC00000006SL5250222","","126.5","","702992.68"
"2025-02-25","2025-02-22","SF FuneralFDC00000006TFH250222","","126.5","","703119.18"
"2025-02-25","2025-02-22","SF FuneralFDC00000006V2H250222","","126.5","","703245.68"
"2025-02-25","2025-02-22","SF FuneralFDC00000006VLX250222","","126.5","","703372.18"
"2025-02-25","2025-02-22","SF FuneralFDC00000006VNK250222","","126.5","","703498.68"
"2025-02-25","2025-02-22","SF FuneralFDC00000006WH3250222","","126.5","","703625.18"
"2025-02-25","2025-02-22","SF FuneralFDC00000006WKY250222","","126.5","","703751.68"
"2025-02-25","2025-02-22","SF FuneralFDC00000006XHW250222","","126.5","","703878.18"
"2025-02-25","2025-02-22","SF FuneralFDC00000006YNB250222","","126.5","","704004.68"
"2025-02-25","2025-02-22","SF FuneralFDC00000006ZSN250222","","126.5","","704131.18"
"2025-02-25","2025-02-22","SF FuneralFDC000000075XC250222","","126.5","","704257.68"
"2025-02-25","2025-02-22","SF FuneralFDC0000000798W250222","","126.5","","704384.18"
"2025-02-25","2025-02-22","SF FuneralFDC000000079XZ250222","","126.5","","704510.68"
"2025-02-25","2025-02-22","SF FuneralFDC00000007FFT250222","","126.5","","704637.18"
"2025-02-25","2025-02-22","SF FuneralFDC00000007JDV250222","","126.5","","704763.68"
"2025-02-25","2025-02-22","SF FuneralFDC00000007JTB250222","","126.5","","704890.18"
"2025-02-25","2025-02-22","SF FuneralFDC00000007KBJ250222","","126.5","","705016.68"
"2025-02-25","2025-02-22","SF FuneralFDC00000007KD3250222","","126.5","","705143.18"
"2025-02-25","2025-02-22","SF FuneralFDC00000007KJK250222","","126.5","","705269.68"
"2025-02-25","2025-02-22","SF FuneralFDC00000007L0Y250222","","126.5","","705396.18"
"2025-02-25","2025-02-22","SF FuneralFDC00000007RYH250222","","126.5","","705522.68"
"2025-02-25","2025-02-22","SF FuneralF786544       250222","","126.5","","705649.18"
"2025-02-25","2025-02-22","SF FuneralF794889       250222","","126.5","","705775.68"
"2025-02-25","2025-02-22","SF FuneralFDC00000007VTS250222","","126.5","","705902.18"
"2025-02-25","2025-02-22","SF FuneralFDC000000080LC250222","","126.5","","706028.68"
"2025-02-25","2025-02-22","SF FuneralFDC000000081K9250222","","126.5","","706155.18"
"2025-02-25","2025-02-22","SF FuneralFDC0000000824Z250222","","126.5","","706281.68"
"2025-02-25","2025-02-22","SF FuneralFDC000000082LK250222","","126.5","","706408.18"
"2025-02-25","2025-02-22","SF FuneralF800711       250222","","126.5","","706534.68"
"2025-02-25","2025-02-22","SF FuneralFDC00000008FMT250222","","126.5","","706661.18"
"2025-02-25","2025-02-22","SF FuneralFDC00000008G40250222","","126.5","","706787.68"
"2025-02-25","2025-02-22","SF FuneralFDC00000008GSY250222","","126.5","","706914.18"
"2025-02-25","2025-02-22","SF FuneralFDC00000008HY7250222","","126.5","","707040.68"
"2025-02-25","2025-02-22","SF FuneralFDC00000008K9Z250222","","126.5","","707167.18"
"2025-02-25","2025-02-22","SF FuneralFDC00000008PLF250222","","126.5","","707293.68"
"2025-02-25","2025-02-22","SF FuneralF804476       250222","","126.5","","707420.18"
"2025-02-25","2025-02-22","SF FuneralF805413       250222","","126.5","","707546.68"
"2025-02-25","2025-02-22","SF FuneralF805816       250222","","126.5","","707673.18"
"2025-02-25","2025-02-22","SF FuneralF809033       250222","","126.5","","707799.68"
"2025-02-25","2025-02-22","SF FuneralF809456       250222","","126.5","","707926.18"
"2025-02-25","2025-02-22","SF FuneralF810602       250222","","126.5","","708052.68"
"2025-02-25","2025-02-22","SF FuneralF811445       250222","","126.5","","708179.18"
"2025-02-25","2025-02-22","SF FuneralF811912       250222","","126.5","","708305.68"
"2025-02-25","2025-02-22","SF FuneralFDC00000009DFS250222","","126.5","","708432.18"
"2025-02-25","2025-02-22","SF FuneralF813389       250222","","126.5","","708558.68"
"2025-02-25","2025-02-22","SF FuneralF819417       250222","","126.5","","708685.18"
"2025-02-25","2025-02-22","SF FuneralF819727       250222","","126.5","","708811.68"
"2025-02-25","2025-02-22","SF FuneralFDC0000000B8R0250222","","126.5","","708938.18"
"2025-02-25","2025-02-22","SF FuneralF820996       250222","","126.5","","709064.68"
"2025-02-25","2025-02-22","SF FuneralF827676       250222","","126.5","","709191.18"
"2025-02-25","2025-02-22","SF FuneralF828454       250222","","126.5","","709317.68"
"2025-02-25","2025-02-22","SF FuneralF830818       250222","","126.5","","709444.18"
"2025-02-25","2025-02-22","SF FuneralF831296       250222","","126.5","","709570.68"
"2025-02-25","2025-02-22","SF FuneralF834160       250222","","126.5","","709697.18"
"2025-02-25","2025-02-22","SF FuneralF838887       250222","","126.5","","709823.68"
"2025-02-25","2025-02-22","SF FuneralF842618       250222","","126.5","","709950.18"
"2025-02-25","2025-02-22","SF FuneralF992030       250222","","126.5","","710076.68"
"2025-02-25","2025-02-22","SF FuneralF992096       250222","","126.5","","710203.18"
"2025-02-25","2025-02-22","SF FuneralFDC0000000JHW8250222","","126.5","","710329.68"
"2025-02-25","2025-02-22","SF FuneralFDC0000000JHWC250222","","126.5","","710456.18"
"2025-02-25","2025-02-22","SF FuneralF1017760      250222","","126.5","","710582.68"
"2025-02-25","2025-02-22","SF FuneralF1017884      250222","","126.5","","710709.18"
"2025-02-25","2025-02-22","SF FuneralF1022247      250222","","126.5","","710835.68"
"2025-02-25","2025-02-22","SF FuneralF1052590      250222","","126.5","","710962.18"
"2025-02-25","2025-02-22","SF FuneralF1054601      250222","","126.5","","711088.68"
"2025-02-25","2025-02-22","SF FuneralF1054620      250222","","126.5","","711215.18"
"2025-02-25","2025-02-22","SF FuneralFDC0000000KC29250222","","126.5","","711341.68"
"2025-02-25","2025-02-22","SF FuneralFDC0000000KC2D250222","","126.5","","711468.18"
"2025-02-25","2025-02-22","SF FuneralF1074463      250222","","126.5","","711594.68"
"2025-02-25","2025-02-22","SF FuneralF1074563      250222","","126.5","","711721.18"
"2025-02-25","2025-02-22","SF FuneralF1074741      250222","","126.5","","711847.68"
"2025-02-25","2025-02-22","SF FuneralF1074767      250222","","126.5","","711974.18"
"2025-02-25","2025-02-22","SF FuneralF1079667      250222","","126.5","","712100.68"
"2025-02-25","2025-02-22","SF FuneralF1083882      250222","","126.5","","712227.18"
"2025-02-25","2025-02-22","SF FuneralF1084719      250222","","126.5","","712353.68"
"2025-02-25","2025-02-22","SF FuneralF1085073      250222","","126.5","","712480.18"
"2025-02-25","2025-02-22","SF FuneralF1103526      250222","","126.5","","712606.68"
"2025-02-25","2025-02-22","SF FuneralF1103903      250222","","126.5","","712733.18"
"2025-02-25","2025-02-22","SF FuneralF1108014      250222","","126.5","","712859.68"
"2025-02-25","2025-02-22","SF FuneralF1108116      250222","","126.5","","712986.18"
"2025-02-25","2025-02-22","SF FuneralF1108174      250222","","126.5","","713112.68"
"2025-02-25","2025-02-22","SF FuneralFDC0000000MHMS250222","","126.5","","713239.18"
"2025-02-25","2025-02-22","SF FuneralF1110463      250222","","126.5","","713365.68"
"2025-02-25","2025-02-22","SF FuneralF1111601      250222","","126.5","","713492.18"
"2025-02-25","2025-02-22","SF FuneralF1112225      250222","","126.5","","713618.68"
"2025-02-25","2025-02-22","SF FuneralF818303       250222","","321.5","","713940.18"
"2025-02-25","2025-02-22","SF FuneralF1112274      250222","","126.5","","714066.68"
"2025-02-25","2025-02-22","SF FuneralF1112430      250222","","126.5","","714193.18"
"2025-02-25","2025-02-22","SF FuneralF1113780      250222","","126.5","","714319.68"
"2025-02-25","2025-02-22","SF FuneralF1113881      250222","","126.5","","714446.18"
"2025-02-25","2025-02-22","SF FuneralF1114511      250222","","126.5","","714572.68"
"2025-02-25","2025-02-22","SF FuneralF1114733      250222","","126.5","","714699.18"
"2025-02-25","2025-02-22","SF FuneralF1115182      250222","","126.5","","714825.68"
"2025-02-25","2025-02-22","SF FuneralF1118478      250222","","126.5","","714952.18"
"2025-02-25","2025-02-22","SF FuneralF787088       250222","","191.5","","715143.68"
"2025-02-25","2025-02-22","SF FuneralF1120318      250222","","126.5","","715270.18"
"2025-02-25","2025-02-22","SF FuneralF1121885      250222","","126.5","","715396.68"
"2025-02-25","2025-02-22","SF FuneralFDC0000000P196250222","","126.5","","715523.18"
"2025-02-25","2025-02-22","SF FuneralF1123628      250222","","126.5","","715649.68"
"2025-02-25","2025-02-22","SF FuneralFDC0000000P9D7250222","","126.5","","715776.18"
"2025-02-25","2025-02-22","SF FuneralF1127438      250222","","126.5","","715902.68"
"2025-02-25","2025-02-22","SF FuneralFDC0000000PTGV250222","","126.5","","716029.18"
"2025-02-25","2025-02-22","SF FuneralF1128986      250222","","126.5","","716155.68"
"2025-02-25","2025-02-22","SF FuneralFDC0000000PXV3250223","","126.5","","716282.18"
"2025-02-25","2025-02-22","SF FuneralFDC0000000PXV4250223","","126.5","","716408.68"
"2025-02-25","2025-02-22","SF FuneralF1130282      250222","","126.5","","716535.18"
"2025-02-25","2025-02-22","SF FuneralF1130639      250222","","126.5","","716661.68"
"2025-02-25","2025-02-22","SF FuneralF1131300      250222","","126.5","","716788.18"
"2025-02-25","2025-02-22","SF FuneralF1130421      250222","","31.63","","716819.81"
"2025-02-25","2025-02-22","SF FuneralF1131922      250222","","126.5","","716946.31"
"2025-02-25","2025-02-22","SF FuneralF1132238      250222","","126.5","","717072.81"
"2025-02-25","2025-02-17","SF FuneralFDC000000065J5250217","","126.5","","717199.31"
"2025-02-25","2025-02-19","SF FuneralF1080366      250219","","126.5","","717325.81"
"2025-02-25","2025-02-20","SF FuneralF812421       250220","","126.5","","717452.31"
"2025-02-25","2025-02-20","SF FuneralF847394       250220","","126.5","","717578.81"
"2025-02-25","2025-02-20","SF FuneralF1124571      250220","","126.5","","717705.31"
"2025-02-25","2025-02-25","SF FuneralFDC000000039MH250225","","220","","717925.31"
"2025-02-25","2025-02-25","SF FuneralFDC00000007HT2250225","","126.5","","718051.81"
"2025-02-25","2025-02-25","SF FuneralFDC00000008HX5250225","","126.5","","718178.31"
"2025-02-25","2025-02-25","SF FuneralFDC00000009383250225","","31.63","","718209.94"
"2025-02-25","2025-02-25","SF FuneralF820335       250225","","126.5","","718336.44"
"2025-02-25","2025-02-25","SF FuneralF1083746      250225","","126.5","","718462.94"
"2025-02-25","2025-02-25","SF FuneralF1111603      250225","","31.63","","718494.57"
"2025-02-25","2025-02-25","SF FuneralF1130428      250225","","126.5","","718621.07"
"2025-02-25","2025-02-25","SF FuneralFDC0000000Q3QL250225","","126.5","","718747.57"
"2025-02-25","2025-02-25","SF FuneralFDC0000000Q4J6250225","","126.5","","718874.07"
"2025-02-25","2025-02-25","SF FuneralFDC000000062FY250225","","126.5","","719000.57"
"2025-02-25","2025-02-25","SF FuneralFDC000000080LX250225","","126.5","","719127.07"
"2025-02-25","2025-02-25","SF FuneralF830094       250225","","63.25","","719190.32"
"2025-02-25","2025-02-25","SF FuneralF792738       250225","","126.5","","719316.82"
"2025-02-25","2025-02-25","SF FuneralFDC00000005GRH250225","","126.5","","719443.32"
"2025-02-25","2025-02-25","SF FuneralFDC00000007JMC250225","","126.5","","719569.82"
"2025-02-25","2025-02-25","SF FuneralF834459       250225","","126.5","","719696.32"
"2025-02-25","2025-02-25","SF FuneralF1125777      250225","","31.63","","719727.95"
"2025-02-25","2025-02-25","SF FuneralFDC0000000873R250225","","126.5","","719854.45"
"2025-02-25","2025-02-25","SF FuneralF1132219      250225","","126.5","","719980.95"
"2025-02-25","2025-02-22","SF FuneralF811329       250222","","126.5","","720107.45"
"2025-02-25","2025-02-22","SF FuneralF823170       250222","","126.5","","720233.95"
"2025-02-25","2025-02-22","SF FuneralF1112276      250222","","126.5","","720360.45"
"2025-02-25","2025-02-25","SF FuneralF832498       250225","","191.5","","720551.95"
"2025-02-25","2025-02-24","Rev SF FuneralFDC00000005WTC250224","","-55","","720496.95"
"2025-02-25","2025-02-21","Rev SF FuneralFDC0000000NNGY250221","","-31.63","","720465.32"
"2025-02-25","2025-02-20","Rev SF FuneralFDC00000007JZ0250220","","-126.5","","720338.82"
"2025-02-25","2025-02-21","Rev SF FuneralFDC00000006Y54250221","","-126.5","","720212.32"
"2025-02-25","2025-02-22","Rev SF FuneralFDC0000000CKHP250222","","-126.5","","720085.82"
"2025-02-25","2025-02-22","Rev SF FuneralFDC0000000N9R4250222","","-126.5","","719959.32"
"2025-02-25","2025-02-22","Rev SF FuneralFDC00000007F8P250222","","-126.5","","719832.82"
"2025-02-25","2025-02-22","Rev SF FuneralFDC00000007HJ6250222","","-126.5","","719706.32"
"2025-02-25","2025-02-22","Rev SF FuneralFDC0000000BMH8250222","","-126.5","","719579.82"
"2025-02-25","2025-02-22","Rev SF FuneralFDC0000000NXVF250223","","-126.5","","719453.32"
"2025-02-25","2025-02-22","Rev SF FuneralFDC00000006XD5250222","","-126.5","","719326.82"
"2025-02-25","2025-02-22","Rev SF FuneralFDC0000000BBCW250222","","-126.5","","719200.32"
"2025-02-25","2025-02-22","Rev SF FuneralFDC00000003BYY250222","","-220","","718980.32"
"2025-02-25","2025-02-22","Rev SF FuneralFDC00000005XWT250222","","-126.5","","718853.82"
"2025-02-25","2025-02-22","Rev SF FuneralFDC0000000607F250222","","-126.5","","718727.32"
"2025-02-25","2025-02-22","Rev SF FuneralFDC00000006Z9F250222","","-126.5","","718600.82"
"2025-02-25","2025-02-22","Rev SF FuneralFDC00000007JXZ250222","","-126.5","","718474.32"
"2025-02-25","2025-02-22","Rev SF FuneralFDC0000000L0CC250222","","-126.5","","718347.82"
"2025-02-25","2025-02-24","Rev SF FuneralFDC00000006N35250224","","-126.5","","718221.32"
"2025-02-25","2025-02-22","Rev SF FuneralFDC000000076RT250222","","-126.5","","718094.82"
"2025-02-25","2025-02-22","Rev SF FuneralFDC000000076RZ250222","","-126.5","","717968.32"
"2025-02-25","2025-02-22","Rev SF FuneralFDC00000005J5B250222","","-126.5","","717841.82"
"2025-02-25","2025-02-22","Rev SF FuneralFDC00000005K7F250222","","-126.5","","717715.32"
"2025-02-25","2025-02-22","Rev SF FuneralFDC0000000K3QC250222","","-126.5","","717588.82"
"2025-02-25","2025-02-22","Rev SF FuneralFDC0000000K3QT250222","","-126.5","","717462.32"
"2025-02-25","2025-02-22","Rev SF FuneralFDC000000034HX250222","","-220","","717242.32"
"2025-02-25","2025-02-22","Rev SF FuneralFDC000000034JT250222","","-220","","717022.32"
"2025-02-25","2025-02-22","Rev SF FuneralFDC000000037LR250222","","-220","","716802.32"
"2025-02-25","2025-02-22","Rev SF FuneralFDC000000037LS250222","","-220","","716582.32"
"2025-02-25","2025-02-22","Rev SF FuneralFDC0000000PX1W250222","","-126.5","","716455.82"
"2025-02-25","2025-02-24","Rev SF FuneralFDC000000079BQ250223","","-126.5","","716329.32"
"2025-02-25","2025-02-22","Rev SF FuneralFDC00000005S9G250222","","-126.5","","716202.82"
"2025-02-25","2025-02-24","Rev SF FuneralFDC0000000JCQP250224","","-126.5","","716076.32"
"2025-02-25","2025-02-25","Rev SF FuneralFDC000000072Q2250225","","-126.5","","715949.82"
"2025-02-25","2025-02-22","SF FuneralFDC0000000NYC4250222","","126.5","","716076.32"
"2025-02-25","2025-02-21","SF FuneralF1108868      250221","","126.5","","716202.82"
"2025-02-25","2025-02-22","SF FuneralFDC00000007HRH250222","","126.5","","716329.32"
"2025-02-25","2025-02-22","SF FuneralFDC00000007HRN250222","","126.5","","716455.82"
"2025-02-25","2025-02-22","SF FuneralF987229       250222","","126.5","","716582.32"
"2025-02-25","2025-02-22","SF FuneralF1073814      250222","","126.5","","716708.82"
"2025-02-25","2025-02-22","SF FuneralF1116770      250222","","126.5","","716835.32"
"2025-02-25","2025-02-20","SF FuneralFDC0000000M8QV250220","","126.5","","716961.82"
"2025-02-25","2025-02-22","SF FuneralFDC0000000617L250222","","126.5","","717088.32"
"2025-02-25","2025-02-22","SF FuneralFDC000000061B3250222","","126.5","","717214.82"
"2025-02-25","2025-02-22","SF FuneralFDC000000075SK250222","","126.5","","717341.32"
"2025-02-25","2025-02-22","SF FuneralFDC00000007LMX250222","","126.5","","717467.82"
"2025-02-25","2025-02-22","SF FuneralF816739       250222","","126.5","","717594.32"
"2025-02-25","2025-02-22","SF FuneralF823998       250222","","126.5","","717720.82"
"2025-02-25","2025-02-22","SF FuneralF840643       250222","","126.5","","717847.32"
"2025-02-25","2025-02-22","SF FuneralF1061970      250222","","126.5","","717973.82"
"2025-02-25","2025-02-22","SF FuneralFDC0000000L13V250222","","126.5","","718100.32"
"2025-02-25","2025-02-22","SF FuneralF1108269      250222","","126.5","","718226.82"
"2025-02-25","2025-02-22","SF FuneralF1108657      250222","","126.5","","718353.32"
"2025-02-25","2025-02-22","SF FuneralF1115875      250222","","126.5","","718479.82"
"2025-02-25","2025-02-22","SF FuneralFDC0000000Q7V2250222","","126.5","","718606.32"
"2025-02-25","2025-02-22","SF FuneralF1132352      250222","","126.5","","718732.82"
"2025-02-25","2025-02-24","SF FuneralFDC000000073MN250224","","126.5","","718859.32"
"2025-02-25","2025-02-24","SF FuneralFDC00000007FWQ250223","","220","","719079.32"
"2025-02-25","2025-02-24","SF FuneralF817507       250224","","126.5","","719205.82"
"2025-02-25","2025-02-24","SF FuneralF1066315      250224","","126.5","","719332.32"
"2025-02-25","2025-02-24","SF FuneralF1074692      250224","","126.5","","719458.82"
"2025-02-25","2025-02-25","SF FuneralFDC000000063BX250225","","126.5","","719585.32"
"2025-02-25","2025-02-25","SF FuneralFDC000000063C6250225","","126.5","","719711.82"
"2025-02-25","2025-02-25","SF FuneralF987557       250225","","126.5","","719838.32"
"2025-02-25","2025-02-25","SF FuneralF1128001      250225","","126.5","","719964.82"
"2025-02-25","2025-02-22","SF FuneralF1072684      250222","","31.63","","719996.45"
"2025-02-25","2025-02-25","SF FuneralF1072724      250225","","31.63","","720028.08"
"2025-02-25","2025-02-25","SF FuneralF1110634      250225","","31.63","","720059.71"
"2025-02-25","2025-02-22","SF FuneralF1125876      250222","","126.5","","720186.21"
"2025-02-25","2025-02-24","SF FuneralFDC00000006QVN250223","","126.5","","720312.71"
"2025-02-25","2025-02-25","SF FuneralF779331       250225","","220","","720532.71"
"2025-02-25","2025-02-25","SF FuneralF992301       250225","","126.5","","720659.21"
"2025-02-25","2025-02-25","SF FuneralF1111731      250225","","31.63","","720690.84"
"2025-02-25","2025-02-21","SF FuneralF988326       250222","","126.5","","720817.34"
"2025-02-25","2025-02-22","SF FuneralFDC00000005ZBD250222","","126.5","","720943.84"
"2025-02-25","2025-02-22","SF FuneralFDC00000007054250222","","126.5","","721070.34"
"2025-02-25","2025-02-22","SF FuneralFDC00000007N1B250222","","126.5","","721196.84"
"2025-02-25","2025-02-22","SF FuneralFDC000000087QS250222","","126.5","","721323.34"
"2025-02-25","2025-02-22","SF FuneralF801555       250222","","191.5","","721514.84"
"2025-02-25","2025-02-22","SF FuneralF815268       250222","","126.5","","721641.34"
"2025-02-25","2025-02-22","SF FuneralF1017064      250222","","126.5","","721767.84"
"2025-02-25","2025-02-22","SF FuneralF1083857      250222","","126.5","","721894.34"
"2025-02-25","2025-02-22","SF FuneralF1085291      250222","","126.5","","722020.84"
"2025-02-25","2025-02-22","SF FuneralFDC0000000N651250222","","126.5","","722147.34"
"2025-02-25","2025-02-22","SF FuneralFDC0000000Q22P250222","","126.5","","722273.84"
"2025-02-25","2025-02-22","SF FuneralF1130824      250222","","126.5","","722400.34"
"2025-02-25","2025-02-22","SF FuneralF1132500      250222","","126.5","","722526.84"
"2025-02-25","2025-02-25","SF FuneralFDC000000031BJ250225","","220","","722746.84"
"2025-02-25","2025-02-25","SF FuneralFDC00000005P7W250225","","126.5","","722873.34"
"2025-02-25","2025-02-25","SF FuneralFDC000000082V5250225","","126.5","","722999.84"
"2025-02-25","2025-02-25","SF FuneralF809493       250225","","126.5","","723126.34"
"2025-02-25","2025-02-25","SF FuneralF1050670      250225","","126.5","","723252.84"
"2025-02-25","2025-02-25","SF FuneralF1108340      250225","","126.5","","723379.34"
"2025-02-25","2025-02-25","SF FuneralF1112091      250225","","126.5","","723505.84"
"2025-02-25","2025-02-22","SF FuneralF1065688      250222","","126.5","","723632.34"
"2025-02-25","2025-02-22","SF FuneralF1127435      250222","","126.5","","723758.84"
"2025-02-25","2025-02-24","SF FuneralFDC00000008X7G250224","","126.5","","723885.34"
"2025-02-25","2025-02-25","SF FuneralFDC0000000HVZS250225","","126.5","","724011.84"
"2025-02-25","2025-02-25","SF FuneralFDC0000000K08S250225","","126.5","","724138.34"
"2025-02-25","2025-02-25","SF FuneralF1120350      250225","","126.5","","724264.84"
"2025-02-25","2025-02-17","SF FuneralF1124325      250217","","126.5","","724391.34"
"2025-02-25","2025-02-18","SF FuneralF992943       250218","","63.25","","724454.59"
"2025-02-25","2025-02-19","SF FuneralFDC00000003Q8Z250219","","220","","724674.59"
"2025-02-25","2025-02-20","SF FuneralF991044       250220","","126.5","","724801.09"
"2025-02-25","2025-02-20","SF FuneralF991582       250220","","126.5","","724927.59"
"2025-02-25","2025-02-21","SF FuneralF986775       250223","","126.5","","725054.09"
"2025-02-25","2025-02-21","SF FuneralF987876       250222","","126.5","","725180.59"
"2025-02-25","2025-02-21","SF FuneralF991099       250222","","126.5","","725307.09"
"2025-02-25","2025-02-22","SF FuneralFDC00000005LVF250222","","126.5","","725433.59"
"2025-02-25","2025-02-22","SF FuneralFDC00000006SQH250222","","126.5","","725560.09"
"2025-02-25","2025-02-22","SF FuneralFDC00000007BHX250222","","126.5","","725686.59"
"2025-02-25","2025-02-22","SF FuneralFDC00000007ZW7250222","","126.5","","725813.09"
"2025-02-25","2025-02-22","SF FuneralF801935       250222","","126.5","","725939.59"
"2025-02-25","2025-02-22","SF FuneralFDC000000098VG250222","","126.5","","726066.09"
"2025-02-25","2025-02-22","SF FuneralF812923       250222","","126.5","","726192.59"
"2025-02-25","2025-02-22","SF FuneralF831025       250222","","126.5","","726319.09"
"2025-02-25","2025-02-22","SF FuneralF1020887      250222","","126.5","","726445.59"
"2025-02-25","2025-02-22","SF FuneralFDC0000000KYQP250222","","126.5","","726572.09"
"2025-02-25","2025-02-22","SF FuneralF1074974      250222","","126.5","","726698.59"
"2025-02-25","2025-02-22","SF FuneralF1112160      250222","","126.5","","726825.09"
"2025-02-25","2025-02-22","SF FuneralF1121918      250222","","126.5","","726951.59"
"2025-02-25","2025-02-22","SF FuneralFDC0000000Q22L250222","","126.5","","727078.09"
"2025-02-25","2025-02-22","SF FuneralF1131971      250223","","126.5","","727204.59"
"2025-02-25","2025-02-24","SF FuneralFDC000000061CF250223","","126.5","","727331.09"
"2025-02-25","2025-02-25","SF FuneralF818917       250225","","126.5","","727457.59"
"2025-02-25","2025-02-25","SF FuneralF1132043      250225","","126.5","","727584.09"
"2025-02-25","2025-02-22","Rev SF FuneralFDC00000007HRH250222","","-126.5","","727457.59"
"2025-02-25","2025-02-12","Rev SF FuneralFDC0000000600K250212","","-126.5","","727331.09"
"2025-02-25","2025-02-20","SF FuneralF1124558      250220","","126.5","","727457.59"
"2025-02-25","2025-02-22","SF FuneralFDC00000005ZFW250222","","126.5","","727584.09"
"2025-02-25","2025-02-22","SF FuneralFDC00000006F54250222","","191.5","","727775.59"
"2025-02-25","2025-02-22","SF FuneralF819549       250222","","126.5","","727902.09"
"2025-02-25","2025-02-22","SF FuneralF823881       250222","","126.5","","728028.59"
"2025-02-25","2025-02-22","SF FuneralF1054511      250222","","126.5","","728155.09"
"2025-02-25","2025-02-22","SF FuneralF1124353      250222","","126.5","","728281.59"
"2025-02-25","2025-02-22","SF FuneralF1125063      250222","","126.5","","728408.09"
"2025-02-25","2025-02-25","SF FuneralFDC00000007LNP250225","","126.5","","728534.59"
"2025-02-25","2025-02-17","SF FuneralF810849       250217","","126.5","","728661.09"
"2025-02-25","2025-02-18","SF FuneralF1080328      250218","","63.25","","728724.34"
"2025-02-25","2025-02-21","SF FuneralFDC00000005ZW7250221","","126.5","","728850.84"
"2025-02-25","2025-02-22","SF FuneralFDC00000003HNP250222","","220","","729070.84"
"2025-02-25","2025-02-22","SF FuneralFDC00000006M2S250222","","126.5","","729197.34"
"2025-02-25","2025-02-22","SF FuneralF815368       250222","","126.5","","729323.84"
"2025-02-25","2025-02-22","SF FuneralF821578       250222","","126.5","","729450.34"
"2025-02-25","2025-02-22","SF FuneralF1055117      250222","","126.5","","729576.84"
"2025-02-25","2025-02-22","SF FuneralFDC0000000LB4G250222","","126.5","","729703.34"
"2025-02-25","2025-02-22","SF FuneralF1116898      250222","","126.5","","729829.84"
"2025-02-25","2025-02-22","SF FuneralF1124785      250222","","126.5","","729956.34"
"2025-02-25","2025-02-22","SF FuneralF1130311      250222","","126.5","","730082.84"
"2025-02-25","2025-02-24","SF FuneralFDC00000007Z7Y250223","","126.5","","730209.34"
"2025-02-25","2025-02-25","SF FuneralFDC00000006K2X250225","","126.5","","730335.84"
"2025-02-25","2025-02-22","SF FuneralFDC0000000941V250222","","126.5","","730462.34"
"2025-02-25","2025-02-22","SF FuneralF1112165      250222","","126.5","","730588.84"
"2025-02-25","2025-02-22","SF FuneralF1065807      250222","","126.5","","730715.34"
"2025-02-25","2025-02-22","SF FuneralF1121790      250222","","126.5","","730841.84"
"2025-02-25","2025-02-24","SF FuneralFDC000000070LP250223","","126.5","","730968.34"
"2025-02-25","2025-02-24","SF FuneralF900678       250224","","126.5","","731094.84"
"2025-02-25","2025-02-24","SF FuneralF1108611      250224","","126.5","","731221.34"
"2025-02-25","2025-02-25","Fee-Teller Transactions","","-15.82","","731205.52"
"2025-02-25","2025-02-25","Dep-Cash-SFTA20241102806","","253","15.82","731458.52"
"2025-02-25","2025-02-22","SF FuneralF809910       250222","","126.5","","731585.02"
"2025-02-25","2025-02-22","SF FuneralFDC0000000BB0P250222","","126.5","","731711.52"
"2025-02-25","2025-02-24","SF FuneralF804332       250224","","126.5","","731838.02"
"2025-02-25","2025-02-25","SF FuneralF797213       250225","","31.63","","731869.65"
"2025-02-25","2025-02-21","SF FuneralF810586       250221","","126.5","","731996.15"
"2025-02-25","2025-02-21","SF FuneralF988853       250222","","126.5","","732122.65"
"2025-02-25","2025-02-22","SF FuneralFDC0000000601K250222","","126.5","","732249.15"
"2025-02-25","2025-02-22","SF FuneralFDC000000063HJ250222","","126.5","","732375.65"
"2025-02-25","2025-02-22","SF FuneralFDC000000063L7250222","","126.5","","732502.15"
"2025-02-25","2025-02-22","SF FuneralFDC00000007LCV250222","","126.5","","732628.65"
"2025-02-25","2025-02-22","SF FuneralF793215       250222","","126.5","","732755.15"
"2025-02-25","2025-02-22","SF FuneralFDC0000000BHZJ250222","","126.5","","732881.65"
"2025-02-25","2025-02-22","SF FuneralF829613       250222","","126.5","","733008.15"
"2025-02-25","2025-02-22","SF FuneralF992546       250222","","126.5","","733134.65"
"2025-02-25","2025-02-22","SF FuneralF1058689      250222","","126.5","","733261.15"
"2025-02-25","2025-02-22","SF FuneralF1073403      250222","","126.5","","733387.65"
"2025-02-25","2025-02-22","SF FuneralF1075281      250222","","126.5","","733514.15"
"2025-02-25","2025-02-22","SF FuneralF1128955      250222","","126.5","","733640.65"
"2025-02-25","2025-02-22","SF FuneralF1130613      250222","","126.5","","733767.15"
"2025-02-25","2025-02-24","SF FuneralFDC00000006867250224","","126.5","","733893.65"
"2025-02-25","2025-02-24","SF FuneralF813394       250224","","126.5","","734020.15"
"2025-02-25","2025-02-24","SF FuneralF830211       250224","","126.5","","734146.65"
"2025-02-25","2025-02-24","SF FuneralF991850       250224","","126.5","","734273.15"
"2025-02-25","2025-02-24","SF FuneralFDC0000000JRDD250224","","126.5","","734399.65"
"2025-02-25","2025-02-24","SF FuneralF1020759      250224","","126.5","","734526.15"
"2025-02-25","2025-02-25","SF FuneralFDC00000007FSR250225","","126.5","","734652.65"
"2025-02-25","2025-02-25","SF FuneralFDC00000007PQS250225","","126.5","","734779.15"
"2025-02-25","2025-02-25","SF FuneralF1122978      250225","","126.5","","734905.65"
"2025-02-25","2025-02-25","SF FuneralFDC0000000Q3J1250225","","126.5","","735032.15"
"2025-02-25","2025-02-22","SF FuneralFDC0000000N2FJ250222","","126.5","","735158.65"
"2025-02-25","2025-02-24","SF FuneralF797798       250223","","126.5","","735285.15"
"2025-02-25","2025-02-24","SF FuneralF1052798      250224","","31.63","","735316.78"
"2025-02-25","2025-02-25","SF FuneralF819196       250225","","31.63","","735348.41"
"2025-02-25","2025-02-25","SF FuneralF1066366      250225","","126.5","","735474.91"
"2025-02-25","2025-02-25","SF FuneralFDC0000000LMWH250225","","126.5","","735601.41"
"2025-02-25","2025-02-22","SF FuneralF819522       250222","","126.5","","735727.91"
"2025-02-25","2025-02-22","SF FuneralF822855       250222","","126.5","","735854.41"
"2025-02-25","2025-02-22","SF FuneralFDC0000000C1H4250222","","126.5","","735980.91"
"2025-02-25","2025-02-22","SF FuneralF842227       250222","","126.5","","736107.41"
"2025-02-25","2025-02-22","SF FuneralF992247       250223","","126.5","","736233.91"
"2025-02-25","2025-02-22","SF FuneralF1054537      250222","","126.5","","736360.41"
"2025-02-25","2025-02-24","SF FuneralFDC00000009CQS250224","","126.5","","736486.91"
"2025-02-25","2025-02-24","SF FuneralF989157       250224","","126.5","","736613.41"
"2025-02-25","2025-02-24","SF FuneralF1128984      250224","","126.5","","736739.91"
"2025-02-25","2025-02-25","SF FuneralFDC000000064M8250225","","126.5","","736866.41"
"2025-02-25","2025-02-25","SF FuneralFDC0000000JNC2250225","","126.5","","736992.91"
"2025-02-25","2025-02-25","SF FuneralF1079094      250225","","126.5","","737119.41"
"2025-02-25","2025-02-25","SF FuneralFDC0000000PQ0R250225","","126.5","","737245.91"
"2025-02-25","2025-02-21","SF FuneralFDC00000006PGX250221","","126.5","","737372.41"
"2025-02-25","2025-02-22","SF FuneralFDC00000005Y6G250222","","126.5","","737498.91"
"2025-02-25","2025-02-22","SF FuneralFDC00000007LPJ250222","","126.5","","737625.41"
"2025-02-25","2025-02-22","SF FuneralFDC00000008VVR250222","","126.5","","737751.91"
"2025-02-25","2025-02-22","SF FuneralF1052457      250222","","126.5","","737878.41"
"2025-02-25","2025-02-22","SF FuneralF1108084      250222","","126.5","","738004.91"
"2025-02-25","2025-02-24","SF FuneralFDC00000005CYT250224","","126.5","","738131.41"
"2025-02-25","2025-02-24","SF FuneralFDC0000000GBJJ250222","","126.5","","738257.91"
"2025-02-25","2025-02-25","SF FuneralF843423       250225","","126.5","","738384.41"
"2025-02-25","2025-02-21","SF FuneralF989522       250222","","126.5","","738510.91"
"2025-02-25","2025-02-22","SF FuneralFDC00000007QR2250222","","126.5","","738637.41"
"2025-02-25","2025-02-22","SF FuneralF1115891      250222","","126.5","","738763.91"
"2025-02-25","2025-02-22","SF FuneralF786291       250222","","126.5","","738890.41"
"2025-02-25","2025-02-25","SF FuneralFDC00000006ZKG250225","","126.5","","739016.91"
"2025-02-25","2025-02-21","SF FuneralF843220       250221","","63.25","","739080.16"
"2025-02-25","2025-02-22","SF FuneralFDC000000062LN250222","","126.5","","739206.66"
"2025-02-25","2025-02-22","SF FuneralFDC00000006V0K250222","","126.5","","739333.16"
"2025-02-25","2025-02-22","SF FuneralFDC00000007JT0250222","","126.5","","739459.66"
"2025-02-25","2025-02-22","SF FuneralF833907       250222","","126.5","","739586.16"
"2025-02-25","2025-02-22","SF FuneralF1020989      250222","","126.5","","739712.66"
"2025-02-25","2025-02-22","SF FuneralF1108239      250222","","126.5","","739839.16"
"2025-02-25","2025-02-22","SF FuneralF1112389      250222","","126.5","","739965.66"
"2025-02-25","2025-02-24","SF FuneralFDC0000000PBGT250224","","126.5","","740092.16"
"2025-02-25","2025-02-24","SF FuneralF1128142      250224","","126.5","","740218.66"
"2025-02-25","2025-02-24","SF FuneralF1131865      250224","","126.5","","740345.16"
"2025-02-25","2025-02-25","SF FuneralF1131876      250225","","126.5","","740471.66"
"2025-02-25","2025-02-21","SF FuneralF1061777      250221","","126.5","","740598.16"
"2025-02-25","2025-02-22","SF FuneralFDC00000006TJ7250222","","126.5","","740724.66"
"2025-02-25","2025-02-22","SF FuneralFDC00000006ZQN250222","","126.5","","740851.16"
"2025-02-25","2025-02-22","SF FuneralFDC0000000757R250222","","126.5","","740977.66"
"2025-02-25","2025-02-22","SF FuneralFDC000000075TV250222","","126.5","","741104.16"
"2025-02-25","2025-02-22","SF FuneralFDC00000008337250222","","126.5","","741230.66"
"2025-02-25","2025-02-22","SF FuneralF805567       250222","","126.5","","741357.16"
"2025-02-25","2025-02-22","SF FuneralF805717       250222","","126.5","","741483.66"
"2025-02-25","2025-02-22","SF FuneralF812632       250222","","126.5","","741610.16"
"2025-02-25","2025-02-22","SF FuneralF821631       250222","","126.5","","741736.66"
"2025-02-25","2025-02-22","SF FuneralFDC0000000JNC1250222","","126.5","","741863.16"
"2025-02-25","2025-02-22","SF FuneralF1066408      250222","","126.5","","741989.66"
"2025-02-25","2025-02-22","SF FuneralF1073198      250222","","126.5","","742116.16"
"2025-02-25","2025-02-22","SF FuneralFDC0000000LB10250222","","126.5","","742242.66"
"2025-02-25","2025-02-22","SF FuneralF1085295      250222","","126.5","","742369.16"
"2025-02-25","2025-02-22","SF FuneralF1110380      250222","","126.5","","742495.66"
"2025-02-25","2025-02-22","SF FuneralFDC0000000MTMT250222","","126.5","","742622.16"
"2025-02-25","2025-02-22","SF FuneralF1116664      250222","","126.5","","742748.66"
"2025-02-25","2025-02-22","SF FuneralF1120200      250222","","126.5","","742875.16"
"2025-02-25","2025-02-22","SF FuneralFDC0000000NVX8250222","","126.5","","743001.66"
"2025-02-25","2025-02-22","SF FuneralF1124181      250222","","126.5","","743128.16"
"2025-02-25","2025-02-22","SF FuneralFDC0000000PR6H250222","","126.5","","743254.66"
"2025-02-25","2025-02-22","SF FuneralF1128377      250222","","126.5","","743381.16"
"2025-02-25","2025-02-22","SF FuneralF1128974      250222","","126.5","","743507.66"
"2025-02-25","2025-02-22","SF FuneralF1131773      250222","","126.5","","743634.16"
"2025-02-25","2025-02-24","SF FuneralFDC00000006XRW250223","","63.25","","743697.41"
"2025-02-25","2025-02-24","SF FuneralFDC0000000867B250224","","126.5","","743823.91"
"2025-02-25","2025-02-24","SF FuneralFDC0000000FBT9250222","","278.31","","744102.22"
"2025-02-25","2025-02-24","SF FuneralF1120811      250224","","126.5","","744228.72"
"2025-02-25","2025-02-24","SF FuneralFDC0000000P2T5250224","","126.5","","744355.22"
"2025-02-25","2025-02-24","SF FuneralF1127643      250224","","126.5","","744481.72"
"2025-02-25","2025-02-25","SF FuneralFDC00000006M59250225","","126.5","","744608.22"
"2025-02-25","2025-02-25","SF FuneralF900614       250225","","126.5","","744734.72"
"2025-02-25","2025-02-25","SF FuneralF1130506      250225","","126.5","","744861.22"
"2025-02-25","2025-02-17","SF FuneralFDC00000006FKQ250216","","126.5","","744987.72"
"2025-02-25","2025-02-20","SF FuneralF1130247      250220","","126.5","","745114.22"
"2025-02-25","2025-02-21","SF FuneralF987078       250222","","126.5","","745240.72"
"2025-02-25","2025-02-21","SF FuneralF989856       250222","","126.5","","745367.22"
"2025-02-25","2025-02-22","SF FuneralFDC00000006GW0250222","","126.5","","745493.72"
"2025-02-25","2025-02-22","SF FuneralFDC000000075TY250222","","126.5","","745620.22"
"2025-02-25","2025-02-22","SF FuneralFDC00000007M48250222","","126.5","","745746.72"
"2025-02-25","2025-02-22","SF FuneralFDC00000007TZN250222","","126.5","","745873.22"
"2025-02-25","2025-02-22","SF FuneralFDC00000007VVZ250222","","126.5","","745999.72"
"2025-02-25","2025-02-22","SF FuneralF804495       250222","","126.5","","746126.22"
"2025-02-25","2025-02-22","SF FuneralFDC00000009MWX250222","","63.25","","746189.47"
"2025-02-25","2025-02-22","SF FuneralF816132       250222","","126.5","","746315.97"
"2025-02-25","2025-02-22","SF FuneralF818332       250222","","126.5","","746442.47"
"2025-02-25","2025-02-22","SF FuneralFDC0000000BD9L250222","","126.5","","746568.97"
"2025-02-25","2025-02-22","SF FuneralF827616       250222","","126.5","","746695.47"
"2025-02-25","2025-02-22","SF FuneralF831048       250222","","126.5","","746821.97"
"2025-02-25","2025-02-22","SF FuneralF832509       250222","","126.5","","746948.47"
"2025-02-25","2025-02-22","SF FuneralFDC0000000DMGD250222","","516.5","","747464.97"
"2025-02-25","2025-02-22","SF FuneralFDC0000000DQHZ250222","","126.5","","747591.47"
"2025-02-25","2025-02-22","SF FuneralF993347       250222","","126.5","","747717.97"
"2025-02-25","2025-02-22","SF FuneralF1068048      250222","","126.5","","747844.47"
"2025-02-25","2025-02-22","SF FuneralF1074480      250222","","126.5","","747970.97"
"2025-02-25","2025-02-22","SF FuneralF1108388      250222","","126.5","","748097.47"
"2025-02-25","2025-02-22","SF FuneralF1108714      250222","","126.5","","748223.97"
"2025-02-25","2025-02-22","SF FuneralF1117284      250222","","126.5","","748350.47"
"2025-02-25","2025-02-22","SF FuneralF1123168      250222","","126.5","","748476.97"
"2025-02-25","2025-02-22","SF FuneralF1124356      250222","","126.5","","748603.47"
"2025-02-25","2025-02-22","SF FuneralF1129525      250222","","126.5","","748729.97"
"2025-02-25","2025-02-22","SF FuneralF1132310      250222","","126.5","","748856.47"
"2025-02-25","2025-02-24","SF FuneralFDC00000006JTQ250224","","126.5","","748982.97"
"2025-02-25","2025-02-24","SF FuneralF808514       250223","","126.5","","749109.47"
"2025-02-25","2025-02-24","SF FuneralF818423       250224","","126.5","","749235.97"
"2025-02-25","2025-02-24","SF FuneralF831674       250224","","126.5","","749362.47"
"2025-02-25","2025-02-24","SF FuneralF844670       250222","","126.5","","749488.97"
"2025-02-25","2025-02-24","SF FuneralF988694       250224","","126.5","","749615.47"
"2025-02-25","2025-02-24","SF FuneralFDC0000000PRG4250224","","126.5","","749741.97"
"2025-02-25","2025-02-24","SF FuneralFDC0000000PRG8250224","","126.5","","749868.47"
"2025-02-25","2025-02-25","SF FuneralFDC00000004J3N250225","","220","","750088.47"
"2025-02-25","2025-02-25","SF FuneralFDC00000007N0P250225","","126.5","","750214.97"
"2025-02-25","2025-02-25","SF FuneralF832942       250225","","126.5","","750341.47"
"2025-02-25","2025-02-22","SF FuneralF1123126      250222","","31.63","","750373.1"
"2025-02-25","2025-02-24","SF FuneralFDC00000006SV7250223","","31.63","","750404.73"
"2025-02-25","2025-02-25","SF FuneralFDC000000073QG250225","","31.63","","750436.36"
"2025-02-25","2025-02-25","SF FuneralF1131484      250225","","31.63","","750467.99"
"2025-02-25","2025-02-22","SF FuneralF1061785      250222","","126.5","","750594.49"
"2025-02-25","2025-02-22","SF FuneralF1127702      250222","","126.5","","750720.99"
"2025-02-25","2024-12-11","Rev SF FuneralF817334       241228","","-126.5","","750594.49"
"2025-02-25","2025-02-24","Rev SF FuneralFDC000000061CF250223","","-126.5","","750467.99"
"2025-02-25","2025-02-22","Rev SF FuneralFDC00000005Z3H250222","","-126.5","","750341.49"
"2025-02-25","2025-02-22","Rev SF FuneralFDC00000007TZN250222","","-126.5","","750214.99"
"2025-02-25","2025-02-22","Rev SF FuneralFDC0000000LB4G250222","","-126.5","","750088.49"
"2025-02-25","2025-02-22","Rev SF FuneralFDC00000007BHX250222","","-126.5","","749961.99"
"2025-02-25","2025-02-21","Rev SF FuneralFDC00000007TC1250221","","-31.63","","749930.36"
"2025-02-25","2025-02-19","Rev SF FuneralFDC00000007DMT250219","","-31.63","","749898.73"
"2025-02-25","2025-02-24","Rev SF FuneralFDC0000000JRDD250224","","-126.5","","749772.23"
"2025-02-25","2025-02-24","Rev SF FuneralFDC00000009CQS250224","","-126.5","","749645.73"
"2025-02-25","2025-02-24","Rev SF FuneralFDC00000005V61250223","","-126.5","","749519.23"
"2025-02-25","2025-02-22","Rev SF FuneralFDC0000000BHZJ250222","","-126.5","","749392.73"
"2025-02-25","2025-02-22","Rev SF FuneralFDC00000005SD7250222","","-126.5","","749266.23"
"2025-02-25","2025-02-25","Rev SF FuneralFDC00000005GLS250225","","-126.5","","749139.73"
"2025-02-25","2025-02-25","Rev SF FuneralFDC000000064M8250225","","-126.5","","749013.23"
"2025-02-25","2025-02-25","Rev SF FuneralFDC0000000LPJZ250225","","-191.5","","748821.73"
"2025-02-25","2025-02-22","Rev SF FuneralFDC000000039N2250222","","-220","","748601.73"
"2025-02-25","2025-02-22","Rev SF FuneralFDC00000003HNP250222","","-220","","748381.73"
"2025-02-25","2025-02-22","Rev SF FuneralFDC00000005GWY250222","","-126.5","","748255.23"
"2025-02-25","2025-02-25","Rev SF FuneralFDC00000005P7W250225","","-126.5","","748128.73"
"2025-02-25","2025-02-25","Rev SF FuneralFDC000000082V5250225","","-126.5","","748002.23"
"2025-02-25","2025-02-25","Rev SF FuneralFDC0000000800P250225","","-126.5","","747875.73"
"2025-02-25","2025-02-25","Rev SF FuneralFDC00000007PQS250225","","-126.5","","747749.23"
"2025-02-25","2025-02-25","Rev SF FuneralFDC0000000Q7SH250225","","-126.5","","747622.73"
"2025-02-25","2025-02-25","Rev SF FuneralFDC0000000800S250225","","-126.5","","747496.23"
"2025-02-25","2025-02-22","Rev SF FuneralFDC0000000N6H4250222","","-126.5","","747369.73"
"2025-02-25","2025-02-24","Rev SF FuneralFDC00000009PLP250223","","-191.5","","747178.23"
"2025-02-25","2025-02-24","Rev SF FuneralFDC0000000867B250224","","-126.5","","747051.73"
"2025-02-25","2025-02-20","Rev SF FuneralFDC0000000NFWS250220","","-126.5","","746925.23"
"2025-02-25","2025-02-22","Rev SF FuneralFDC00000006V60250222","","-126.5","","746798.73"
"2025-02-25","2025-02-22","Rev SF FuneralFDC00000006W6N250222","","-126.5","","746672.23"
"2025-02-25","2025-02-22","Rev SF FuneralFDC00000006W6P250222","","-126.5","","746545.73"
"2025-02-25","2025-02-22","Rev SF FuneralFDC0000000MS44250222","","-126.5","","746419.23"
"2025-02-25","2025-02-13","Rev SF FuneralFDC000000061C9250213","","-63.25","","746355.98"
"2025-02-25","2025-02-25","Rev SF FuneralFDC000000063BX250225","","-126.5","","746229.48"
"2025-02-25","2025-02-25","Rev SF FuneralFDC000000063C6250225","","-126.5","","746102.98"
"2025-02-25","2025-02-25","Rev SF FuneralFDC00000007MXH250225","","-126.5","","745976.48"
"2025-02-25","2025-02-22","Rev SF FuneralFDC00000006MQC250222","","-126.5","","745849.98"
"2025-02-25","2025-02-22","Rev SF FuneralFDC0000000711K250222","","-126.5","","745723.48"
"2025-02-25","2025-02-22","Rev SF FuneralFDC000000085TB250222","","-126.5","","745596.98"
"2025-02-25","2025-02-22","Rev SF FuneralFDC0000000NPH3250222","","-126.5","","745470.48"
"2025-02-25","2025-02-22","Rev SF FuneralFDC0000000NVX8250222","","-126.5","","745343.98"
"2025-02-25","2025-02-22","Rev SF FuneralFDC0000000757R250222","","-126.5","","745217.48"
"2025-02-25","2025-02-22","Rev SF FuneralFDC00000006M2S250222","","-126.5","","745090.98"
"2025-02-25","2025-02-22","Rev SF FuneralFDC0000000NFTV250222","","-126.5","","744964.48"
"2025-02-25","2025-02-22","Rev SF FuneralFDC0000000941V250222","","-126.5","","744837.98"
"2025-02-25","2025-02-22","Rev SF FuneralFDC00000008BSZ250222","","-126.5","","744711.48"
"2025-02-25","2025-01-24","Rev SF FuneralF817334       250128","","-126.5","","744584.98"
"2025-02-25","2025-02-22","Rev SF FuneralFDC00000006BQJ250222","","-126.5","","744458.48"
"2025-02-25","2025-02-11","Rev SF FuneralFDC00000009CP1250211","","-95.75","","744362.73"
"2025-02-25","2025-01-30","Rev SF FuneralFDC000000061C9250130","","-63.25","","744299.48"
"2025-02-25","2025-02-25","SF FuneralF806032       250225","","31.63","","744331.11"
"2025-02-25","2025-02-25","SF FuneralFDC00000009DYR250225","","126.5","","744457.61"
"2025-02-25","2025-02-25","SF FuneralF1080339      250225","","126.5","","744584.11"
"2025-02-25","2025-02-25","SF FuneralF1120757      250225","","126.5","","744710.61"
"2025-02-25","2025-02-17","SF FuneralFDC00000006P9Z250217","","63.25","","744773.86"
"2025-02-25","2025-02-22","SF FuneralFDC000000060T5250222","","126.5","","744900.36"
"2025-02-25","2025-02-22","SF FuneralFDC000000063G0250222","","126.5","","745026.86"
"2025-02-25","2025-02-22","SF FuneralF809089       250222","","126.5","","745153.36"
"2025-02-25","2025-02-22","SF FuneralF831265       250222","","126.5","","745279.86"
"2025-02-25","2025-02-22","SF FuneralF831295       250222","","126.5","","745406.36"
"2025-02-25","2025-02-22","SF FuneralF1120927      250222","","126.5","","745532.86"
"2025-02-25","2025-02-22","SF FuneralFDC000000064FZ250222","","126.5","","745659.36"
"2025-02-25","2025-02-22","SF FuneralFDC0000000676D250222","","126.5","","745785.86"
"2025-02-25","2025-02-22","SF FuneralFDC00000008W3W250222","","126.5","","745912.36"
"2025-02-25","2025-02-22","SF FuneralF796307       250222","","126.5","","746038.86"
"2025-02-25","2025-02-22","SF FuneralF780624       250222","","126.5","","746165.36"
"2025-02-25","2025-02-22","SF FuneralF812710       250222","","126.5","","746291.86"
"2025-02-25","2025-02-22","SF FuneralFDC00000009YXK250222","","126.5","","746418.36"
"2025-02-25","2025-02-22","SF FuneralF818771       250222","","126.5","","746544.86"
"2025-02-25","2025-02-22","SF FuneralF819093       250222","","126.5","","746671.36"
"2025-02-25","2025-02-22","SF FuneralF787442       250222","","126.5","","746797.86"
"2025-02-25","2025-02-22","SF FuneralFDC0000000BL93250222","","126.5","","746924.36"
"2025-02-25","2025-02-22","SF FuneralF832133       250222","","126.5","","747050.86"
"2025-02-25","2025-02-22","SF FuneralF838832       250222","","126.5","","747177.36"
"2025-02-25","2025-02-22","SF FuneralF841143       250222","","126.5","","747303.86"
"2025-02-25","2025-02-22","SF FuneralFDC0000000JH5D250222","","126.5","","747430.36"
"2025-02-25","2025-02-22","SF FuneralF1054693      250222","","126.5","","747556.86"
"2025-02-25","2025-02-22","SF FuneralF1054801      250222","","126.5","","747683.36"
"2025-02-25","2025-02-22","SF FuneralFDC0000000K5TZ250222","","126.5","","747809.86"
"2025-02-25","2025-02-22","SF FuneralF1059343      250222","","126.5","","747936.36"
"2025-02-25","2025-02-22","SF FuneralF1061780      250222","","126.5","","748062.86"
"2025-02-25","2025-02-22","SF FuneralF1074635      250222","","126.5","","748189.36"
"2025-02-25","2025-02-22","SF FuneralFDC0000000LCB2250222","","126.5","","748315.86"
"2025-02-25","2025-02-22","SF FuneralF1108294      250222","","126.5","","748442.36"
"2025-02-25","2025-02-22","SF FuneralF1108336      250222","","126.5","","748568.86"
"2025-02-25","2025-02-22","SF FuneralFDC0000000NF5T250222","","126.5","","748695.36"
"2025-02-25","2025-02-22","SF FuneralFDC0000000NF5W250222","","126.5","","748821.86"
"2025-02-25","2025-02-22","SF FuneralF1117872      250222","","126.5","","748948.36"
"2025-02-25","2025-02-22","SF FuneralF1122836      250222","","126.5","","749074.86"
"2025-02-25","2025-02-22","SF FuneralF1127782      250222","","126.5","","749201.36"
"2025-02-25","2025-02-22","SF FuneralF1131693      250222","","126.5","","749327.86"
"2025-02-25","2025-02-21","SF FuneralF989231       250222","","126.5","","749454.36"
"2025-02-25","2025-02-21","SF FuneralF980379       250221","","31.63","","749485.99"
"2025-02-25","2025-02-22","SF FuneralFDC000000061DK250222","","126.5","","749612.49"
"2025-02-25","2025-02-22","SF FuneralF811344       250222","","126.5","","749738.99"
"2025-02-25","2025-02-22","SF FuneralF813156       250222","","126.5","","749865.49"
"2025-02-25","2025-02-22","SF FuneralF798992       250222","","191.5","","750056.99"
"2025-02-25","2025-02-22","SF FuneralFDC0000000NNBV250222","","126.5","","750183.49"
"2025-02-25","2025-02-22","SF FuneralFDC0000000NNC1250222","","126.5","","750309.99"
"2025-02-25","2025-02-24","SF FuneralFDC00000006KTR250224","","126.5","","750436.49"
"2025-02-25","2025-02-25","SF FuneralFDC00000007FMQ250225","","213.31","","750649.8"
"2025-02-25","2025-02-25","SF FuneralFDC0000000Q5R3250225","","126.5","","750776.3"
"2025-02-25","2025-02-24","SF FuneralFDC000000061P1250223","","126.5","","750902.8"
"2025-02-25","2025-02-24","SF FuneralFDC00000008XSK250224","","126.5","","751029.3"
"2025-02-25","2025-02-24","SF FuneralF993435       250224","","126.5","","751155.8"
"2025-02-25","2025-02-24","SF FuneralF1100809      250224","","31.63","","751187.43"
"2025-02-26","2025-02-22","SF FuneralF1021306      250222","","126.5","","751313.93"
"2025-02-26","2025-02-24","SF FuneralFDC00000005PQQ250224","","126.5","","751440.43"
"2025-02-26","2025-02-24","SF FuneralFDC000000062BN250224","","126.5","","751566.93"
"2025-02-26","2025-02-21","SF FuneralFDC00000007L7K250221","","126.5","","751693.43"
"2025-02-26","2025-02-21","SF FuneralF987343       250222","","126.5","","751819.93"
"2025-02-26","2025-02-21","SF FuneralFDC0000000J3N8250222","","126.5","","751946.43"
"2025-02-26","2025-02-22","SF FuneralFDC000000063VN250222","","256.5","","752202.93"
"2025-02-26","2025-02-22","SF FuneralFDC00000006WYN250222","","126.5","","752329.43"
"2025-02-26","2025-02-22","SF FuneralFDC00000006X07250222","","126.5","","752455.93"
"2025-02-26","2025-02-22","SF FuneralFDC00000006ZY8250222","","126.5","","752582.43"
"2025-02-26","2025-02-22","SF FuneralFDC0000000700C250222","","126.5","","752708.93"
"2025-02-26","2025-02-22","SF FuneralFDC000000077TS250222","","126.5","","752835.43"
"2025-02-26","2025-02-22","SF FuneralF801859       250222","","126.5","","752961.93"
"2025-02-26","2025-02-22","SF FuneralF792189       250222","","126.5","","753088.43"
"2025-02-26","2025-02-22","SF FuneralFDC0000000DF1Q250222","","126.5","","753214.93"
"2025-02-26","2025-02-22","SF FuneralF1074689      250222","","126.5","","753341.43"
"2025-02-26","2025-02-22","SF FuneralF1112098      250222","","126.5","","753467.93"
"2025-02-26","2025-02-22","SF FuneralF1117884      250222","","126.5","","753594.43"
"2025-02-26","2025-02-22","SF FuneralF1122991      250222","","126.5","","753720.93"
"2025-02-26","2025-02-22","SF FuneralF1127872      250222","","126.5","","753847.43"
"2025-02-26","2025-02-24","SF FuneralFDC00000008208250223","","126.5","","753973.93"
"2025-02-26","2025-02-24","SF FuneralFDC0000000B48N250223","","126.5","","754100.43"
"2025-02-26","2025-02-24","SF FuneralF833331       250224","","126.5","","754226.93"
"2025-02-26","2025-02-25","SF FuneralFDC00000006WJ6250225","","126.5","","754353.43"
"2025-02-26","2025-02-25","SF FuneralF833978       250225","","126.5","","754479.93"
"2025-02-26","2025-02-25","SF FuneralF1067015      250225","","126.5","","754606.43"
"2025-02-26","2025-02-17","SF FuneralFDC00000007M2D250216","","63.25","","754669.68"
"2025-02-26","2025-02-20","SF FuneralFDC00000008M3G250220","","126.5","","754796.18"
"2025-02-26","2025-02-22","SF FuneralFDC00000006K4F250222","","126.5","","754922.68"
"2025-02-26","2025-02-22","SF FuneralFDC000000071M4250222","","126.5","","755049.18"
"2025-02-26","2025-02-22","SF FuneralFDC000000071MP250222","","126.5","","755175.68"
"2025-02-26","2025-02-22","SF FuneralFDC00000007TZQ250222","","126.5","","755302.18"
"2025-02-26","2025-02-22","SF FuneralFDC000000081FM250222","","126.5","","755428.68"
"2025-02-26","2025-02-22","SF FuneralF798432       250222","","126.5","","755555.18"
"2025-02-26","2025-02-22","SF FuneralFDC000000087KD250222","","126.5","","755681.68"
"2025-02-26","2025-02-22","SF FuneralF783581       250222","","126.5","","755808.18"
"2025-02-26","2025-02-22","SF FuneralF823752       250222","","126.5","","755934.68"
"2025-02-26","2025-02-22","SF FuneralF828391       250222","","126.5","","756061.18"
"2025-02-26","2025-02-22","SF FuneralF1054919      250222","","126.5","","756187.68"
"2025-02-26","2025-02-22","SF FuneralFDC0000000KWVL250222","","126.5","","756314.18"
"2025-02-26","2025-02-22","SF FuneralF1074667      250222","","126.5","","756440.68"
"2025-02-26","2025-02-22","SF FuneralF1084930      250222","","126.5","","756567.18"
"2025-02-26","2025-02-22","SF FuneralF1095225      250223","","126.5","","756693.68"
"2025-02-26","2025-02-22","SF FuneralF1112092      250222","","126.5","","756820.18"
"2025-02-26","2025-02-22","SF FuneralFDC0000000NCC5250222","","126.5","","756946.68"
"2025-02-26","2025-02-22","SF FuneralF1120824      250222","","126.5","","757073.18"
"2025-02-26","2025-02-22","SF FuneralF1123564      250222","","126.5","","757199.68"
"2025-02-26","2025-02-22","SF FuneralF1131002      250222","","126.5","","757326.18"
"2025-02-26","2025-02-24","SF FuneralFDC00000005W9P250223","","126.5","","757452.68"
"2025-02-26","2025-02-24","SF FuneralFDC000000078PD250224","","126.5","","757579.18"
"2025-02-26","2025-02-24","SF FuneralFDC00000007R58250224","","126.5","","757705.68"
"2025-02-26","2025-02-24","SF FuneralFDC0000000B1BT250223","","126.5","","757832.18"
"2025-02-26","2025-02-24","SF FuneralF818445       250223","","126.5","","757958.68"
"2025-02-26","2025-02-24","SF FuneralFDC0000000GYS5250222","","126.5","","758085.18"
"2025-02-26","2025-02-24","SF FuneralF1065665      250224","","126.5","","758211.68"
"2025-02-26","2025-02-24","SF FuneralFDC0000000P891250224","","126.5","","758338.18"
"2025-02-26","2025-02-25","SF FuneralFDC000000062VW250225","","126.5","","758464.68"
"2025-02-26","2025-02-25","SF FuneralFDC00000006FBZ250225","","126.5","","758591.18"
"2025-02-26","2025-02-25","SF FuneralFDC00000006WKT250225","","126.5","","758717.68"
"2025-02-26","2025-02-25","SF FuneralF830020       250225","","126.5","","758844.18"
"2025-02-26","2025-02-25","SF FuneralF987635       250225","","126.5","","758970.68"
"2025-02-26","2025-02-25","SF FuneralF1020554      250225","","126.5","","759097.18"
"2025-02-26","2025-02-25","SF FuneralF1059436      250225","","126.5","","759223.68"
"2025-02-26","2025-02-25","SF FuneralF1113595      250225","","126.5","","759350.18"
"2025-02-26","2025-02-25","SF FuneralF1130977      250225","","126.5","","759476.68"
"2025-02-26","2025-02-25","SF FuneralF1131152      250225","","126.5","","759603.18"
"2025-02-26","2025-02-25","SF FuneralF1131174      250225","","126.5","","759729.68"
"2025-02-26","2025-02-25","SF FuneralF1131177      250225","","126.5","","759856.18"
"2025-02-26","2025-02-21","SF FuneralF987627       250222","","126.5","","759982.68"
"2025-02-26","2025-02-21","SF FuneralF991409       250221","","126.5","","760109.18"
"2025-02-26","2025-02-21","SF FuneralFDC0000000JY3G250221","","126.5","","760235.68"
"2025-02-26","2025-02-22","SF FuneralFDC000000030NZ250222","","220","","760455.68"
"2025-02-26","2025-02-22","SF FuneralFDC000000032Y3250222","","220","","760675.68"
"2025-02-26","2025-02-22","SF FuneralFDC00000005S20250222","","126.5","","760802.18"
"2025-02-26","2025-02-22","SF FuneralFDC000000061VY250222","","126.5","","760928.68"
"2025-02-26","2025-02-22","SF FuneralFDC000000062BW250222","","126.5","","761055.18"
"2025-02-26","2025-02-22","SF FuneralFDC00000006DJV250222","","126.5","","761181.68"
"2025-02-26","2025-02-22","SF FuneralFDC000000073M8250222","","126.5","","761308.18"
"2025-02-26","2025-02-22","SF FuneralFDC00000007BW6250222","","126.5","","761434.68"
"2025-02-26","2025-02-22","SF FuneralF801292       250222","","126.5","","761561.18"
"2025-02-26","2025-02-22","SF FuneralFDC0000000B0Z9250222","","126.5","","761687.68"
"2025-02-26","2025-02-22","SF FuneralF819266       250222","","126.5","","761814.18"
"2025-02-26","2025-02-22","SF FuneralF819677       250222","","126.5","","761940.68"
"2025-02-26","2025-02-22","SF FuneralFDC0000000BJ5F250222","","126.5","","762067.18"
"2025-02-26","2025-02-22","SF FuneralF829911       250222","","126.5","","762193.68"
"2025-02-26","2025-02-22","SF FuneralF842128       250222","","126.5","","762320.18"
"2025-02-26","2025-02-22","SF FuneralF1016962      250222","","126.5","","762446.68"
"2025-02-26","2025-02-22","SF FuneralF1022113      250222","","126.5","","762573.18"
"2025-02-26","2025-02-22","SF FuneralF1052784      250222","","126.5","","762699.68"
"2025-02-26","2025-02-22","SF FuneralF1054532      250222","","126.5","","762826.18"
"2025-02-26","2025-02-22","SF FuneralF1054538      250222","","126.5","","762952.68"
"2025-02-26","2025-02-22","SF FuneralF1060639      250222","","126.5","","763079.18"
"2025-02-26","2025-02-22","SF FuneralF815536       250222","","321.5","","763400.68"
"2025-02-26","2025-02-22","SF FuneralF1073142      250222","","126.5","","763527.18"
"2025-02-26","2025-02-22","SF FuneralF1073749      250222","","126.5","","763653.68"
"2025-02-26","2025-02-22","SF FuneralF1083632      250222","","126.5","","763780.18"
"2025-02-26","2025-02-22","SF FuneralF1084304      250222","","126.5","","763906.68"
"2025-02-26","2025-02-22","SF FuneralF1109347      250222","","126.5","","764033.18"
"2025-02-26","2025-02-22","SF FuneralF1110479      250222","","126.5","","764159.68"
"2025-02-26","2025-02-22","SF FuneralF1115854      250222","","126.5","","764286.18"
"2025-02-26","2025-02-22","SF FuneralF1116092      250222","","126.5","","764412.68"
"2025-02-26","2025-02-22","SF FuneralF1117021      250222","","126.5","","764539.18"
"2025-02-26","2025-02-22","SF FuneralF1125426      250222","","126.5","","764665.68"
"2025-02-26","2025-02-22","SF FuneralF1127369      250222","","126.5","","764792.18"
"2025-02-26","2025-02-22","SF FuneralF1130673      250222","","126.5","","764918.68"
"2025-02-26","2025-02-24","SF FuneralFDC00000005TTG250223","","191.5","","765110.18"
"2025-02-26","2025-02-24","SF FuneralFDC00000006MRT250224","","126.5","","765236.68"
"2025-02-26","2025-02-24","SF FuneralFDC00000007N34250224","","126.5","","765363.18"
"2025-02-26","2025-02-24","SF FuneralFDC000000084T2250223","","126.5","","765489.68"
"2025-02-26","2025-02-24","SF FuneralF818631       250224","","126.5","","765616.18"
"2025-02-26","2025-02-24","SF FuneralF831662       250223","","126.5","","765742.68"
"2025-02-26","2025-02-24","SF FuneralF841696       250223","","126.5","","765869.18"
"2025-02-26","2025-02-24","SF FuneralF842646       250223","","126.5","","765995.68"
"2025-02-26","2025-02-24","SF FuneralF847273       250222","","126.5","","766122.18"
"2025-02-26","2025-02-25","SF FuneralF834312       250225","","126.5","","766248.68"
"2025-02-26","2025-02-25","SF FuneralF792924       250225","","126.5","","766375.18"
"2025-02-26","2025-02-22","SF FuneralFDC00000006SS8250222","","126.5","","766501.68"
"2025-02-26","2025-02-22","SF FuneralF841747       250222","","126.5","","766628.18"
"2025-02-26","2025-02-22","SF FuneralF1074771      250222","","126.5","","766754.68"
"2025-02-26","2025-02-22","SF FuneralF1126282      250222","","126.5","","766881.18"
"2025-02-26","2025-02-24","SF FuneralF811738       250224","","126.5","","767007.68"
"2025-02-26","2025-02-24","SF FuneralF1114627      250224","","63.25","","767070.93"
"2025-02-26","2025-02-25","SF FuneralF991573       250225","","126.5","","767197.43"
"2025-02-26","2025-02-25","SF FuneralF1131443      250225","","126.5","","767323.93"
"2025-02-26","2025-02-25","SF FuneralFDC000000057TZ250225","","126.5","","767450.43"
"2025-02-26","2025-02-25","SF FuneralFDC00000006B1X250225","","126.5","","767576.93"
"2025-02-26","2025-02-25","SF FuneralFDC00000007NWY250225","","126.5","","767703.43"
"2025-02-26","2025-02-25","SF FuneralFDC0000000807H250225","","126.5","","767829.93"
"2025-02-26","2025-02-25","SF FuneralF802406       250225","","126.5","","767956.43"
"2025-02-26","2025-02-25","SF FuneralF808541       250225","","191.5","","768147.93"
"2025-02-26","2025-02-25","SF FuneralF814927       250225","","126.5","","768274.43"
"2025-02-26","2025-02-25","SF FuneralF829674       250225","","126.5","","768400.93"
"2025-02-26","2025-02-25","SF FuneralF987238       250225","","126.5","","768527.43"
"2025-02-26","2025-02-25","SF FuneralFDC0000000HZS6250225","","63.25","","768590.68"
"2025-02-26","2025-02-25","SF FuneralF991439       250225","","126.5","","768717.18"
"2025-02-26","2025-02-25","SF FuneralFDC0000000JYCT250225","","126.5","","768843.68"
"2025-02-26","2025-02-25","SF FuneralF1055105      250225","","126.5","","768970.18"
"2025-02-26","2025-02-25","SF FuneralF1058661      250225","","126.5","","769096.68"
"2025-02-26","2025-02-25","SF FuneralF1066019      250225","","126.5","","769223.18"
"2025-02-26","2025-02-25","SF FuneralF1104010      250225","","126.5","","769349.68"
"2025-02-26","2025-02-25","SF FuneralF1112446      250225","","126.5","","769476.18"
"2025-02-26","2025-02-25","SF FuneralF1120419      250225","","126.5","","769602.68"
"2025-02-26","2025-02-25","SF FuneralF1120526      250225","","126.5","","769729.18"
"2025-02-26","2025-02-25","SF FuneralF1120657      250225","","126.5","","769855.68"
"2025-02-26","2025-02-25","SF FuneralF1120678      250225","","126.5","","769982.18"
"2025-02-26","2025-02-25","SF FuneralF1120784      250225","","126.5","","770108.68"
"2025-02-26","2025-02-25","SF FuneralF1120840      250225","","126.5","","770235.18"
"2025-02-26","2025-02-25","SF FuneralF1129223      250225","","126.5","","770361.68"
"2025-02-26","2025-02-21","SF FuneralF1108577      250221","","126.5","","770488.18"
"2025-02-26","2025-02-21","SF FuneralF1110423      250221","","126.5","","770614.68"
"2025-02-26","2025-02-21","SF FuneralF1117916      250221","","126.5","","770741.18"
"2025-02-26","2025-02-21","SF FuneralF1126961      250221","","63.25","","770804.43"
"2025-02-26","2025-02-22","SF FuneralFDC00000005X4T250222","","126.5","","770930.93"
"2025-02-26","2025-02-22","SF FuneralFDC000000060BB250222","","126.5","","771057.43"
"2025-02-26","2025-02-22","SF FuneralFDC0000000630S250222","","126.5","","771183.93"
"2025-02-26","2025-02-22","SF FuneralFDC000000065HK250222","","126.5","","771310.43"
"2025-02-26","2025-02-22","SF FuneralFDC00000006TS2250222","","126.5","","771436.93"
"2025-02-26","2025-02-22","SF FuneralFDC00000006WL5250222","","126.5","","771563.43"
"2025-02-26","2025-02-22","SF FuneralFDC000000077SJ250222","","126.5","","771689.93"
"2025-02-26","2025-02-22","SF FuneralFDC00000007M00250222","","126.5","","771816.43"
"2025-02-26","2025-02-22","SF FuneralFDC00000007NPV250222","","126.5","","771942.93"
"2025-02-26","2025-02-22","SF FuneralFDC00000007ZRM250222","","126.5","","772069.43"
"2025-02-26","2025-02-22","SF FuneralFDC000000081SC250222","","126.5","","772195.93"
"2025-02-26","2025-02-22","SF FuneralFDC0000000837Q250222","","126.5","","772322.43"
"2025-02-26","2025-02-22","SF FuneralFDC0000000837V250222","","126.5","","772448.93"
"2025-02-26","2025-02-22","SF FuneralF802158       250222","","126.5","","772575.43"
"2025-02-26","2025-02-22","SF FuneralF793001       250222","","126.5","","772701.93"
"2025-02-26","2025-02-22","SF FuneralF816113       250222","","126.5","","772828.43"
"2025-02-26","2025-02-22","SF FuneralF817547       250222","","126.5","","772954.93"
"2025-02-26","2025-02-22","SF FuneralFDC0000000B439250222","","126.5","","773081.43"
"2025-02-26","2025-02-22","SF FuneralF819782       250222","","126.5","","773207.93"
"2025-02-26","2025-02-22","SF FuneralFDC0000000BRLV250222","","126.5","","773334.43"
"2025-02-26","2025-02-22","SF FuneralFDC0000000BYP5250222","","126.5","","773460.93"
"2025-02-26","2025-02-22","SF FuneralF831879       250222","","126.5","","773587.43"
"2025-02-26","2025-02-22","SF FuneralF833615       250222","","126.5","","773713.93"
"2025-02-26","2025-02-22","SF FuneralF786759       250222","","126.5","","773840.43"
"2025-02-26","2025-02-22","SF FuneralFDC0000000D7JN250222","","126.5","","773966.93"
"2025-02-26","2025-02-22","SF FuneralFDC0000000DFMZ250222","","126.5","","774093.43"
"2025-02-26","2025-02-22","SF FuneralF841152       250222","","126.5","","774219.93"
"2025-02-26","2025-02-22","SF FuneralF991823       250222","","126.5","","774346.43"
"2025-02-26","2025-02-22","SF FuneralF992099       250222","","126.5","","774472.93"
"2025-02-26","2025-02-22","SF FuneralF1020638      250222","","126.5","","774599.43"
"2025-02-26","2025-02-22","SF FuneralF1033699      250222","","126.5","","774725.93"
"2025-02-26","2025-02-22","SF FuneralF1052576      250222","","126.5","","774852.43"
"2025-02-26","2025-02-22","SF FuneralF1054624      250222","","126.5","","774978.93"
"2025-02-26","2025-02-22","SF FuneralFDC0000000K6R0250222","","126.5","","775105.43"
"2025-02-26","2025-02-22","SF FuneralF1055080      250222","","126.5","","775231.93"
"2025-02-26","2025-02-22","SF FuneralF1055125      250222","","126.5","","775358.43"
"2025-02-26","2025-02-22","SF FuneralF1058715      250222","","126.5","","775484.93"
"2025-02-26","2025-02-22","SF FuneralFDC0000000KDK3250222","","126.5","","775611.43"
"2025-02-26","2025-02-22","SF FuneralF1068286      250223","","126.5","","775737.93"
"2025-02-26","2025-02-22","SF FuneralF1068345      250223","","126.5","","775864.43"
"2025-02-26","2025-02-22","SF FuneralF1073861      250222","","126.5","","775990.93"
"2025-02-26","2025-02-22","SF FuneralF1074524      250222","","126.5","","776117.43"
"2025-02-26","2025-02-22","SF FuneralF1074594      250222","","126.5","","776243.93"
"2025-02-26","2025-02-22","SF FuneralF1078263      250222","","126.5","","776370.43"
"2025-02-26","2025-02-22","SF FuneralF1080439      250222","","126.5","","776496.93"
"2025-02-26","2025-02-22","SF FuneralF1108258      250222","","126.5","","776623.43"
"2025-02-26","2025-02-22","SF FuneralF1108583      250222","","126.5","","776749.93"
"2025-02-26","2025-02-22","SF FuneralFDC0000000MQ4Q250222","","126.5","","776876.43"
"2025-02-26","2025-02-22","SF FuneralF1112113      250222","","126.5","","777002.93"
"2025-02-26","2025-02-22","SF FuneralFDC0000000N7HW250222","","126.5","","777129.43"
"2025-02-26","2025-02-22","SF FuneralF1115768      250222","","126.5","","777255.93"
"2025-02-26","2025-02-22","SF FuneralF1116809      250223","","126.5","","777382.43"
"2025-02-26","2025-02-22","SF FuneralFDC0000000NKBT250222","","126.5","","777508.93"
"2025-02-26","2025-02-22","SF FuneralFDC0000000NMS5250222","","126.5","","777635.43"
"2025-02-26","2025-02-22","SF FuneralF1120139      250222","","126.5","","777761.93"
"2025-02-26","2025-02-22","SF FuneralF1120171      250222","","126.5","","777888.43"
"2025-02-26","2025-02-22","SF FuneralF1120700      250222","","126.5","","778014.93"
"2025-02-26","2025-02-22","SF FuneralFDC0000000P42Z250222","","126.5","","778141.43"
"2025-02-26","2025-02-22","SF FuneralF1123410      250222","","126.5","","778267.93"
"2025-02-26","2025-02-22","SF FuneralF1124421      250222","","126.5","","778394.43"
"2025-02-26","2025-02-22","SF FuneralF1124430      250222","","126.5","","778520.93"
"2025-02-26","2025-02-22","SF FuneralF1124560      250222","","126.5","","778647.43"
"2025-02-26","2025-02-22","SF FuneralFDC0000000PDRC250222","","126.5","","778773.93"
"2025-02-26","2025-02-22","SF FuneralFDC0000000PS98250222","","126.5","","778900.43"
"2025-02-26","2025-02-22","SF FuneralF1127807      250222","","126.5","","779026.93"
"2025-02-26","2025-02-22","SF FuneralFDC0000000PVL2250222","","126.5","","779153.43"
"2025-02-26","2025-02-22","SF FuneralFDC0000000PVL3250222","","126.5","","779279.93"
"2025-02-26","2025-02-22","SF FuneralF1130341      250222","","126.5","","779406.43"
"2025-02-26","2025-02-22","SF FuneralF1132520      250222","","126.5","","779532.93"
"2025-02-26","2025-02-24","SF FuneralFDC000000042QS250224","","220","","779752.93"
"2025-02-26","2025-02-24","SF FuneralFDC000000060CD250224","","126.5","","779879.43"
"2025-02-26","2025-02-24","SF FuneralFDC00000006M73250224","","126.5","","780005.93"
"2025-02-26","2025-02-24","SF FuneralFDC00000007KRD250223","","191.5","","780197.43"
"2025-02-26","2025-02-24","SF FuneralF808031       250224","","126.5","","780323.93"
"2025-02-26","2025-02-24","SF FuneralF823527       250223","","126.5","","780450.43"
"2025-02-26","2025-02-24","SF FuneralF831232       250224","","126.5","","780576.93"
"2025-02-26","2025-02-24","SF FuneralF844543       250222","","126.5","","780703.43"
"2025-02-26","2025-02-24","SF FuneralF900788       250222","","126.5","","780829.93"
"2025-02-26","2025-02-24","SF FuneralF1120632      250224","","126.5","","780956.43"
"2025-02-26","2025-02-24","SF FuneralF1130878      250224","","126.5","","781082.93"
"2025-02-26","2025-02-17","SF FuneralF793327       250216","","63.25","","781146.18"
"2025-02-26","2025-02-17","SF FuneralF1079118      250217","","63.25","","781209.43"
"2025-02-26","2025-02-19","SF FuneralFDC0000000N9F0250219","","126.5","","781335.93"
"2025-02-26","2025-02-21","SF FuneralFDC00000003HVM250221","","220","","781555.93"
"2025-02-26","2025-02-21","SF FuneralFDC0000000HP20250222","","126.5","","781682.43"
"2025-02-26","2025-02-21","SF FuneralF991207       250222","","126.5","","781808.93"
"2025-02-26","2025-02-21","SF FuneralFDC00000005HJM250221","","31.63","","781840.56"
"2025-02-26","2025-02-22","SF FuneralFDC00000005MWG250222","","31.63","","781872.19"
"2025-02-26","2025-02-25","SF FuneralF798485       250225","","31.63","","781903.82"
"2025-02-26","2025-02-26","SF FuneralF1108332      250226","","126.5","","782030.32"
"2025-02-26","2025-02-26","SF FuneralF794083       250226","","126.5","","782156.82"
"2025-02-26","2025-02-25","SF FuneralF803520       250225","","31.63","","782188.45"
"2025-02-26","2025-02-25","SF FuneralF811655       250225","","31.63","","782220.08"
"2025-02-26","2025-02-25","SF FuneralFDC00000009H46250225","","31.63","","782251.71"
"2025-02-26","2025-02-25","SF FuneralFDC00000009WP2250225","","126.5","","782378.21"
"2025-02-26","2025-02-22","SF FuneralFDC00000002VNJ250222","","220","","782598.21"
"2025-02-26","2025-02-22","SF FuneralFDC00000002XNK250222","","220","","782818.21"
"2025-02-26","2025-02-22","SF FuneralFDC000000071Y8250222","","126.5","","782944.71"
"2025-02-26","2025-02-22","SF FuneralFDC00000007TKX250222","","126.5","","783071.21"
"2025-02-26","2025-02-22","SF FuneralFDC00000007Y9T250222","","126.5","","783197.71"
"2025-02-26","2025-02-22","SF FuneralFDC000000081XL250222","","126.5","","783324.21"
"2025-02-26","2025-02-22","SF FuneralFDC0000000835F250222","","126.5","","783450.71"
"2025-02-26","2025-02-22","SF FuneralF805642       250222","","126.5","","783577.21"
"2025-02-26","2025-02-22","SF FuneralF809178       250222","","126.5","","783703.71"
"2025-02-26","2025-02-22","SF FuneralF816954       250222","","126.5","","783830.21"
"2025-02-26","2025-02-22","SF FuneralF820362       250222","","126.5","","783956.71"
"2025-02-26","2025-02-22","SF FuneralF823322       250222","","126.5","","784083.21"
"2025-02-26","2025-02-22","SF FuneralF841605       250222","","126.5","","784209.71"
"2025-02-26","2025-02-22","SF FuneralFDC0000000K3ZY250222","","126.5","","784336.21"
"2025-02-26","2025-02-22","SF FuneralF1054791      250222","","126.5","","784462.71"
"2025-02-26","2025-02-22","SF FuneralF1065706      250222","","126.5","","784589.21"
"2025-02-26","2025-02-22","SF FuneralF1072959      250222","","126.5","","784715.71"
"2025-02-26","2025-02-22","SF FuneralF1074785      250222","","31.63","","784747.34"
"2025-02-26","2025-02-22","SF FuneralF1079123      250222","","126.5","","784873.84"
"2025-02-26","2025-02-22","SF FuneralFDC0000000LXQZ250222","","126.5","","785000.34"
"2025-02-26","2025-02-22","SF FuneralF1108649      250222","","126.5","","785126.84"
"2025-02-26","2025-02-22","SF FuneralFDC0000000P3XQ250222","","126.5","","785253.34"
"2025-02-26","2025-02-22","SF FuneralF1123448      250222","","126.5","","785379.84"
"2025-02-26","2025-02-22","SF FuneralF1123623      250222","","126.5","","785506.34"
"2025-02-26","2025-02-22","SF FuneralF1128129      250222","","126.5","","785632.84"
"2025-02-26","2025-02-22","SF FuneralF1131024      250222","","126.5","","785759.34"
"2025-02-26","2025-02-22","SF FuneralF1131224      250222","","126.5","","785885.84"
"2025-02-26","2025-02-21","SF FuneralF988461       250222","","126.5","","786012.34"
"2025-02-26","2025-02-24","SF FuneralFDC00000008CZQ250223","","126.5","","786138.84"
"2025-02-26","2025-02-24","SF FuneralF844752       250222","","126.5","","786265.34"
"2025-02-26","2025-02-24","SF FuneralF847307       250222","","126.5","","786391.84"
"2025-02-26","2025-02-24","SF FuneralF900810       250222","","126.5","","786518.34"
"2025-02-26","2025-02-24","SF FuneralF1103842      250224","","126.5","","786644.84"
"2025-02-26","2025-02-26","SF FuneralF823667       250226","","126.5","","786771.34"
"2025-02-26","2025-02-26","SF FuneralF1060609      250226","","126.5","","786897.84"
"2025-02-26","2025-02-21","SF FuneralF987397       250222","","126.5","","787024.34"
"2025-02-26","2025-02-22","SF FuneralFDC00000005X27250222","","126.5","","787150.84"
"2025-02-26","2025-02-22","SF FuneralFDC00000008HX7250222","","126.5","","787277.34"
"2025-02-26","2025-02-22","SF FuneralF805637       250222","","126.5","","787403.84"
"2025-02-26","2025-02-22","SF FuneralF828782       250222","","126.5","","787530.34"
"2025-02-26","2025-02-22","SF FuneralF992584       250222","","126.5","","787656.84"
"2025-02-26","2025-02-22","SF FuneralF1033981      250222","","126.5","","787783.34"
"2025-02-26","2025-02-22","SF FuneralF1061756      250222","","126.5","","787909.84"
"2025-02-26","2025-02-22","SF FuneralF1083610      250222","","126.5","","788036.34"
"2025-02-26","2025-02-22","SF FuneralF1110120      250222","","126.5","","788162.84"
"2025-02-26","2025-02-22","SF FuneralF1111984      250223","","126.5","","788289.34"
"2025-02-26","2025-02-22","SF FuneralF1125491      250222","","126.5","","788415.84"
"2025-02-26","2025-02-22","SF FuneralF1129246      250222","","126.5","","788542.34"
"2025-02-26","2025-02-24","SF FuneralFDC00000003Z7R250224","","220","","788762.34"
"2025-02-26","2025-02-25","SF FuneralFDC00000007L59250225","","126.5","","788888.84"
"2025-02-26","2025-02-25","SF FuneralF812990       250225","","126.5","","789015.34"
"2025-02-26","2025-02-25","SF FuneralF827961       250225","","126.5","","789141.84"
"2025-02-26","2025-02-25","SF FuneralF843086       250225","","126.5","","789268.34"
"2025-02-26","2025-02-25","SF FuneralF1129906      250225","","126.5","","789394.84"
"2025-02-26","2025-02-21","SF FuneralF812779       250221","","31.63","","789426.47"
"2025-02-26","2025-02-22","SF FuneralFDC00000005XNC250222","","31.63","","789458.1"
"2025-02-26","2025-02-22","SF FuneralF814211       250222","","31.63","","789489.73"
"2025-02-26","2025-02-22","SF FuneralF1127843      250222","","31.63","","789521.36"
"2025-02-26","2025-02-22","SF FuneralF1130776      250222","","31.63","","789552.99"
"2025-02-26","2025-02-24","SF FuneralFDC0000000502G250224","","31.63","","789584.62"
"2025-02-26","2025-02-24","SF FuneralF832096       250223","","31.63","","789616.25"
"2025-02-26","2025-02-24","SF FuneralF1073147      250224","","31.63","","789647.88"
"2025-02-26","2025-02-24","SF FuneralF1123098      250224","","31.63","","789679.51"
"2025-02-26","2025-02-25","SF FuneralFDC00000007YZB250225","","31.63","","789711.14"
"2025-02-26","2025-02-25","SF FuneralF817682       250225","","31.63","","789742.77"
"2025-02-26","2025-02-25","SF FuneralFDC0000000HN9N250225","","31.63","","789774.4"
"2025-02-26","2025-02-25","SF FuneralF1131861      250225","","31.63","","789806.03"
"2025-02-26","2025-02-23","SF FuneralF809947       250223","","126.5","","789932.53"
"2025-02-26","2025-02-23","SF FuneralF812335       250223","","126.5","","790059.03"
"2025-02-26","2025-02-23","SF FuneralF779060       250223","","213.31","","790272.34"
"2025-02-26","2025-02-23","SF FuneralF831418       250223","","126.5","","790398.84"
"2025-02-26","2025-02-23","SF FuneralF834536       250223","","126.5","","790525.34"
"2025-02-26","2025-02-23","SF FuneralF840458       250223","","126.5","","790651.84"
"2025-02-26","2025-02-17","SF FuneralFDC00000007V0Z250217","","126.5","","790778.34"
"2025-02-26","2025-02-21","SF FuneralF1033599      250221","","126.5","","790904.84"
"2025-02-26","2025-02-22","SF FuneralFDC000000062K7250222","","126.5","","791031.34"
"2025-02-26","2025-02-22","SF FuneralF805715       250222","","126.5","","791157.84"
"2025-02-26","2025-02-22","SF FuneralF1083643      250223","","126.5","","791284.34"
"2025-02-26","2025-02-22","SF FuneralF1085234      250222","","126.5","","791410.84"
"2025-02-26","2025-02-22","SF FuneralFDC0000000N4SP250223","","126.5","","791537.34"
"2025-02-26","2025-02-24","SF FuneralFDC000000062LJ250223","","126.5","","791663.84"
"2025-02-26","2025-02-24","SF FuneralFDC0000000631B250223","","126.5","","791790.34"
"2025-02-26","2025-02-24","SF FuneralFDC0000000708R250223","","126.5","","791916.84"
"2025-02-26","2025-02-24","SF FuneralFDC00000007L5H250223","","126.5","","792043.34"
"2025-02-26","2025-02-24","SF FuneralF901297       250224","","31.63","","792074.97"
"2025-02-26","2025-02-25","SF FuneralFDC00000007Q0F250225","","126.5","","792201.47"
"2025-02-26","2025-02-25","SF FuneralF822353       250225","","31.63","","792233.1"
"2025-02-26","2025-02-26","SF FuneralFDC000000035M1250226","","220","","792453.1"
"2025-02-26","2025-02-22","SF FuneralFDC000000079S2250222","","220","","792673.1"
"2025-02-26","2025-02-22","SF FuneralF819632       250222","","126.5","","792799.6"
"2025-02-26","2025-02-22","SF FuneralF1066589      250222","","126.5","","792926.1"
"2025-02-26","2025-02-24","SF FuneralFDC00000006200250223","","126.5","","793052.6"
"2025-02-26","2025-02-24","SF FuneralF819589       250223","","126.5","","793179.1"
"2025-02-26","2025-02-24","SF FuneralF834511       250223","","126.5","","793305.6"
"2025-02-26","2025-02-25","SF FuneralF827759       250225","","126.5","","793432.1"
"2025-02-26","2025-02-18","SF FuneralFDC00000007F8K250218","","63.25","","793495.35"
"2025-02-26","2025-02-21","SF FuneralF1127870      250221","","126.5","","793621.85"
"2025-02-26","2025-02-20","SF FuneralF1108440      250220","","126.5","","793748.35"
"2025-02-26","2025-02-20","SF FuneralF812547       250220","","126.5","","793874.85"
"2025-02-26","2025-02-20","SF FuneralF991566       250220","","126.5","","794001.35"
"2025-02-26","2025-02-21","SF FuneralF991321       250222","","126.5","","794127.85"
"2025-02-26","2025-02-22","SF FuneralFDC00000005DX4250222","","126.5","","794254.35"
"2025-02-26","2025-02-22","SF FuneralFDC000000063TV250222","","126.5","","794380.85"
"2025-02-26","2025-02-22","SF FuneralFDC000000065Z3250222","","126.5","","794507.35"
"2025-02-26","2025-02-22","SF FuneralFDC000000070D0250222","","126.5","","794633.85"
"2025-02-26","2025-02-22","SF FuneralFDC00000007GYW250222","","126.5","","794760.35"
"2025-02-26","2025-02-22","SF FuneralFDC00000007M0H250222","","126.5","","794886.85"
"2025-02-26","2025-02-22","SF FuneralFDC000000084FG250222","","126.5","","795013.35"
"2025-02-26","2025-02-22","SF FuneralFDC000000085QH250222","","126.5","","795139.85"
"2025-02-26","2025-02-22","SF FuneralF819573       250222","","126.5","","795266.35"
"2025-02-26","2025-02-22","SF FuneralFDC0000000BK8N250222","","126.5","","795392.85"
"2025-02-26","2025-02-22","SF FuneralF823397       250222","","126.5","","795519.35"
"2025-02-26","2025-02-22","SF FuneralF840610       250222","","126.5","","795645.85"
"2025-02-26","2025-02-22","SF FuneralF842179       250222","","126.5","","795772.35"
"2025-02-26","2025-02-22","SF FuneralF1052696      250222","","126.5","","795898.85"
"2025-02-26","2025-02-22","SF FuneralFDC0000000K5QR250223","","126.5","","796025.35"
"2025-02-26","2025-02-22","SF FuneralF1058763      250222","","126.5","","796151.85"
"2025-02-26","2025-02-22","SF FuneralF1075289      250222","","126.5","","796278.35"
"2025-02-26","2025-02-22","SF FuneralF1104260      250223","","63.25","","796341.6"
"2025-02-26","2025-02-22","SF FuneralF1116813      250223","","126.5","","796468.1"
"2025-02-26","2025-02-22","SF FuneralF1120513      250223","","126.5","","796594.6"
"2025-02-26","2025-02-22","SF FuneralF1123080      250222","","126.5","","796721.1"
"2025-02-26","2025-02-22","SF FuneralF791589       250222","","191.5","","796912.6"
"2025-02-26","2025-02-22","SF FuneralFDC0000000Q29G250223","","126.5","","797039.1"
"2025-02-26","2025-02-24","SF FuneralFDC00000005G3N250223","","126.5","","797165.6"
"2025-02-26","2025-02-24","SF FuneralFDC00000005V2N250223","","213.31","","797378.91"
"2025-02-26","2025-02-24","SF FuneralFDC000000063H4250223","","126.5","","797505.41"
"2025-02-26","2025-02-24","SF FuneralFDC00000006JKX250223","","126.5","","797631.91"
"2025-02-26","2025-02-24","SF FuneralFDC00000006PKJ250223","","126.5","","797758.41"
"2025-02-26","2025-02-24","SF FuneralFDC00000006PL1250223","","126.5","","797884.91"
"2025-02-26","2025-02-24","SF FuneralFDC00000006YBG250223","","126.5","","798011.41"
"2025-02-26","2025-02-24","SF FuneralFDC000000079SZ250223","","126.5","","798137.91"
"2025-02-26","2025-02-24","SF FuneralFDC00000007NY0250223","","126.5","","798264.41"
"2025-02-26","2025-02-24","SF FuneralF799717       250223","","126.5","","798390.91"
"2025-02-26","2025-02-24","SF FuneralF801921       250223","","126.5","","798517.41"
"2025-02-26","2025-02-23","SF FuneralF809757       250223","","126.5","","798643.91"
"2025-02-26","2025-02-24","SF FuneralF815559       250224","","126.5","","798770.41"
"2025-02-26","2025-02-24","SF FuneralF832531       250224","","126.5","","798896.91"
"2025-02-26","2025-02-24","SF FuneralF842951       250222","","126.5","","799023.41"
"2025-02-26","2025-02-24","SF FuneralF1079258      250224","","126.5","","799149.91"
"2025-02-26","2025-02-25","SF FuneralFDC000000064BH250225","","126.5","","799276.41"
"2025-02-26","2025-02-25","SF FuneralFDC00000008MZZ250225","","126.5","","799402.91"
"2025-02-26","2025-02-25","SF FuneralF991541       250225","","191.5","","799594.41"
"2025-02-26","2025-02-25","SF FuneralF1114169      250225","","126.5","","799720.91"
"2025-02-26","2025-02-25","SF FuneralF1118739      250225","","63.25","","799784.16"
"2025-02-26","2025-02-26","SF FuneralF819111       250226","","31.63","","799815.79"
"2025-02-26","2025-02-26","SF FuneralF989005       250226","","126.5","","799942.29"
"2025-02-26","2025-02-26","SF FuneralFDC0000000J5P3250226","","126.5","","800068.79"
"2025-02-26","2025-02-26","SF FuneralF1052723      250226","","126.5","","800195.29"
"2025-02-26","2025-02-26","SF FuneralF1125012      250226","","126.5","","800321.79"
"2025-02-26","2025-02-24","SF FuneralFDC0000000691S250223","","126.5","","800448.29"
"2025-02-26","2025-02-24","SF FuneralFDC00000006P1B250223","","126.5","","800574.79"
"2025-02-26","2025-02-24","SF FuneralFDC00000006WJX250223","","126.5","","800701.29"
"2025-02-26","2025-02-24","SF FuneralFDC000000075F3250223","","126.5","","800827.79"
"2025-02-26","2025-02-24","SF FuneralFDC00000007KMD250223","","126.5","","800954.29"
"2025-02-26","2025-02-24","SF FuneralFDC000000081W4250223","","126.5","","801080.79"
"2025-02-26","2025-02-24","SF FuneralFDC000000085JV250223","","126.5","","801207.29"
"2025-02-26","2025-02-24","SF FuneralFDC000000086PD250223","","126.5","","801333.79"
"2025-02-26","2025-02-24","SF FuneralFDC00000009X3F250223","","126.5","","801460.29"
"2025-02-26","2025-02-24","SF FuneralF819085       250224","","63.25","","801523.54"
"2025-02-26","2025-02-24","SF FuneralF844726       250222","","126.5","","801650.04"
"2025-02-26","2025-02-24","SF FuneralF1132491      250224","","126.5","","801776.54"
"2025-02-26","2025-02-22","SF FuneralFDC00000006473250222","","126.5","","801903.04"
"2025-02-26","2025-02-22","SF FuneralFDC00000006S0Q250222","","126.5","","802029.54"
"2025-02-26","2025-02-22","SF FuneralFDC00000006S0X250222","","126.5","","802156.04"
"2025-02-26","2025-02-22","SF FuneralFDC00000006Z85250222","","126.5","","802282.54"
"2025-02-26","2025-02-22","SF FuneralFDC000000070QX250222","","126.5","","802409.04"
"2025-02-26","2025-02-22","SF FuneralFDC000000070R4250222","","126.5","","802535.54"
"2025-02-26","2025-02-22","SF FuneralF804398       250222","","126.5","","802662.04"
"2025-02-26","2025-02-22","SF FuneralF805634       250222","","126.5","","802788.54"
"2025-02-26","2025-02-22","SF FuneralF817548       250222","","126.5","","802915.04"
"2025-02-26","2025-02-22","SF FuneralFDC0000000CWBN250222","","126.5","","803041.54"
"2025-02-26","2025-02-22","SF FuneralFDC0000000JVB7250222","","126.5","","803168.04"
"2025-02-26","2025-02-22","SF FuneralFDC0000000JXGW250222","","126.5","","803294.54"
"2025-02-26","2025-02-22","SF FuneralF1073035      250222","","126.5","","803421.04"
"2025-02-26","2025-02-22","SF FuneralF1108619      250223","","126.5","","803547.54"
"2025-02-26","2025-02-22","SF FuneralF1112411      250223","","126.5","","803674.04"
"2025-02-26","2025-02-22","SF FuneralF1115944      250222","","126.5","","803800.54"
"2025-02-26","2025-02-22","SF FuneralF1115973      250222","","126.5","","803927.04"
"2025-02-26","2025-02-22","SF FuneralFDC0000000NM6R250222","","126.5","","804053.54"
"2025-02-26","2025-02-22","SF FuneralFDC0000000NPGS250222","","126.5","","804180.04"
"2025-02-26","2025-02-22","SF FuneralF1122747      250222","","126.5","","804306.54"
"2025-02-26","2025-02-22","SF FuneralFDC0000000P8Z0250222","","126.5","","804433.04"
"2025-02-26","2025-02-22","SF FuneralFDC0000000PS33250222","","126.5","","804559.54"
"2025-02-26","2025-02-22","SF FuneralF1129532      250222","","126.5","","804686.04"
"2025-02-26","2025-02-22","SF FuneralFDC000000060JT250222","","126.5","","804812.54"
"2025-02-26","2025-02-22","SF FuneralFDC000000062KX250222","","126.5","","804939.04"
"2025-02-26","2025-02-22","SF FuneralFDC000000062KZ250222","","126.5","","805065.54"
"2025-02-26","2025-02-22","SF FuneralFDC000000062L0250222","","126.5","","805192.04"
"2025-02-26","2025-02-22","SF FuneralFDC000000062LG250222","","126.5","","805318.54"
"2025-02-26","2025-02-22","SF FuneralFDC000000063K4250222","","126.5","","805445.04"
"2025-02-26","2025-02-22","SF FuneralFDC0000000657F250222","","126.5","","805571.54"
"2025-02-26","2025-02-22","SF FuneralFDC00000006BCV250222","","126.5","","805698.04"
"2025-02-26","2025-02-22","SF FuneralFDC00000006D5H250222","","126.5","","805824.54"
"2025-02-26","2025-02-22","SF FuneralFDC00000006MKS250222","","126.5","","805951.04"
"2025-02-26","2025-02-22","SF FuneralFDC0000000711Y250222","","126.5","","806077.54"
"2025-02-26","2025-02-22","SF FuneralFDC000000078CS250222","","126.5","","806204.04"
"2025-02-26","2025-02-22","SF FuneralFDC00000007F1R250222","","126.5","","806330.54"
"2025-02-26","2025-02-22","SF FuneralFDC00000007MH6250222","","126.5","","806457.04"
"2025-02-26","2025-02-22","SF FuneralFDC00000007VYV250222","","126.5","","806583.54"
"2025-02-26","2025-02-22","SF FuneralFDC00000007W6K250222","","126.5","","806710.04"
"2025-02-26","2025-02-22","SF FuneralF805904       250222","","126.5","","806836.54"
"2025-02-26","2025-02-22","SF FuneralFDC00000008XWQ250222","","126.5","","806963.04"
"2025-02-26","2025-02-22","SF FuneralFDC000000092ZZ250222","","126.5","","807089.54"
"2025-02-26","2025-02-22","SF FuneralF823659       250222","","126.5","","807216.04"
"2025-02-26","2025-02-22","SF FuneralF823933       250222","","126.5","","807342.54"
"2025-02-26","2025-02-22","SF FuneralF827981       250222","","126.5","","807469.04"
"2025-02-26","2025-02-22","SF FuneralF831480       250222","","126.5","","807595.54"
"2025-02-26","2025-02-22","SF FuneralF841058       250222","","126.5","","807722.04"
"2025-02-26","2025-02-22","SF FuneralF993871       250222","","126.5","","807848.54"
"2025-02-26","2025-02-22","SF FuneralF1017873      250222","","126.5","","807975.04"
"2025-02-26","2025-02-22","SF FuneralF1052919      250222","","126.5","","808101.54"
"2025-02-26","2025-02-22","SF FuneralFDC0000000K5S1250223","","126.5","","808228.04"
"2025-02-26","2025-02-22","SF FuneralF1060620      250222","","126.5","","808354.54"
"2025-02-26","2025-02-22","SF FuneralFDC0000000KWDK250222","","126.5","","808481.04"
"2025-02-26","2025-02-22","SF FuneralF1066528      250222","","126.5","","808607.54"
"2025-02-26","2025-02-22","SF FuneralF1073709      250222","","126.5","","808734.04"
"2025-02-26","2025-02-22","SF FuneralFDC0000000LJ53250223","","126.5","","808860.54"
"2025-02-26","2025-02-22","SF FuneralF1080528      250222","","126.5","","808987.04"
"2025-02-26","2025-02-22","SF FuneralFDC0000000LQRJ250223","","126.5","","809113.54"
"2025-02-26","2025-02-22","SF FuneralF1084862      250223","","126.5","","809240.04"
"2025-02-26","2025-02-22","SF FuneralF1084959      250223","","126.5","","809366.54"
"2025-02-26","2025-02-22","SF FuneralFDC0000000MJVX250222","","126.5","","809493.04"
"2025-02-26","2025-02-22","SF FuneralFDC0000000NB6N250222","","126.5","","809619.54"
"2025-02-26","2025-02-22","SF FuneralFDC0000000NB79250223","","126.5","","809746.04"
"2025-02-26","2025-02-22","SF FuneralFDC0000000NGN1250223","","126.5","","809872.54"
"2025-02-26","2025-02-22","SF FuneralF1116808      250223","","126.5","","809999.04"
"2025-02-26","2025-02-22","SF FuneralF1117604      250223","","126.5","","810125.54"
"2025-02-26","2025-02-22","SF FuneralF1118935      250223","","126.5","","810252.04"
"2025-02-26","2025-02-22","SF FuneralF1120686      250222","","126.5","","810378.54"
"2025-02-26","2025-02-22","SF FuneralF1123075      250223","","126.5","","810505.04"
"2025-02-26","2025-02-22","SF FuneralFDC0000000P4G0250222","","126.5","","810631.54"
"2025-02-26","2025-02-22","SF FuneralF1124214      250222","","126.5","","810758.04"
"2025-02-26","2025-02-24","SF FuneralFDC00000005G2Y250223","","126.5","","810884.54"
"2025-02-26","2025-02-24","SF FuneralFDC00000005GBV250223","","126.5","","811011.04"
"2025-02-26","2025-02-24","SF FuneralFDC00000005ZD0250223","","126.5","","811137.54"
"2025-02-26","2025-02-24","SF FuneralFDC000000061P5250223","","126.5","","811264.04"
"2025-02-26","2025-02-24","SF FuneralFDC000000062RF250223","","126.5","","811390.54"
"2025-02-26","2025-02-24","SF FuneralFDC000000062RH250223","","126.5","","811517.04"
"2025-02-26","2025-02-24","SF FuneralFDC000000062X2250223","","126.5","","811643.54"
"2025-02-26","2025-02-24","SF FuneralFDC00000006BN0250223","","126.5","","811770.04"
"2025-02-26","2025-02-24","SF FuneralFDC00000006CQ7250223","","126.5","","811896.54"
"2025-02-26","2025-02-24","SF FuneralFDC00000006DM9250223","","126.5","","812023.04"
"2025-02-26","2025-02-24","SF FuneralFDC00000006DR3250223","","126.5","","812149.54"
"2025-02-26","2025-02-24","SF FuneralFDC00000006FKG250223","","126.5","","812276.04"
"2025-02-26","2025-02-24","SF FuneralFDC00000006HSW250223","","126.5","","812402.54"
"2025-02-26","2025-02-24","SF FuneralFDC00000006J7G250224","","126.5","","812529.04"
"2025-02-26","2025-02-24","SF FuneralFDC00000006RZS250223","","126.5","","812655.54"
"2025-02-26","2025-02-24","SF FuneralFDC00000006SF6250223","","126.5","","812782.04"
"2025-02-26","2025-02-24","SF FuneralFDC00000006SFJ250223","","126.5","","812908.54"
"2025-02-26","2025-02-24","SF FuneralFDC00000006V13250223","","126.5","","813035.04"
"2025-02-26","2025-02-24","SF FuneralFDC00000006XCM250223","","126.5","","813161.54"
"2025-02-26","2025-02-24","SF FuneralFDC00000006XCN250223","","126.5","","813288.04"
"2025-02-26","2025-02-24","SF FuneralFDC00000006YFW250223","","126.5","","813414.54"
"2025-02-26","2025-02-24","SF FuneralFDC000000072D3250223","","126.5","","813541.04"
"2025-02-26","2025-02-24","SF FuneralFDC000000076MR250223","","126.5","","813667.54"
"2025-02-26","2025-02-24","SF FuneralFDC00000007B9D250223","","126.5","","813794.04"
"2025-02-26","2025-02-24","SF FuneralFDC00000007CGY250224","","126.5","","813920.54"
"2025-02-26","2025-02-24","SF FuneralFDC00000007KGM250223","","126.5","","814047.04"
"2025-02-26","2025-02-24","SF FuneralFDC00000007N8Y250223","","126.5","","814173.54"
"2025-02-26","2025-02-24","SF FuneralFDC00000007QKB250223","","126.5","","814300.04"
"2025-02-26","2025-02-24","SF FuneralFDC00000007T0L250223","","126.5","","814426.54"
"2025-02-26","2025-02-24","SF FuneralF795069       250223","","126.5","","814553.04"
"2025-02-26","2025-02-24","SF FuneralF796059       250223","","126.5","","814679.54"
"2025-02-26","2025-02-24","SF FuneralFDC00000007YKN250223","","126.5","","814806.04"
"2025-02-26","2025-02-24","SF FuneralFDC000000081YW250223","","126.5","","814932.54"
"2025-02-26","2025-02-24","SF FuneralF797642       250223","","126.5","","815059.04"
"2025-02-26","2025-02-24","SF FuneralFDC000000083Q9250223","","126.5","","815185.54"
"2025-02-26","2025-02-24","SF FuneralFDC000000085ZS250223","","126.5","","815312.04"
"2025-02-26","2025-02-24","SF FuneralF799615       250223","","126.5","","815438.54"
"2025-02-26","2025-02-24","SF FuneralF801508       250223","","126.5","","815565.04"
"2025-02-26","2025-02-24","SF FuneralFDC00000008M3F250224","","126.5","","815691.54"
"2025-02-26","2025-02-24","SF FuneralF805487       250223","","126.5","","815818.04"
"2025-02-26","2025-02-24","SF FuneralF811747       250223","","126.5","","815944.54"
"2025-02-26","2025-02-24","SF FuneralF814090       250223","","126.5","","816071.04"
"2025-02-26","2025-02-24","SF FuneralF814731       250224","","126.5","","816197.54"
"2025-02-26","2025-02-24","SF FuneralF823548       250223","","126.5","","816324.04"
"2025-02-26","2025-02-24","SF FuneralF823700       250223","","126.5","","816450.54"
"2025-02-26","2025-02-24","SF FuneralFDC0000000DM55250223","","126.5","","816577.04"
"2025-02-26","2025-02-24","SF FuneralF794199       250223","","191.5","","816768.54"
"2025-02-26","2025-02-24","SF FuneralF847199       250222","","126.5","","816895.04"
"2025-02-26","2025-02-24","SF FuneralF847280       250223","","126.5","","817021.54"
"2025-02-26","2025-02-24","SF FuneralF986887       250224","","126.5","","817148.04"
"2025-02-26","2025-02-24","SF FuneralF993323       250224","","126.5","","817274.54"
"2025-02-26","2025-02-24","SF FuneralF1061854      250224","","126.5","","817401.04"
"2025-02-26","2025-02-24","SF FuneralF1061866      250224","","126.5","","817527.54"
"2025-02-26","2025-02-24","SF FuneralF1068281      250224","","63.25","","817590.79"
"2025-02-26","2025-02-24","SF FuneralFDC0000000N7NV250224","","126.5","","817717.29"
"2025-02-26","2025-02-17","SF FuneralFDC000000063BR250216","","126.5","","817843.79"
"2025-02-26","2025-02-17","SF FuneralFDC00000009MKM250217","","126.5","","817970.29"
"2025-02-26","2025-02-17","SF FuneralF991264       250217","","63.25","","818033.54"
"2025-02-26","2025-02-18","SF FuneralFDC00000006PKR250218","","126.5","","818160.04"
"2025-02-26","2025-02-18","SF FuneralF814575       250218","","63.25","","818223.29"
"2025-02-26","2025-02-18","SF FuneralF991860       250218","","63.25","","818286.54"
"2025-02-26","2025-02-18","SF FuneralF1085175      250218","","63.25","","818349.79"
"2025-02-26","2025-02-20","SF FuneralFDC000000092ZX250220","","126.5","","818476.29"
"2025-02-26","2025-02-21","SF FuneralF823630       250221","","126.5","","818602.79"
"2025-02-26","2025-02-21","SF FuneralF843222       250221","","126.5","","818729.29"
"2025-02-26","2025-02-21","SF FuneralFDC0000000H39C250222","","126.5","","818855.79"
"2025-02-26","2025-02-21","SF FuneralF991029       250222","","126.5","","818982.29"
"2025-02-26","2025-02-21","SF FuneralFDC0000000J3SW250222","","126.5","","819108.79"
"2025-02-26","2025-02-21","SF FuneralF1120910      250221","","126.5","","819235.29"
"2025-02-26","2025-02-25","SF FuneralFDC000000061TT250225","","126.5","","819361.79"
"2025-02-26","2025-02-25","SF FuneralFDC00000007BJL250225","","126.5","","819488.29"
"2025-02-26","2025-02-25","SF FuneralFDC00000007QY3250225","","126.5","","819614.79"
"2025-02-26","2025-02-25","SF FuneralF806008       250225","","126.5","","819741.29"
"2025-02-26","2025-02-25","SF FuneralF811759       250225","","126.5","","819867.79"
"2025-02-26","2025-02-25","SF FuneralF815978       250225","","126.5","","819994.29"
"2025-02-26","2025-02-25","SF FuneralF831894       250225","","126.5","","820120.79"
"2025-02-26","2025-02-25","SF FuneralF833052       250225","","126.5","","820247.29"
"2025-02-26","2025-02-25","SF FuneralF840712       250225","","126.5","","820373.79"
"2025-02-26","2025-02-25","SF FuneralF981133       250225","","126.5","","820500.29"
"2025-02-26","2025-02-25","SF FuneralF986818       250225","","126.5","","820626.79"
"2025-02-26","2025-02-25","SF FuneralF993702       250225","","126.5","","820753.29"
"2025-02-26","2025-02-25","SF FuneralF1126248      250225","","126.5","","820879.79"
"2025-02-26","2025-02-26","SF FuneralF1122926      250226","","31.63","","820911.42"
"2025-02-26","2025-02-17","SF FuneralF1128124      250217","","126.5","","821037.92"
"2025-02-26","2025-02-21","SF FuneralF988433       250222","","126.5","","821164.42"
"2025-02-26","2025-02-20","SF FuneralFDC000000058K3250220","","126.5","","821290.92"
"2025-02-26","2025-02-20","SF FuneralFDC000000063TZ250220","","126.5","","821417.42"
"2025-02-26","2025-02-22","SF FuneralFDC00000007L14250222","","126.5","","821543.92"
"2025-02-26","2025-02-22","SF FuneralFDC00000007VJH250222","","126.5","","821670.42"
"2025-02-26","2025-02-22","SF FuneralFDC00000007VJV250222","","126.5","","821796.92"
"2025-02-26","2025-02-22","SF FuneralF803914       250222","","126.5","","821923.42"
"2025-02-26","2025-02-22","SF FuneralF813225       250222","","126.5","","822049.92"
"2025-02-26","2025-02-22","SF FuneralF815685       250222","","126.5","","822176.42"
"2025-02-26","2025-02-22","SF FuneralFDC0000000LQNQ250222","","126.5","","822302.92"
"2025-02-26","2025-02-22","SF FuneralFDC0000000NLY9250222","","31.63","","822334.55"
"2025-02-26","2025-02-22","SF FuneralF1117993      250222","","31.63","","822366.18"
"2025-02-26","2025-02-22","SF FuneralF1123134      250222","","126.5","","822492.68"
"2025-02-26","2025-02-22","SF FuneralF1124375      250222","","126.5","","822619.18"
"2025-02-26","2025-02-24","SF FuneralF811320       250223","","126.5","","822745.68"
"2025-02-26","2025-02-24","SF FuneralF811557       250223","","126.5","","822872.18"
"2025-02-26","2025-02-20","SF FuneralFDC00000006C4W250220","","126.5","","822998.68"
"2025-02-26","2025-02-21","SF FuneralFDC000000064DK250221","","126.5","","823125.18"
"2025-02-26","2025-02-21","SF FuneralF793229       250221","","343.31","","823468.49"
"2025-02-26","2025-02-21","SF FuneralF991449       250222","","126.5","","823594.99"
"2025-02-26","2025-02-22","SF FuneralFDC00000005GFY250222","","126.5","","823721.49"
"2025-02-26","2025-02-22","SF FuneralFDC00000006K1J250222","","126.5","","823847.99"
"2025-02-26","2025-02-22","SF FuneralFDC00000006K1V250222","","126.5","","823974.49"
"2025-02-26","2025-02-22","SF FuneralFDC00000006SK3250222","","126.5","","824100.99"
"2025-02-26","2025-02-22","SF FuneralFDC0000000722R250222","","126.5","","824227.49"
"2025-02-26","2025-02-22","SF FuneralFDC000000078RD250222","","126.5","","824353.99"
"2025-02-26","2025-02-22","SF FuneralF796597       250222","","126.5","","824480.49"
"2025-02-26","2025-02-22","SF FuneralFDC0000000B4NX250222","","126.5","","824606.99"
"2025-02-26","2025-02-22","SF FuneralF821247       250222","","126.5","","824733.49"
"2025-02-26","2025-02-22","SF FuneralF830013       250222","","126.5","","824859.99"
"2025-02-26","2025-02-22","SF FuneralF831176       250222","","126.5","","824986.49"
"2025-02-26","2025-02-22","SF FuneralF1017543      250222","","126.5","","825112.99"
"2025-02-26","2025-02-22","SF FuneralF1060480      250223","","126.5","","825239.49"
"2025-02-26","2025-02-22","SF FuneralF1061698      250222","","126.5","","825365.99"
"2025-02-26","2025-02-22","SF FuneralF1061985      250222","","126.5","","825492.49"
"2025-02-26","2025-02-22","SF FuneralF1072715      250222","","126.5","","825618.99"
"2025-02-26","2025-02-22","SF FuneralF1074674      250222","","126.5","","825745.49"
"2025-02-26","2025-02-22","SF FuneralF1112060      250222","","126.5","","825871.99"
"2025-02-26","2025-02-22","SF FuneralF1115116      250222","","126.5","","825998.49"
"2025-02-26","2025-02-22","SF FuneralF1115917      250222","","126.5","","826124.99"
"2025-02-26","2025-02-22","SF FuneralFDC0000000NWRL250223","","126.5","","826251.49"
"2025-02-26","2025-02-22","SF FuneralF1127098      250223","","126.5","","826377.99"
"2025-02-26","2025-02-24","SF FuneralFDC00000006ZTD250223","","126.5","","826504.49"
"2025-02-26","2025-02-24","SF FuneralFDC00000007B83250223","","126.5","","826630.99"
"2025-02-26","2025-02-24","SF FuneralFDC00000007MQ7250223","","126.5","","826757.49"
"2025-02-26","2025-02-24","SF FuneralF793413       250223","","126.5","","826883.99"
"2025-02-26","2025-02-24","SF FuneralF811628       250223","","126.5","","827010.49"
"2025-02-26","2025-02-24","SF FuneralFDC00000009YZC250223","","126.5","","827136.99"
"2025-02-26","2025-02-24","SF FuneralF833075       250223","","126.5","","827263.49"
"2025-02-26","2025-02-24","SF FuneralF833989       250224","","126.5","","827389.99"
"2025-02-26","2025-02-24","SF FuneralF988640       250224","","126.5","","827516.49"
"2025-02-26","2025-02-24","SF FuneralF1066274      250224","","31.63","","827548.12"
"2025-02-26","2025-02-25","SF FuneralFDC00000006F1B250225","","126.5","","827674.62"
"2025-02-26","2025-02-25","SF FuneralFDC00000007Z0K250225","","126.5","","827801.12"
"2025-02-26","2025-02-26","SF FuneralF992105       250226","","126.5","","827927.62"
"2025-02-26","2025-02-26","SF FuneralF993496       250226","","126.5","","828054.12"
"2025-02-26","2025-02-26","SF FuneralF1123483      250226","","126.5","","828180.62"
"2025-02-26","2025-02-25","SF FuneralFDC00000006V35250225","","126.5","","828307.12"
"2025-02-26","2025-02-25","SF FuneralF1020439      250225","","63.25","","828370.37"
"2025-02-26","2025-02-25","SF FuneralF1020870      250225","","126.5","","828496.87"
"2025-02-26","2025-02-25","SF FuneralF1117618      250225","","126.5","","828623.37"
"2025-02-26","2025-02-25","SF FuneralF1118437      250225","","126.5","","828749.87"
"2025-02-26","2025-02-25","SF FuneralF1120837      250225","","191.5","","828941.37"
"2025-02-26","2025-02-25","SF FuneralF1129544      250225","","126.5","","829067.87"
"2025-02-26","2025-02-25","SF FuneralFDC0000000Q3YF250225","","126.5","","829194.37"
"2025-02-26","2025-02-26","SF FuneralFDC00000006KRZ250226","","126.5","","829320.87"
"2025-02-26","2025-02-26","SF FuneralFDC00000007T46250226","","126.5","","829447.37"
"2025-02-26","2025-02-26","SF FuneralF801776       250226","","126.5","","829573.87"
"2025-02-26","2025-02-26","SF FuneralF804608       250226","","126.5","","829700.37"
"2025-02-26","2025-02-26","SF FuneralF786392       250226","","191.5","","829891.87"
"2025-02-26","2025-02-26","SF FuneralF823589       250226","","126.5","","830018.37"
"2025-02-26","2025-02-26","SF FuneralF831473       250226","","126.5","","830144.87"
"2025-02-26","2025-02-26","SF FuneralF832424       250226","","126.5","","830271.37"
"2025-02-26","2025-02-26","SF FuneralF840857       250226","","126.5","","830397.87"
"2025-02-26","2025-02-26","SF FuneralF981421       250226","","126.5","","830524.37"
"2025-02-26","2025-02-26","SF FuneralF988892       250226","","126.5","","830650.87"
"2025-02-26","2025-02-26","SF FuneralF992457       250226","","126.5","","830777.37"
"2025-02-26","2025-02-26","SF FuneralF1016776      250226","","126.5","","830903.87"
"2025-02-26","2025-02-26","SF FuneralF1017051      250226","","126.5","","831030.37"
"2025-02-26","2025-02-26","SF FuneralF1017593      250226","","126.5","","831156.87"
"2025-02-26","2025-02-26","SF FuneralF1055102      250226","","126.5","","831283.37"
"2025-02-26","2025-02-26","SF FuneralFDC0000000LFLZ250226","","126.5","","831409.87"
"2025-02-26","2025-02-26","SF FuneralF1102954      250226","","126.5","","831536.37"
"2025-02-26","2025-02-26","SF FuneralFDC0000000NLGP250226","","126.5","","831662.87"
"2025-02-26","2025-02-26","SF FuneralF1123107      250226","","126.5","","831789.37"
"2025-02-26","2025-02-26","SF FuneralFDC0000000PP1Z250226","","126.5","","831915.87"
"2025-02-26","2025-02-26","SF FuneralF1128665      250226","","126.5","","832042.37"
"2025-02-26","2025-02-20","SF FuneralFDC0000000K8V4250220","","31.63","","832074"
"2025-02-26","2025-02-21","SF FuneralFDC00000007W5M250221","","31.63","","832105.63"
"2025-02-26","2025-02-21","SF FuneralF987269       250221","","31.63","","832137.26"
"2025-02-26","2025-02-24","SF FuneralF812864       250223","","31.63","","832168.89"
"2025-02-26","2025-02-24","SF FuneralF834627       250223","","31.63","","832200.52"
"2025-02-26","2025-02-25","SF FuneralFDC00000005YYS250225","","31.63","","832232.15"
"2025-02-26","2025-02-25","SF FuneralFDC000000069NH250225","","31.63","","832263.78"
"2025-02-26","2025-02-26","SF FuneralFDC00000007B1L250226","","126.5","","832390.28"
"2025-02-26","2025-02-26","SF FuneralFDC00000008L4K250226","","126.5","","832516.78"
"2025-02-26","2025-02-26","SF FuneralFDC0000000KKBT250226","","95.75","","832612.53"
"2025-02-26","2025-02-26","SF FuneralF1108615      250226","","126.5","","832739.03"
"2025-02-26","2025-02-26","SF FuneralF1124996      250226","","126.5","","832865.53"
"2025-02-26","2025-02-19","SF FuneralFDC0000000B0NN250219","","126.5","","832992.03"
"2025-02-26","2025-02-22","SF FuneralF1080292      250222","","126.5","","833118.53"
"2025-02-26","2025-02-21","Rev SF FuneralFDC0000000JXK7250221","","-31.63","","833086.9"
"2025-02-26","2025-02-25","Rev SF FuneralFDC0000000N8G1250225","","-31.63","","833055.27"
"2025-02-26","2025-02-25","Rev SF FuneralFDC0000000HN9N250225","","-31.63","","833023.64"
"2025-02-26","2025-01-22","Rev SF FuneralFDC0000000MK28250122","","-126.5","","832897.14"
"2025-02-26","2024-12-23","Rev SF FuneralF1073411      241227","","-126.5","","832770.64"
"2025-02-26","2025-01-24","Rev SF FuneralF1073411      250127","","-126.5","","832644.14"
"2025-02-26","2025-02-20","Rev SF FuneralFDC000000060BM250220","","-126.5","","832517.64"
"2025-02-26","2025-02-17","Rev SF FuneralFDC00000007M2D250216","","-63.25","","832454.39"
"2025-02-26","2025-02-20","Rev SF FuneralFDC00000008M3G250220","","-126.5","","832327.89"
"2025-02-26","2025-02-21","Rev SF FuneralFDC0000000773W250221","","-126.5","","832201.39"
"2025-02-26","2025-02-24","Rev SF FuneralFDC00000007B9D250223","","-126.5","","832074.89"
"2025-02-26","2025-02-22","Rev SF FuneralFDC0000000MK28250222","","-126.5","","831948.39"
"2025-02-26","2025-02-24","Rev SF FuneralFDC000000078PD250224","","-126.5","","831821.89"
"2025-02-26","2025-02-22","Rev SF FuneralFDC0000000N2FJ250222","","-126.5","","831695.39"
"2025-02-26","2025-02-22","Rev SF FuneralFDC0000000KWVL250222","","-126.5","","831568.89"
"2025-02-26","2025-02-22","Rev SF FuneralFDC00000006YD9250222","","-126.5","","831442.39"
"2025-02-26","2025-02-22","Rev SF FuneralFDC0000000700C250222","","-126.5","","831315.89"
"2025-02-26","2025-02-22","Rev SF FuneralFDC000000062LG250222","","-126.5","","831189.39"
"2025-02-26","2025-02-22","Rev SF FuneralFDC00000007M57250222","","-126.5","","831062.89"
"2025-02-26","2025-02-22","Rev SF FuneralFDC00000006VP1250222","","-126.5","","830936.39"
"2025-02-26","2025-02-22","Rev SF FuneralFDC00000006VP2250222","","-126.5","","830809.89"
"2025-02-26","2025-02-22","Rev SF FuneralFDC000000062BW250222","","-126.5","","830683.39"
"2025-02-26","2025-02-22","Rev SF FuneralFDC000000062KZ250222","","-126.5","","830556.89"
"2025-02-26","2025-02-22","Rev SF FuneralFDC00000007TZQ250222","","-126.5","","830430.39"
"2025-02-26","2025-02-22","Rev SF FuneralFDC000000062L0250222","","-126.5","","830303.89"
"2025-02-26","2025-02-22","Rev SF FuneralFDC00000007BW6250222","","-126.5","","830177.39"
"2025-02-26","2025-02-22","Rev SF FuneralFDC0000000NGN1250223","","-126.5","","830050.89"
"2025-02-26","2025-02-22","Rev SF FuneralFDC0000000B0Z9250222","","-126.5","","829924.39"
"2025-02-26","2025-02-22","Rev SF FuneralFDC0000000N7HW250222","","-126.5","","829797.89"
"2025-02-26","2025-02-22","Rev SF FuneralFDC00000008XWQ250222","","-126.5","","829671.39"
"2025-02-26","2025-02-22","Rev SF FuneralFDC00000006WL5250222","","-126.5","","829544.89"
"2025-02-26","2025-02-22","Rev SF FuneralFDC00000008FL2250222","","-126.5","","829418.39"
"2025-02-26","2025-02-25","Rev SF FuneralFDC0000000PWW4250225","","-126.5","","829291.89"
"2025-02-26","2025-02-25","Rev SF FuneralFDC0000000HVZS250225","","-126.5","","829165.39"
"2025-02-26","2025-02-25","Rev SF FuneralFDC000000057TZ250225","","-126.5","","829038.89"
"2025-02-26","2025-02-24","SF FuneralFDC00000002X26250224","","220","","829258.89"
"2025-02-26","2025-02-25","SF FuneralF1075100      250225","","126.5","","829385.39"
"2025-02-26","2025-02-24","SF FuneralF1108463      250224","","126.5","","829511.89"
"2025-02-26","2025-02-25","SF FuneralF1122763      250225","","126.5","","829638.39"
"2025-02-26","2025-02-21","SF FuneralF991404       250222","","126.5","","829764.89"
"2025-02-26","2025-02-22","SF FuneralFDC00000005ZQ7250222","","126.5","","829891.39"
"2025-02-26","2025-02-22","SF FuneralFDC0000000713G250222","","126.5","","830017.89"
"2025-02-26","2025-02-22","SF FuneralF1108575      250222","","126.5","","830144.39"
"2025-02-26","2025-02-22","SF FuneralF1112254      250223","","126.5","","830270.89"
"2025-02-26","2025-02-22","SF FuneralF1115905      250222","","126.5","","830397.39"
"2025-02-26","2025-02-24","SF FuneralFDC000000066F0250223","","191.5","","830588.89"
"2025-02-26","2025-02-24","SF FuneralFDC00000007N2Y250224","","126.5","","830715.39"
"2025-02-26","2025-02-24","SF FuneralF1112313      250224","","126.5","","830841.89"
"2025-02-26","2025-02-25","SF FuneralFDC0000000655K250225","","126.5","","830968.39"
"2025-02-26","2025-02-25","SF FuneralFDC00000007GSG250225","","126.5","","831094.89"
"2025-02-26","2025-02-25","SF FuneralFDC00000008MGS250225","","126.5","","831221.39"
"2025-02-26","2025-02-25","SF FuneralFDC00000009618250225","","126.5","","831347.89"
"2025-02-26","2025-02-26","SF FuneralFDC00000007PTW250226","","63.25","","831411.14"
"2025-02-26","2025-02-22","SF FuneralF1079004      250223","","31.63","","831442.77"
"2025-02-26","2025-02-24","SF FuneralFDC00000005RR7250224","","31.63","","831474.4"
"2025-02-26","2025-02-25","SF FuneralFDC0000000JHBW250225","","31.63","","831506.03"
"2025-02-26","2025-02-17","SF FuneralF1052512      250217","","126.5","","831632.53"
"2025-02-26","2025-02-22","SF FuneralFDC00000002WYD250222","","220","","831852.53"
"2025-02-26","2025-02-22","SF FuneralFDC00000006019250222","","126.5","","831979.03"
"2025-02-26","2025-02-22","SF FuneralFDC0000000619J250222","","126.5","","832105.53"
"2025-02-26","2025-02-22","SF FuneralFDC00000006VBV250222","","126.5","","832232.03"
"2025-02-26","2025-02-22","SF FuneralFDC00000007NM0250222","","126.5","","832358.53"
"2025-02-26","2025-02-22","SF FuneralF807962       250222","","126.5","","832485.03"
"2025-02-26","2025-02-22","SF FuneralFDC00000009JQJ250222","","126.5","","832611.53"
"2025-02-26","2025-02-22","SF FuneralF831390       250222","","126.5","","832738.03"
"2025-02-26","2025-02-22","SF FuneralF833650       250222","","126.5","","832864.53"
"2025-02-26","2025-02-22","SF FuneralF1022169      250222","","126.5","","832991.03"
"2025-02-26","2025-02-22","SF FuneralF1054722      250223","","63.25","","833054.28"
"2025-02-26","2025-02-22","SF FuneralF1116009      250223","","126.5","","833180.78"
"2025-02-26","2025-02-22","SF FuneralFDC0000000NXGF250222","","126.5","","833307.28"
"2025-02-26","2025-02-24","SF FuneralFDC000000061JT250223","","126.5","","833433.78"
"2025-02-26","2025-02-24","SF FuneralFDC00000006H5S250223","","126.5","","833560.28"
"2025-02-26","2025-02-24","SF FuneralFDC00000006W7W250224","","126.5","","833686.78"
"2025-02-26","2025-02-24","SF FuneralFDC0000000857H250223","","126.5","","833813.28"
"2025-02-26","2025-02-24","SF FuneralF823193       250224","","126.5","","833939.78"
"2025-02-26","2025-02-24","SF FuneralFDC0000000J22Z250224","","126.5","","834066.28"
"2025-02-26","2025-02-25","SF FuneralFDC0000000635S250225","","126.5","","834192.78"
"2025-02-26","2025-02-25","SF FuneralF793244       250225","","321.5","","834514.28"
"2025-02-26","2025-02-25","SF FuneralF1066664      250225","","126.5","","834640.78"
"2025-02-26","2025-02-22","Rev SF FuneralFDC00000006GQ0250222","","-126.5","","834514.28"
"2025-02-26","2025-02-20","Rev SF FuneralFDC00000005ZQ2250220","","-126.5","","834387.78"
"2025-02-26","2025-02-24","SF FuneralF1122758      250224","","126.5","","834514.28"
"2025-02-26","2025-02-24","SF FuneralF1083670      250224","","126.5","","834640.78"
"2025-02-26","2025-02-25","SF FuneralF1115227      250225","","126.5","","834767.28"
"2025-02-26","2025-02-18","SF FuneralF814290       250218","","63.25","","834830.53"
"2025-02-26","2025-02-20","SF FuneralFDC000000063GX250220","","126.5","","834957.03"
"2025-02-26","2025-02-22","SF FuneralFDC000000080J1250222","","126.5","","835083.53"
"2025-02-26","2025-02-22","SF FuneralF993467       250223","","126.5","","835210.03"
"2025-02-26","2025-02-22","SF FuneralFDC0000000LLT3250223","","126.5","","835336.53"
"2025-02-26","2025-02-24","SF FuneralF817252       250224","","126.5","","835463.03"
"2025-02-26","2025-02-24","SF FuneralF1020942      250224","","63.25","","835526.28"
"2025-02-26","2025-02-24","SF FuneralF1055228      250224","","126.5","","835652.78"
"2025-02-26","2025-02-24","SF FuneralF1131541      250224","","31.63","","835684.41"
"2025-02-26","2025-02-22","SF FuneralFDC00000007LSC250222","","126.5","","835810.91"
"2025-02-26","2025-02-22","SF FuneralFDC00000008JLB250222","","126.5","","835937.41"
"2025-02-26","2025-02-25","SF FuneralFDC0000000FC19250225","","126.5","","836063.91"
"2025-02-26","2025-02-25","SF FuneralF1083898      250225","","63.25","","836127.16"
"2025-02-26","2025-02-24","SF FuneralF819833       250223","","126.5","","836253.66"
"2025-02-26","2025-02-24","SF FuneralF1114923      250224","","126.5","","836380.16"
"2025-02-26","2025-02-25","SF FuneralF1033956      250225","","126.5","","836506.66"
"2025-02-26","2025-02-26","SF FuneralF844042       250226","","31.63","","836538.29"
"2025-02-26","2025-02-20","SF FuneralF815121       250220","","126.5","","836664.79"
"2025-02-26","2025-02-22","SF FuneralFDC000000067N5250222","","126.5","","836791.29"
"2025-02-26","2025-02-22","SF FuneralFDC000000067N8250222","","126.5","","836917.79"
"2025-02-26","2025-02-22","SF FuneralFDC00000006WYZ250222","","126.5","","837044.29"
"2025-02-26","2025-02-22","SF FuneralFDC0000000B43D250222","","126.5","","837170.79"
"2025-02-26","2025-02-22","SF FuneralF1054879      250222","","126.5","","837297.29"
"2025-02-26","2025-02-22","SF FuneralF1061801      250222","","126.5","","837423.79"
"2025-02-26","2025-02-22","SF FuneralF1080232      250223","","63.25","","837487.04"
"2025-02-26","2025-02-22","SF FuneralF1108092      250222","","126.5","","837613.54"
"2025-02-26","2025-02-22","SF FuneralF1130212      250223","","126.5","","837740.04"
"2025-02-26","2025-02-24","SF FuneralFDC0000000B6SN250223","","126.5","","837866.54"
"2025-02-26","2025-02-24","SF FuneralF843071       250224","","126.5","","837993.04"
"2025-02-26","2025-02-24","SF FuneralFDC0000000FVPD250224","","31.63","","838024.67"
"2025-02-26","2025-02-24","SF FuneralF1113736      250224","","126.5","","838151.17"
"2025-02-26","2025-02-24","SF FuneralFDC0000000P4M6250224","","126.5","","838277.67"
"2025-02-26","2025-02-24","SF FuneralF1123401      250224","","126.5","","838404.17"
"2025-02-26","2025-02-24","SF FuneralF1130721      250224","","126.5","","838530.67"
"2025-02-26","2025-02-25","SF FuneralFDC00000005WF7250225","","126.5","","838657.17"
"2025-02-26","2025-02-25","SF FuneralFDC00000006K2B250225","","126.5","","838783.67"
"2025-02-26","2025-02-25","SF FuneralFDC00000006R2Y250225","","126.5","","838910.17"
"2025-02-26","2025-02-25","SF FuneralFDC00000007KZR250225","","126.5","","839036.67"
"2025-02-26","2025-02-25","SF FuneralFDC00000007KZT250225","","126.5","","839163.17"
"2025-02-26","2025-02-25","SF FuneralF1080249      250225","","31.63","","839194.8"
"2025-02-26","2025-02-25","SF FuneralF1126085      250225","","126.5","","839321.3"
"2025-02-26","2025-02-25","SF FuneralF1132446      250225","","126.5","","839447.8"
"2025-02-26","2025-02-26","SF FuneralFDC00000007030250226","","126.5","","839574.3"
"2025-02-26","2025-02-26","SF FuneralF991031       250226","","126.5","","839700.8"
"2025-02-26","2025-02-22","SF FuneralF840726       250222","","126.5","","839827.3"
"2025-02-26","2025-02-22","SF FuneralF1084633      250222","","126.5","","839953.8"
"2025-02-26","2025-02-24","SF FuneralFDC000000060D4250223","","126.5","","840080.3"
"2025-02-26","2025-02-24","SF FuneralFDC0000000695T250224","","126.5","","840206.8"
"2025-02-26","2025-02-23","SF FuneralF833459       250223","","126.5","","840333.3"
"2025-02-26","2025-02-21","SF FuneralF1124409      250221","","126.5","","840459.8"
"2025-02-26","2025-02-22","SF FuneralF1068347      250222","","126.5","","840586.3"
"2025-02-26","2025-02-22","SF FuneralF1108109      250222","","126.5","","840712.8"
"2025-02-26","2025-02-24","SF FuneralFDC000000042HH250223","","55","","840767.8"
"2025-02-26","2025-02-24","SF FuneralFDC00000005NKJ250224","","31.63","","840799.43"
"2025-02-26","2025-02-24","SF FuneralF799342       250223","","126.5","","840925.93"
"2025-02-26","2025-02-24","SF FuneralF1126134      250224","","126.5","","841052.43"
"2025-02-26","2025-02-25","SF FuneralFDC00000007MTG250225","","126.5","","841178.93"
"2025-02-26","2025-02-26","SF FuneralF815129       250226","","126.5","","841305.43"
"2025-02-26","2025-02-24","SF FuneralF1020604      250224","","126.5","","841431.93"
"2025-02-26","2025-02-25","SF FuneralF1125013      250225","","126.5","","841558.43"
"2025-02-26","2025-02-17","SF FuneralFDC00000005ZVK250216","","126.5","","841684.93"
"2025-02-26","2025-02-21","SF FuneralF989432       250221","","126.5","","841811.43"
"2025-02-26","2025-02-22","SF FuneralFDC00000006TYL250222","","126.5","","841937.93"
"2025-02-26","2025-02-22","SF FuneralFDC000000080YV250222","","126.5","","842064.43"
"2025-02-26","2025-02-22","SF FuneralF819694       250222","","126.5","","842190.93"
"2025-02-26","2025-02-22","SF FuneralF833195       250222","","126.5","","842317.43"
"2025-02-26","2025-02-22","SF FuneralF1073121      250222","","126.5","","842443.93"
"2025-02-26","2025-02-22","SF FuneralFDC0000000PXSJ250223","","126.5","","842570.43"
"2025-02-26","2025-02-24","SF FuneralF820446       250224","","126.5","","842696.93"
"2025-02-26","2025-02-25","SF FuneralFDC000000073KC250225","","126.5","","842823.43"
"2025-02-26","2025-02-25","SF FuneralFDC00000007V8S250225","","126.5","","842949.93"
"2025-02-26","2025-02-25","SF FuneralF808036       250225","","126.5","","843076.43"
"2025-02-26","2025-02-25","SF FuneralF1074842      250225","","126.5","","843202.93"
"2025-02-26","2025-02-25","SF FuneralF1131055      250225","","126.5","","843329.43"
"2025-02-26","2025-02-26","SF FuneralFDC00000007R9K250226","","126.5","","843455.93"
"2025-02-26","2025-02-26","SF FuneralFDC00000007R9P250226","","126.5","","843582.43"
"2025-02-26","2025-02-17","SF FuneralFDC00000005ZV9250216","","126.5","","843708.93"
"2025-02-26","2025-02-22","SF FuneralFDC000000076PJ250222","","126.5","","843835.43"
"2025-02-26","2025-02-22","SF FuneralFDC00000007CF5250222","","126.5","","843961.93"
"2025-02-26","2025-02-22","SF FuneralFDC00000007D4Y250222","","126.5","","844088.43"
"2025-02-26","2025-02-22","SF FuneralFDC000000081H9250222","","126.5","","844214.93"
"2025-02-26","2025-02-22","SF FuneralF805398       250222","","126.5","","844341.43"
"2025-02-26","2025-02-22","SF FuneralF784736       250222","","31.63","","844373.06"
"2025-02-26","2025-02-22","SF FuneralF832121       250222","","126.5","","844499.56"
"2025-02-26","2025-02-22","SF FuneralFDC0000000MLZ8250223","","126.5","","844626.06"
"2025-02-26","2025-02-22","SF FuneralFDC0000000MLZD250223","","126.5","","844752.56"
"2025-02-26","2025-02-24","SF FuneralFDC00000006RQ8250223","","31.63","","844784.19"
"2025-02-26","2025-02-24","SF FuneralFDC000000077PZ250223","","126.5","","844910.69"
"2025-02-26","2025-02-24","SF FuneralFDC000000080YP250223","","63.25","","844973.94"
"2025-02-26","2025-02-24","SF FuneralF801722       250224","","31.63","","845005.57"
"2025-02-26","2025-02-24","SF FuneralFDC00000009G6B250223","","31.63","","845037.2"
"2025-02-26","2025-02-24","SF FuneralFDC00000009XWR250223","","31.63","","845068.83"
"2025-02-26","2025-02-24","SF FuneralFDC0000000L661250224","","126.5","","845195.33"
"2025-02-26","2025-02-24","SF FuneralF1118324      250224","","31.63","","845226.96"
"2025-02-26","2025-02-24","SF FuneralF1120841      250224","","126.5","","845353.46"
"2025-02-26","2025-02-24","SF FuneralFDC0000000P5RB250224","","126.5","","845479.96"
"2025-02-26","2025-02-25","SF FuneralFDC00000007NSD250225","","126.5","","845606.46"
"2025-02-26","2025-02-25","SF FuneralFDC00000007SC0250225","","126.5","","845732.96"
"2025-02-26","2025-02-25","SF FuneralFDC0000000822J250225","","126.5","","845859.46"
"2025-02-26","2025-02-25","SF FuneralFDC000000086B2250225","","31.63","","845891.09"
"2025-02-26","2025-02-25","SF FuneralFDC00000008T9H250225","","126.5","","846017.59"
"2025-02-26","2025-02-25","SF FuneralF816835       250225","","31.63","","846049.22"
"2025-02-26","2025-02-25","SF FuneralFDC0000000BD5B250225","","126.5","","846175.72"
"2025-02-26","2025-02-25","SF FuneralF989465       250225","","126.5","","846302.22"
"2025-02-26","2025-02-25","SF FuneralF1127346      250225","","31.63","","846333.85"
"2025-02-26","2025-02-22","SF FuneralF1084868      250222","","126.5","","846460.35"
"2025-02-26","2025-02-25","Rev SF FuneralFDC00000007GSG250225","","-126.5","","846333.85"
"2025-02-26","2025-02-25","Rev SF FuneralFDC00000006K2X250225","","-126.5","","846207.35"
"2025-02-26","2025-02-21","Rev SF FuneralFDC0000000HP20250222","","-126.5","","846080.85"
"2025-02-26","2025-02-24","Rev SF FuneralFDC000000083Q9250223","","-126.5","","845954.35"
"2025-02-26","2025-02-25","Rev SF FuneralFDC00000005WF7250225","","-126.5","","845827.85"
"2025-02-26","2024-11-07","Rev SF FuneralFDC00000007W5T241107","","-126.5","","845701.35"
"2025-02-26","2025-02-21","Rev SF FuneralFDC00000007QP1250221","","-126.5","","845574.85"
"2025-02-26","2024-10-07","Rev SF FuneralFDC00000007W5T241007","","-126.5","","845448.35"
"2025-02-26","2025-02-07","Rev SF FuneralFDC00000007W5T250207","","-126.5","","845321.85"
"2025-02-26","2025-02-18","Rev SF FuneralFDC0000000JHBW250218","","-31.63","","845290.22"
"2025-02-26","2025-02-24","Rev SF FuneralFDC0000000P891250224","","-126.5","","845163.72"
"2025-02-26","2025-02-24","Rev SF FuneralFDC000000062X2250223","","-126.5","","845037.22"
"2025-02-26","2025-02-22","Rev SF FuneralFDC00000006WYR250222","","-126.5","","844910.72"
"2025-02-26","2025-02-22","Rev SF FuneralFDC00000006WYX250222","","-126.5","","844784.22"
"2025-02-26","2025-02-22","Rev SF FuneralFDC0000000LJ53250223","","-126.5","","844657.72"
"2025-02-26","2025-02-22","Rev SF FuneralFDC000000076PJ250222","","-126.5","","844531.22"
"2025-02-26","2025-02-24","Rev SF FuneralFDC00000008X7G250224","","-126.5","","844404.72"
"2025-02-26","2025-02-24","Rev SF FuneralFDC00000007N2Y250224","","-126.5","","844278.22"
"2025-02-26","2025-02-22","Rev SF FuneralFDC0000000837Q250222","","-126.5","","844151.72"
"2025-02-26","2025-02-22","Rev SF FuneralFDC0000000837V250222","","-126.5","","844025.22"
"2025-02-26","2025-02-22","Rev SF FuneralFDC0000000NXGF250222","","-126.5","","843898.72"
"2025-02-26","2025-02-22","Rev SF FuneralFDC0000000630S250222","","-126.5","","843772.22"
"2025-02-26","2025-02-22","Rev SF FuneralFDC0000000NCC5250222","","-126.5","","843645.72"
"2025-02-26","2025-02-24","Rev SF FuneralFDC000000076MR250223","","-126.5","","843519.22"
"2025-02-26","2025-02-25","Rev SF FuneralFDC0000000655K250225","","-126.5","","843392.72"
"2025-02-26","2025-02-24","Rev SF FuneralFDC0000000B6SN250223","","-126.5","","843266.22"
"2025-02-26","2025-02-22","Rev SF FuneralFDC00000006MKS250222","","-126.5","","843139.72"
"2025-02-26","2025-02-25","Rev SF FuneralFDC0000000BD5B250225","","-126.5","","843013.22"
"2025-02-26","2025-02-25","Rev SF FuneralFDC00000006R2Y250225","","-126.5","","842886.72"
"2025-02-26","2024-09-07","Rev SF FuneralFDC00000007W5T240907","","-126.5","","842760.22"
"2025-02-26","2025-02-22","Rev SF FuneralFDC0000000D6PQ250222","","-126.5","","842633.72"
"2025-02-26","2025-02-21","Rev SF FuneralFDC00000007W5M250221","","-31.63","","842602.09"
"2025-02-26","2025-02-25","Rev SF FuneralFDC0000000JHBW250225","","-31.63","","842570.46"
"2025-02-26","2025-02-11","Rev SF FuneralFDC0000000JHBW250211","","-31.63","","842538.83"
"2025-02-26","2025-02-22","Rev SF FuneralFDC00000007VYV250222","","-126.5","","842412.33"
"2025-02-26","2025-02-22","Rev SF FuneralFDC00000006BCV250222","","-126.5","","842285.83"
"2025-02-26","2025-02-22","Rev SF FuneralFDC0000000PS98250222","","-126.5","","842159.33"
"2025-02-26","2025-01-24","Rev SF FuneralFDC00000005WF7250125","","-126.5","","842032.83"
"2025-02-26","2025-02-22","Rev SF FuneralFDC0000000NB79250223","","-126.5","","841906.33"
"2025-02-26","2025-02-22","Rev SF FuneralFDC0000000Q1V8250222","","-126.5","","841779.83"
"2025-02-26","2025-02-17","Rev SF FuneralFDC00000009MKM250217","","-126.5","","841653.33"
"2025-02-26","2024-12-07","Rev SF FuneralFDC00000007W5T241207","","-126.5","","841526.83"
"2025-02-26","2025-02-20","Rev SF FuneralFDC000000063GX250220","","-126.5","","841400.33"
"2025-02-26","2025-02-22","SF FuneralFDC00000006208250222","","220","","841620.33"
"2025-02-26","2025-02-22","SF FuneralFDC0000000783S250222","","191.5","","841811.83"
"2025-02-26","2025-02-22","SF FuneralF798624       250222","","126.5","","841938.33"
"2025-02-26","2025-02-22","SF FuneralF992692       250222","","126.5","","842064.83"
"2025-02-26","2025-02-22","SF FuneralF1054651      250222","","126.5","","842191.33"
"2025-02-26","2025-02-22","SF FuneralF1079388      250222","","126.5","","842317.83"
"2025-02-26","2025-02-22","SF FuneralF1100804      250222","","126.5","","842444.33"
"2025-02-26","2025-02-22","SF FuneralF1113628      250222","","126.5","","842570.83"
"2025-02-26","2025-02-22","SF FuneralF1120188      250222","","256.5","","842827.33"
"2025-02-26","2025-02-22","SF FuneralFDC0000000P3N3250222","","126.5","","842953.83"
"2025-02-26","2025-02-25","SF FuneralFDC000000031YB250225","","220","","843173.83"
"2025-02-26","2025-02-25","SF FuneralF808612       250225","","126.5","","843300.33"
"2025-02-26","2025-02-23","SF FuneralF815982       250223","","126.5","","843426.83"
"2025-02-26","2025-02-20","SF FuneralF992427       250220","","126.5","","843553.33"
"2025-02-26","2025-02-24","SF FuneralFDC00000002XYZ250223","","55","","843608.33"
"2025-02-26","2025-02-24","SF FuneralF843408       250222","","126.5","","843734.83"
"2025-02-26","2025-02-24","SF FuneralF786846       250224","","126.5","","843861.33"
"2025-02-26","2025-02-24","SF FuneralF1067980      250224","","126.5","","843987.83"
"2025-02-26","2025-02-24","SF FuneralF1085166      250224","","126.5","","844114.33"
"2025-02-26","2025-02-24","SF FuneralF1129890      250224","","126.5","","844240.83"
"2025-02-26","2025-02-26","SF FuneralFDC000000074NN250226","","126.5","","844367.33"
"2025-02-26","2025-02-17","SF FuneralFDC00000006MWP250216","","63.25","","844430.58"
"2025-02-26","2025-02-22","SF FuneralFDC00000006JPK250222","","126.5","","844557.08"
"2025-02-26","2025-02-22","SF FuneralFDC00000007CHH250222","","126.5","","844683.58"
"2025-02-26","2025-02-22","SF FuneralF1020528      250222","","126.5","","844810.08"
"2025-02-26","2025-02-22","SF FuneralF1112299      250223","","126.5","","844936.58"
"2025-02-26","2025-02-22","SF FuneralF1129917      250223","","31.63","","844968.21"
"2025-02-26","2025-02-22","SF FuneralFDC0000000JY24250223","","31.63","","844999.84"
"2025-02-26","2025-02-24","SF FuneralFDC00000005X05250224","","126.5","","845126.34"
"2025-02-26","2025-02-24","SF FuneralF820309       250224","","126.5","","845252.84"
"2025-02-26","2025-02-25","SF FuneralF802429       250225","","126.5","","845379.34"
"2025-02-26","2025-02-26","SF FuneralFDC00000006B87250226","","126.5","","845505.84"
"2025-02-27","2025-02-22","SF FuneralF1083875      250222","","126.5","","845632.34"
"2025-02-27","2025-02-22","SF FuneralFDC0000000BHLR250222","","220","","845852.34"
"2025-02-27","2025-02-24","SF FuneralF1128771      250224","","126.5","","845978.84"
"2025-02-27","2025-02-25","SF FuneralF795930       250225","","126.5","","846105.34"
"2025-02-27","2025-02-17","SF FuneralFDC00000006NPV250216","","110","","846215.34"
"2025-02-27","2025-02-18","SF FuneralF1073281      250218","","63.25","","846278.59"
"2025-02-27","2025-02-21","SF FuneralFDC00000003JQF250221","","220","","846498.59"
"2025-02-27","2025-02-21","SF FuneralFDC0000000HTQF250223","","126.5","","846625.09"
"2025-02-27","2025-02-21","SF FuneralF990824       250222","","126.5","","846751.59"
"2025-02-27","2025-02-21","SF FuneralF991083       250222","","126.5","","846878.09"
"2025-02-27","2025-02-21","SF FuneralF1059290      250221","","126.5","","847004.59"
"2025-02-27","2025-02-21","SF FuneralF1125171      250221","","126.5","","847131.09"
"2025-02-27","2025-02-22","SF FuneralFDC000000031K0250222","","220","","847351.09"
"2025-02-27","2025-02-22","SF FuneralFDC0000000610D250222","","126.5","","847477.59"
"2025-02-27","2025-02-22","SF FuneralFDC00000006NKJ250222","","126.5","","847604.09"
"2025-02-27","2025-02-22","SF FuneralFDC00000006T7D250222","","126.5","","847730.59"
"2025-02-27","2025-02-22","SF FuneralFDC00000006YGZ250222","","126.5","","847857.09"
"2025-02-27","2025-02-22","SF FuneralFDC00000007LNV250222","","126.5","","847983.59"
"2025-02-27","2025-02-22","SF FuneralF817171       250222","","126.5","","848110.09"
"2025-02-27","2025-02-22","SF FuneralFDC0000000BM1M250222","","126.5","","848236.59"
"2025-02-27","2025-02-22","SF FuneralF1058639      250222","","126.5","","848363.09"
"2025-02-27","2025-02-22","SF FuneralF1083598      250223","","126.5","","848489.59"
"2025-02-27","2025-02-22","SF FuneralF1116000      250223","","126.5","","848616.09"
"2025-02-27","2025-02-22","SF FuneralFDC0000000NLPJ250223","","126.5","","848742.59"
"2025-02-27","2025-02-22","SF FuneralF1120215      250223","","126.5","","848869.09"
"2025-02-27","2025-02-24","SF FuneralFDC000000069NW250224","","126.5","","848995.59"
"2025-02-27","2025-02-24","SF FuneralFDC00000006H5X250224","","126.5","","849122.09"
"2025-02-27","2025-02-24","SF FuneralFDC00000006KV4250223","","126.5","","849248.59"
"2025-02-27","2025-02-24","SF FuneralFDC00000006RN5250224","","126.5","","849375.09"
"2025-02-27","2025-02-24","SF FuneralF809717       250224","","63.25","","849438.34"
"2025-02-27","2025-02-24","SF FuneralF815872       250224","","126.5","","849564.84"
"2025-02-27","2025-02-24","SF FuneralF822342       250224","","126.5","","849691.34"
"2025-02-27","2025-02-24","SF FuneralF847256       250224","","126.5","","849817.84"
"2025-02-27","2025-02-24","SF FuneralF1055233      250224","","126.5","","849944.34"
"2025-02-27","2025-02-24","SF FuneralF1059711      250224","","126.5","","850070.84"
"2025-02-27","2025-02-24","SF FuneralFDC0000000LCXG250224","","126.5","","850197.34"
"2025-02-27","2025-02-24","SF FuneralF1114500      250224","","126.5","","850323.84"
"2025-02-27","2025-02-24","SF FuneralF1120325      250224","","126.5","","850450.34"
"2025-02-27","2025-02-24","SF FuneralF1120690      250224","","126.5","","850576.84"
"2025-02-27","2025-02-24","SF FuneralF1124548      250224","","126.5","","850703.34"
"2025-02-27","2025-02-25","SF FuneralF1084442      250225","","126.5","","850829.84"
"2025-02-27","2025-02-25","SF FuneralF1120244      250225","","126.5","","850956.34"
"2025-02-27","2025-02-25","SF FuneralF1124825      250225","","126.5","","851082.84"
"2025-02-27","2025-02-25","SF FuneralFDC0000000PSLJ250225","","126.5","","851209.34"
"2025-02-27","2025-02-25","SF FuneralF1127891      250225","","126.5","","851335.84"
"2025-02-27","2025-02-25","SF FuneralF1130786      250225","","126.5","","851462.34"
"2025-02-27","2025-02-25","SF FuneralF1131847      250225","","126.5","","851588.84"
"2025-02-27","2025-02-26","SF FuneralF992367       250226","","126.5","","851715.34"
"2025-02-27","2025-02-26","SF FuneralFDC0000000JG8W250226","","126.5","","851841.84"
"2025-02-27","2025-02-18","SF FuneralF830994       250218","","63.25","","851905.09"
"2025-02-27","2025-02-21","SF FuneralFDC00000008FRT250221","","126.5","","852031.59"
"2025-02-27","2025-02-22","SF FuneralF1074909      250223","","126.5","","852158.09"
"2025-02-27","2025-02-22","SF FuneralF1112270      250222","","126.5","","852284.59"
"2025-02-27","2025-02-24","SF FuneralF807982       250223","","126.5","","852411.09"
"2025-02-27","2025-02-24","SF FuneralFDC00000009XDL250224","","126.5","","852537.59"
"2025-02-27","2025-02-24","SF FuneralF820012       250224","","31.63","","852569.22"
"2025-02-27","2025-02-24","SF FuneralF1108874      250224","","126.5","","852695.72"
"2025-02-27","2025-02-24","SF FuneralF1119905      250224","","126.5","","852822.22"
"2025-02-27","2025-02-25","SF FuneralFDC00000005L57250225","","31.63","","852853.85"
"2025-02-27","2025-02-26","SF FuneralFDC000000064GW250226","","31.63","","852885.48"
"2025-02-27","2025-02-26","SF FuneralF1124138      250226","","31.63","","852917.11"
"2025-02-27","2025-02-24","SF FuneralFDC00000005YNL250224","","55","","852972.11"
"2025-02-27","2025-02-24","SF FuneralFDC000000087G6250223","","31.63","","853003.74"
"2025-02-27","2025-02-18","SF FuneralFDC00000007DNK250218","","63.25","","853066.99"
"2025-02-27","2025-02-22","SF FuneralF810118       250222","","126.5","","853193.49"
"2025-02-27","2025-02-24","SF FuneralFDC00000007QR9250223","","126.5","","853319.99"
"2025-02-27","2025-02-24","SF FuneralFDC00000008JC5250224","","126.5","","853446.49"
"2025-02-27","2025-02-24","SF FuneralFDC0000000J1YG250224","","126.5","","853572.99"
"2025-02-27","2025-02-24","SF FuneralFDC0000000L76X250224","","126.5","","853699.49"
"2025-02-27","2025-02-24","SF FuneralF1074515      250224","","126.5","","853825.99"
"2025-02-27","2025-02-25","SF FuneralFDC00000007LN5250225","","126.5","","853952.49"
"2025-02-27","2025-02-25","SF FuneralF833557       250225","","63.25","","854015.74"
"2025-02-27","2025-02-25","SF FuneralF987501       250225","","126.5","","854142.24"
"2025-02-27","2025-02-25","SF FuneralF1079262      250225","","126.5","","854268.74"
"2025-02-27","2025-02-26","SF FuneralF1120885      250226","","126.5","","854395.24"
"2025-02-27","2025-02-17","SF FuneralFDC00000006GCJ250217","","126.5","","854521.74"
"2025-02-27","2025-02-19","SF FuneralF900289       250219","","126.5","","854648.24"
"2025-02-27","2025-02-19","SF FuneralFDC0000000H00Z250219","","126.5","","854774.74"
"2025-02-27","2025-02-19","SF FuneralF900778       250219","","126.5","","854901.24"
"2025-02-27","2025-02-20","SF FuneralFDC000000069VM250220","","126.5","","855027.74"
"2025-02-27","2025-02-20","SF FuneralF1118467      250220","","126.5","","855154.24"
"2025-02-27","2025-02-21","SF FuneralFDC00000006MTQ250221","","126.5","","855280.74"
"2025-02-27","2025-02-21","SF FuneralF988068       250222","","126.5","","855407.24"
"2025-02-27","2025-02-22","SF FuneralFDC00000005MT5250222","","220","","855627.24"
"2025-02-27","2025-02-22","SF FuneralFDC00000007BJC250222","","126.5","","855753.74"
"2025-02-27","2025-02-22","SF FuneralFDC000000081HV250222","","126.5","","855880.24"
"2025-02-27","2025-02-22","SF FuneralFDC0000000BVXW250222","","126.5","","856006.74"
"2025-02-27","2025-02-22","SF FuneralF993765       250222","","126.5","","856133.24"
"2025-02-27","2025-02-22","SF FuneralF1055158      250223","","126.5","","856259.74"
"2025-02-27","2025-02-22","SF FuneralF1055288      250223","","126.5","","856386.24"
"2025-02-27","2025-02-22","SF FuneralF1074877      250222","","126.5","","856512.74"
"2025-02-27","2025-02-22","SF FuneralF1083602      250223","","126.5","","856639.24"
"2025-02-27","2025-02-22","SF FuneralF1085055      250223","","126.5","","856765.74"
"2025-02-27","2025-02-22","SF FuneralF1103905      250223","","126.5","","856892.24"
"2025-02-27","2025-02-22","SF FuneralF1108345      250222","","126.5","","857018.74"
"2025-02-27","2025-02-22","SF FuneralF787835       250223","","126.5","","857145.24"
"2025-02-27","2025-02-22","SF FuneralF1115841      250223","","126.5","","857271.74"
"2025-02-27","2025-02-22","SF FuneralF1117923      250222","","126.5","","857398.24"
"2025-02-27","2025-02-22","SF FuneralF1120320      250223","","126.5","","857524.74"
"2025-02-27","2025-02-24","SF FuneralFDC00000007MBZ250224","","126.5","","857651.24"
"2025-02-27","2025-02-24","SF FuneralF808894       250223","","126.5","","857777.74"
"2025-02-27","2025-02-24","SF FuneralF819744       250223","","126.5","","857904.24"
"2025-02-27","2025-02-24","SF FuneralF988585       250224","","126.5","","858030.74"
"2025-02-27","2025-02-24","SF FuneralFDC0000000JXV3250224","","126.5","","858157.24"
"2025-02-27","2025-02-24","SF FuneralF1119767      250224","","126.5","","858283.74"
"2025-02-27","2025-02-24","SF FuneralFDC0000000PB42250224","","126.5","","858410.24"
"2025-02-27","2025-02-25","SF FuneralFDC0000000761J250225","","126.5","","858536.74"
"2025-02-27","2025-02-25","SF FuneralF1131282      250225","","126.5","","858663.24"
"2025-02-27","2025-02-25","SF FuneralFDC0000000Q6DN250225","","126.5","","858789.74"
"2025-02-27","2025-02-25","SF FuneralF1131907      250225","","126.5","","858916.24"
"2025-02-27","2025-02-26","SF FuneralFDC0000000MLBX250226","","126.5","","859042.74"
"2025-02-27","2025-02-21","SF FuneralFDC00000003JQR250221","","220","","859262.74"
"2025-02-27","2025-02-21","SF FuneralF819362       250221","","31.63","","859294.37"
"2025-02-27","2025-02-22","SF FuneralF817708       250222","","126.5","","859420.87"
"2025-02-27","2025-02-22","SF FuneralF827733       250222","","126.5","","859547.37"
"2025-02-27","2025-02-22","SF FuneralF1127813      250222","","126.5","","859673.87"
"2025-02-27","2025-02-24","SF FuneralFDC00000005LQV250224","","31.63","","859705.5"
"2025-02-27","2025-02-24","SF FuneralFDC00000005LX1250223","","63.25","","859768.75"
"2025-02-27","2025-02-24","SF FuneralFDC00000005MZK250223","","126.5","","859895.25"
"2025-02-27","2025-02-24","SF FuneralFDC00000005YW3250224","","31.63","","859926.88"
"2025-02-27","2025-02-24","SF FuneralFDC00000007DM5250224","","126.5","","860053.38"
"2025-02-27","2025-02-24","SF FuneralFDC00000007F6S250223","","63.25","","860116.63"
"2025-02-27","2025-02-24","SF FuneralF819012       250224","","31.63","","860148.26"
"2025-02-27","2025-02-24","SF FuneralFDC0000000NNR0250224","","126.5","","860274.76"
"2025-02-27","2025-02-24","SF FuneralF1118466      250224","","126.5","","860401.26"
"2025-02-27","2025-02-25","SF FuneralF814338       250225","","31.63","","860432.89"
"2025-02-27","2025-02-25","SF FuneralF823831       250225","","126.5","","860559.39"
"2025-02-27","2025-02-25","SF FuneralF1022224      250225","","126.5","","860685.89"
"2025-02-27","2025-02-25","SF FuneralF782215       250225","","191.5","","860877.39"
"2025-02-27","2025-02-25","SF FuneralF1083909      250225","","126.5","","861003.89"
"2025-02-27","2025-02-25","SF FuneralF1120277      250225","","126.5","","861130.39"
"2025-02-27","2025-02-25","SF FuneralF1127391      250225","","126.5","","861256.89"
"2025-02-27","2025-02-26","SF FuneralFDC000000071CH250226","","126.5","","861383.39"
"2025-02-27","2025-02-26","SF FuneralF808993       250226","","126.5","","861509.89"
"2025-02-27","2025-02-18","SF FuneralF993574       250218","","126.5","","861636.39"
"2025-02-27","2025-02-22","SF FuneralFDC000000087Y8250222","","63.25","","861699.64"
"2025-02-27","2025-02-22","SF FuneralF800917       250222","","126.5","","861826.14"
"2025-02-27","2025-02-22","SF FuneralF808276       250222","","126.5","","861952.64"
"2025-02-27","2025-02-22","SF FuneralF831947       250222","","126.5","","862079.14"
"2025-02-27","2025-02-22","SF FuneralFDC0000000DZGP250222","","126.5","","862205.64"
"2025-02-27","2025-02-22","SF FuneralFDC0000000DZGT250222","","126.5","","862332.14"
"2025-02-27","2025-02-22","SF FuneralFDC0000000K4ZG250223","","126.5","","862458.64"
"2025-02-27","2025-02-22","SF FuneralF1108312      250223","","126.5","","862585.14"
"2025-02-27","2025-02-22","SF FuneralF1116076      250222","","126.5","","862711.64"
"2025-02-27","2025-02-22","SF FuneralFDC0000000P7KT250222","","126.5","","862838.14"
"2025-02-27","2025-02-22","SF FuneralF1130966      250222","","126.5","","862964.64"
"2025-02-27","2025-02-24","SF FuneralF801534       250223","","126.5","","863091.14"
"2025-02-27","2025-02-24","SF FuneralF811504       250224","","126.5","","863217.64"
"2025-02-27","2025-02-24","SF FuneralF840573       250223","","126.5","","863344.14"
"2025-02-27","2025-02-24","SF FuneralF1021258      250224","","126.5","","863470.64"
"2025-02-27","2025-02-24","SF FuneralF1118003      250224","","126.5","","863597.14"
"2025-02-27","2025-02-25","SF FuneralFDC00000007NHT250225","","126.5","","863723.64"
"2025-02-27","2025-02-25","SF FuneralF992513       250225","","126.5","","863850.14"
"2025-02-27","2025-02-25","SF FuneralF1108307      250225","","126.5","","863976.64"
"2025-02-27","2025-02-25","SF FuneralF1112340      250225","","126.5","","864103.14"
"2025-02-27","2025-02-25","SF FuneralF1112365      250225","","126.5","","864229.64"
"2025-02-27","2025-02-25","SF FuneralFDC0000000NPVZ250225","","126.5","","864356.14"
"2025-02-27","2025-02-25","SF FuneralF1132059      250225","","126.5","","864482.64"
"2025-02-27","2025-02-26","SF FuneralF812958       250226","","126.5","","864609.14"
"2025-02-27","2025-02-26","SF FuneralF813112       250226","","126.5","","864735.64"
"2025-02-27","2025-02-26","SF FuneralF830003       250226","","126.5","","864862.14"
"2025-02-27","2025-02-26","SF FuneralF833656       250226","","126.5","","864988.64"
"2025-02-27","2025-02-22","SF FuneralFDC0000000JVCB250223","","31.63","","865020.27"
"2025-02-27","2025-02-22","SF FuneralF1054743      250223","","31.63","","865051.9"
"2025-02-27","2025-02-22","SF FuneralF1074576      250223","","31.63","","865083.53"
"2025-02-27","2025-02-22","SF FuneralFDC0000000LNR4250223","","31.63","","865115.16"
"2025-02-27","2025-02-22","SF FuneralFDC0000000PZBG250223","","31.63","","865146.79"
"2025-02-27","2025-02-24","SF FuneralF802251       250224","","31.63","","865178.42"
"2025-02-27","2025-02-24","SF FuneralF804126       250224","","31.63","","865210.05"
"2025-02-27","2025-02-24","SF FuneralF814448       250223","","31.63","","865241.68"
"2025-02-27","2025-02-24","SF FuneralF834650       250223","","31.63","","865273.31"
"2025-02-27","2025-02-24","SF FuneralFDC0000000K09V250224","","31.63","","865304.94"
"2025-02-27","2025-02-24","SF FuneralF1079351      250224","","31.63","","865336.57"
"2025-02-27","2025-02-24","SF FuneralF1122727      250224","","31.63","","865368.2"
"2025-02-27","2025-02-25","SF FuneralF816581       250225","","31.63","","865399.83"
"2025-02-27","2025-02-22","SF FuneralF797281       250222","","126.5","","865526.33"
"2025-02-27","2025-02-22","SF FuneralFDC000000081RY250222","","126.5","","865652.83"
"2025-02-27","2025-02-22","SF FuneralF1117166      250222","","126.5","","865779.33"
"2025-02-27","2025-02-24","SF FuneralFDC000000066G8250224","","126.5","","865905.83"
"2025-02-27","2025-02-24","SF FuneralF805875       250223","","63.25","","865969.08"
"2025-02-27","2025-02-24","SF FuneralF1109596      250224","","126.5","","866095.58"
"2025-02-27","2025-02-24","SF FuneralF1112311      250224","","126.5","","866222.08"
"2025-02-27","2025-02-24","SF FuneralF1132233      250224","","126.5","","866348.58"
"2025-02-27","2025-02-25","SF FuneralFDC00000002R5L250225","","220","","866568.58"
"2025-02-27","2025-02-25","SF FuneralFDC00000005ZDF250225","","126.5","","866695.08"
"2025-02-27","2025-02-25","SF FuneralFDC00000006GN2250225","","126.5","","866821.58"
"2025-02-27","2025-02-25","SF FuneralFDC0000000719J250225","","126.5","","866948.08"
"2025-02-27","2025-02-25","SF FuneralFDC00000007N5C250225","","126.5","","867074.58"
"2025-02-27","2025-02-25","SF FuneralF807966       250225","","126.5","","867201.08"
"2025-02-27","2025-02-25","SF FuneralF1054763      250225","","126.5","","867327.58"
"2025-02-27","2025-02-25","SF FuneralF1103537      250225","","126.5","","867454.08"
"2025-02-27","2025-02-25","SF FuneralF1124199      250225","","126.5","","867580.58"
"2025-02-27","2025-02-25","SF FuneralF1129921      250225","","126.5","","867707.08"
"2025-02-27","2025-02-25","SF FuneralF1131780      250225","","126.5","","867833.58"
"2025-02-27","2025-02-26","SF FuneralFDC0000000NJ6M250226","","126.5","","867960.08"
"2025-02-27","2025-02-25","SF FuneralFDC000000075W6250225","","126.5","","868086.58"
"2025-02-27","2025-02-23","SF FuneralF827721       250223","","126.5","","868213.08"
"2025-02-27","2025-02-23","SF FuneralF831958       250223","","126.5","","868339.58"
"2025-02-27","2025-02-22","SF FuneralF808243       250222","","126.5","","868466.08"
"2025-02-27","2025-02-22","SF FuneralF1021491      250223","","31.63","","868497.71"
"2025-02-27","2025-02-27","SF FuneralFDC000000069YV250227","","126.5","","868624.21"
"2025-02-27","2025-02-27","SF FuneralFDC00000008LDC250227","","126.5","","868750.71"
"2025-02-27","2025-02-27","SF FuneralF827821       250227","","126.5","","868877.21"
"2025-02-27","2025-02-27","SF FuneralF840895       250227","","126.5","","869003.71"
"2025-02-27","2025-02-27","SF FuneralF1079635      250227","","126.5","","869130.21"
"2025-02-27","2025-02-27","SF FuneralF1108246      250227","","126.5","","869256.71"
"2025-02-27","2025-02-27","SF FuneralF1112408      250227","","126.5","","869383.21"
"2025-02-27","2025-02-27","SF FuneralFDC0000000N823250227","","126.5","","869509.71"
"2025-02-27","2025-02-21","SF FuneralF842194       250221","","126.5","","869636.21"
"2025-02-27","2025-02-21","SF FuneralF987537       250222","","126.5","","869762.71"
"2025-02-27","2025-02-25","SF FuneralFDC000000068HC250225","","126.5","","869889.21"
"2025-02-27","2025-02-25","SF FuneralFDC00000006YL8250225","","126.5","","870015.71"
"2025-02-27","2025-02-25","SF FuneralFDC00000007DQ7250225","","126.5","","870142.21"
"2025-02-27","2025-02-25","SF FuneralFDC00000007M4S250225","","126.5","","870268.71"
"2025-02-27","2025-02-25","SF FuneralFDC00000008C4Y250225","","63.25","","870331.96"
"2025-02-27","2025-02-25","SF FuneralF810426       250225","","31.63","","870363.59"
"2025-02-27","2025-02-25","SF FuneralF813503       250225","","31.63","","870395.22"
"2025-02-27","2025-02-25","SF FuneralF820256       250225","","126.5","","870521.72"
"2025-02-27","2025-02-25","SF FuneralF1123172      250225","","31.63","","870553.35"
"2025-02-27","2025-02-24","SF FuneralFDC00000004V81250223","","220","","870773.35"
"2025-02-27","2025-02-24","SF FuneralFDC00000006HD2250223","","126.5","","870899.85"
"2025-02-27","2025-02-24","SF FuneralFDC000000074J4250224","","126.5","","871026.35"
"2025-02-27","2025-02-24","SF FuneralF1113735      250224","","31.63","","871057.98"
"2025-02-27","2025-02-24","SF FuneralF1120655      250224","","31.63","","871089.61"
"2025-02-27","2025-02-24","SF FuneralF1124840      250224","","126.5","","871216.11"
"2025-02-27","2025-02-24","SF FuneralFDC0000000PNWZ250224","","126.5","","871342.61"
"2025-02-27","2025-02-24","SF FuneralF1131807      250224","","126.5","","871469.11"
"2025-02-27","2025-02-26","SF FuneralF829643       250226","","126.5","","871595.61"
"2025-02-27","2025-02-27","SF FuneralFDC00000008H5N250227","","126.5","","871722.11"
"2025-02-27","2025-02-27","SF FuneralF802160       250227","","126.5","","871848.61"
"2025-02-27","2025-02-27","SF FuneralFDC00000009DS8250227","","126.5","","871975.11"
"2025-02-27","2025-02-27","SF FuneralF813695       250227","","126.5","","872101.61"
"2025-02-27","2025-02-27","SF FuneralF842484       250227","","126.5","","872228.11"
"2025-02-27","2025-02-27","SF FuneralFDC0000000KPHL250227","","126.5","","872354.61"
"2025-02-27","2025-02-27","SF FuneralF1122713      250227","","126.5","","872481.11"
"2025-02-27","2025-02-27","SF FuneralF813217       250227","","126.5","","872607.61"
"2025-02-27","2025-02-27","SF FuneralF1073559      250227","","126.5","","872734.11"
"2025-02-27","2025-02-27","SF FuneralF1110630      250227","","126.5","","872860.61"
"2025-02-27","2025-02-27","SF FuneralFDC0000000NPRY250227","","126.5","","872987.11"
"2025-02-27","2025-02-27","SF FuneralF1120826      250227","","126.5","","873113.61"
"2025-02-27","2025-02-27","SF FuneralFDC00000005N6M250227","","31.63","","873145.24"
"2025-02-27","2025-02-27","SF FuneralF829020       250227","","31.63","","873176.87"
"2025-02-27","2025-02-21","SF FuneralF843246       250221","","31.63","","873208.5"
"2025-02-27","2025-02-22","SF FuneralF822852       250222","","31.63","","873240.13"
"2025-02-27","2025-02-22","SF FuneralF1017512      250223","","31.63","","873271.76"
"2025-02-27","2025-02-24","SF FuneralFDC000000067C7250224","","31.63","","873303.39"
"2025-02-27","2025-02-24","SF FuneralF818028       250224","","31.63","","873335.02"
"2025-02-27","2025-02-25","SF FuneralFDC00000008C95250225","","31.63","","873366.65"
"2025-02-27","2025-02-25","SF FuneralF823596       250225","","31.63","","873398.28"
"2025-02-27","2025-02-25","SF FuneralF799620       250225","","64.13","","873462.41"
"2025-02-27","2025-02-27","SF FuneralFDC00000006Q3V250227","","31.63","","873494.04"
"2025-02-27","2025-02-21","SF FuneralF818785       250221","","31.63","","873525.67"
"2025-02-27","2025-02-21","SF FuneralFDC00000006ZP5250221","","31.63","","873557.3"
"2025-02-27","2025-02-21","SF FuneralF812905       250221","","31.63","","873588.93"
"2025-02-27","2025-02-24","SF FuneralFDC00000008MY8250223","","31.63","","873620.56"
"2025-02-27","2025-02-24","SF FuneralFDC00000009958250224","","31.63","","873652.19"
"2025-02-27","2025-02-24","SF FuneralF811324       250224","","112.88","","873765.07"
"2025-02-27","2025-02-25","SF FuneralF809823       250225","","31.63","","873796.7"
"2025-02-27","2025-02-25","SF FuneralF828129       250225","","31.63","","873828.33"
"2025-02-27","2025-02-21","SF FuneralFDC000000032VH250221","","55","","873883.33"
"2025-02-27","2025-02-21","SF FuneralFDC00000005RS3250221","","31.63","","873914.96"
"2025-02-27","2025-02-24","SF FuneralF988318       250224","","31.63","","873946.59"
"2025-02-27","2025-02-24","SF FuneralF1068000      250224","","31.63","","873978.22"
"2025-02-27","2025-02-24","SF FuneralF1130901      250224","","31.63","","874009.85"
"2025-02-27","2025-02-22","SF FuneralF815008       250222","","126.5","","874136.35"
"2025-02-27","2025-02-22","SF FuneralF1085475      250222","","126.5","","874262.85"
"2025-02-27","2025-02-24","SF FuneralFDC00000003GV3250224","","220","","874482.85"
"2025-02-27","2025-02-24","SF FuneralFDC0000000615C250224","","126.5","","874609.35"
"2025-02-27","2025-02-24","SF FuneralFDC000000075T7250224","","126.5","","874735.85"
"2025-02-27","2025-02-24","SF FuneralFDC0000000867C250224","","126.5","","874862.35"
"2025-02-27","2025-02-24","SF FuneralF812016       250224","","126.5","","874988.85"
"2025-02-27","2025-02-24","SF FuneralF821685       250224","","126.5","","875115.35"
"2025-02-27","2025-02-24","SF FuneralF1074651      250224","","126.5","","875241.85"
"2025-02-27","2025-02-24","SF FuneralF1074695      250224","","126.5","","875368.35"
"2025-02-27","2025-02-27","SF FuneralFDC00000002XTX250227","","110","","875478.35"
"2025-02-27","2025-02-18","SF FuneralF829119       250218","","63.25","","875541.6"
"2025-02-27","2025-02-27","SF FuneralF1128128      250227","","126.5","","875668.1"
"2025-02-27","2025-02-22","SF FuneralF991596       250223","","126.5","","875794.6"
"2025-02-27","2025-02-22","SF FuneralF1112038      250222","","126.5","","875921.1"
"2025-02-27","2025-02-22","SF FuneralF1120548      250222","","126.5","","876047.6"
"2025-02-27","2025-02-24","SF FuneralFDC00000005D9R250224","","126.5","","876174.1"
"2025-02-27","2025-02-24","SF FuneralFDC00000006CNL250224","","126.5","","876300.6"
"2025-02-27","2025-02-24","SF FuneralF818902       250223","","126.5","","876427.1"
"2025-02-27","2025-02-24","SF FuneralF1120189      250224","","126.5","","876553.6"
"2025-02-27","2025-02-24","SF FuneralFDC0000000P5GG250224","","126.5","","876680.1"
"2025-02-27","2025-02-24","SF FuneralF1129483      250224","","126.5","","876806.6"
"2025-02-27","2025-02-24","SF FuneralF1129493      250224","","126.5","","876933.1"
"2025-02-27","2025-02-25","SF FuneralF1116033      250225","","126.5","","877059.6"
"2025-02-27","2025-02-27","SF FuneralF1074957      250227","","126.5","","877186.1"
"2025-02-27","2025-02-27","SF FuneralF992543       250227","","126.5","","877312.6"
"2025-02-27","2025-02-27","SF FuneralF1118918      250227","","126.5","","877439.1"
"2025-02-27","2025-02-27","SF FuneralF1120528      250227","","126.5","","877565.6"
"2025-02-27","2025-02-24","SF FuneralF1120145      250224","","126.5","","877692.1"
"2025-02-27","2025-02-26","SF FuneralFDC0000000JGRR250226","","126.5","","877818.6"
"2025-02-27","2025-02-27","SF FuneralF833929       250227","","126.5","","877945.1"
"2025-02-27","2025-02-27","SF FuneralF834878       250227","","126.5","","878071.6"
"2025-02-27","2025-02-27","SF FuneralFDC0000000N89V250227","","126.5","","878198.1"
"2025-02-27","2025-02-21","SF FuneralF987257       250222","","126.5","","878324.6"
"2025-02-27","2025-02-22","SF FuneralFDC00000007TZX250222","","126.5","","878451.1"
"2025-02-27","2025-02-22","SF FuneralF815500       250222","","126.5","","878577.6"
"2025-02-27","2025-02-22","SF FuneralFDC0000000J62Q250222","","126.5","","878704.1"
"2025-02-27","2025-02-22","SF FuneralF991896       250222","","126.5","","878830.6"
"2025-02-27","2025-02-22","SF FuneralF1102905      250223","","126.5","","878957.1"
"2025-02-27","2025-02-22","SF FuneralFDC0000000M30C250223","","126.5","","879083.6"
"2025-02-27","2025-02-22","SF FuneralF1108642      250222","","126.5","","879210.1"
"2025-02-27","2025-02-22","SF FuneralF1108790      250222","","126.5","","879336.6"
"2025-02-27","2025-02-24","SF FuneralFDC0000000614B250224","","126.5","","879463.1"
"2025-02-27","2025-02-24","SF FuneralF823421       250224","","126.5","","879589.6"
"2025-02-27","2025-02-24","SF FuneralF834154       250224","","126.5","","879716.1"
"2025-02-27","2025-02-24","SF FuneralF992260       250224","","126.5","","879842.6"
"2025-02-27","2025-02-24","SF FuneralF1084272      250224","","126.5","","879969.1"
"2025-02-27","2025-02-27","SF FuneralFDC00000008QXW250227","","126.5","","880095.6"
"2025-02-27","2025-02-27","SF FuneralF1072976      250227","","126.5","","880222.1"
"2025-02-27","2025-02-27","SF FuneralFDC0000000MQNT250227","","126.5","","880348.6"
"2025-02-27","2025-02-27","SF FuneralFDC00000006QQP250227","","126.5","","880475.1"
"2025-02-27","2025-02-27","SF FuneralFDC00000006QQQ250227","","126.5","","880601.6"
"2025-02-27","2025-02-27","SF FuneralFDC00000006SD3250227","","126.5","","880728.1"
"2025-02-27","2025-02-27","SF FuneralFDC00000006TK3250227","","126.5","","880854.6"
"2025-02-27","2025-02-27","SF FuneralF989143       250227","","126.5","","880981.1"
"2025-02-27","2025-02-27","SF FuneralFDC0000000JD19250227","","126.5","","881107.6"
"2025-02-27","2025-02-27","SF FuneralF1068192      250227","","126.5","","881234.1"
"2025-02-27","2025-02-27","SF FuneralF1078639      250227","","213.31","","881447.41"
"2025-02-27","2025-02-24","SF FuneralF802560       250224","","126.5","","881573.91"
"2025-02-27","2025-02-24","SF FuneralF1084839      250224","","126.5","","881700.41"
"2025-02-27","2025-02-25","SF FuneralFDC00000008LS5250225","","126.5","","881826.91"
"2025-02-27","2025-02-25","SF FuneralF818304       250225","","126.5","","881953.41"
"2025-02-27","2025-02-26","SF FuneralFDC0000000P186250226","","126.5","","882079.91"
"2025-02-27","2025-02-26","SF FuneralF1122569      250226","","126.5","","882206.41"
"2025-02-27","2025-02-25","SF FuneralF1112232      250225","","126.5","","882332.91"
"2025-02-27","2025-02-26","SF FuneralF991184       250226","","126.5","","882459.41"
"2025-02-27","2025-02-27","SF FuneralF990402       250227","","126.5","","882585.91"
"2025-02-27","2025-02-24","SF FuneralF809517       250223","","126.5","","882712.41"
"2025-02-27","2025-02-24","SF FuneralF1132335      250224","","126.5","","882838.91"
"2025-02-27","2025-02-25","SF FuneralFDC00000007FRN250225","","220","","883058.91"
"2025-02-27","2025-02-27","SF FuneralF900708       250227","","126.5","","883185.41"
"2025-02-27","2025-02-27","SF FuneralFDC0000000H9BG250227","","126.5","","883311.91"
"2025-02-27","2025-02-27","SF FuneralF1128198      250227","","126.5","","883438.41"
"2025-02-27","2025-02-19","SF FuneralFDC00000006CWS250219","","126.5","","883564.91"
"2025-02-27","2025-02-22","SF FuneralF1068091      250222","","126.5","","883691.41"
"2025-02-27","2025-02-24","SF FuneralFDC0000000600R250224","","126.5","","883817.91"
"2025-02-27","2025-02-24","SF FuneralFDC00000006L4X250224","","126.5","","883944.41"
"2025-02-27","2025-02-24","SF FuneralFDC00000006RPR250224","","126.5","","884070.91"
"2025-02-27","2025-02-24","SF FuneralFDC0000000HYZ4250224","","126.5","","884197.41"
"2025-02-27","2025-02-24","SF FuneralF1017430      250224","","126.5","","884323.91"
"2025-02-27","2025-02-24","SF FuneralF1114700      250224","","126.5","","884450.41"
"2025-02-27","2025-02-27","SF FuneralFDC00000002XFJ250227","","220","","884670.41"
"2025-02-27","2025-02-27","SF FuneralFDC000000032FF250227","","220","","884890.41"
"2025-02-27","2025-02-21","SF FuneralF987858       250222","","126.5","","885016.91"
"2025-02-27","2025-02-22","SF FuneralF820884       250222","","126.5","","885143.41"
"2025-02-27","2025-02-22","SF FuneralF991688       250222","","126.5","","885269.91"
"2025-02-27","2025-02-25","SF FuneralF1020834      250225","","126.5","","885396.41"
"2025-02-27","2025-02-25","SF FuneralF1132057      250225","","126.5","","885522.91"
"2025-02-27","2025-02-26","SF FuneralF813581       250226","","63.25","","885586.16"
"2025-02-27","2025-02-27","SF FuneralFDC0000000PBGN250227","","126.5","","885712.66"
"2025-02-27","2025-02-24","SF FuneralFDC000000074VZ250224","","126.5","","885839.16"
"2025-02-27","2025-02-24","SF FuneralF1117359      250224","","126.5","","885965.66"
"2025-02-27","2025-02-25","SF FuneralFDC000000030F5250225","","220","","886185.66"
"2025-02-27","2025-02-25","SF FuneralF831654       250225","","63.25","","886248.91"
"2025-02-27","2025-02-25","SF FuneralF1112438      250225","","126.5","","886375.41"
"2025-02-27","2025-02-26","SF FuneralF1120897      250226","","126.5","","886501.91"
"2025-02-27","2025-02-27","SF FuneralFDC00000007WKS250227","","126.5","","886628.41"
"2025-02-27","2025-02-27","SF FuneralFDC00000007YWF250227","","126.5","","886754.91"
"2025-02-27","2025-02-27","SF FuneralF829549       250227","","126.5","","886881.41"
"2025-02-27","2025-02-27","SF FuneralF1114198      250227","","126.5","","887007.91"
"2025-02-27","2025-02-21","SF FuneralF990247       250221","","126.5","","887134.41"
"2025-02-27","2025-02-21","SF FuneralF990378       250221","","31.63","","887166.04"
"2025-02-27","2025-02-24","SF FuneralF799519       250224","","126.5","","887292.54"
"2025-02-27","2025-02-24","SF FuneralF802334       250224","","126.5","","887419.04"
"2025-02-27","2025-02-24","SF FuneralFDC00000008P48250224","","126.5","","887545.54"
"2025-02-27","2025-02-26","SF FuneralF1104136      250226","","126.5","","887672.04"
"2025-02-27","2025-02-27","SF FuneralF827684       250227","","126.5","","887798.54"
"2025-02-27","2025-02-27","SF FuneralF827846       250227","","126.5","","887925.04"
"2025-02-27","2025-02-27","SF FuneralF831129       250227","","126.5","","888051.54"
"2025-02-27","2025-02-21","SF FuneralF991082       250222","","126.5","","888178.04"
"2025-02-27","2025-02-22","SF FuneralFDC00000007KBW250222","","126.5","","888304.54"
"2025-02-27","2025-02-22","SF FuneralF1054805      250222","","126.5","","888431.04"
"2025-02-27","2025-02-22","SF FuneralF1078499      250222","","126.5","","888557.54"
"2025-02-27","2025-02-22","SF FuneralF1083661      250222","","126.5","","888684.04"
"2025-02-27","2025-02-24","SF FuneralFDC00000006LCM250224","","126.5","","888810.54"
"2025-02-27","2025-02-24","SF FuneralF1115046      250224","","126.5","","888937.04"
"2025-02-27","2025-02-24","SF FuneralFDC0000000NL2F250224","","126.5","","889063.54"
"2025-02-27","2025-02-24","SF FuneralF1121936      250224","","126.5","","889190.04"
"2025-02-27","2025-02-24","SF FuneralF1127730      250224","","126.5","","889316.54"
"2025-02-27","2025-02-25","SF FuneralFDC0000000775D250225","","126.5","","889443.04"
"2025-02-27","2025-02-25","SF FuneralFDC0000000P19V250225","","126.5","","889569.54"
"2025-02-27","2025-02-27","SF FuneralFDC0000000372T250227","","220","","889789.54"
"2025-02-27","2025-02-27","SF FuneralFDC0000000D2XC250227","","126.5","","889916.04"
"2025-02-27","2025-02-27","SF FuneralF1066338      250227","","126.5","","890042.54"
"2025-02-27","2025-02-27","SF FuneralF1066340      250227","","126.5","","890169.04"
"2025-02-27","2025-02-27","SF FuneralF1112510      250227","","126.5","","890295.54"
"2025-02-27","2025-02-27","SF FuneralF1121881      250227","","126.5","","890422.04"
"2025-02-27","2025-02-25","SF FuneralF1079185      250225","","126.5","","890548.54"
"2025-02-27","2025-02-27","SF FuneralF844554       250227","","126.5","","890675.04"
"2025-02-27","2025-02-19","SF FuneralF844791       250219","","126.5","","890801.54"
"2025-02-27","2025-02-20","SF FuneralFDC00000006HTW250220","","126.5","","890928.04"
"2025-02-27","2025-02-21","SF FuneralF989577       250222","","126.5","","891054.54"
"2025-02-27","2025-02-22","SF FuneralF1068055      250222","","126.5","","891181.04"
"2025-02-27","2025-02-22","SF FuneralF1120434      250222","","126.5","","891307.54"
"2025-02-27","2025-02-24","SF FuneralFDC000000030HX250224","","220","","891527.54"
"2025-02-27","2025-02-24","SF FuneralFDC00000006V8P250223","","126.5","","891654.04"
"2025-02-27","2025-02-24","SF FuneralFDC00000006Z09250224","","126.5","","891780.54"
"2025-02-27","2025-02-24","SF FuneralF805981       250224","","126.5","","891907.04"
"2025-02-27","2025-02-24","SF FuneralF821252       250223","","126.5","","892033.54"
"2025-02-27","2025-02-24","SF FuneralF1054992      250224","","126.5","","892160.04"
"2025-02-27","2025-02-24","SF FuneralF1108310      250224","","126.5","","892286.54"
"2025-02-27","2025-02-24","SF FuneralF1111683      250224","","126.5","","892413.04"
"2025-02-27","2025-02-25","SF FuneralF1085352      250225","","126.5","","892539.54"
"2025-02-27","2025-02-27","SF FuneralFDC000000061W3250227","","126.5","","892666.04"
"2025-02-27","2025-02-27","SF FuneralF841084       250227","","126.5","","892792.54"
"2025-02-27","2025-02-27","SF FuneralF1073411      250227","","126.5","","892919.04"
"2025-02-27","2025-02-21","SF FuneralFDC000000054MP250221","","126.5","","893045.54"
"2025-02-27","2025-02-22","SF FuneralF1060271      250222","","126.5","","893172.04"
"2025-02-27","2025-02-22","SF FuneralF1103524      250222","","126.5","","893298.54"
"2025-02-27","2025-02-24","SF FuneralFDC00000009XRR250224","","126.5","","893425.04"
"2025-02-27","2025-02-24","SF FuneralF822058       250223","","126.5","","893551.54"
"2025-02-27","2025-02-24","SF FuneralF822253       250224","","126.5","","893678.04"
"2025-02-27","2025-02-24","SF FuneralF991539       250224","","126.5","","893804.54"
"2025-02-27","2025-02-24","SF FuneralF993933       250224","","126.5","","893931.04"
"2025-02-27","2025-02-24","SF FuneralFDC0000000JNDN250224","","126.5","","894057.54"
"2025-02-27","2025-02-24","SF FuneralF1054706      250224","","126.5","","894184.04"
"2025-02-27","2025-02-24","SF FuneralF1122581      250224","","126.5","","894310.54"
"2025-02-27","2025-02-24","SF FuneralF1122762      250224","","126.5","","894437.04"
"2025-02-27","2025-02-25","SF FuneralFDC00000006K1W250225","","126.5","","894563.54"
"2025-02-27","2025-02-25","SF FuneralFDC00000006K2M250225","","126.5","","894690.04"
"2025-02-27","2025-02-25","SF FuneralFDC00000007D6D250225","","126.5","","894816.54"
"2025-02-27","2025-02-25","SF FuneralFDC00000007Q10250225","","126.5","","894943.04"
"2025-02-27","2025-02-25","SF FuneralFDC0000000BL9M250225","","126.5","","895069.54"
"2025-02-27","2025-02-27","SF FuneralFDC00000004GM0250227","","220","","895289.54"
"2025-02-27","2025-02-27","SF FuneralFDC0000000F5C8250227","","126.5","","895416.04"
"2025-02-27","2025-02-26","SF FuneralFDC000000035B7250226","","220","","895636.04"
"2025-02-27","2025-02-25","SF FuneralF1079171      250225","","126.5","","895762.54"
"2025-02-27","2025-02-25","SF FuneralF1127329      250225","","126.5","","895889.04"
"2025-02-27","2025-02-25","SF FuneralF1122731      250225","","126.5","","896015.54"
"2025-02-27","2025-02-26","SF FuneralFDC0000000636G250226","","126.5","","896142.04"
"2025-02-27","2025-02-27","SF FuneralFDC00000007225250227","","126.5","","896268.54"
"2025-02-27","2025-02-27","SF FuneralFDC00000009C6F250227","","126.5","","896395.04"
"2025-02-27","2025-02-27","SF FuneralF815985       250227","","126.5","","896521.54"
"2025-02-27","2025-02-27","SF FuneralF1055149      250227","","126.5","","896648.04"
"2025-02-27","2025-02-20","SF FuneralFDC00000005Y98250220","","126.5","","896774.54"
"2025-02-27","2025-02-22","SF FuneralF1112303      250222","","126.5","","896901.04"
"2025-02-27","2025-02-22","SF FuneralFDC0000000PY8T250222","","126.5","","897027.54"
"2025-02-27","2025-02-24","SF FuneralFDC0000000744S250224","","126.5","","897154.04"
"2025-02-27","2025-02-24","SF FuneralFDC0000000N0BX250224","","126.5","","897280.54"
"2025-02-27","2025-02-24","SF FuneralF1116007      250224","","126.5","","897407.04"
"2025-02-27","2025-02-24","SF FuneralF1122808      250224","","126.5","","897533.54"
"2025-02-27","2025-02-24","SF FuneralF1122812      250224","","126.5","","897660.04"
"2025-02-27","2025-02-24","SF FuneralF1123301      250224","","126.5","","897786.54"
"2025-02-27","2025-02-24","SF FuneralF1127618      250224","","126.5","","897913.04"
"2025-02-27","2025-02-24","SF FuneralFDC0000000Q4WP250224","","126.5","","898039.54"
"2025-02-27","2025-02-24","SF FuneralFDC0000000Q8VD250224","","126.5","","898166.04"
"2025-02-27","2025-02-26","SF FuneralF810355       250226","","126.5","","898292.54"
"2025-02-27","2025-02-26","SF FuneralFDC00000009TNH250226","","126.5","","898419.04"
"2025-02-27","2025-02-26","SF FuneralF1125457      250226","","126.5","","898545.54"
"2025-02-27","2025-02-27","SF FuneralFDC00000005HGX250227","","126.5","","898672.04"
"2025-02-27","2025-02-27","SF FuneralFDC00000005HR2250227","","126.5","","898798.54"
"2025-02-27","2025-02-27","SF FuneralF803670       250227","","126.5","","898925.04"
"2025-02-27","2025-02-27","SF FuneralF830293       250227","","126.5","","899051.54"
"2025-02-27","2025-02-27","SF FuneralF831097       250227","","126.5","","899178.04"
"2025-02-27","2025-02-27","SF FuneralF1022023      250227","","126.5","","899304.54"
"2025-02-27","2025-02-27","SF FuneralFDC000000085XL250227","","126.5","","899431.04"
"2025-02-27","2025-02-27","SF FuneralF1112374      250227","","126.5","","899557.54"
"2025-02-27","2025-02-27","SF FuneralFDC000000072BP250227","","126.5","","899684.04"
"2025-02-27","2025-02-27","SF FuneralF816049       250227","","126.5","","899810.54"
"2025-02-27","2025-02-27","SF FuneralF816057       250227","","126.5","","899937.04"
"2025-02-27","2025-02-27","SF FuneralF821801       250227","","126.5","","900063.54"
"2025-02-27","2025-02-27","SF FuneralFDC0000000GH0P250227","","126.5","","900190.04"
"2025-02-27","2025-02-27","SF FuneralFDC0000000L74B250227","","126.5","","900316.54"
"2025-02-27","2025-02-27","SF FuneralFDC00000006BNS250227","","126.5","","900443.04"
"2025-02-27","2025-02-27","SF FuneralFDC00000006J73250227","","126.5","","900569.54"
"2025-02-27","2025-02-27","SF FuneralF811811       250227","","126.5","","900696.04"
"2025-02-27","2025-02-27","SF FuneralF812079       250227","","126.5","","900822.54"
"2025-02-27","2025-02-27","SF FuneralF812337       250227","","126.5","","900949.04"
"2025-02-27","2025-02-27","SF FuneralF818050       250227","","126.5","","901075.54"
"2025-02-27","2025-02-27","SF FuneralF901489       250227","","126.5","","901202.04"
"2025-02-27","2025-02-27","SF FuneralF1055026      250227","","126.5","","901328.54"
"2025-02-27","2025-02-27","SF FuneralF1110672      250227","","126.5","","901455.04"
"2025-02-27","2025-02-25","SF FuneralF992323       250225","","126.5","","901581.54"
"2025-02-27","2025-02-27","SF FuneralF808311       250227","","126.5","","901708.04"
"2025-02-27","2025-02-27","SF FuneralFDC00000009G6V250227","","126.5","","901834.54"
"2025-02-27","2025-02-27","SF FuneralF829023       250227","","126.5","","901961.04"
"2025-02-27","2025-02-27","SF FuneralF1021764      250227","","126.5","","902087.54"
"2025-02-27","2025-02-20","SF FuneralF813417       250220","","126.5","","902214.04"
"2025-02-27","2025-02-22","SF FuneralF1083744      250223","","126.5","","902340.54"
"2025-02-27","2025-02-25","SF FuneralF1124555      250225","","126.5","","902467.04"
"2025-02-27","2025-02-18","SF FuneralF993911       250218","","126.5","","902593.54"
"2025-02-27","2025-02-24","SF FuneralF1078055      250224","","126.5","","902720.04"
"2025-02-27","2025-02-27","SF FuneralF803250       250227","","126.5","","902846.54"
"2025-02-27","2025-02-27","SF FuneralF823733       250227","","126.5","","902973.04"
"2025-02-27","2025-02-27","SF FuneralF828262       250227","","126.5","","903099.54"
"2025-02-27","2025-02-27","SF FuneralF900937       250227","","126.5","","903226.04"
"2025-02-27","2025-02-27","SF FuneralF1126851      250227","","126.5","","903352.54"
"2025-02-27","2025-02-24","SF FuneralF1120920      250224","","126.5","","903479.04"
"2025-02-27","2025-02-25","SF FuneralFDC00000007VNM250225","","126.5","","903605.54"
"2025-02-27","2025-02-26","SF FuneralF992851       250226","","126.5","","903732.04"
"2025-02-27","2025-02-27","SF FuneralF1127676      250227","","126.5","","903858.54"
"2025-02-27","2025-02-22","SF FuneralFDC00000007B19250222","","126.5","","903985.04"
"2025-02-27","2025-02-22","SF FuneralF815578       250222","","126.5","","904111.54"
"2025-02-27","2025-02-22","SF FuneralF1055198      250222","","126.5","","904238.04"
"2025-02-27","2025-02-22","SF FuneralF1083835      250223","","126.5","","904364.54"
"2025-02-27","2025-02-24","SF FuneralFDC00000007KNH250224","","126.5","","904491.04"
"2025-02-27","2025-02-24","SF FuneralF1103628      250224","","126.5","","904617.54"
"2025-02-27","2025-02-24","SF FuneralFDC0000000PRW8250224","","126.5","","904744.04"
"2025-02-27","2025-02-24","SF FuneralF1131530      250224","","126.5","","904870.54"
"2025-02-27","2025-02-27","SF FuneralFDC000000067Q3250227","","126.5","","904997.04"
"2025-02-27","2025-02-27","SF FuneralFDC000000067QN250227","","126.5","","905123.54"
"2025-02-27","2025-02-27","SF FuneralF1052298      250227","","126.5","","905250.04"
"2025-02-27","2025-02-27","SF FuneralF1079662      250227","","126.5","","905376.54"
"2025-02-27","2025-02-27","SF FuneralF1103175      250227","","126.5","","905503.04"
"2025-02-27","2025-02-27","SF FuneralF1110652      250227","","63.25","","905566.29"
"2025-02-27","2025-02-27","SF FuneralF1122805      250227","","126.5","","905692.79"
"2025-02-27","2025-02-22","SF FuneralFDC00000007TWL250222","","126.5","","905819.29"
"2025-02-27","2025-02-24","SF FuneralFDC000000079BT250224","","126.5","","905945.79"
"2025-02-27","2025-02-24","SF FuneralFDC00000007CJG250224","","126.5","","906072.29"
"2025-02-27","2025-02-24","SF FuneralFDC00000008JPT250224","","126.5","","906198.79"
"2025-02-27","2025-02-24","SF FuneralF820104       250224","","126.5","","906325.29"
"2025-02-27","2025-02-24","SF FuneralF1108282      250224","","126.5","","906451.79"
"2025-02-27","2025-02-24","SF FuneralF1108360      250224","","126.5","","906578.29"
"2025-02-27","2025-02-24","SF FuneralF1113132      250224","","126.5","","906704.79"
"2025-02-27","2025-02-24","SF FuneralF1117016      250224","","126.5","","906831.29"
"2025-02-27","2025-02-24","SF FuneralFDC0000000NK40250224","","126.5","","906957.79"
"2025-02-27","2025-02-24","SF FuneralF1128784      250224","","126.5","","907084.29"
"2025-02-27","2025-02-24","SF FuneralF1131294      250224","","126.5","","907210.79"
"2025-02-27","2025-02-25","SF FuneralFDC000000087HW250225","","126.5","","907337.29"
"2025-02-27","2025-02-25","SF FuneralF827841       250225","","126.5","","907463.79"
"2025-02-27","2025-02-25","SF FuneralF841041       250225","","126.5","","907590.29"
"2025-02-27","2025-02-25","SF FuneralFDC0000000NC20250225","","126.5","","907716.79"
"2025-02-27","2025-02-27","SF FuneralF843773       250227","","126.5","","907843.29"
"2025-02-27","2025-02-27","SF FuneralF1060527      250227","","126.5","","907969.79"
"2025-02-27","2025-02-22","SF FuneralF800019       250222","","126.5","","908096.29"
"2025-02-27","2025-02-22","SF FuneralF805869       250222","","126.5","","908222.79"
"2025-02-27","2025-02-22","SF FuneralF1060910      250222","","126.5","","908349.29"
"2025-02-27","2025-02-22","SF FuneralF1112354      250223","","126.5","","908475.79"
"2025-02-27","2025-02-22","SF FuneralF1118795      250222","","126.5","","908602.29"
"2025-02-27","2025-02-24","SF FuneralFDC00000005P7P250224","","126.5","","908728.79"
"2025-02-27","2025-02-24","SF FuneralFDC00000005YV6250224","","63.25","","908792.04"
"2025-02-27","2025-02-24","SF FuneralFDC00000007DLH250224","","126.5","","908918.54"
"2025-02-27","2025-02-24","SF FuneralFDC00000007Z60250224","","126.5","","909045.04"
"2025-02-27","2025-02-24","SF FuneralFDC00000007Z6B250224","","126.5","","909171.54"
"2025-02-27","2025-02-24","SF FuneralFDC00000008JB6250224","","126.5","","909298.04"
"2025-02-27","2025-02-24","SF FuneralF806042       250224","","126.5","","909424.54"
"2025-02-27","2025-02-24","SF FuneralF819802       250224","","31.63","","909456.17"
"2025-02-27","2025-02-24","SF FuneralF830161       250224","","126.5","","909582.67"
"2025-02-27","2025-02-24","SF FuneralFDC0000000DVCF250224","","126.5","","909709.17"
"2025-02-27","2025-02-24","SF FuneralF988378       250224","","126.5","","909835.67"
"2025-02-27","2025-02-24","SF FuneralF841738       250224","","191.5","","910027.17"
"2025-02-27","2025-02-24","SF FuneralF1051762      250224","","126.5","","910153.67"
"2025-02-27","2025-02-24","SF FuneralF1074859      250224","","126.5","","910280.17"
"2025-02-27","2025-02-24","SF FuneralF1083939      250224","","126.5","","910406.67"
"2025-02-27","2025-02-24","SF FuneralF1103514      250224","","126.5","","910533.17"
"2025-02-27","2025-02-24","SF FuneralF1130526      250224","","126.5","","910659.67"
"2025-02-27","2025-02-24","SF FuneralF1130847      250224","","31.63","","910691.3"
"2025-02-27","2025-02-20","SF FuneralF790319       250220","","126.5","","910817.8"
"2025-02-27","2025-02-22","SF FuneralFDC0000000874K250222","","126.5","","910944.3"
"2025-02-27","2025-02-22","SF FuneralF993775       250222","","126.5","","911070.8"
"2025-02-27","2025-02-24","SF FuneralFDC000000070S8250224","","126.5","","911197.3"
"2025-02-27","2025-02-24","SF FuneralFDC000000077HX250224","","126.5","","911323.8"
"2025-02-27","2025-02-24","SF FuneralF831376       250223","","126.5","","911450.3"
"2025-02-27","2025-02-24","SF FuneralF1054776      250224","","126.5","","911576.8"
"2025-02-27","2025-02-24","SF FuneralF1060529      250224","","126.5","","911703.3"
"2025-02-27","2025-02-24","SF FuneralF1075286      250224","","126.5","","911829.8"
"2025-02-27","2025-02-24","SF FuneralF1113588      250224","","126.5","","911956.3"
"2025-02-27","2025-02-24","SF FuneralF1113737      250224","","126.5","","912082.8"
"2025-02-27","2025-02-24","SF FuneralF1118830      250224","","126.5","","912209.3"
"2025-02-27","2025-02-24","SF FuneralF1120634      250224","","126.5","","912335.8"
"2025-02-27","2025-02-24","SF FuneralFDC0000000Q3Z2250224","","126.5","","912462.3"
"2025-02-27","2025-02-26","SF FuneralF828762       250226","","126.5","","912588.8"
"2025-02-27","2025-02-27","SF FuneralF1128072      250227","","126.5","","912715.3"
"2025-02-27","2025-02-22","SF FuneralF828655       250222","","126.5","","912841.8"
"2025-02-27","2025-02-24","SF FuneralFDC00000006VZC250224","","126.5","","912968.3"
"2025-02-27","2025-02-27","SF FuneralF1068184      250227","","126.5","","913094.8"
"2025-02-27","2025-02-27","SF FuneralF1129056      250227","","126.5","","913221.3"
"2025-02-27","2025-02-24","SF FuneralFDC00000004CSK250224","","55","","913276.3"
"2025-02-27","2025-02-24","SF FuneralFDC00000004CSL250224","","55","","913331.3"
"2025-02-27","2025-02-24","SF FuneralFDC00000006KJY250224","","126.5","","913457.8"
"2025-02-27","2025-02-24","SF FuneralFDC00000007KKQ250224","","126.5","","913584.3"
"2025-02-27","2025-02-24","SF FuneralFDC00000007LPH250224","","191.5","","913775.8"
"2025-02-27","2025-02-24","SF FuneralF811743       250224","","126.5","","913902.3"
"2025-02-27","2025-02-24","SF FuneralF820956       250223","","31.63","","913933.93"
"2025-02-27","2025-02-24","SF FuneralFDC0000000CFFG250224","","126.5","","914060.43"
"2025-02-27","2025-02-24","SF FuneralFDC0000000CWBD250223","","31.63","","914092.06"
"2025-02-27","2025-02-24","SF FuneralF1060362      250224","","191.5","","914283.56"
"2025-02-27","2025-02-24","SF FuneralF1080229      250224","","126.5","","914410.06"
"2025-02-27","2025-02-24","SF FuneralF1120232      250224","","126.5","","914536.56"
"2025-02-27","2025-02-24","SF FuneralF1120562      250224","","126.5","","914663.06"
"2025-02-27","2025-02-24","SF FuneralFDC0000000P12Y250224","","126.5","","914789.56"
"2025-02-27","2025-02-24","SF FuneralF1124593      250224","","126.5","","914916.06"
"2025-02-27","2025-02-24","SF FuneralFDC0000000PJD9250224","","126.5","","915042.56"
"2025-02-27","2025-02-24","SF FuneralF1127889      250224","","126.5","","915169.06"
"2025-02-27","2025-02-24","SF FuneralF1131257      250224","","126.5","","915295.56"
"2025-02-27","2025-02-22","SF FuneralF1083664      250222","","126.5","","915422.06"
"2025-02-27","2025-02-27","SF FuneralF842867       250227","","126.5","","915548.56"
"2025-02-27","2025-02-27","SF FuneralF843163       250227","","126.5","","915675.06"
"2025-02-27","2025-02-27","SF FuneralF1060856      250227","","126.5","","915801.56"
"2025-02-27","2025-02-27","SF FuneralF1073599      250227","","126.5","","915928.06"
"2025-02-27","2025-02-27","SF FuneralF1114641      250227","","126.5","","916054.56"
"2025-02-27","2025-02-25","SF FuneralFDC00000005NVT250225","","126.5","","916181.06"
"2025-02-27","2025-02-25","SF FuneralFDC0000000630N250225","","126.5","","916307.56"
"2025-02-27","2025-02-25","SF FuneralFDC00000006S26250225","","126.5","","916434.06"
"2025-02-27","2025-02-25","SF FuneralFDC00000006ZDP250225","","126.5","","916560.56"
"2025-02-27","2025-02-25","SF FuneralF818153       250225","","31.63","","916592.19"
"2025-02-27","2025-02-25","SF FuneralF992268       250225","","63.25","","916655.44"
"2025-02-27","2025-02-25","SF FuneralF1132977      250225","","126.5","","916781.94"
"2025-02-27","2025-02-25","SF FuneralFDC0000000L5Z4250225","","63.25","","916845.19"
"2025-02-27","2025-02-27","SF FuneralFDC00000005J9P250227","","126.5","","916971.69"
"2025-02-27","2025-02-22","SF FuneralFDC0000000632S250222","","126.5","","917098.19"
"2025-02-27","2025-02-22","SF FuneralFDC00000006YFZ250222","","126.5","","917224.69"
"2025-02-27","2025-02-22","SF FuneralFDC00000007B00250222","","126.5","","917351.19"
"2025-02-27","2025-02-22","SF FuneralFDC00000007DGP250222","","126.5","","917477.69"
"2025-02-27","2025-02-22","SF FuneralF991808       250223","","126.5","","917604.19"
"2025-02-27","2025-02-22","SF FuneralF1021848      250222","","126.5","","917730.69"
"2025-02-27","2025-02-22","SF FuneralF1052646      250222","","126.5","","917857.19"
"2025-02-27","2025-02-22","SF FuneralF1111503      250222","","126.5","","917983.69"
"2025-02-27","2025-02-22","SF FuneralF1115166      250222","","126.5","","918110.19"
"2025-02-27","2025-02-22","SF FuneralFDC0000000NSKT250223","","126.5","","918236.69"
"2025-02-27","2025-02-22","SF FuneralF1120695      250223","","126.5","","918363.19"
"2025-02-27","2025-02-25","SF FuneralF990192       250225","","126.5","","918489.69"
"2025-02-27","2025-02-27","SF FuneralFDC000000093F2250227","","126.5","","918616.19"
"2025-02-27","2025-02-27","SF FuneralFDC00000009465250227","","126.5","","918742.69"
"2025-02-27","2025-02-26","SF FuneralF992088       250226","","126.5","","918869.19"
"2025-02-27","2025-02-27","SF FuneralFDC00000005MVD250227","","126.5","","918995.69"
"2025-02-27","2025-02-27","SF FuneralF802220       250227","","126.5","","919122.19"
"2025-02-27","2025-02-27","SF FuneralF1124779      250227","","126.5","","919248.69"
"2025-02-27","2025-02-24","SF FuneralF1055151      250224","","126.5","","919375.19"
"2025-02-27","2025-02-24","SF FuneralF1130849      250224","","126.5","","919501.69"
"2025-02-27","2025-02-25","SF FuneralFDC00000007SP3250225","","126.5","","919628.19"
"2025-02-27","2025-02-25","SF FuneralFDC00000008LS2250225","","126.5","","919754.69"
"2025-02-27","2025-02-26","SF FuneralF809353       250226","","126.5","","919881.19"
"2025-02-27","2025-02-26","SF FuneralF994056       250226","","126.5","","920007.69"
"2025-02-27","2025-02-27","SF FuneralFDC00000005W2B250227","","126.5","","920134.19"
"2025-02-27","2025-02-27","SF FuneralF802603       250227","","126.5","","920260.69"
"2025-02-27","2025-02-27","SF FuneralF820318       250227","","126.5","","920387.19"
"2025-02-27","2025-02-27","SF FuneralFDC00000006MHK250227","","126.5","","920513.69"
"2025-02-27","2025-02-27","SF FuneralF817023       250227","","126.5","","920640.19"
"2025-02-27","2025-02-27","SF FuneralF833243       250227","","126.5","","920766.69"
"2025-02-27","2025-02-27","SF FuneralF1079496      250227","","126.5","","920893.19"
"2025-02-27","2025-02-27","SF FuneralFDC0000000NZP1250227","","126.5","","921019.69"
"2025-02-27","2025-02-21","SF FuneralFDC00000007XDS250221","","126.5","","921146.19"
"2025-02-27","2025-02-21","SF FuneralF1058751      250221","","126.5","","921272.69"
"2025-02-27","2025-02-21","SF FuneralF1120573      250221","","31.63","","921304.32"
"2025-02-27","2025-02-27","SF FuneralFDC00000009JVK250227","","126.5","","921430.82"
"2025-02-27","2025-02-27","SF FuneralF1060409      250227","","126.5","","921557.32"
"2025-02-27","2025-02-27","SF FuneralF1060520      250227","","126.5","","921683.82"
"2025-02-27","2025-02-27","SF FuneralFDC0000000565R250227","","126.5","","921810.32"
"2025-02-27","2025-02-27","SF FuneralFDC00000005N77250227","","126.5","","921936.82"
"2025-02-27","2025-02-27","SF FuneralF814212       250227","","126.5","","922063.32"
"2025-02-27","2025-02-27","SF FuneralF833201       250227","","126.5","","922189.82"
"2025-02-27","2025-02-21","SF FuneralF981014       250222","","126.5","","922316.32"
"2025-02-27","2025-02-22","SF FuneralF804827       250222","","126.5","","922442.82"
"2025-02-27","2025-02-22","SF FuneralF812963       250222","","126.5","","922569.32"
"2025-02-27","2025-02-22","SF FuneralF797890       250222","","126.5","","922695.82"
"2025-02-27","2025-02-22","SF FuneralF1128761      250222","","126.5","","922822.32"
"2025-02-27","2025-02-22","SF FuneralF1129387      250223","","126.5","","922948.82"
"2025-02-27","2025-02-24","SF FuneralFDC00000003S1L250224","","55","","923003.82"
"2025-02-27","2025-02-24","SF FuneralFDC000000063P3250224","","126.5","","923130.32"
"2025-02-27","2025-02-24","SF FuneralFDC000000066DM250223","","126.5","","923256.82"
"2025-02-27","2025-02-24","SF FuneralFDC00000006K42250224","","126.5","","923383.32"
"2025-02-27","2025-02-24","SF FuneralFDC00000006XXP250224","","126.5","","923509.82"
"2025-02-27","2025-02-24","SF FuneralFDC00000007H77250223","","126.5","","923636.32"
"2025-02-27","2025-02-24","SF FuneralFDC00000007HG8250223","","126.5","","923762.82"
"2025-02-27","2025-02-24","SF FuneralFDC00000007NXB250224","","126.5","","923889.32"
"2025-02-27","2025-02-24","SF FuneralFDC00000008HSV250224","","126.5","","924015.82"
"2025-02-27","2025-02-24","SF FuneralF804478       250224","","126.5","","924142.32"
"2025-02-27","2025-02-24","SF FuneralF817065       250224","","126.5","","924268.82"
"2025-02-27","2025-02-24","SF FuneralF833802       250224","","126.5","","924395.32"
"2025-02-27","2025-02-24","SF FuneralF1016838      250224","","126.5","","924521.82"
"2025-02-27","2025-02-24","SF FuneralF1052345      250224","","31.63","","924553.45"
"2025-02-27","2025-02-24","SF FuneralF1108830      250224","","126.5","","924679.95"
"2025-02-27","2025-02-24","SF FuneralF1114988      250224","","126.5","","924806.45"
"2025-02-27","2025-02-24","SF FuneralFDC0000000NW1Y250224","","126.5","","924932.95"
"2025-02-27","2025-02-24","SF FuneralF1122282      250224","","126.5","","925059.45"
"2025-02-27","2025-02-24","SF FuneralF1130457      250224","","126.5","","925185.95"
"2025-02-27","2025-02-24","SF FuneralF1130995      250224","","126.5","","925312.45"
"2025-02-27","2025-02-25","SF FuneralFDC000000030ZQ250225","","260","","925572.45"
"2025-02-27","2025-02-25","SF FuneralFDC00000007039250225","","126.5","","925698.95"
"2025-02-27","2025-02-25","SF FuneralF1084879      250225","","126.5","","925825.45"
"2025-02-27","2025-02-25","SF FuneralF1113998      250225","","126.5","","925951.95"
"2025-02-27","2025-02-25","SF FuneralF1132261      250225","","126.5","","926078.45"
"2025-02-27","2025-02-26","SF FuneralFDC000000058ZY250226","","126.5","","926204.95"
"2025-02-27","2025-02-27","SF FuneralFDC00000003NRY250227","","220","","926424.95"
"2025-02-27","2025-02-27","SF FuneralFDC00000005XT6250227","","126.5","","926551.45"
"2025-02-27","2025-02-27","SF FuneralFDC00000006603250227","","126.5","","926677.95"
"2025-02-27","2025-02-27","SF FuneralF804519       250227","","126.5","","926804.45"
"2025-02-27","2025-02-27","SF FuneralF828578       250227","","126.5","","926930.95"
"2025-02-27","2025-02-27","SF FuneralF843663       250227","","126.5","","927057.45"
"2025-02-27","2025-02-27","SF FuneralF980979       250227","","126.5","","927183.95"
"2025-02-27","2025-02-27","SF FuneralF1060980      250227","","126.5","","927310.45"
"2025-02-27","2025-02-27","SF FuneralFDC0000000LMJP250227","","321.5","","927631.95"
"2025-02-27","2025-02-27","SF FuneralFDC0000000MTN2250227","","126.5","","927758.45"
"2025-02-27","2025-02-27","SF FuneralFDC0000000MTN5250227","","126.5","","927884.95"
"2025-02-27","2025-02-27","SF FuneralFDC0000000N9GX250227","","126.5","","928011.45"
"2025-02-27","2025-02-27","SF FuneralFDC0000000NNVX250227","","126.5","","928137.95"
"2025-02-27","2025-02-27","SF FuneralF1119674      250227","","126.5","","928264.45"
"2025-02-27","2025-02-27","SF FuneralF1120516      250227","","126.5","","928390.95"
"2025-02-27","2025-02-18","SF FuneralFDC000000074HC250218","","126.5","","928517.45"
"2025-02-27","2025-02-19","SF FuneralF980991       250219","","126.5","","928643.95"
"2025-02-27","2025-02-20","SF FuneralFDC00000006M01250220","","126.5","","928770.45"
"2025-02-27","2025-02-20","SF FuneralF1126189      250220","","126.5","","928896.95"
"2025-02-27","2025-02-21","SF FuneralFDC000000071HJ250221","","126.5","","929023.45"
"2025-02-27","2025-02-22","SF FuneralFDC00000004C5S250222","","220","","929243.45"
"2025-02-27","2025-02-22","SF FuneralF805857       250222","","126.5","","929369.95"
"2025-02-27","2025-02-22","SF FuneralF1060968      250223","","31.63","","929401.58"
"2025-02-27","2025-02-22","SF FuneralF1073415      250222","","126.5","","929528.08"
"2025-02-27","2025-02-22","SF FuneralF1112185      250222","","126.5","","929654.58"
"2025-02-27","2025-02-22","SF FuneralF1112517      250222","","126.5","","929781.08"
"2025-02-27","2025-02-24","SF FuneralFDC00000002WYL250224","","55","","929836.08"
"2025-02-27","2025-02-24","SF FuneralFDC00000003591250224","","55","","929891.08"
"2025-02-27","2025-02-24","SF FuneralFDC00000003HCL250224","","220","","930111.08"
"2025-02-27","2025-02-24","SF FuneralFDC00000005XWN250224","","126.5","","930237.58"
"2025-02-27","2025-02-24","SF FuneralFDC00000006K7G250224","","126.5","","930364.08"
"2025-02-27","2025-02-24","SF FuneralFDC00000006KRJ250224","","126.5","","930490.58"
"2025-02-27","2025-02-24","SF FuneralFDC00000006WM1250224","","126.5","","930617.08"
"2025-02-27","2025-02-24","SF FuneralFDC000000074VY250224","","126.5","","930743.58"
"2025-02-27","2025-02-24","SF FuneralF805867       250224","","126.5","","930870.08"
"2025-02-27","2025-02-24","SF FuneralFDC00000009KV0250224","","126.5","","930996.58"
"2025-02-27","2025-02-24","SF FuneralF831975       250224","","126.5","","931123.08"
"2025-02-27","2025-02-24","SF FuneralFDC0000000CJ17250224","","126.5","","931249.58"
"2025-02-27","2025-02-24","SF FuneralF840846       250224","","126.5","","931376.08"
"2025-02-27","2025-02-24","SF FuneralF987531       250224","","126.5","","931502.58"
"2025-02-27","2025-02-24","SF FuneralF1021167      250224","","126.5","","931629.08"
"2025-02-27","2025-02-24","SF FuneralF1110684      250224","","126.5","","931755.58"
"2025-02-27","2025-02-24","SF FuneralF1112559      250224","","126.5","","931882.08"
"2025-02-27","2025-02-24","SF FuneralF1118440      250224","","126.5","","932008.58"
"2025-02-27","2025-02-24","SF FuneralF808184       250224","","126.5","","932135.08"
"2025-02-27","2025-02-24","SF FuneralF1120844      250224","","126.5","","932261.58"
"2025-02-27","2025-02-24","SF FuneralF1121905      250224","","126.5","","932388.08"
"2025-02-27","2025-02-24","SF FuneralF1128679      250224","","126.5","","932514.58"
"2025-02-27","2025-02-24","SF FuneralF1129140      250224","","126.5","","932641.08"
"2025-02-27","2025-02-24","SF FuneralF1130798      250224","","126.5","","932767.58"
"2025-02-27","2025-02-24","SF FuneralF1130917      250224","","126.5","","932894.08"
"2025-02-27","2025-02-24","SF FuneralF1131082      250224","","126.5","","933020.58"
"2025-02-27","2025-02-27","SF FuneralFDC00000004JN5250227","","220","","933240.58"
"2025-02-27","2025-02-27","SF FuneralFDC00000004JZF250227","","220","","933460.58"
"2025-02-27","2025-02-27","SF FuneralFDC00000005DYD250227","","126.5","","933587.08"
"2025-02-27","2025-02-27","SF FuneralFDC00000005DYW250227","","126.5","","933713.58"
"2025-02-27","2025-02-27","SF FuneralFDC00000005KBW250227","","126.5","","933840.08"
"2025-02-27","2025-02-27","SF FuneralFDC000000084PZ250227","","126.5","","933966.58"
"2025-02-27","2025-02-27","SF FuneralFDC000000085H3250227","","126.5","","934093.08"
"2025-02-27","2025-02-27","SF FuneralFDC00000008BMZ250227","","126.5","","934219.58"
"2025-02-27","2025-02-27","SF FuneralF816209       250227","","126.5","","934346.08"
"2025-02-27","2025-02-27","SF FuneralF840687       250227","","126.5","","934472.58"
"2025-02-27","2025-02-27","SF FuneralF842384       250227","","126.5","","934599.08"
"2025-02-27","2025-02-27","SF FuneralF986850       250227","","126.5","","934725.58"
"2025-02-27","2025-02-27","SF FuneralF1060538      250227","","126.5","","934852.08"
"2025-02-27","2025-02-27","SF FuneralF1074874      250227","","126.5","","934978.58"
"2025-02-27","2025-02-27","SF FuneralF1078423      250227","","126.5","","935105.08"
"2025-02-27","2025-02-27","SF FuneralF1114728      250227","","126.5","","935231.58"
"2025-02-27","2025-02-27","SF FuneralF1116893      250227","","126.5","","935358.08"
"2025-02-27","2025-02-27","SF FuneralF1118988      250227","","126.5","","935484.58"
"2025-02-27","2025-02-25","SF FuneralFDC00000005PVX250225","","220","","935704.58"
"2025-02-27","2025-02-25","SF FuneralFDC000000077YM250225","","126.5","","935831.08"
"2025-02-27","2025-02-25","SF FuneralFDC000000079VJ250225","","126.5","","935957.58"
"2025-02-27","2025-02-25","SF FuneralFDC00000007MX8250225","","220","","936177.58"
"2025-02-27","2025-02-25","SF FuneralFDC00000007Q24250225","","126.5","","936304.08"
"2025-02-27","2025-02-25","SF FuneralF794159       250225","","126.5","","936430.58"
"2025-02-27","2025-02-25","SF FuneralFDC00000007YL6250225","","126.5","","936557.08"
"2025-02-27","2025-02-25","SF FuneralFDC00000008HNM250225","","126.5","","936683.58"
"2025-02-27","2025-02-25","SF FuneralFDC00000008HPF250225","","126.5","","936810.08"
"2025-02-27","2025-02-25","SF FuneralF815888       250225","","126.5","","936936.58"
"2025-02-27","2025-02-25","SF FuneralF993846       250225","","126.5","","937063.08"
"2025-02-27","2025-02-25","SF FuneralF1115031      250225","","31.63","","937094.71"
"2025-02-27","2025-02-25","SF FuneralF1120567      250225","","126.5","","937221.21"
"2025-02-27","2025-02-25","SF FuneralF1126844      250225","","126.5","","937347.71"
"2025-02-27","2025-02-26","SF FuneralF843713       250226","","126.5","","937474.21"
"2025-02-27","2025-02-26","SF FuneralF993473       250226","","126.5","","937600.71"
"2025-02-27","2025-02-26","SF FuneralF1121941      250226","","126.5","","937727.21"
"2025-02-27","2025-02-27","SF FuneralFDC00000005DRW250227","","126.5","","937853.71"
"2025-02-27","2025-02-27","SF FuneralF842626       250227","","126.5","","937980.21"
"2025-02-27","2025-02-27","SF FuneralF1115164      250227","","126.5","","938106.71"
"2025-02-27","2025-02-27","SF FuneralF822542       250227","","126.5","","938233.21"
"2025-02-27","2025-02-27","SF FuneralF831967       250227","","126.5","","938359.71"
"2025-02-27","2025-02-27","SF FuneralF841023       250227","","126.5","","938486.21"
"2025-02-27","2025-02-27","SF FuneralF780539       250227","","365.12","","938851.33"
"2025-02-27","2025-02-27","SF FuneralF1074892      250227","","126.5","","938977.83"
"2025-02-27","2025-02-27","SF FuneralF1120818      250227","","126.5","","939104.33"
"2025-02-27","2025-02-24","SF FuneralF831649       250223","","126.5","","939230.83"
"2025-02-27","2025-02-24","SF FuneralF1104007      250224","","126.5","","939357.33"
"2025-02-27","2025-02-11","Rev SF FuneralFDC00000007ZH7250211","","-31.63","","939325.7"
"2025-02-27","2025-02-21","Rev SF FuneralFDC000000032VH250221","","-55","","939270.7"
"2025-02-27","2025-02-21","Rev SF FuneralFDC0000000K7CQ250221","","-31.63","","939239.07"
"2025-02-27","2025-02-24","Rev SF FuneralFDC00000005YNL250224","","-55","","939184.07"
"2025-02-27","2025-02-24","Rev SF FuneralFDC00000005YW3250224","","-31.63","","939152.44"
"2025-02-27","2025-02-21","Rev SF FuneralFDC00000008FRT250221","","-126.5","","939025.94"
"2025-02-27","2025-02-22","Rev SF FuneralFDC0000000DZGT250222","","-126.5","","938899.44"
"2025-02-27","2025-02-22","Rev SF FuneralFDC0000000K4YT250222","","-126.5","","938772.94"
"2025-02-27","2025-02-22","Rev SF FuneralFDC0000000K4ZG250223","","-126.5","","938646.44"
"2025-02-27","2025-02-22","Rev SF FuneralFDC00000005HCN250222","","-126.5","","938519.94"
"2025-02-27","2025-02-19","Rev SF FuneralFDC0000000KY1M250219","","-126.5","","938393.44"
"2025-02-27","2025-02-22","Rev SF FuneralFDC00000006YGZ250222","","-126.5","","938266.94"
"2025-02-27","2025-02-22","Rev SF FuneralFDC0000000874K250222","","-126.5","","938140.44"
"2025-02-27","2025-02-22","Rev SF FuneralFDC00000006T7D250222","","-126.5","","938013.94"
"2025-02-27","2025-02-22","Rev SF FuneralFDC00000006T86250222","","-126.5","","937887.44"
"2025-02-27","2025-02-22","Rev SF FuneralFDC000000032Y3250222","","-220","","937667.44"
"2025-02-27","2025-02-22","Rev SF FuneralFDC00000009JQJ250222","","-126.5","","937540.94"
"2025-02-27","2025-02-22","Rev SF FuneralFDC00000007VSR250222","","-126.5","","937414.44"
"2025-02-27","2025-02-22","Rev SF FuneralFDC0000000BVXW250222","","-126.5","","937287.94"
"2025-02-27","2025-02-22","Rev SF FuneralFDC00000006RLZ250222","","-126.5","","937161.44"
"2025-02-27","2025-02-24","Rev SF FuneralFDC00000006RN5250224","","-126.5","","937034.94"
"2025-02-27","2025-02-24","Rev SF FuneralFDC00000007MBZ250224","","-126.5","","936908.44"
"2025-02-27","2025-02-24","Rev SF FuneralFDC00000007F6S250223","","-63.25","","936845.19"
"2025-02-27","2025-02-24","Rev SF FuneralFDC0000000J1YG250224","","-126.5","","936718.69"
"2025-02-27","2025-02-24","Rev SF FuneralFDC00000006H5X250224","","-126.5","","936592.19"
"2025-02-27","2025-02-26","Rev SF FuneralFDC0000000JG8W250226","","-126.5","","936465.69"
"2025-02-27","2025-02-25","Rev SF FuneralFDC00000007F33250225","","-126.5","","936339.19"
"2025-02-27","2025-02-25","Rev SF FuneralFDC0000000Q3J1250225","","-126.5","","936212.69"
"2025-02-27","2025-02-22","SF FuneralFDC00000006MXC250222","","126.5","","936339.19"
"2025-02-27","2025-02-22","SF FuneralF1061047      250223","","126.5","","936465.69"
"2025-02-27","2025-02-25","SF FuneralFDC0000000666V250225","","126.5","","936592.19"
"2025-02-27","2025-02-25","SF FuneralF1020866      250225","","126.5","","936718.69"
"2025-02-27","2025-02-18","SF FuneralF809215       250218","","63.25","","936781.94"
"2025-02-27","2025-02-19","SF FuneralF802180       250219","","126.5","","936908.44"
"2025-02-27","2025-02-22","SF FuneralFDC00000003N7T250222","","220","","937128.44"
"2025-02-27","2025-02-22","SF FuneralFDC000000069KZ250222","","126.5","","937254.94"
"2025-02-27","2025-02-22","SF FuneralF1084330      250222","","126.5","","937381.44"
"2025-02-27","2025-02-22","SF FuneralF1116712      250223","","126.5","","937507.94"
"2025-02-27","2025-02-22","SF FuneralF1131356      250222","","126.5","","937634.44"
"2025-02-27","2025-02-24","SF FuneralFDC00000006XQB250224","","126.5","","937760.94"
"2025-02-27","2025-02-24","SF FuneralFDC00000008L4W250224","","126.5","","937887.44"
"2025-02-27","2025-02-24","SF FuneralF831804       250223","","126.5","","938013.94"
"2025-02-27","2025-02-24","SF FuneralF1131975      250224","","126.5","","938140.44"
"2025-02-27","2025-02-25","SF FuneralFDC00000005MTH250225","","220","","938360.44"
"2025-02-27","2025-02-25","SF FuneralF1078565      250225","","126.5","","938486.94"
"2025-02-27","2025-02-25","SF FuneralF1085146      250225","","126.5","","938613.44"
"2025-02-27","2025-02-25","SF FuneralF1112390      250225","","126.5","","938739.94"
"2025-02-27","2025-02-25","SF FuneralF1113762      250225","","126.5","","938866.44"
"2025-02-27","2025-02-25","SF FuneralF1123498      250225","","126.5","","938992.94"
"2025-02-27","2025-02-25","SF FuneralF1128831      250225","","126.5","","939119.44"
"2025-02-27","2025-02-26","SF FuneralF827626       250226","","126.5","","939245.94"
"2025-02-27","2025-02-27","SF FuneralFDC000000064FV250227","","126.5","","939372.44"
"2025-02-27","2025-02-27","SF FuneralF802305       250227","","126.5","","939498.94"
"2025-02-27","2025-02-27","SF FuneralF802549       250227","","126.5","","939625.44"
"2025-02-27","2025-02-27","SF FuneralF813504       250227","","126.5","","939751.94"
"2025-02-27","2025-02-27","SF FuneralF1120861      250227","","126.5","","939878.44"
"2025-02-27","2025-02-22","SF FuneralFDC00000007NMQ250222","","126.5","","940004.94"
"2025-02-27","2025-02-22","SF FuneralF798604       250222","","126.5","","940131.44"
"2025-02-27","2025-02-22","SF FuneralF823972       250222","","126.5","","940257.94"
"2025-02-27","2025-02-22","SF FuneralF827889       250222","","126.5","","940384.44"
"2025-02-27","2025-02-22","SF FuneralF1108533      250222","","126.5","","940510.94"
"2025-02-27","2025-02-24","SF FuneralF814386       250224","","126.5","","940637.44"
"2025-02-27","2025-02-24","SF FuneralF1033945      250224","","126.5","","940763.94"
"2025-02-27","2025-02-24","SF FuneralF1058838      250224","","126.5","","940890.44"
"2025-02-27","2025-02-24","SF FuneralF1112267      250224","","126.5","","941016.94"
"2025-02-27","2025-02-24","SF FuneralF1114756      250224","","126.5","","941143.44"
"2025-02-27","2025-02-24","SF FuneralF1125954      250224","","126.5","","941269.94"
"2025-02-27","2025-02-24","SF FuneralF1127451      250224","","126.5","","941396.44"
"2025-02-27","2025-02-25","SF FuneralFDC00000005Z3F250225","","63.25","","941459.69"
"2025-02-27","2025-02-25","SF FuneralFDC00000006V4D250225","","126.5","","941586.19"
"2025-02-27","2025-02-25","SF FuneralFDC00000007SPD250225","","126.5","","941712.69"
"2025-02-27","2025-02-25","SF FuneralFDC00000008MXM250225","","126.5","","941839.19"
"2025-02-27","2025-02-25","SF FuneralF809262       250225","","126.5","","941965.69"
"2025-02-27","2025-02-25","SF FuneralF1108762      250225","","126.5","","942092.19"
"2025-02-27","2025-02-25","SF FuneralF1124528      250225","","126.5","","942218.69"
"2025-02-27","2025-02-25","SF FuneralF1131483      250225","","126.5","","942345.19"
"2025-02-27","2025-02-25","SF FuneralF1131627      250225","","126.5","","942471.69"
"2025-02-27","2025-02-26","SF FuneralFDC000000033PX250226","","220","","942691.69"
"2025-02-27","2025-02-26","SF FuneralF827754       250226","","126.5","","942818.19"
"2025-02-27","2025-02-26","SF FuneralF828132       250226","","126.5","","942944.69"
"2025-02-27","2025-02-26","SF FuneralF988427       250226","","126.5","","943071.19"
"2025-02-27","2025-02-26","SF FuneralFDC0000000K7J2250226","","126.5","","943197.69"
"2025-02-27","2025-02-26","SF FuneralF1060693      250226","","126.5","","943324.19"
"2025-02-27","2025-02-26","SF FuneralF1078957      250226","","126.5","","943450.69"
"2025-02-27","2025-02-27","SF FuneralFDC00000005CG9250227","","126.5","","943577.19"
"2025-02-27","2025-02-27","SF FuneralFDC000000069J2250227","","126.5","","943703.69"
"2025-02-27","2025-02-27","SF FuneralFDC000000072X5250227","","126.5","","943830.19"
"2025-02-27","2025-02-27","SF FuneralFDC000000073XW250227","","126.5","","943956.69"
"2025-02-27","2025-02-27","SF FuneralF817688       250227","","126.5","","944083.19"
"2025-02-27","2025-02-27","SF FuneralF842760       250227","","126.5","","944209.69"
"2025-02-27","2025-02-27","SF FuneralF900702       250227","","126.5","","944336.19"
"2025-02-27","2025-02-27","SF FuneralF1017683      250227","","126.5","","944462.69"
"2025-02-27","2025-02-27","SF FuneralF1078500      250227","","126.5","","944589.19"
"2025-02-27","2025-02-27","SF FuneralF1083760      250227","","126.5","","944715.69"
"2025-02-27","2025-02-27","SF FuneralF1110018      250227","","126.5","","944842.19"
"2025-02-27","2025-02-27","SF FuneralF1110420      250227","","126.5","","944968.69"
"2025-02-27","2025-02-27","SF FuneralF1112379      250227","","126.5","","945095.19"
"2025-02-27","2025-02-27","SF FuneralF1122890      250227","","126.5","","945221.69"
"2025-02-27","2025-02-21","SF FuneralFDC00000007ZWN250221","","31.63","","945253.32"
"2025-02-27","2025-02-21","SF FuneralFDC00000007ZWY250221","","31.63","","945284.95"
"2025-02-27","2025-02-21","SF FuneralFDC0000000JTLM250221","","126.5","","945411.45"
"2025-02-27","2025-02-22","SF FuneralF1113980      250223","","126.5","","945537.95"
"2025-02-27","2025-02-24","SF FuneralF1096643      250224","","126.5","","945664.45"
"2025-02-27","2025-02-24","SF FuneralF1115070      250224","","126.5","","945790.95"
"2025-02-27","2025-02-25","SF FuneralFDC000000064P9250225","","31.63","","945822.58"
"2025-02-27","2025-02-25","SF FuneralF834784       250225","","31.63","","945854.21"
"2025-02-27","2025-02-25","SF FuneralF992519       250225","","31.63","","945885.84"
"2025-02-27","2025-02-25","SF FuneralF993719       250225","","31.63","","945917.47"
"2025-02-27","2025-02-19","Rev SF FuneralFDC0000000618M250219","","-126.5","","945790.97"
"2025-02-27","2025-02-22","Rev SF FuneralFDC0000000B4NX250222","","-126.5","","945664.47"
"2025-02-27","2025-02-24","SF FuneralFDC0000000K6KT250224","","126.5","","945790.97"
"2025-02-27","2025-02-24","SF FuneralF1060467      250224","","126.5","","945917.47"
"2025-02-27","2025-02-25","SF FuneralF1016936      250225","","63.25","","945980.72"
"2025-02-27","2025-02-27","SF FuneralFDC00000006N8S250227","","126.5","","946107.22"
"2025-02-27","2025-02-27","SF FuneralF1075307      250227","","126.5","","946233.72"
"2025-02-27","2025-01-24","Rev SF FuneralF901489       250127","","-126.5","","946107.22"
"2025-02-27","2025-02-21","SF FuneralF830001       250221","","63.25","","946170.47"
"2025-02-27","2025-02-22","SF FuneralFDC00000008LMD250222","","126.5","","946296.97"
"2025-02-27","2025-02-22","SF FuneralF992433       250222","","126.5","","946423.47"
"2025-02-27","2025-02-22","SF FuneralF1067928      250222","","126.5","","946549.97"
"2025-02-27","2025-02-24","SF FuneralFDC00000007CLX250223","","126.5","","946676.47"
"2025-02-27","2025-02-24","SF FuneralF830084       250224","","63.25","","946739.72"
"2025-02-27","2025-02-24","SF FuneralF993696       250224","","126.5","","946866.22"
"2025-02-27","2025-02-25","SF FuneralF831757       250225","","63.25","","946929.47"
"2025-02-27","2025-02-25","SF FuneralFDC0000000Q2M3250225","","126.5","","947055.97"
"2025-02-27","2025-02-26","SF FuneralF1120546      250226","","126.5","","947182.47"
"2025-02-27","2025-02-27","SF FuneralF812623       250227","","126.5","","947308.97"
"2025-02-27","2025-02-27","SF FuneralF1108540      250227","","126.5","","947435.47"
"2025-02-27","2025-02-27","SF FuneralF1109140      250227","","126.5","","947561.97"
"2025-02-27","2025-02-27","SF FuneralF1128696      250227","","126.5","","947688.47"
"2025-02-27","2025-02-24","SF FuneralFDC00000006D2N250224","","126.5","","947814.97"
"2025-02-27","2025-02-24","SF FuneralFDC00000009G6R250224","","31.63","","947846.6"
"2025-02-27","2025-02-25","SF FuneralF805648       250225","","31.63","","947878.23"
"2025-02-27","2025-02-21","SF FuneralF815237       250221","","63.25","","947941.48"
"2025-02-27","2025-02-22","SF FuneralFDC0000000609Q250222","","126.5","","948067.98"
"2025-02-27","2025-02-22","SF FuneralF1116109      250223","","126.5","","948194.48"
"2025-02-27","2025-02-24","SF FuneralFDC00000006XFM250224","","31.63","","948226.11"
"2025-02-27","2025-02-25","SF FuneralFDC000000032JV250225","","220","","948446.11"
"2025-02-27","2025-02-25","SF FuneralF1131046      250225","","126.5","","948572.61"
"2025-02-27","2025-02-25","SF FuneralF1132469      250225","","126.5","","948699.11"
"2025-02-27","2025-02-27","SF FuneralFDC00000003KDQ250227","","220","","948919.11"
"2025-02-27","2025-02-27","SF FuneralF840809       250227","","126.5","","949045.61"
"2025-02-27","2025-02-27","SF FuneralF1113910      250227","","126.5","","949172.11"
"2025-02-27","2025-02-22","SF FuneralF805678       250222","","126.5","","949298.61"
"2025-02-27","2025-02-26","SF FuneralFDC0000000M449250226","","126.5","","949425.11"
"2025-02-27","2025-02-27","SF FuneralFDC00000005GSZ250227","","126.5","","949551.61"
"2025-02-27","2025-02-27","SF FuneralFDC00000005L3F250227","","126.5","","949678.11"
"2025-02-27","2025-02-27","SF FuneralF1058629      250227","","126.5","","949804.61"
"2025-02-27","2025-02-10","Rev SF FuneralFDC0000000MXS0250210","","-63.25","","949741.36"
"2025-02-27","2025-01-27","Rev SF FuneralFDC0000000MXS0250127","","-63.25","","949678.11"
"2025-02-27","2025-02-24","SF FuneralF1130437      250224","","126.5","","949804.61"
"2025-02-27","2025-02-25","SF FuneralFDC0000000804X250225","","126.5","","949931.11"
"2025-02-27","2025-02-25","SF FuneralF816053       250225","","126.5","","950057.61"
"2025-02-27","2025-02-27","SF FuneralF822967       250227","","126.5","","950184.11"
"2025-02-27","2025-02-27","SF FuneralF1016896      250227","","126.5","","950310.61"
"2025-02-27","2025-02-27","SF FuneralF1068020      250227","","126.5","","950437.11"
"2025-02-27","2025-02-22","SF FuneralFDC00000005ZR9250222","","126.5","","950563.61"
"2025-02-27","2025-02-22","SF FuneralF1111595      250223","","31.63","","950595.24"
"2025-02-27","2025-02-24","SF FuneralF1124140      250224","","31.63","","950626.87"
"2025-02-27","2025-02-24","SF FuneralF1132453      250224","","31.63","","950658.5"
"2025-02-27","2025-02-25","SF FuneralFDC00000008JVD250225","","31.63","","950690.13"
"2025-02-27","2025-02-25","SF FuneralFDC0000000JYX1250225","","126.5","","950816.63"
"2025-02-27","2025-02-25","SF FuneralF1111675      250225","","31.63","","950848.26"
"2025-02-27","2025-02-25","SF FuneralFDC0000000ND1R250225","","31.63","","950879.89"
"2025-02-27","2025-02-25","SF FuneralFDC0000000ND1S250225","","31.63","","950911.52"
"2025-02-27","2025-02-25","SF FuneralFDC0000000NTBQ250225","","31.63","","950943.15"
"2025-02-27","2025-02-25","SF FuneralF1120133      250225","","31.63","","950974.78"
"2025-02-27","2025-02-26","SF FuneralFDC0000000LG2D250226","","31.63","","951006.41"
"2025-02-27","2025-02-26","SF FuneralF1078566      250226","","31.63","","951038.04"
"2025-02-27","2025-02-27","SF FuneralF818891       250227","","126.5","","951164.54"
"2025-02-27","2025-02-20","SF FuneralFDC00000005Z44250220","","126.5","","951291.04"
"2025-02-27","2025-02-21","SF FuneralFDC00000006JSG250221","","126.5","","951417.54"
"2025-02-27","2025-02-21","SF FuneralFDC000000075L7250221","","63.25","","951480.79"
"2025-02-27","2025-02-21","SF FuneralFDC00000008Z24250221","","126.5","","951607.29"
"2025-02-27","2025-02-21","SF FuneralF842800       250221","","126.5","","951733.79"
"2025-02-27","2025-02-21","SF FuneralF987746       250222","","126.5","","951860.29"
"2025-02-27","2025-02-22","SF FuneralFDC00000003932250222","","220","","952080.29"
"2025-02-27","2025-02-22","SF FuneralFDC00000006CLB250222","","126.5","","952206.79"
"2025-02-27","2025-02-22","SF FuneralF833338       250222","","126.5","","952333.29"
"2025-02-27","2025-02-22","SF FuneralF1055038      250222","","126.5","","952459.79"
"2025-02-27","2025-02-22","SF FuneralF1061879      250222","","191.5","","952651.29"
"2025-02-27","2025-02-22","SF FuneralF1114608      250222","","126.5","","952777.79"
"2025-02-27","2025-02-22","SF FuneralF1118144      250223","","126.5","","952904.29"
"2025-02-27","2025-02-22","SF FuneralFDC0000000P47W250223","","126.5","","953030.79"
"2025-02-27","2025-02-22","SF FuneralF1123294      250223","","126.5","","953157.29"
"2025-02-27","2025-02-22","SF FuneralF1127636      250222","","126.5","","953283.79"
"2025-02-27","2025-02-24","SF FuneralFDC00000006ZZW250223","","126.5","","953410.29"
"2025-02-27","2025-02-24","SF FuneralFDC00000007990250224","","126.5","","953536.79"
"2025-02-27","2025-02-24","SF FuneralF832110       250224","","126.5","","953663.29"
"2025-02-27","2025-02-24","SF FuneralF847242       250224","","126.5","","953789.79"
"2025-02-27","2025-02-24","SF FuneralF1078696      250224","","126.5","","953916.29"
"2025-02-27","2025-02-24","SF FuneralFDC0000000N7M9250224","","126.5","","954042.79"
"2025-02-27","2025-02-24","SF FuneralFDC0000000PGQS250224","","126.5","","954169.29"
"2025-02-27","2025-02-24","SF FuneralF1132071      250224","","126.5","","954295.79"
"2025-02-27","2025-02-25","SF FuneralF802141       250225","","126.5","","954422.29"
"2025-02-27","2025-02-25","SF FuneralFDC00000008JX9250225","","126.5","","954548.79"
"2025-02-27","2025-02-25","SF FuneralF804121       250225","","126.5","","954675.29"
"2025-02-27","2025-02-25","SF FuneralF821168       250225","","126.5","","954801.79"
"2025-02-27","2025-02-25","SF FuneralF1120111      250225","","126.5","","954928.29"
"2025-02-27","2025-02-26","SF FuneralF1128194      250226","","126.5","","955054.79"
"2025-02-27","2025-02-27","SF FuneralFDC00000004BWJ250227","","220","","955274.79"
"2025-02-27","2025-02-27","SF FuneralFDC00000006KGR250227","","126.5","","955401.29"
"2025-02-27","2025-02-27","SF FuneralFDC00000006RVM250227","","126.5","","955527.79"
"2025-02-27","2025-02-27","SF FuneralF798379       250227","","126.5","","955654.29"
"2025-02-27","2025-02-27","SF FuneralF811891       250227","","126.5","","955780.79"
"2025-02-27","2025-02-27","SF FuneralF830961       250227","","126.5","","955907.29"
"2025-02-27","2025-02-27","SF FuneralF841764       250227","","126.5","","956033.79"
"2025-02-27","2025-02-27","SF FuneralF987653       250227","","126.5","","956160.29"
"2025-02-27","2025-02-27","SF FuneralF993361       250227","","126.5","","956286.79"
"2025-02-27","2025-02-27","SF FuneralF1055057      250227","","126.5","","956413.29"
"2025-02-27","2025-02-27","SF FuneralFDC0000000LDRG250227","","126.5","","956539.79"
"2025-02-27","2025-02-27","SF FuneralFDC0000000P19M250227","","126.5","","956666.29"
"2025-02-27","2025-02-27","SF FuneralF1122594      250227","","126.5","","956792.79"
"2025-02-27","2025-02-27","SF FuneralF1127667      250227","","126.5","","956919.29"
"2025-02-27","2025-01-24","Rev SF FuneralFDC000000081CC250127","","-126.5","","956792.79"
"2025-02-27","2025-02-20","SF FuneralFDC00000006TH1250220","","63.25","","956856.04"
"2025-02-27","2025-02-21","SF FuneralFDC000000060R4250221","","126.5","","956982.54"
"2025-02-27","2025-02-22","SF FuneralFDC000000030SK250222","","220","","957202.54"
"2025-02-27","2025-02-22","SF FuneralF1085336      250222","","126.5","","957329.04"
"2025-02-27","2025-02-24","SF FuneralFDC0000000DCSR250224","","126.5","","957455.54"
"2025-02-27","2025-02-24","SF FuneralFDC0000000DCVF250224","","126.5","","957582.04"
"2025-02-27","2025-02-25","SF FuneralFDC00000003HFV250225","","220","","957802.04"
"2025-02-27","2025-02-25","SF FuneralF796739       250225","","31.63","","957833.67"
"2025-02-27","2025-02-25","SF FuneralF1120389      250225","","126.5","","957960.17"
"2025-02-27","2025-02-27","SF FuneralF813495       250227","","126.5","","958086.67"
"2025-02-27","2025-02-21","SF FuneralF991266       250222","","126.5","","958213.17"
"2025-02-27","2025-02-24","SF FuneralF1021004      250224","","31.63","","958244.8"
"2025-02-27","2025-02-25","SF FuneralF1065836      250225","","126.5","","958371.3"
"2025-02-27","2025-02-25","SF FuneralF1119033      250225","","63.25","","958434.55"
"2025-02-27","2025-02-27","SF FuneralF1066056      250227","","126.5","","958561.05"
"2025-02-27","2025-02-21","SF FuneralFDC00000008GY4250221","","31.63","","958592.68"
"2025-02-27","2025-02-21","SF FuneralF805275       250221","","31.63","","958624.31"
"2025-02-27","2025-02-22","SF FuneralFDC00000006034250222","","126.5","","958750.81"
"2025-02-27","2025-02-22","SF FuneralFDC00000006489250222","","126.5","","958877.31"
"2025-02-27","2025-02-22","SF FuneralFDC000000072NN250222","","126.5","","959003.81"
"2025-02-27","2025-02-22","SF FuneralFDC0000000BHFW250222","","126.5","","959130.31"
"2025-02-27","2025-02-22","SF FuneralF1117309      250222","","126.5","","959256.81"
"2025-02-27","2025-02-24","SF FuneralFDC000000070PX250224","","31.63","","959288.44"
"2025-02-27","2025-02-24","SF FuneralFDC00000007H6K250224","","31.63","","959320.07"
"2025-02-27","2025-02-24","SF FuneralFDC00000007PP8250224","","31.63","","959351.7"
"2025-02-27","2025-02-24","SF FuneralF800626       250224","","31.63","","959383.33"
"2025-02-27","2025-02-24","SF FuneralF803226       250224","","31.63","","959414.96"
"2025-02-27","2025-02-24","SF FuneralFDC0000000918Q250224","","47.88","","959462.84"
"2025-02-27","2025-02-24","SF FuneralF843034       250224","","31.63","","959494.47"
"2025-02-27","2025-02-24","SF FuneralF1017630      250224","","31.63","","959526.1"
"2025-02-27","2025-02-24","SF FuneralF1060055      250224","","31.63","","959557.73"
"2025-02-27","2025-02-24","SF FuneralFDC0000000P0LT250224","","126.5","","959684.23"
"2025-02-27","2025-02-24","SF FuneralF1129904      250224","","31.63","","959715.86"
"2025-02-27","2025-02-24","SF FuneralF1130649      250224","","31.63","","959747.49"
"2025-02-27","2025-02-24","SF FuneralF1131037      250224","","31.63","","959779.12"
"2025-02-27","2025-02-24","SF FuneralF1132388      250224","","31.63","","959810.75"
"2025-02-27","2025-02-25","SF FuneralFDC00000005H2H250225","","31.63","","959842.38"
"2025-02-27","2025-02-25","SF FuneralFDC00000007ZD3250225","","31.63","","959874.01"
"2025-02-27","2025-02-25","SF FuneralFDC000000088BV250225","","31.63","","959905.64"
"2025-02-27","2025-02-25","SF FuneralF815955       250225","","31.63","","959937.27"
"2025-02-27","2025-02-25","SF FuneralF831704       250225","","31.63","","959968.9"
"2025-02-27","2025-02-25","SF FuneralF1102910      250225","","31.63","","960000.53"
"2025-02-27","2025-02-25","SF FuneralF1111742      250225","","31.63","","960032.16"
"2025-02-27","2025-02-25","SF FuneralF1114433      250225","","31.63","","960063.79"
"2025-02-27","2025-02-25","SF FuneralF1122784      250225","","126.5","","960190.29"
"2025-02-27","2025-02-25","SF FuneralF1123129      250225","","31.63","","960221.92"
"2025-02-27","2025-02-25","SF FuneralF1127482      250225","","31.63","","960253.55"
"2025-02-27","2025-02-25","SF FuneralFDC0000000Q453250225","","126.5","","960380.05"
"2025-02-27","2025-02-25","SF FuneralF1132098      250225","","126.5","","960506.55"
"2025-02-27","2025-02-26","SF FuneralF815698       250226","","126.5","","960633.05"
"2025-02-27","2025-02-26","SF FuneralF1033625      250226","","126.5","","960759.55"
"2025-02-27","2025-02-27","SF FuneralFDC00000005C1C250227","","126.5","","960886.05"
"2025-02-27","2025-02-27","SF FuneralFDC00000005Q6V250227","","126.5","","961012.55"
"2025-02-27","2025-02-27","SF FuneralFDC00000005T5M250227","","220","","961232.55"
"2025-02-27","2025-02-27","SF FuneralFDC00000006FKS250227","","126.5","","961359.05"
"2025-02-27","2025-02-27","SF FuneralFDC000000083HX250227","","126.5","","961485.55"
"2025-02-27","2025-02-27","SF FuneralF827816       250227","","126.5","","961612.05"
"2025-02-27","2025-02-27","SF FuneralF1122919      250227","","126.5","","961738.55"
"2025-02-27","2025-02-27","SF FuneralF1127546      250227","","126.5","","961865.05"
"2025-02-27","2025-02-18","SF FuneralFDC00000005LTH250218","","64.5","","961929.55"
"2025-02-27","2025-02-18","SF FuneralF901068       250218","","126.5","","962056.05"
"2025-02-27","2025-02-21","SF FuneralF981763       250223","","126.5","","962182.55"
"2025-02-27","2025-02-21","SF FuneralF986734       250223","","126.5","","962309.05"
"2025-02-27","2025-02-22","SF FuneralFDC00000005Z5P250222","","126.5","","962435.55"
"2025-02-27","2025-02-22","SF FuneralF821132       250222","","126.5","","962562.05"
"2025-02-27","2025-02-22","SF FuneralF841619       250222","","126.5","","962688.55"
"2025-02-27","2025-02-22","SF FuneralF1122775      250222","","126.5","","962815.05"
"2025-02-27","2025-02-22","SF FuneralF1130482      250222","","126.5","","962941.55"
"2025-02-27","2025-02-24","SF FuneralFDC00000006BPC250224","","126.5","","963068.05"
"2025-02-27","2025-02-24","SF FuneralFDC00000006BXR250224","","126.5","","963194.55"
"2025-02-27","2025-02-24","SF FuneralFDC00000006TRY250224","","63.25","","963257.8"
"2025-02-27","2025-02-24","SF FuneralFDC00000007MF0250224","","126.5","","963384.3"
"2025-02-27","2025-02-24","SF FuneralFDC0000000811P250224","","126.5","","963510.8"
"2025-02-27","2025-02-24","SF FuneralF816262       250223","","126.5","","963637.3"
"2025-02-27","2025-02-24","SF FuneralF778519       250224","","126.5","","963763.8"
"2025-02-27","2025-02-24","SF FuneralF820178       250224","","126.5","","963890.3"
"2025-02-27","2025-02-24","SF FuneralF831656       250223","","126.5","","964016.8"
"2025-02-27","2025-02-24","SF FuneralF989371       250224","","63.25","","964080.05"
"2025-02-27","2025-02-24","SF FuneralF990991       250224","","63.25","","964143.3"
"2025-02-27","2025-02-24","SF FuneralF1060513      250224","","126.5","","964269.8"
"2025-02-27","2025-02-24","SF FuneralF1115148      250224","","126.5","","964396.3"
"2025-02-27","2025-02-24","SF FuneralF1120308      250224","","126.5","","964522.8"
"2025-02-27","2025-02-24","SF FuneralF1126920      250224","","126.5","","964649.3"
"2025-02-27","2025-02-24","SF FuneralF1130771      250224","","126.5","","964775.8"
"2025-02-27","2025-02-24","SF FuneralF1131794      250224","","126.5","","964902.3"
"2025-02-27","2025-02-24","SF FuneralF1132350      250224","","126.5","","965028.8"
"2025-02-27","2025-02-25","SF FuneralFDC0000000621F250225","","126.5","","965155.3"
"2025-02-27","2025-02-25","SF FuneralFDC00000006RZQ250225","","126.5","","965281.8"
"2025-02-27","2025-02-25","SF FuneralFDC00000007V1W250225","","126.5","","965408.3"
"2025-02-27","2025-02-25","SF FuneralFDC0000000CQMV250225","","63.25","","965471.55"
"2025-02-27","2025-02-25","SF FuneralF900916       250225","","126.5","","965598.05"
"2025-02-27","2025-02-25","SF FuneralF1016929      250225","","63.25","","965661.3"
"2025-02-27","2025-02-25","SF FuneralF1108985      250225","","126.5","","965787.8"
"2025-02-27","2025-02-25","SF FuneralF1112148      250225","","126.5","","965914.3"
"2025-02-27","2025-02-25","SF FuneralF1125183      250225","","126.5","","966040.8"
"2025-02-27","2025-02-25","SF FuneralF1130838      250225","","126.5","","966167.3"
"2025-02-27","2025-02-25","SF FuneralF1131021      250225","","126.5","","966293.8"
"2025-02-27","2025-02-25","SF FuneralF1131345      250225","","126.5","","966420.3"
"2025-02-27","2025-02-26","SF FuneralF799304       250226","","126.5","","966546.8"
"2025-02-27","2025-02-27","SF FuneralFDC00000005Q72250227","","126.5","","966673.3"
"2025-02-27","2025-02-27","SF FuneralFDC00000006K5G250227","","126.5","","966799.8"
"2025-02-27","2025-02-27","SF FuneralF832725       250227","","126.5","","966926.3"
"2025-02-27","2025-02-27","SF FuneralFDC0000000KFJS250227","","321.5","","967247.8"
"2025-02-27","2025-02-27","SF FuneralFDC0000000LCT3250227","","126.5","","967374.3"
"2025-02-27","2025-02-27","SF FuneralFDC0000000LCT7250227","","126.5","","967500.8"
"2025-02-27","2025-02-27","SF FuneralF1078671      250227","","126.5","","967627.3"
"2025-02-27","2025-02-27","SF FuneralF1108145      250227","","126.5","","967753.8"
"2025-02-27","2025-02-27","SF FuneralF1108309      250227","","126.5","","967880.3"
"2025-02-27","2025-02-27","SF FuneralFDC0000000MF9J250227","","126.5","","968006.8"
"2025-02-27","2025-02-27","SF FuneralF1109833      250227","","126.5","","968133.3"
"2025-02-27","2025-02-22","SF FuneralFDC0000000BL9R250222","","126.5","","968259.8"
"2025-02-27","2025-02-22","SF FuneralF1054784      250222","","126.5","","968386.3"
"2025-02-27","2025-02-24","SF FuneralFDC00000007554250223","","126.5","","968512.8"
"2025-02-27","2025-02-24","SF FuneralF1115020      250224","","63.25","","968576.05"
"2025-02-27","2025-02-24","SF FuneralF1118762      250224","","126.5","","968702.55"
"2025-02-27","2025-02-24","SF FuneralF1116081      250224","","126.5","","968829.05"
"2025-02-27","2025-02-25","SF FuneralFDC00000005N64250225","","63.25","","968892.3"
"2025-02-27","2025-02-25","SF FuneralFDC00000006WZ3250225","","126.5","","969018.8"
"2025-02-27","2025-02-25","SF FuneralFDC00000007LTF250225","","126.5","","969145.3"
"2025-02-27","2025-02-25","SF FuneralFDC00000007NZG250225","","126.5","","969271.8"
"2025-02-27","2025-02-25","SF FuneralF774903       250225","","126.5","","969398.3"
"2025-02-27","2025-02-25","SF FuneralF779557       250225","","191.5","","969589.8"
"2025-02-27","2025-02-25","SF FuneralF1114885      250225","","126.5","","969716.3"
"2025-02-27","2025-02-25","SF FuneralFDC0000000NW1G250225","","126.5","","969842.8"
"2025-02-27","2025-02-25","SF FuneralF1127905      250225","","126.5","","969969.3"
"2025-02-27","2025-02-25","SF FuneralF1132193      250225","","126.5","","970095.8"
"2025-02-27","2025-02-26","SF FuneralFDC000000071CQ250226","","126.5","","970222.3"
"2025-02-27","2025-02-26","SF FuneralF811326       250226","","126.5","","970348.8"
"2025-02-27","2025-02-27","SF FuneralFDC00000005N5Q250227","","126.5","","970475.3"
"2025-02-27","2025-02-27","SF FuneralFDC00000005RQQ250227","","220","","970695.3"
"2025-02-27","2025-02-27","SF FuneralFDC00000006ZP7250227","","126.5","","970821.8"
"2025-02-27","2025-02-27","SF FuneralF805984       250227","","126.5","","970948.3"
"2025-02-27","2025-02-27","SF FuneralF841878       250227","","126.5","","971074.8"
"2025-02-27","2025-02-27","SF FuneralF1060976      250227","","126.5","","971201.3"
"2025-02-27","2025-02-24","SF FuneralF830266       250224","","31.63","","971232.93"
"2025-02-27","2025-02-24","SF FuneralF1125116      250224","","31.63","","971264.56"
"2025-02-27","2025-02-25","SF FuneralFDC0000000K09P250225","","65","","971329.56"
"2025-02-27","2025-02-25","SF FuneralF1126100      250225","","31.63","","971361.19"
"2025-02-27","2025-02-26","SF FuneralF1124171      250226","","31.63","","971392.82"
"2025-02-27","2025-02-25","Rev SF FuneralFDC00000005L57250225","","-31.63","","971361.19"
"2025-02-27","2025-02-22","Rev SF FuneralFDC0000000LNR4250223","","-31.63","","971329.56"
"2025-02-27","2025-02-26","Rev SF FuneralFDC0000000LG2D250226","","-31.63","","971297.93"
"2025-02-27","2025-02-22","Rev SF FuneralFDC00000007TWL250222","","-126.5","","971171.43"
"2025-02-27","2025-02-22","Rev SF FuneralFDC000000080YV250222","","-126.5","","971044.93"
"2025-02-27","2025-02-26","Rev SF FuneralFDC0000000JGRR250226","","-126.5","","970918.43"
"2025-02-27","2025-02-26","Rev SF FuneralFDC000000071CQ250226","","-126.5","","970791.93"
"2025-02-27","2025-02-22","Rev SF FuneralFDC00000006PS8250222","","-126.5","","970665.43"
"2025-02-27","2025-02-22","Rev SF FuneralFDC00000006PSD250222","","-126.5","","970538.93"
"2025-02-27","2025-02-25","Rev SF FuneralFDC00000008LS2250225","","-126.5","","970412.43"
"2025-02-27","2025-02-25","Rev SF FuneralFDC00000005N64250225","","-63.25","","970349.18"
"2025-02-27","2025-02-24","Rev SF FuneralFDC0000000867C250224","","-126.5","","970222.68"
"2025-02-27","2025-02-24","Rev SF FuneralFDC0000000614B250224","","-126.5","","970096.18"
"2025-02-27","2025-02-24","Rev SF FuneralFDC0000000615C250224","","-126.5","","969969.68"
"2025-02-27","2025-02-24","Rev SF FuneralFDC00000006L4X250224","","-126.5","","969843.18"
"2025-02-27","2025-02-21","Rev SF FuneralFDC00000006JSG250221","","-126.5","","969716.68"
"2025-02-27","2025-02-24","Rev SF FuneralFDC000000075T7250224","","-126.5","","969590.18"
"2025-02-27","2025-02-21","Rev SF FuneralFDC0000000JTLM250221","","-126.5","","969463.68"
"2025-02-27","2025-02-27","Rev SF FuneralFDC00000009465250227","","-126.5","","969337.18"
"2025-02-27","2025-02-27","Rev SF FuneralFDC00000009G6V250227","","-126.5","","969210.68"
"2025-02-27","2025-02-27","Rev SF FuneralFDC00000006QQP250227","","-126.5","","969084.18"
"2025-02-27","2025-02-27","Rev SF FuneralFDC00000006QQQ250227","","-126.5","","968957.68"
"2025-02-27","2025-02-27","Rev SF FuneralFDC000000085XL250227","","-126.5","","968831.18"
"2025-02-27","2025-02-27","Rev SF FuneralFDC0000000D2XC250227","","-126.5","","968704.68"
"2025-02-27","2025-02-27","Rev SF FuneralFDC00000006KGR250227","","-126.5","","968578.18"
"2025-02-27","2025-02-21","Rev SF FuneralFDC00000007ZWN250221","","-31.63","","968546.55"
"2025-02-27","2025-02-21","Rev SF FuneralFDC00000005RS3250221","","-31.63","","968514.92"
"2025-02-27","2025-01-24","Rev SF FuneralFDC00000005RS3250124","","-31.63","","968483.29"
"2025-02-27","2025-02-21","Rev SF FuneralFDC00000008TX4250221","","-126.5","","968356.79"
"2025-02-27","2025-02-22","Rev SF FuneralFDC000000060XP250222","","-126.5","","968230.29"
"2025-02-27","2025-02-21","Rev SF FuneralFDC00000008Z24250221","","-126.5","","968103.79"
"2025-02-27","2024-12-11","Rev SF FuneralF1124548      241224","","-126.5","","967977.29"
"2025-02-27","2025-02-22","Rev SF FuneralFDC00000002X18250222","","-220","","967757.29"
"2025-02-27","2025-02-22","Rev SF FuneralFDC0000000J62Q250222","","-126.5","","967630.79"
"2025-02-27","2025-02-24","Rev SF FuneralFDC00000006W3K250223","","-126.5","","967504.29"
"2025-02-27","2025-01-24","Rev SF FuneralF833929       250127","","-126.5","","967377.79"
"2025-02-27","2025-02-24","Rev SF FuneralFDC00000006XQB250224","","-126.5","","967251.29"
"2025-02-27","2024-12-23","Rev SF FuneralF834476       241224","","-126.5","","967124.79"
"2025-02-27","2025-02-22","Rev SF FuneralFDC00000008N5F250222","","-126.5","","966998.29"
"2025-02-27","2025-02-22","Rev SF FuneralFDC00000007D4Y250222","","-126.5","","966871.79"
"2025-02-27","2025-02-25","Rev SF FuneralFDC00000008LS5250225","","-126.5","","966745.29"
"2025-02-27","2025-02-27","Rev SF FuneralFDC0000000372T250227","","-220","","966525.29"
"2025-02-27","2025-02-24","Rev SF FuneralFDC0000000P5GG250224","","-126.5","","966398.79"
"2025-02-27","2025-02-26","SF FuneralFDC00000008X5B250226","","31.63","","966430.42"
"2025-02-27","2025-02-26","SF FuneralF822661       250226","","126.5","","966556.92"
"2025-02-27","2025-02-26","SF FuneralFDC0000000LKMB250226","","126.5","","966683.42"
"2025-02-27","2025-02-26","SF FuneralFDC0000000LKMF250226","","126.5","","966809.92"
"2025-02-27","2025-02-26","SF FuneralF1111944      250226","","126.5","","966936.42"
"2025-02-27","2025-02-26","SF FuneralF1112302      250226","","126.5","","967062.92"
"2025-02-27","2025-02-26","SF FuneralF1122682      250226","","126.5","","967189.42"
"2025-02-27","2025-02-20","SF FuneralF822775       250220","","126.5","","967315.92"
"2025-02-27","2025-02-22","SF FuneralF1084500      250222","","126.5","","967442.42"
"2025-02-27","2025-02-24","SF FuneralFDC000000060CT250223","","126.5","","967568.92"
"2025-02-27","2025-02-24","SF FuneralF1068049      250224","","126.5","","967695.42"
"2025-02-27","2025-02-24","SF FuneralFDC0000000MSC7250224","","47.88","","967743.3"
"2025-02-27","2025-02-25","SF FuneralF841235       250225","","126.5","","967869.8"
"2025-02-27","2025-02-25","SF FuneralF988913       250225","","31.63","","967901.43"
"2025-02-27","2025-02-25","SF FuneralF1055264      250225","","126.5","","968027.93"
"2025-02-27","2025-02-25","SF FuneralF1127485      250225","","31.63","","968059.56"
"2025-02-27","2025-02-25","SF FuneralF1129082      250225","","126.5","","968186.06"
"2025-02-27","2025-02-26","SF FuneralF834027       250226","","126.5","","968312.56"
"2025-02-27","2025-02-26","SF FuneralF1116727      250226","","126.5","","968439.06"
"2025-02-27","2025-02-27","SF FuneralF803249       250227","","126.5","","968565.56"
"2025-02-27","2025-02-27","SF FuneralF1074835      250227","","126.5","","968692.06"
"2025-02-27","2025-02-27","SF FuneralF1125837      250227","","126.5","","968818.56"
"2025-02-27","2025-02-21","SF FuneralF831792       250221","","31.63","","968850.19"
"2025-02-27","2025-02-22","SF FuneralFDC000000072HD250222","","126.5","","968976.69"
"2025-02-27","2025-02-22","SF FuneralF805759       250222","","126.5","","969103.19"
"2025-02-27","2025-02-24","SF FuneralF833736       250223","","126.5","","969229.69"
"2025-02-27","2025-02-24","SF FuneralF843842       250224","","63.25","","969292.94"
"2025-02-27","2025-02-24","SF FuneralF1068032      250224","","63.25","","969356.19"
"2025-02-27","2025-02-24","SF FuneralFDC0000000N7TM250224","","126.5","","969482.69"
"2025-02-27","2025-02-25","SF FuneralFDC00000002QF4250225","","55","","969537.69"
"2025-02-27","2025-02-25","SF FuneralF809796       250225","","63.25","","969600.94"
"2025-02-27","2025-02-25","SF FuneralF811576       250225","","126.5","","969727.44"
"2025-02-27","2025-02-25","SF FuneralF833023       250225","","126.5","","969853.94"
"2025-02-27","2025-02-25","SF FuneralF1113963      250225","","31.63","","969885.57"
"2025-02-27","2025-02-25","SF FuneralF1127432      250225","","31.63","","969917.2"
"2025-02-27","2025-02-25","SF FuneralF1132939      250225","","126.5","","970043.7"
"2025-02-27","2025-02-26","SF FuneralF992138       250226","","126.5","","970170.2"
"2025-02-27","2025-02-26","SF FuneralF1121764      250226","","126.5","","970296.7"
"2025-02-27","2025-02-27","SF FuneralF1122718      250227","","31.63","","970328.33"
"2025-02-27","2025-02-21","SF FuneralFDC00000007MLW250221","","126.5","","970454.83"
"2025-02-27","2025-02-22","SF FuneralF805804       250222","","126.5","","970581.33"
"2025-02-27","2025-02-22","SF FuneralF1078327      250222","","126.5","","970707.83"
"2025-02-27","2025-02-22","SF FuneralF1108324      250222","","126.5","","970834.33"
"2025-02-27","2025-02-22","SF FuneralF1111976      250222","","126.5","","970960.83"
"2025-02-27","2025-02-22","SF FuneralF1114730      250223","","31.63","","970992.46"
"2025-02-27","2025-02-22","SF FuneralF1118554      250223","","126.5","","971118.96"
"2025-02-27","2025-02-27","SF FuneralFDC00000002T5B250227","","220","","971338.96"
"2025-02-27","2025-02-27","SF FuneralFDC000000059D7250227","","126.5","","971465.46"
"2025-02-27","2025-02-27","SF FuneralFDC00000005DZD250227","","126.5","","971591.96"
"2025-02-27","2025-02-27","SF FuneralFDC000000081CC250227","","126.5","","971718.46"
"2025-02-27","2025-02-27","SF FuneralFDC0000000BMF5250227","","126.5","","971844.96"
"2025-02-27","2025-02-27","SF FuneralF829709       250227","","126.5","","971971.46"
"2025-02-27","2025-02-27","SF FuneralF830762       250227","","126.5","","972097.96"
"2025-02-27","2025-02-27","SF FuneralF830825       250227","","126.5","","972224.46"
"2025-02-27","2025-02-27","SF FuneralF831002       250227","","126.5","","972350.96"
"2025-02-27","2025-02-27","SF FuneralF842229       250227","","126.5","","972477.46"
"2025-02-27","2025-02-27","SF FuneralF844280       250227","","126.5","","972603.96"
"2025-02-27","2025-02-27","SF FuneralF1016868      250227","","126.5","","972730.46"
"2025-02-27","2025-02-27","SF FuneralF1050697      250227","","126.5","","972856.96"
"2025-02-27","2025-02-27","SF FuneralF1078865      250227","","47.88","","972904.84"
"2025-02-27","2025-02-27","SF FuneralF1108788      250227","","126.5","","973031.34"
"2025-02-27","2025-02-27","SF FuneralF1110003      250227","","126.5","","973157.84"
"2025-02-27","2025-02-27","SF FuneralF1114703      250227","","126.5","","973284.34"
"2025-02-27","2025-02-27","SF FuneralF1120309      250227","","126.5","","973410.84"
"2025-02-27","2025-02-27","SF FuneralF1128706      250227","","126.5","","973537.34"
"2025-02-27","2025-02-25","SF FuneralFDC00000003HX7250225","","220","","973757.34"
"2025-02-27","2025-02-25","SF FuneralF804590       250225","","126.5","","973883.84"
"2025-02-27","2025-02-25","SF FuneralFDC00000009LMY250225","","126.5","","974010.34"
"2025-02-27","2025-02-25","SF FuneralF981116       250225","","126.5","","974136.84"
"2025-02-27","2025-02-25","SF FuneralF993703       250225","","63.25","","974200.09"
"2025-02-27","2025-02-25","SF FuneralF1116035      250225","","126.5","","974326.59"
"2025-02-27","2025-02-25","SF FuneralF1118809      250225","","31.63","","974358.22"
"2025-02-27","2025-02-25","SF FuneralF1118848      250225","","31.63","","974389.85"
"2025-02-27","2025-02-25","SF FuneralF1120305      250225","","126.5","","974516.35"
"2025-02-27","2025-02-25","SF FuneralF1108147      250225","","126.5","","974642.85"
"2025-02-27","2025-02-25","SF FuneralF1131796      250225","","31.63","","974674.48"
"2025-02-27","2025-02-23","SF FuneralF815224       250223","","126.5","","974800.98"
"2025-02-27","2025-02-24","SF FuneralFDC00000003B9L250224","","220","","975020.98"
"2025-02-27","2025-02-24","SF FuneralFDC00000006TGL250223","","126.5","","975147.48"
"2025-02-27","2025-02-24","SF FuneralF829978       250224","","63.25","","975210.73"
"2025-02-27","2025-02-24","SF FuneralF834614       250224","","31.63","","975242.36"
"2025-02-27","2025-02-24","SF FuneralF844339       250224","","31.63","","975273.99"
"2025-02-27","2025-02-24","SF FuneralF791581       250224","","47.88","","975321.87"
"2025-02-27","2025-02-24","SF FuneralF1102815      250224","","31.63","","975353.5"
"2025-02-27","2025-02-24","SF FuneralF1102914      250224","","31.63","","975385.13"
"2025-02-27","2025-02-24","SF FuneralF1113766      250224","","126.5","","975511.63"
"2025-02-27","2025-02-24","SF FuneralF1122010      250224","","126.5","","975638.13"
"2025-02-28","2025-02-24","SF FuneralF815135       250224","","31.63","","975669.76"
"2025-02-28","2025-02-24","SF FuneralF820769       250224","","31.63","","975701.39"
"2025-02-28","2025-02-24","SF FuneralF834044       250224","","31.63","","975733.02"
"2025-02-28","2025-02-24","SF FuneralF1104295      250224","","31.63","","975764.65"
"2025-02-28","2025-02-24","SF FuneralFDC0000000N7Y7250224","","31.63","","975796.28"
"2025-02-28","2025-02-25","SF FuneralF1132895      250225","","31.63","","975827.91"
"2025-02-28","2025-02-26","SF FuneralF1060919      250226","","31.63","","975859.54"
"2025-02-28","2025-02-25","SF FuneralF1103986      250225","","31.63","","975891.17"
"2025-02-28","2025-02-28","SF FuneralFDC00000003BFT250228","","220","","976111.17"
"2025-02-28","2025-02-28","SF FuneralFDC00000005D1V250228","","220","","976331.17"
"2025-02-28","2025-02-28","SF FuneralFDC000000077MK250228","","126.5","","976457.67"
"2025-02-28","2025-02-28","SF FuneralFDC00000007PYN250228","","126.5","","976584.17"
"2025-02-28","2025-02-28","SF FuneralFDC00000007RZL250228","","126.5","","976710.67"
"2025-02-28","2025-02-28","SF FuneralFDC00000008YNH250228","","213.31","","976923.98"
"2025-02-28","2025-02-28","SF FuneralF843230       250228","","126.5","","977050.48"
"2025-02-28","2025-02-28","SF FuneralF987734       250301","","126.5","","977176.98"
"2025-02-28","2025-02-28","SF FuneralF1118832      250228","","126.5","","977303.48"
"2025-02-28","2025-02-22","SF FuneralFDC000000032TY250222","","220","","977523.48"
"2025-02-28","2025-02-22","SF FuneralF821030       250222","","126.5","","977649.98"
"2025-02-28","2025-02-22","SF FuneralF1058826      250223","","126.5","","977776.48"
"2025-02-28","2025-02-22","SF FuneralFDC0000000L4SZ250222","","126.5","","977902.98"
"2025-02-28","2025-02-22","SF FuneralF1073845      250222","","126.5","","978029.48"
"2025-02-28","2025-02-22","SF FuneralF1130913      250222","","126.5","","978155.98"
"2025-02-28","2025-02-24","SF FuneralFDC0000000652T250224","","126.5","","978282.48"
"2025-02-28","2025-02-24","SF FuneralFDC00000006Q8K250223","","126.5","","978408.98"
"2025-02-28","2025-02-24","SF FuneralFDC00000006T4G250223","","126.5","","978535.48"
"2025-02-28","2025-02-24","SF FuneralFDC0000000708S250224","","126.5","","978661.98"
"2025-02-28","2025-02-24","SF FuneralFDC00000007092250224","","126.5","","978788.48"
"2025-02-28","2025-02-24","SF FuneralFDC00000007MCS250223","","126.5","","978914.98"
"2025-02-28","2025-02-24","SF FuneralFDC0000000832F250223","","63.25","","978978.23"
"2025-02-28","2025-02-24","SF FuneralFDC000000099T5250223","","126.5","","979104.73"
"2025-02-28","2025-02-24","SF FuneralF815172       250224","","126.5","","979231.23"
"2025-02-28","2025-02-24","SF FuneralF815724       250224","","126.5","","979357.73"
"2025-02-28","2025-02-24","SF FuneralF831914       250224","","126.5","","979484.23"
"2025-02-28","2025-02-24","SF FuneralF841226       250224","","126.5","","979610.73"
"2025-02-28","2025-02-24","SF FuneralF981682       250224","","126.5","","979737.23"
"2025-02-28","2025-02-24","SF FuneralF1058727      250224","","126.5","","979863.73"
"2025-02-28","2025-02-24","SF FuneralFDC0000000MD6P250224","","126.5","","979990.23"
"2025-02-28","2025-02-24","SF FuneralF1110330      250224","","63.25","","980053.48"
"2025-02-28","2025-02-24","SF FuneralF1113769      250224","","63.25","","980116.73"
"2025-02-28","2025-02-24","SF FuneralF1126088      250224","","126.5","","980243.23"
"2025-02-28","2025-02-24","SF FuneralF1131783      250224","","126.5","","980369.73"
"2025-02-28","2025-02-25","SF FuneralFDC00000006122250225","","126.5","","980496.23"
"2025-02-28","2025-02-25","SF FuneralFDC000000067FT250225","","63.25","","980559.48"
"2025-02-28","2025-02-25","SF FuneralFDC000000070HK250225","","126.5","","980685.98"
"2025-02-28","2025-02-25","SF FuneralFDC00000007BQ3250225","","126.5","","980812.48"
"2025-02-28","2025-02-25","SF FuneralFDC00000007TNM250225","","126.5","","980938.98"
"2025-02-28","2025-02-25","SF FuneralFDC000000082D1250225","","126.5","","981065.48"
"2025-02-28","2025-02-25","SF FuneralFDC000000087TS250225","","126.5","","981191.98"
"2025-02-28","2025-02-25","SF FuneralFDC000000089WZ250225","","126.5","","981318.48"
"2025-02-28","2025-02-25","SF FuneralFDC00000008BSS250225","","63.25","","981381.73"
"2025-02-28","2025-02-25","SF FuneralF816154       250225","","126.5","","981508.23"
"2025-02-28","2025-02-25","SF FuneralF833843       250225","","126.5","","981634.73"
"2025-02-28","2025-02-25","SF FuneralF841803       250225","","126.5","","981761.23"
"2025-02-28","2025-02-25","SF FuneralF988057       250225","","126.5","","981887.73"
"2025-02-28","2025-02-25","SF FuneralF1020971      250225","","126.5","","982014.23"
"2025-02-28","2025-02-25","SF FuneralF1021355      250225","","126.5","","982140.73"
"2025-02-28","2025-02-25","SF FuneralF1055169      250225","","126.5","","982267.23"
"2025-02-28","2025-02-25","SF FuneralF1066743      250225","","126.5","","982393.73"
"2025-02-28","2025-02-25","SF FuneralF1067884      250225","","126.5","","982520.23"
"2025-02-28","2025-02-25","SF FuneralF1067926      250225","","126.5","","982646.73"
"2025-02-28","2025-02-25","SF FuneralF1108347      250225","","126.5","","982773.23"
"2025-02-28","2025-02-25","SF FuneralF1112386      250225","","126.5","","982899.73"
"2025-02-28","2025-02-25","SF FuneralF1115976      250225","","126.5","","983026.23"
"2025-02-28","2025-02-25","SF FuneralF1129546      250225","","126.5","","983152.73"
"2025-02-28","2025-02-25","SF FuneralF1131619      250225","","126.5","","983279.23"
"2025-02-28","2025-02-25","SF FuneralF1131630      250225","","126.5","","983405.73"
"2025-02-28","2025-02-26","SF FuneralF992356       250226","","126.5","","983532.23"
"2025-02-28","2025-02-26","SF FuneralF1131296      250226","","126.5","","983658.73"
"2025-02-28","2025-02-27","SF FuneralF987256       250227","","126.5","","983785.23"
"2025-02-28","2025-02-27","SF FuneralF1079485      250227","","126.5","","983911.73"
"2025-02-28","2025-02-27","SF FuneralF1113324      250227","","126.5","","984038.23"
"2025-02-28","2025-02-27","SF FuneralF1118950      250227","","126.5","","984164.73"
"2025-02-28","2025-02-27","SF FuneralF1120925      250227","","126.5","","984291.23"
"2025-02-28","2025-02-21","SF FuneralFDC00000007RD4250221","","31.63","","984322.86"
"2025-02-28","2025-02-21","SF FuneralF831565       250221","","31.63","","984354.49"
"2025-02-28","2025-02-24","SF FuneralFDC00000005GH0250224","","31.63","","984386.12"
"2025-02-28","2025-02-24","SF FuneralFDC00000005RR8250224","","31.63","","984417.75"
"2025-02-28","2025-02-24","SF FuneralFDC000000074Y5250224","","55","","984472.75"
"2025-02-28","2025-02-24","SF FuneralF810250       250224","","31.63","","984504.38"
"2025-02-28","2025-02-24","SF FuneralF827602       250224","","31.63","","984536.01"
"2025-02-28","2025-02-24","SF FuneralF841850       250224","","31.63","","984567.64"
"2025-02-28","2025-02-24","SF FuneralF901184       250224","","31.63","","984599.27"
"2025-02-28","2025-02-24","SF FuneralF986655       250224","","31.63","","984630.9"
"2025-02-28","2025-02-24","SF FuneralF990276       250224","","31.63","","984662.53"
"2025-02-28","2025-02-24","SF FuneralF993678       250224","","31.63","","984694.16"
"2025-02-28","2025-02-24","SF FuneralF1016810      250224","","31.63","","984725.79"
"2025-02-28","2025-02-24","SF FuneralFDC0000000KYZ5250224","","31.63","","984757.42"
"2025-02-28","2025-02-24","SF FuneralF1084032      250224","","31.63","","984789.05"
"2025-02-28","2025-02-24","SF FuneralF1102887      250224","","31.63","","984820.68"
"2025-02-28","2025-02-24","SF FuneralF1112394      250224","","31.63","","984852.31"
"2025-02-28","2025-02-24","SF FuneralF1115136      250224","","31.63","","984883.94"
"2025-02-28","2025-02-24","SF FuneralF1115957      250224","","31.63","","984915.57"
"2025-02-28","2025-02-24","SF FuneralF1118005      250224","","31.63","","984947.2"
"2025-02-28","2025-02-24","SF FuneralF1130713      250224","","31.63","","984978.83"
"2025-02-28","2025-02-24","SF FuneralF1132295      250224","","31.63","","985010.46"
"2025-02-28","2025-02-25","SF FuneralFDC00000003BTC250225","","55","","985065.46"
"2025-02-28","2025-02-25","SF FuneralFDC00000005PFJ250225","","31.63","","985097.09"
"2025-02-28","2025-02-25","SF FuneralFDC000000079S6250225","","31.63","","985128.72"
"2025-02-28","2025-02-25","SF FuneralFDC00000007DFS250225","","31.63","","985160.35"
"2025-02-28","2025-02-25","SF FuneralFDC00000007KLD250225","","31.63","","985191.98"
"2025-02-28","2025-02-25","SF FuneralFDC00000007ZH7250225","","31.63","","985223.61"
"2025-02-28","2025-02-25","SF FuneralF827707       250225","","31.63","","985255.24"
"2025-02-28","2025-02-25","SF FuneralFDC0000000BMW2250225","","31.63","","985286.87"
"2025-02-28","2025-02-25","SF FuneralFDC0000000BT1S250225","","31.63","","985318.5"
"2025-02-28","2025-02-25","SF FuneralFDC0000000J00M250225","","31.63","","985350.13"
"2025-02-28","2025-02-25","SF FuneralF993633       250225","","31.63","","985381.76"
"2025-02-28","2025-02-25","SF FuneralFDC0000000K22X250225","","31.63","","985413.39"
"2025-02-28","2025-02-25","SF FuneralFDC0000000N526250225","","31.63","","985445.02"
"2025-02-28","2025-02-25","SF FuneralF1118352      250225","","31.63","","985476.65"
"2025-02-28","2025-02-25","SF FuneralF1118865      250225","","31.63","","985508.28"
"2025-02-28","2025-02-25","SF FuneralF1123316      250225","","31.63","","985539.91"
"2025-02-28","2025-02-25","SF FuneralF1127863      250225","","31.63","","985571.54"
"2025-02-28","2025-02-25","SF FuneralF1131536      250225","","31.63","","985603.17"
"2025-02-28","2025-02-26","SF FuneralF800771       250226","","31.63","","985634.8"
"2025-02-28","2025-02-26","SF FuneralF823094       250226","","31.63","","985666.43"
"2025-02-28","2025-02-26","SF FuneralF1124144      250226","","31.63","","985698.06"
"2025-02-28","2025-02-24","SF FuneralF815223       250223","","126.5","","985824.56"
"2025-02-28","2025-02-24","SF FuneralF1131008      250224","","126.5","","985951.06"
"2025-02-28","2025-02-26","SF FuneralFDC00000004BW6250226","","220","","986171.06"
"2025-02-28","2025-02-26","SF FuneralFDC000000070XZ250226","","126.5","","986297.56"
"2025-02-28","2025-02-26","SF FuneralFDC0000000774H250226","","126.5","","986424.06"
"2025-02-28","2025-02-26","SF FuneralFDC00000007H1F250226","","126.5","","986550.56"
"2025-02-28","2025-02-26","SF FuneralF802400       250226","","126.5","","986677.06"
"2025-02-28","2025-02-26","SF FuneralF808230       250226","","126.5","","986803.56"
"2025-02-28","2025-02-26","SF FuneralF1119769      250226","","126.5","","986930.06"
"2025-02-28","2025-02-26","SF FuneralF1122742      250226","","126.5","","987056.56"
"2025-02-28","2025-02-26","SF FuneralF1124775      250226","","126.5","","987183.06"
"2025-02-28","2025-02-27","SF FuneralFDC00000005FC0250227","","126.5","","987309.56"
"2025-02-28","2025-02-27","SF FuneralFDC00000005WNX250227","","126.5","","987436.06"
"2025-02-28","2025-02-27","SF FuneralF802138       250227","","126.5","","987562.56"
"2025-02-28","2025-02-27","SF FuneralFDC00000009FRN250227","","126.5","","987689.06"
"2025-02-28","2025-02-27","SF FuneralF820060       250227","","126.5","","987815.56"
"2025-02-28","2025-02-27","SF FuneralF986787       250227","","126.5","","987942.06"
"2025-02-28","2025-02-27","SF FuneralF1059413      250227","","126.5","","988068.56"
"2025-02-28","2025-02-27","SF FuneralFDC0000000LTVB250227","","126.5","","988195.06"
"2025-02-28","2025-02-27","SF FuneralF1084871      250227","","126.5","","988321.56"
"2025-02-28","2025-02-27","SF FuneralF1084890      250227","","126.5","","988448.06"
"2025-02-28","2025-02-27","SF FuneralF1102913      250227","","126.5","","988574.56"
"2025-02-28","2025-02-27","SF FuneralF1112508      250227","","126.5","","988701.06"
"2025-02-28","2025-02-27","SF FuneralF1114328      250227","","126.5","","988827.56"
"2025-02-28","2025-02-27","SF FuneralF1116908      250227","","126.5","","988954.06"
"2025-02-28","2025-02-27","SF FuneralF1121923      250227","","126.5","","989080.56"
"2025-02-28","2025-02-27","SF FuneralF1125059      250227","","126.5","","989207.06"
"2025-02-28","2025-02-27","SF FuneralF1125843      250227","","126.5","","989333.56"
"2025-02-28","2025-02-27","SF FuneralF1128999      250227","","126.5","","989460.06"
"2025-02-28","2025-02-19","SF FuneralF1115069      250219","","63.25","","989523.31"
"2025-02-28","2025-02-20","SF FuneralF1060262      250220","","126.5","","989649.81"
"2025-02-28","2025-02-20","SF FuneralFDC0000000L146250220","","126.5","","989776.31"
"2025-02-28","2025-02-20","SF FuneralF1123231      250220","","126.5","","989902.81"
"2025-02-28","2025-02-21","SF FuneralFDC00000005NBQ250221","","126.5","","990029.31"
"2025-02-28","2025-02-21","SF FuneralF841744       250221","","126.5","","990155.81"
"2025-02-28","2025-02-22","SF FuneralFDC000000065D4250222","","126.5","","990282.31"
"2025-02-28","2025-02-22","SF FuneralFDC000000065VK250222","","126.5","","990408.81"
"2025-02-28","2025-02-22","SF FuneralFDC00000008NPF250222","","126.5","","990535.31"
"2025-02-28","2025-02-22","SF FuneralF1120823      250222","","126.5","","990661.81"
"2025-02-28","2025-02-24","SF FuneralFDC000000067BV250224","","126.5","","990788.31"
"2025-02-28","2025-02-24","SF FuneralFDC00000006XCF250224","","126.5","","990914.81"
"2025-02-28","2025-02-24","SF FuneralFDC00000007MKJ250224","","126.5","","991041.31"
"2025-02-28","2025-02-24","SF FuneralFDC00000007N8K250224","","126.5","","991167.81"
"2025-02-28","2025-02-24","SF FuneralF827664       250224","","63.25","","991231.06"
"2025-02-28","2025-02-24","SF FuneralF1061830      250224","","126.5","","991357.56"
"2025-02-28","2025-02-24","SF FuneralFDC0000000MD6N250224","","126.5","","991484.06"
"2025-02-28","2025-02-24","SF FuneralF1108561      250224","","126.5","","991610.56"
"2025-02-28","2025-02-24","SF FuneralF1108732      250224","","126.5","","991737.06"
"2025-02-28","2025-02-25","SF FuneralFDC00000006ZHR250225","","126.5","","991863.56"
"2025-02-28","2025-02-25","SF FuneralFDC00000007YRL250225","","126.5","","991990.06"
"2025-02-28","2025-02-25","SF FuneralF988975       250225","","126.5","","992116.56"
"2025-02-28","2025-02-25","SF FuneralF1020783      250225","","126.5","","992243.06"
"2025-02-28","2025-02-25","SF FuneralF1078333      250225","","126.5","","992369.56"
"2025-02-28","2025-02-25","SF FuneralF1103753      250225","","126.5","","992496.06"
"2025-02-28","2025-02-25","SF FuneralF1115959      250225","","126.5","","992622.56"
"2025-02-28","2025-02-25","SF FuneralF1130945      250225","","126.5","","992749.06"
"2025-02-28","2025-02-26","SF FuneralF1059431      250226","","126.5","","992875.56"
"2025-02-28","2025-02-26","SF FuneralF1121899      250226","","126.5","","993002.06"
"2025-02-28","2025-02-27","SF FuneralF786966       250227","","126.5","","993128.56"
"2025-02-28","2025-02-27","SF FuneralF798998       250227","","126.5","","993255.06"
"2025-02-28","2025-02-27","SF FuneralF842463       250227","","126.5","","993381.56"
"2025-02-28","2025-02-27","SF FuneralFDC0000000KFH7250227","","126.5","","993508.06"
"2025-02-28","2025-02-27","SF FuneralF1120936      250227","","126.5","","993634.56"
"2025-02-28","2025-02-27","SF FuneralF1127973      250227","","126.5","","993761.06"
"2025-02-28","2025-02-20","SF FuneralFDC00000005M0Y250220","","126.5","","993887.56"
"2025-02-28","2025-02-21","SF FuneralFDC00000007MLG250221","","220","","994107.56"
"2025-02-28","2025-02-21","SF FuneralFDC00000008205250221","","126.5","","994234.06"
"2025-02-28","2025-02-21","SF FuneralF803347       250221","","126.5","","994360.56"
"2025-02-28","2025-02-21","SF FuneralF1108253      250221","","126.5","","994487.06"
"2025-02-28","2025-02-21","SF FuneralF1129117      250221","","126.5","","994613.56"
"2025-02-28","2025-02-22","SF FuneralFDC000000030P2250222","","220","","994833.56"
"2025-02-28","2025-02-22","SF FuneralFDC00000005GLG250222","","126.5","","994960.06"
"2025-02-28","2025-02-22","SF FuneralFDC00000005ZHX250222","","126.5","","995086.56"
"2025-02-28","2025-02-22","SF FuneralFDC000000085C4250222","","126.5","","995213.06"
"2025-02-28","2025-02-22","SF FuneralF803777       250222","","126.5","","995339.56"
"2025-02-28","2025-02-22","SF FuneralF818548       250222","","126.5","","995466.06"
"2025-02-28","2025-02-22","SF FuneralF822044       250222","","126.5","","995592.56"
"2025-02-28","2025-02-22","SF FuneralF992079       250223","","126.5","","995719.06"
"2025-02-28","2025-02-22","SF FuneralF1068327      250222","","126.5","","995845.56"
"2025-02-28","2025-02-22","SF FuneralF1102936      250222","","126.5","","995972.06"
"2025-02-28","2025-02-22","SF FuneralF1108335      250222","","126.5","","996098.56"
"2025-02-28","2025-02-24","SF FuneralFDC00000003D9X250224","","220","","996318.56"
"2025-02-28","2025-02-24","SF FuneralFDC00000006Z1H250223","","126.5","","996445.06"
"2025-02-28","2025-02-24","SF FuneralFDC000000070HF250224","","126.5","","996571.56"
"2025-02-28","2025-02-24","SF FuneralFDC00000007N8N250224","","126.5","","996698.06"
"2025-02-28","2025-02-24","SF FuneralFDC00000007R5Z250224","","63.25","","996761.31"
"2025-02-28","2025-02-24","SF FuneralFDC0000000831X250223","","63.25","","996824.56"
"2025-02-28","2025-02-24","SF FuneralF798445       250223","","126.5","","996951.06"
"2025-02-28","2025-02-24","SF FuneralF833321       250224","","126.5","","997077.56"
"2025-02-28","2025-02-24","SF FuneralF843425       250224","","191.5","","997269.06"
"2025-02-28","2025-02-24","SF FuneralF1020978      250224","","126.5","","997395.56"
"2025-02-28","2025-02-24","SF FuneralF1021482      250224","","126.5","","997522.06"
"2025-02-28","2025-02-24","SF FuneralF1060914      250224","","63.25","","997585.31"
"2025-02-28","2025-02-24","SF FuneralFDC0000000LWJY250224","","126.5","","997711.81"
"2025-02-28","2025-02-24","SF FuneralF1110347      250224","","126.5","","997838.31"
"2025-02-28","2025-02-24","SF FuneralF1114111      250224","","126.5","","997964.81"
"2025-02-28","2025-02-24","SF FuneralF797550       250224","","126.5","","998091.31"
"2025-02-28","2025-02-24","SF FuneralFDC0000000PRPK250224","","126.5","","998217.81"
"2025-02-28","2025-02-25","SF FuneralFDC00000003D2J250225","","110","","998327.81"
"2025-02-28","2025-02-25","SF FuneralFDC000000068B0250225","","126.5","","998454.31"
"2025-02-28","2025-02-25","SF FuneralFDC00000006LLR250225","","126.5","","998580.81"
"2025-02-28","2025-02-25","SF FuneralFDC00000006MXW250225","","63.25","","998644.06"
"2025-02-28","2025-02-25","SF FuneralFDC00000007Q9T250225","","126.5","","998770.56"
"2025-02-28","2025-02-25","SF FuneralF811721       250225","","126.5","","998897.06"
"2025-02-28","2025-02-25","SF FuneralF989167       250225","","126.5","","999023.56"
"2025-02-28","2025-02-25","SF FuneralFDC0000000KFZP250225","","63.25","","999086.81"
"2025-02-28","2025-02-25","SF FuneralF1060528      250225","","63.25","","999150.06"
"2025-02-28","2025-02-25","SF FuneralF1074593      250225","","126.5","","999276.56"
"2025-02-28","2025-02-25","SF FuneralF1079157      250225","","63.25","","999339.81"
"2025-02-28","2025-02-25","SF FuneralFDC0000000Q26X250225","","126.5","","999466.31"
"2025-02-28","2025-02-25","SF FuneralF1130719      250225","","126.5","","999592.81"
"2025-02-28","2025-02-25","SF FuneralF1130805      250225","","126.5","","999719.31"
"2025-02-28","2025-02-25","SF FuneralF1130843      250225","","126.5","","999845.81"
"2025-02-28","2025-02-25","SF FuneralF1132339      250225","","126.5","","999972.31"
"2025-02-28","2025-02-26","SF FuneralF828069       250226","","126.5","","1000098.81"
"2025-02-28","2025-02-26","SF FuneralF842446       250226","","126.5","","1000225.31"
"2025-02-28","2025-02-26","SF FuneralF993666       250226","","126.5","","1000351.81"
"2025-02-28","2025-02-26","SF FuneralF1016673      250226","","126.5","","1000478.31"
"2025-02-28","2025-02-27","SF FuneralFDC00000008RKZ250227","","126.5","","1000604.81"
"2025-02-28","2025-02-27","SF FuneralFDC00000008RYW250227","","126.5","","1000731.31"
"2025-02-28","2025-02-27","SF FuneralFDC00000008RZ0250227","","126.5","","1000857.81"
"2025-02-28","2025-02-27","SF FuneralF811695       250227","","126.5","","1000984.31"
"2025-02-28","2025-02-27","SF FuneralF841074       250227","","126.5","","1001110.81"
"2025-02-28","2025-02-27","SF FuneralF1074699      250227","","126.5","","1001237.31"
"2025-02-28","2025-02-27","SF FuneralF1114019      250227","","126.5","","1001363.81"
"2025-02-28","2025-02-27","SF FuneralFDC0000000NZ9M250227","","126.5","","1001490.31"
"2025-02-28","2025-02-25","SF FuneralFDC00000007NXH250225","","126.5","","1001616.81"
"2025-02-28","2025-02-25","SF FuneralF1078541      250225","","126.5","","1001743.31"
"2025-02-28","2025-02-25","SF FuneralFDC0000000Q8C9250225","","126.5","","1001869.81"
"2025-02-28","2025-02-26","SF FuneralF813598       250226","","126.5","","1001996.31"
"2025-02-28","2025-02-26","SF FuneralFDC0000000JCX1250226","","126.5","","1002122.81"
"2025-02-28","2025-02-26","SF FuneralF993570       250226","","126.5","","1002249.31"
"2025-02-28","2025-02-26","SF FuneralF1016815      250226","","126.5","","1002375.81"
"2025-02-28","2025-02-26","SF FuneralF1022000      250226","","126.5","","1002502.31"
"2025-02-28","2025-02-27","SF FuneralFDC00000005SQJ250227","","126.5","","1002628.81"
"2025-02-28","2025-02-27","SF FuneralFDC00000005ZZC250227","","126.5","","1002755.31"
"2025-02-28","2025-02-27","SF FuneralFDC00000006C6L250227","","126.5","","1002881.81"
"2025-02-28","2025-02-27","SF FuneralFDC00000006TVB250227","","126.5","","1003008.31"
"2025-02-28","2025-02-27","SF FuneralFDC000000076M7250227","","126.5","","1003134.81"
"2025-02-28","2025-02-27","SF FuneralF819027       250227","","126.5","","1003261.31"
"2025-02-28","2025-02-27","SF FuneralFDC0000000DQW2250227","","126.5","","1003387.81"
"2025-02-28","2025-02-27","SF FuneralFDC0000000H3SM250227","","126.5","","1003514.31"
"2025-02-28","2025-02-27","SF FuneralF1055162      250227","","126.5","","1003640.81"
"2025-02-28","2025-02-27","SF FuneralF1080407      250227","","126.5","","1003767.31"
"2025-02-28","2025-02-27","SF FuneralF1114046      250227","","126.5","","1003893.81"
"2025-02-28","2025-02-27","SF FuneralFDC0000000P0RR250227","","126.5","","1004020.31"
"2025-02-28","2025-02-24","SF FuneralFDC00000004NQP250223","","31.63","","1004051.94"
"2025-02-28","2025-02-24","SF FuneralFDC00000005NR4250224","","31.63","","1004083.57"
"2025-02-28","2025-02-24","SF FuneralFDC00000007WVJ250224","","31.63","","1004115.2"
"2025-02-28","2025-02-24","SF FuneralF813361       250224","","31.63","","1004146.83"
"2025-02-28","2025-02-24","SF FuneralF815144       250224","","31.63","","1004178.46"
"2025-02-28","2025-02-24","SF FuneralF822865       250224","","31.63","","1004210.09"
"2025-02-28","2025-02-24","SF FuneralF1072930      250224","","31.63","","1004241.72"
"2025-02-28","2025-02-24","SF FuneralF1073218      250224","","31.63","","1004273.35"
"2025-02-28","2025-02-24","SF FuneralF1108848      250224","","31.63","","1004304.98"
"2025-02-28","2025-02-24","SF FuneralFDC0000000PYVQ250224","","31.63","","1004336.61"
"2025-02-28","2025-02-25","SF FuneralF814180       250225","","31.63","","1004368.24"
"2025-02-28","2025-02-25","SF FuneralF987241       250225","","31.63","","1004399.87"
"2025-02-28","2025-02-25","SF FuneralF1128820      250225","","31.63","","1004431.5"
"2025-02-28","2025-02-27","SF FuneralFDC00000006ZNM250227","","31.63","","1004463.13"
"2025-02-28","2025-02-27","SF FuneralF805236       250227","","31.63","","1004494.76"
"2025-02-28","2025-02-18","SF FuneralF993692       250218","","63.25","","1004558.01"
"2025-02-28","2025-02-24","SF FuneralF804198       250224","","63.25","","1004621.26"
"2025-02-28","2025-02-24","SF FuneralF1112218      250224","","126.5","","1004747.76"
"2025-02-28","2025-02-24","SF FuneralF1119011      250224","","126.5","","1004874.26"
"2025-02-28","2025-02-25","SF FuneralFDC00000007388250225","","126.5","","1005000.76"
"2025-02-28","2025-02-25","SF FuneralF1129025      250225","","126.5","","1005127.26"
"2025-02-28","2025-02-25","SF FuneralF1130982      250225","","126.5","","1005253.76"
"2025-02-28","2025-02-26","SF FuneralF1059444      250226","","126.5","","1005380.26"
"2025-02-28","2025-02-26","SF FuneralF1066067      250226","","126.5","","1005506.76"
"2025-02-28","2025-02-27","SF FuneralFDC000000080X5250227","","126.5","","1005633.26"
"2025-02-28","2025-02-20","SF FuneralFDC00000006NLK250220","","126.5","","1005759.76"
"2025-02-28","2025-02-21","SF FuneralF988112       250222","","126.5","","1005886.26"
"2025-02-28","2025-02-22","SF FuneralFDC00000005XG2250222","","126.5","","1006012.76"
"2025-02-28","2025-02-22","SF FuneralF805248       250222","","126.5","","1006139.26"
"2025-02-28","2025-02-22","SF FuneralFDC000000094ZN250222","","126.5","","1006265.76"
"2025-02-28","2025-02-22","SF FuneralF811423       250222","","126.5","","1006392.26"
"2025-02-28","2025-02-22","SF FuneralF1017741      250222","","126.5","","1006518.76"
"2025-02-28","2025-02-22","SF FuneralF1020771      250222","","126.5","","1006645.26"
"2025-02-28","2025-02-22","SF FuneralF1114951      250223","","126.5","","1006771.76"
"2025-02-28","2025-02-24","SF FuneralFDC00000006328250224","","126.5","","1006898.26"
"2025-02-28","2025-02-24","SF FuneralFDC00000006MW9250224","","126.5","","1007024.76"
"2025-02-28","2025-02-24","SF FuneralF812703       250223","","126.5","","1007151.26"
"2025-02-28","2025-02-24","SF FuneralF821865       250224","","63.25","","1007214.51"
"2025-02-28","2025-02-24","SF FuneralF1083899      250224","","126.5","","1007341.01"
"2025-02-28","2025-02-24","SF FuneralF1128880      250224","","126.5","","1007467.51"
"2025-02-28","2025-02-24","SF FuneralF1130650      250224","","126.5","","1007594.01"
"2025-02-28","2025-02-25","SF FuneralF810352       250225","","126.5","","1007720.51"
"2025-02-28","2025-02-25","SF FuneralF993355       250225","","126.5","","1007847.01"
"2025-02-28","2025-02-25","SF FuneralF1131075      250225","","126.5","","1007973.51"
"2025-02-28","2025-02-26","SF FuneralFDC00000006386250226","","126.5","","1008100.01"
"2025-02-28","2025-02-26","SF FuneralF1118245      250226","","126.5","","1008226.51"
"2025-02-28","2025-02-27","SF FuneralFDC00000005SNP250227","","126.5","","1008353.01"
"2025-02-28","2025-02-27","SF FuneralFDC0000000659D250227","","126.5","","1008479.51"
"2025-02-28","2025-02-27","SF FuneralFDC000000065GW250227","","126.5","","1008606.01"
"2025-02-28","2025-02-27","SF FuneralFDC0000000696S250227","","126.5","","1008732.51"
"2025-02-28","2025-02-27","SF FuneralFDC00000006DGC250227","","126.5","","1008859.01"
"2025-02-28","2025-02-27","SF FuneralFDC00000006ZHS250227","","126.5","","1008985.51"
"2025-02-28","2025-02-27","SF FuneralF808363       250227","","126.5","","1009112.01"
"2025-02-28","2025-02-27","SF FuneralF1112265      250227","","126.5","","1009238.51"
"2025-02-28","2025-02-20","SF FuneralFDC000000067MK250220","","126.5","","1009365.01"
"2025-02-28","2025-02-21","SF FuneralF1125165      250221","","126.5","","1009491.51"
"2025-02-28","2025-02-22","SF FuneralF812729       250222","","126.5","","1009618.01"
"2025-02-28","2025-02-22","SF FuneralF823203       250222","","126.5","","1009744.51"
"2025-02-28","2025-02-22","SF FuneralF1108736      250222","","126.5","","1009871.01"
"2025-02-28","2025-02-24","SF FuneralFDC0000000820X250224","","126.5","","1009997.51"
"2025-02-28","2025-02-24","SF FuneralF823428       250224","","126.5","","1010124.01"
"2025-02-28","2025-02-24","SF FuneralF830196       250224","","126.5","","1010250.51"
"2025-02-28","2025-02-24","SF FuneralF1060760      250224","","63.25","","1010313.76"
"2025-02-28","2025-02-24","SF FuneralF1074819      250224","","126.5","","1010440.26"
"2025-02-28","2025-02-24","SF FuneralF1112102      250224","","63.25","","1010503.51"
"2025-02-28","2025-02-24","SF FuneralF1113968      250224","","63.25","","1010566.76"
"2025-02-28","2025-02-24","SF FuneralF1124771      250224","","126.5","","1010693.26"
"2025-02-28","2025-02-25","SF FuneralFDC00000006G7M250225","","126.5","","1010819.76"
"2025-02-28","2025-02-25","SF FuneralFDC00000007VD0250225","","126.5","","1010946.26"
"2025-02-28","2025-02-25","SF FuneralFDC00000007VFN250225","","126.5","","1011072.76"
"2025-02-28","2025-02-25","SF FuneralF823642       250225","","126.5","","1011199.26"
"2025-02-28","2025-02-25","SF FuneralFDC0000000FQV0250225","","63.25","","1011262.51"
"2025-02-28","2025-02-25","SF FuneralF1120913      250225","","126.5","","1011389.01"
"2025-02-28","2025-02-25","SF FuneralF1130779      250225","","126.5","","1011515.51"
"2025-02-28","2025-02-25","SF FuneralF1132363      250225","","126.5","","1011642.01"
"2025-02-28","2025-02-27","SF FuneralF1078536      250227","","126.5","","1011768.51"
"2025-02-28","2025-02-27","SF FuneralF1108254      250227","","126.5","","1011895.01"
"2025-02-28","2025-02-18","SF FuneralF823133       250218","","126.5","","1012021.51"
"2025-02-28","2025-02-18","SF FuneralF1017847      250218","","63.25","","1012084.76"
"2025-02-28","2025-02-22","SF FuneralFDC00000003MN1250222","","220","","1012304.76"
"2025-02-28","2025-02-22","SF FuneralFDC00000003MNW250222","","220","","1012524.76"
"2025-02-28","2025-02-22","SF FuneralFDC00000007CP5250222","","126.5","","1012651.26"
"2025-02-28","2025-02-22","SF FuneralFDC00000007CX0250222","","126.5","","1012777.76"
"2025-02-28","2025-02-22","SF FuneralFDC00000008KRN250222","","126.5","","1012904.26"
"2025-02-28","2025-02-22","SF FuneralFDC0000000BCTS250222","","126.5","","1013030.76"
"2025-02-28","2025-02-24","SF FuneralFDC00000006R1D250223","","126.5","","1013157.26"
"2025-02-28","2025-02-24","SF FuneralF805872       250224","","126.5","","1013283.76"
"2025-02-28","2025-02-24","SF FuneralF818873       250224","","126.5","","1013410.26"
"2025-02-28","2025-02-24","SF FuneralF820713       250224","","126.5","","1013536.76"
"2025-02-28","2025-02-24","SF FuneralF832986       250224","","126.5","","1013663.26"
"2025-02-28","2025-02-24","SF FuneralF834043       250224","","63.25","","1013726.51"
"2025-02-28","2025-02-24","SF FuneralF1020636      250224","","126.5","","1013853.01"
"2025-02-28","2025-02-24","SF FuneralF1067997      250224","","126.5","","1013979.51"
"2025-02-28","2025-02-24","SF FuneralFDC0000000NWX1250224","","191.5","","1014171.01"
"2025-02-28","2025-02-24","SF FuneralF782168       250224","","126.5","","1014297.51"
"2025-02-28","2025-02-24","SF FuneralF1131189      250224","","126.5","","1014424.01"
"2025-02-28","2025-02-25","SF FuneralFDC00000007YPY250225","","126.5","","1014550.51"
"2025-02-28","2025-02-25","SF FuneralF816528       250225","","126.5","","1014677.01"
"2025-02-28","2025-02-25","SF FuneralF841858       250225","","126.5","","1014803.51"
"2025-02-28","2025-02-25","SF FuneralF1054827      250225","","126.5","","1014930.01"
"2025-02-28","2025-02-25","SF FuneralF779732       250225","","126.5","","1015056.51"
"2025-02-28","2025-02-27","SF FuneralF802244       250227","","126.5","","1015183.01"
"2025-02-28","2025-02-27","SF FuneralF812416       250227","","126.5","","1015309.51"
"2025-02-28","2025-02-27","SF FuneralF813372       250227","","126.5","","1015436.01"
"2025-02-28","2025-02-27","SF FuneralFDC00000009HB8250227","","126.5","","1015562.51"
"2025-02-28","2025-02-27","SF FuneralF821294       250227","","126.5","","1015689.01"
"2025-02-28","2025-02-27","SF FuneralFDC0000000DNYN250227","","126.5","","1015815.51"
"2025-02-28","2025-02-27","SF FuneralFDC0000000LTGX250227","","126.5","","1015942.01"
"2025-02-28","2025-02-27","SF FuneralF1128075      250227","","126.5","","1016068.51"
"2025-02-28","2025-02-22","SF FuneralF1017782      250222","","126.5","","1016195.01"
"2025-02-28","2025-02-22","SF FuneralF1083871      250222","","126.5","","1016321.51"
"2025-02-28","2025-02-24","SF FuneralF1132229      250224","","126.5","","1016448.01"
"2025-02-28","2025-02-25","SF FuneralFDC00000006JR9250225","","126.5","","1016574.51"
"2025-02-28","2025-02-25","SF FuneralF990777       250225","","63.25","","1016637.76"
"2025-02-28","2025-02-25","SF FuneralF1016996      250225","","126.5","","1016764.26"
"2025-02-28","2025-02-26","SF FuneralF992108       250226","","126.5","","1016890.76"
"2025-02-28","2025-02-26","SF FuneralF1128140      250226","","126.5","","1017017.26"
"2025-02-28","2025-02-27","SF FuneralFDC00000003WD1250227","","220","","1017237.26"
"2025-02-28","2025-02-27","SF FuneralFDC000000086LY250227","","126.5","","1017363.76"
"2025-02-28","2025-02-27","SF FuneralF831607       250227","","126.5","","1017490.26"
"2025-02-28","2025-02-27","SF FuneralF842261       250227","","126.5","","1017616.76"
"2025-02-28","2025-02-27","SF FuneralFDC0000000FNW1250227","","126.5","","1017743.26"
"2025-02-28","2025-02-27","SF FuneralF1055002      250227","","126.5","","1017869.76"
"2025-02-28","2025-02-27","SF FuneralFDC0000000KJBJ250227","","126.5","","1017996.26"
"2025-02-28","2025-02-27","SF FuneralF1125263      250227","","126.5","","1018122.76"
"2025-02-28","2025-02-27","SF FuneralF1128719      250227","","126.5","","1018249.26"
"2025-02-28","2025-02-21","SF FuneralFDC0000000H5YY250223","","31.63","","1018280.89"
"2025-02-28","2025-02-24","SF FuneralFDC00000004NQM250223","","31.63","","1018312.52"
"2025-02-28","2025-02-24","SF FuneralF1118957      250224","","31.63","","1018344.15"
"2025-02-28","2025-02-24","SF FuneralF1129402      250224","","31.63","","1018375.78"
"2025-02-28","2025-02-24","SF FuneralF1132386      250224","","31.63","","1018407.41"
"2025-02-28","2025-02-25","SF FuneralFDC00000005R1B250225","","31.63","","1018439.04"
"2025-02-28","2025-02-25","SF FuneralF802295       250225","","31.63","","1018470.67"
"2025-02-28","2025-02-25","SF FuneralF814063       250225","","31.63","","1018502.3"
"2025-02-28","2025-02-25","SF FuneralF819158       250225","","31.63","","1018533.93"
"2025-02-28","2025-02-25","SF FuneralF821837       250225","","47.88","","1018581.81"
"2025-02-28","2025-02-25","SF FuneralF830294       250225","","31.63","","1018613.44"
"2025-02-28","2025-02-25","SF FuneralF1066227      250225","","31.63","","1018645.07"
"2025-02-28","2025-02-25","SF FuneralF1110079      250225","","31.63","","1018676.7"
"2025-02-28","2025-02-25","SF FuneralFDC0000000NZV5250225","","31.63","","1018708.33"
"2025-02-28","2025-02-25","SF FuneralF1121873      250225","","31.63","","1018739.96"
"2025-02-28","2025-02-25","SF FuneralF1130942      250225","","31.63","","1018771.59"
"2025-02-28","2025-02-26","SF FuneralFDC0000000MLNC250226","","31.63","","1018803.22"
"2025-02-28","2025-02-27","SF FuneralFDC00000005P8B250227","","31.63","","1018834.85"
"2025-02-28","2025-02-27","SF FuneralF1116989      250227","","31.63","","1018866.48"
"2025-02-28","2025-02-20","SF FuneralFDC00000007L23250220","","126.5","","1018992.98"
"2025-02-28","2025-02-21","SF FuneralFDC0000000HJSC250223","","126.5","","1019119.48"
"2025-02-28","2025-02-22","SF FuneralFDC0000000J995250223","","126.5","","1019245.98"
"2025-02-28","2025-02-24","SF FuneralFDC00000005PH9250224","","63.25","","1019309.23"
"2025-02-28","2025-02-24","SF FuneralF818769       250223","","126.5","","1019435.73"
"2025-02-28","2025-02-24","SF FuneralF823486       250224","","126.5","","1019562.23"
"2025-02-28","2025-02-24","SF FuneralF1068031      250224","","126.5","","1019688.73"
"2025-02-28","2025-02-24","SF FuneralF1113184      250224","","126.5","","1019815.23"
"2025-02-28","2025-02-24","SF FuneralF1114604      250224","","63.25","","1019878.48"
"2025-02-28","2025-02-24","SF FuneralF1132387      250224","","63.25","","1019941.73"
"2025-02-28","2025-02-25","SF FuneralF840754       250225","","126.5","","1020068.23"
"2025-02-28","2025-02-25","SF FuneralF1016773      250225","","126.5","","1020194.73"
"2025-02-28","2025-02-25","SF FuneralF1054959      250225","","126.5","","1020321.23"
"2025-02-28","2025-02-25","SF FuneralF1054998      250225","","63.25","","1020384.48"
"2025-02-28","2025-02-25","SF FuneralF1116008      250225","","126.5","","1020510.98"
"2025-02-28","2025-02-25","SF FuneralF1116029      250225","","126.5","","1020637.48"
"2025-02-28","2025-02-25","SF FuneralF1116940      250225","","126.5","","1020763.98"
"2025-02-28","2025-02-26","SF FuneralFDC00000008385250226","","126.5","","1020890.48"
"2025-02-28","2025-02-26","SF FuneralFDC0000000FVPK250226","","126.5","","1021016.98"
"2025-02-28","2025-02-26","SF FuneralF992042       250226","","126.5","","1021143.48"
"2025-02-28","2025-02-26","SF FuneralF1022170      250226","","126.5","","1021269.98"
"2025-02-28","2025-02-26","SF FuneralFDC0000000PFWQ250226","","126.5","","1021396.48"
"2025-02-28","2025-02-27","SF FuneralFDC000000069ZD250227","","126.5","","1021522.98"
"2025-02-28","2025-02-27","SF FuneralFDC00000006D6D250227","","126.5","","1021649.48"
"2025-02-28","2025-02-27","SF FuneralFDC000000085BX250227","","126.5","","1021775.98"
"2025-02-28","2025-02-27","SF FuneralF820042       250227","","126.5","","1021902.48"
"2025-02-28","2025-02-27","SF FuneralF823415       250227","","126.5","","1022028.98"
"2025-02-28","2025-02-27","SF FuneralF832656       250227","","126.5","","1022155.48"
"2025-02-28","2025-02-27","SF FuneralF834081       250227","","126.5","","1022281.98"
"2025-02-28","2025-02-27","SF FuneralF1112343      250227","","126.5","","1022408.48"
"2025-02-28","2025-02-27","SF FuneralFDC0000000N3WX250227","","126.5","","1022534.98"
"2025-02-28","2025-02-27","SF FuneralF1116105      250227","","126.5","","1022661.48"
"2025-02-28","2025-02-27","SF FuneralF1126091      250227","","126.5","","1022787.98"
"2025-02-28","2025-02-26","SF FuneralFDC000000078V2250226","","126.5","","1022914.48"
"2025-02-28","2025-02-26","SF FuneralF799032       250226","","126.5","","1023040.98"
"2025-02-28","2025-02-26","SF FuneralF820082       250226","","126.5","","1023167.48"
"2025-02-28","2025-02-26","SF FuneralF991944       250226","","126.5","","1023293.98"
"2025-02-28","2025-02-26","SF FuneralF1059424      250226","","31.63","","1023325.61"
"2025-02-28","2025-02-26","SF FuneralF1074661      250226","","126.5","","1023452.11"
"2025-02-28","2025-02-27","SF FuneralFDC00000005LNN250227","","126.5","","1023578.61"
"2025-02-28","2025-02-27","SF FuneralF804409       250227","","126.5","","1023705.11"
"2025-02-28","2025-02-27","SF FuneralFDC00000008WQZ250227","","126.5","","1023831.61"
"2025-02-28","2025-02-27","SF FuneralF813322       250227","","126.5","","1023958.11"
"2025-02-28","2025-02-27","SF FuneralF813959       250227","","126.5","","1024084.61"
"2025-02-28","2025-02-27","SF FuneralF992223       250227","","126.5","","1024211.11"
"2025-02-28","2025-02-27","SF FuneralF1050804      250227","","126.5","","1024337.61"
"2025-02-28","2025-02-27","SF FuneralF1055035      250227","","126.5","","1024464.11"
"2025-02-28","2025-02-27","SF FuneralF1102935      250227","","126.5","","1024590.61"
"2025-02-28","2025-02-27","SF FuneralFDC0000000MLKK250227","","126.5","","1024717.11"
"2025-02-28","2025-02-27","SF FuneralF1116775      250227","","126.5","","1024843.61"
"2025-02-28","2025-02-27","SF FuneralF1118150      250227","","126.5","","1024970.11"
"2025-02-28","2025-02-27","SF FuneralF1120118      250227","","126.5","","1025096.61"
"2025-02-28","2025-02-27","SF FuneralFDC0000000PLXF250227","","126.5","","1025223.11"
"2025-02-28","2025-02-22","SF FuneralFDC00000005NJ8250222","","126.5","","1025349.61"
"2025-02-28","2025-02-22","SF FuneralFDC00000008S7L250222","","126.5","","1025476.11"
"2025-02-28","2025-02-22","SF FuneralFDC0000000K8W4250222","","126.5","","1025602.61"
"2025-02-28","2025-02-22","SF FuneralFDC0000000K8W8250222","","126.5","","1025729.11"
"2025-02-28","2025-02-22","SF FuneralFDC0000000KPV2250222","","126.5","","1025855.61"
"2025-02-28","2025-02-22","SF FuneralF1061963      250222","","126.5","","1025982.11"
"2025-02-28","2025-02-22","SF FuneralF1117998      250223","","31.63","","1026013.74"
"2025-02-28","2025-02-22","SF FuneralFDC0000000Q26R250222","","126.5","","1026140.24"
"2025-02-28","2025-02-22","SF FuneralF1130648      250222","","126.5","","1026266.74"
"2025-02-28","2025-02-25","SF FuneralFDC00000007423250225","","126.5","","1026393.24"
"2025-02-28","2025-02-25","SF FuneralFDC00000007LS5250225","","126.5","","1026519.74"
"2025-02-28","2025-02-25","SF FuneralFDC00000007PQ8250225","","126.5","","1026646.24"
"2025-02-28","2025-02-25","SF FuneralF797055       250225","","31.63","","1026677.87"
"2025-02-28","2025-02-25","SF FuneralFDC0000000892D250225","","31.63","","1026709.5"
"2025-02-28","2025-02-25","SF FuneralF802690       250225","","126.5","","1026836"
"2025-02-28","2025-02-25","SF FuneralF816567       250225","","126.5","","1026962.5"
"2025-02-28","2025-02-25","SF FuneralF828867       250225","","31.63","","1026994.13"
"2025-02-28","2025-02-25","SF FuneralF832091       250225","","126.5","","1027120.63"
"2025-02-28","2025-02-25","SF FuneralFDC0000000ML7D250225","","31.63","","1027152.26"
"2025-02-28","2025-02-25","SF FuneralF1114013      250225","","126.5","","1027278.76"
"2025-02-28","2025-02-25","SF FuneralF1120129      250225","","31.63","","1027310.39"
"2025-02-28","2025-02-25","SF FuneralF1121896      250225","","126.5","","1027436.89"
"2025-02-28","2025-02-25","SF FuneralF1128933      250225","","126.5","","1027563.39"
"2025-02-28","2025-02-25","SF FuneralF1123132      250225","","31.63","","1027595.02"
"2025-02-28","2025-02-25","SF FuneralFDC0000000Q40W250225","","126.5","","1027721.52"
"2025-02-28","2025-02-25","SF FuneralF1132354      250225","","31.63","","1027753.15"
"2025-02-28","2025-02-25","SF FuneralF1132474      250225","","126.5","","1027879.65"
"2025-02-28","2025-02-21","SF FuneralFDC00000002TMK250221","","220","","1028099.65"
"2025-02-28","2025-02-24","SF FuneralFDC00000006GXV250224","","126.5","","1028226.15"
"2025-02-28","2025-02-24","SF FuneralFDC00000006YLJ250224","","126.5","","1028352.65"
"2025-02-28","2025-02-24","SF FuneralFDC00000007BF1250224","","126.5","","1028479.15"
"2025-02-28","2025-02-24","SF FuneralFDC00000007N87250224","","126.5","","1028605.65"
"2025-02-28","2025-02-24","SF FuneralF787309       250224","","191.5","","1028797.15"
"2025-02-28","2025-02-24","SF FuneralF844765       250223","","126.5","","1028923.65"
"2025-02-28","2025-02-24","SF FuneralFDC0000000HS6H250224","","31.63","","1028955.28"
"2025-02-28","2025-02-24","SF FuneralF990272       250224","","126.5","","1029081.78"
"2025-02-28","2025-02-24","SF FuneralF1109922      250224","","126.5","","1029208.28"
"2025-02-28","2025-02-24","SF FuneralF1111402      250224","","63.25","","1029271.53"
"2025-02-28","2025-02-24","SF FuneralF1112468      250224","","126.5","","1029398.03"
"2025-02-28","2025-02-24","SF FuneralFDC0000000N4NK250224","","126.5","","1029524.53"
"2025-02-28","2025-02-28","SF FuneralFDC000000072S2250228","","126.5","","1029651.03"
"2025-02-28","2025-02-28","SF FuneralF821009       250228","","126.5","","1029777.53"
"2025-02-28","2025-02-28","SF FuneralF1109647      250228","","126.5","","1029904.03"
"2025-02-28","2025-02-28","SF FuneralF842095       250228","","126.5","","1030030.53"
"2025-02-28","2025-02-19","SF FuneralFDC00000005WR7250219","","220","","1030250.53"
"2025-02-28","2025-02-19","SF FuneralF801249       250219","","126.5","","1030377.03"
"2025-02-28","2025-02-21","SF FuneralFDC000000062MM250221","","126.5","","1030503.53"
"2025-02-28","2025-02-22","SF FuneralFDC00000007NRS250222","","126.5","","1030630.03"
"2025-02-28","2025-02-22","SF FuneralFDC000000085CS250222","","126.5","","1030756.53"
"2025-02-28","2025-02-22","SF FuneralF831901       250222","","126.5","","1030883.03"
"2025-02-28","2025-02-22","SF FuneralFDC0000000DJ12250222","","126.5","","1031009.53"
"2025-02-28","2025-02-22","SF FuneralFDC0000000DJ18250222","","126.5","","1031136.03"
"2025-02-28","2025-02-22","SF FuneralFDC0000000K4DX250222","","126.5","","1031262.53"
"2025-02-28","2025-02-22","SF FuneralFDC0000000L7NZ250222","","126.5","","1031389.03"
"2025-02-28","2025-02-22","SF FuneralF1084288      250222","","31.63","","1031420.66"
"2025-02-28","2025-02-22","SF FuneralFDC0000000PNQD250223","","126.5","","1031547.16"
"2025-02-28","2025-02-22","SF FuneralF1131707      250222","","126.5","","1031673.66"
"2025-02-28","2025-02-24","SF FuneralFDC000000066LB250223","","126.5","","1031800.16"
"2025-02-28","2025-02-24","SF FuneralF840921       250224","","126.5","","1031926.66"
"2025-02-28","2025-02-24","SF FuneralF1080529      250224","","31.63","","1031958.29"
"2025-02-28","2025-02-24","SF FuneralF782628       250224","","256.5","","1032214.79"
"2025-02-28","2025-02-25","SF FuneralFDC00000002Y4M250225","","55","","1032269.79"
"2025-02-28","2025-02-25","SF FuneralFDC00000006T39250225","","31.63","","1032301.42"
"2025-02-28","2025-02-25","SF FuneralFDC00000006X91250225","","31.63","","1032333.05"
"2025-02-28","2025-02-25","SF FuneralFDC00000007GFW250225","","126.5","","1032459.55"
"2025-02-28","2025-02-25","SF FuneralFDC00000007MMS250225","","126.5","","1032586.05"
"2025-02-28","2025-02-25","SF FuneralFDC00000007N5X250225","","126.5","","1032712.55"
"2025-02-28","2025-02-25","SF FuneralFDC00000007NXT250225","","126.5","","1032839.05"
"2025-02-28","2025-02-25","SF FuneralFDC000000080WH250225","","31.63","","1032870.68"
"2025-02-28","2025-02-25","SF FuneralFDC000000085J9250225","","126.5","","1032997.18"
"2025-02-28","2025-02-25","SF FuneralF811608       250225","","126.5","","1033123.68"
"2025-02-28","2025-02-25","SF FuneralF821545       250225","","47.88","","1033171.56"
"2025-02-28","2025-02-25","SF FuneralF988546       250225","","126.5","","1033298.06"
"2025-02-28","2025-02-25","SF FuneralF1060950      250225","","31.63","","1033329.69"
"2025-02-28","2025-02-25","SF FuneralF1080280      250225","","63.25","","1033392.94"
"2025-02-28","2025-02-25","SF FuneralF1084274      250225","","126.5","","1033519.44"
"2025-02-28","2025-02-25","SF FuneralF1112301      250225","","126.5","","1033645.94"
"2025-02-28","2025-02-25","SF FuneralFDC0000000PK12250225","","126.5","","1033772.44"
"2025-02-28","2025-02-25","SF FuneralF1126065      250225","","126.5","","1033898.94"
"2025-02-28","2025-02-25","SF FuneralF1130244      250225","","126.5","","1034025.44"
"2025-02-28","2025-02-25","SF FuneralF1130879      250225","","126.5","","1034151.94"
"2025-02-28","2025-02-25","SF FuneralF1130976      250225","","126.5","","1034278.44"
"2025-02-28","2025-02-25","SF FuneralFDC0000000Q5BY250225","","126.5","","1034404.94"
"2025-02-28","2025-02-25","SF FuneralF1132026      250225","","126.5","","1034531.44"
"2025-02-28","2025-02-25","SF FuneralFDC0000000Q7HY250225","","126.5","","1034657.94"
"2025-02-28","2025-02-26","SF FuneralFDC000000071KH250226","","126.5","","1034784.44"
"2025-02-28","2025-02-26","SF FuneralF992446       250226","","126.5","","1034910.94"
"2025-02-28","2025-02-27","SF FuneralFDC0000000339T250227","","220","","1035130.94"
"2025-02-28","2025-02-27","SF FuneralFDC00000003FFM250227","","220","","1035350.94"
"2025-02-28","2025-02-27","SF FuneralFDC000000059D3250227","","126.5","","1035477.44"
"2025-02-28","2025-02-27","SF FuneralFDC00000005DXV250227","","126.5","","1035603.94"
"2025-02-28","2025-02-27","SF FuneralFDC000000069GZ250227","","126.5","","1035730.44"
"2025-02-28","2025-02-27","SF FuneralFDC00000006DTV250227","","126.5","","1035856.94"
"2025-02-28","2025-02-27","SF FuneralFDC00000006GZM250227","","126.5","","1035983.44"
"2025-02-28","2025-02-27","SF FuneralFDC00000006S4T250227","","126.5","","1036109.94"
"2025-02-28","2025-02-27","SF FuneralFDC00000006W4J250227","","126.5","","1036236.44"
"2025-02-28","2025-02-27","SF FuneralF778125       250227","","220","","1036456.44"
"2025-02-28","2025-02-27","SF FuneralF812657       250227","","126.5","","1036582.94"
"2025-02-28","2025-02-27","SF FuneralF812840       250227","","126.5","","1036709.44"
"2025-02-28","2025-02-27","SF FuneralF815064       250227","","126.5","","1036835.94"
"2025-02-28","2025-02-27","SF FuneralF822053       250227","","126.5","","1036962.44"
"2025-02-28","2025-02-27","SF FuneralF822952       250227","","126.5","","1037088.94"
"2025-02-28","2025-02-27","SF FuneralF823983       250227","","126.5","","1037215.44"
"2025-02-28","2025-02-27","SF FuneralF827599       250227","","126.5","","1037341.94"
"2025-02-28","2025-02-27","SF FuneralF830408       250227","","126.5","","1037468.44"
"2025-02-28","2025-02-27","SF FuneralF981693       250227","","126.5","","1037594.94"
"2025-02-28","2025-02-27","SF FuneralFDC0000000K5PJ250227","","321.5","","1037916.44"
"2025-02-28","2025-02-27","SF FuneralF1083804      250227","","126.5","","1038042.94"
"2025-02-28","2025-02-27","SF FuneralF1108678      250227","","126.5","","1038169.44"
"2025-02-28","2025-02-27","SF FuneralFDC0000000N0H3250227","","126.5","","1038295.94"
"2025-02-28","2025-02-27","SF FuneralFDC0000000N5CR250227","","126.5","","1038422.44"
"2025-02-28","2025-02-27","SF FuneralF1114392      250227","","126.5","","1038548.94"
"2025-02-28","2025-02-27","SF FuneralF1114461      250227","","126.5","","1038675.44"
"2025-02-28","2025-02-27","SF FuneralFDC0000000NWVP250227","","126.5","","1038801.94"
"2025-02-28","2025-02-27","SF FuneralF783349       250227","","126.5","","1038928.44"
"2025-02-28","2025-02-27","SF FuneralF1123980      250227","","126.5","","1039054.94"
"2025-02-28","2025-02-27","SF FuneralF1129381      250227","","126.5","","1039181.44"
"2025-02-28","2025-02-28","SF FuneralFDC00000002VBK250228","","220","","1039401.44"
"2025-02-28","2025-02-28","SF FuneralFDC000000030FC250228","","220","","1039621.44"
"2025-02-28","2025-02-28","SF FuneralFDC000000043CD250228","","220","","1039841.44"
"2025-02-28","2025-02-28","SF FuneralFDC00000005MPF250228","","126.5","","1039967.94"
"2025-02-28","2025-02-28","SF FuneralFDC00000005S28250228","","126.5","","1040094.44"
"2025-02-28","2025-02-28","SF FuneralFDC000000065BR250228","","126.5","","1040220.94"
"2025-02-28","2025-02-28","SF FuneralFDC000000065JM250228","","126.5","","1040347.44"
"2025-02-28","2025-02-28","SF FuneralFDC000000065PG250228","","126.5","","1040473.94"
"2025-02-28","2025-02-28","SF FuneralFDC000000065PP250228","","126.5","","1040600.44"
"2025-02-28","2025-02-28","SF FuneralFDC000000067CN250228","","126.5","","1040726.94"
"2025-02-28","2025-02-28","SF FuneralFDC000000067HN250228","","126.5","","1040853.44"
"2025-02-28","2025-02-28","SF FuneralFDC000000069HM250228","","126.5","","1040979.94"
"2025-02-28","2025-02-28","SF FuneralFDC00000006CH3250228","","126.5","","1041106.44"
"2025-02-28","2025-02-28","SF FuneralFDC00000006FNM250228","","126.5","","1041232.94"
"2025-02-28","2025-02-28","SF FuneralFDC00000006HJD250228","","126.5","","1041359.44"
"2025-02-28","2025-02-28","SF FuneralFDC00000006LGS250228","","126.5","","1041485.94"
"2025-02-28","2025-02-28","SF FuneralFDC00000006N9F250228","","126.5","","1041612.44"
"2025-02-28","2025-02-28","SF FuneralFDC00000006R0M250228","","126.5","","1041738.94"
"2025-02-28","2025-02-28","SF FuneralFDC00000006XVJ250228","","126.5","","1041865.44"
"2025-02-28","2025-02-28","SF FuneralFDC000000070ZN250228","","126.5","","1041991.94"
"2025-02-28","2025-02-28","SF FuneralFDC000000071MZ250228","","126.5","","1042118.44"
"2025-02-28","2025-02-28","SF FuneralFDC000000071YM250228","","126.5","","1042244.94"
"2025-02-28","2025-02-28","SF FuneralFDC00000007441250228","","126.5","","1042371.44"
"2025-02-28","2025-02-28","SF FuneralFDC000000074LY250228","","126.5","","1042497.94"
"2025-02-28","2025-02-28","SF FuneralFDC0000000757Z250228","","126.5","","1042624.44"
"2025-02-28","2025-02-28","SF FuneralFDC00000007615250228","","126.5","","1042750.94"
"2025-02-28","2025-02-28","SF FuneralFDC00000007627250228","","126.5","","1042877.44"
"2025-02-28","2025-02-28","SF FuneralFDC0000000783B250228","","126.5","","1043003.94"
"2025-02-28","2025-02-28","SF FuneralF791097       250228","","126.5","","1043130.44"
"2025-02-28","2025-02-28","SF FuneralF799033       250228","","126.5","","1043256.94"
"2025-02-28","2025-02-28","SF FuneralFDC000000086M1250228","","126.5","","1043383.44"
"2025-02-28","2025-02-28","SF FuneralFDC00000008M5S250228","","126.5","","1043509.94"
"2025-02-28","2025-02-28","SF FuneralF817335       250228","","126.5","","1043636.44"
"2025-02-28","2025-02-28","SF FuneralF817341       250228","","126.5","","1043762.94"
"2025-02-28","2025-02-28","SF FuneralF817524       250228","","126.5","","1043889.44"
"2025-02-28","2025-02-28","SF FuneralF812012       250228","","126.5","","1044015.94"
"2025-02-28","2025-02-28","SF FuneralFDC0000000BGQB250228","","191.5","","1044207.44"
"2025-02-28","2025-02-28","SF FuneralFDC0000000CR7X250228","","126.5","","1044333.94"
"2025-02-28","2025-02-28","SF FuneralF828117       250228","","126.5","","1044460.44"
"2025-02-28","2025-02-28","SF FuneralF900784       250228","","126.5","","1044586.94"
"2025-02-28","2025-02-28","SF FuneralF901052       250228","","126.5","","1044713.44"
"2025-02-28","2025-02-28","SF FuneralF981156       250228","","126.5","","1044839.94"
"2025-02-28","2025-02-28","SF FuneralF987134       250228","","126.5","","1044966.44"
"2025-02-28","2025-02-28","SF FuneralF993809       250228","","31.63","","1044998.07"
"2025-02-28","2025-02-28","SF FuneralF1017724      250228","","126.5","","1045124.57"
"2025-02-28","2025-02-28","SF FuneralF1033539      250228","","126.5","","1045251.07"
"2025-02-28","2025-02-28","SF FuneralF1072946      250228","","126.5","","1045377.57"
"2025-02-28","2025-02-28","SF FuneralF1084023      250228","","126.5","","1045504.07"
"2025-02-28","2025-02-28","SF FuneralF1103530      250228","","126.5","","1045630.57"
"2025-02-28","2025-02-28","SF FuneralFDC0000000MP8W250228","","126.5","","1045757.07"
"2025-02-28","2025-02-28","SF FuneralF1111353      250228","","126.5","","1045883.57"
"2025-02-28","2025-02-28","SF FuneralF1115120      250228","","126.5","","1046010.07"
"2025-02-28","2025-02-28","SF FuneralFDC0000000NC6Y250228","","126.5","","1046136.57"
"2025-02-28","2025-02-28","SF FuneralF1118340      250228","","63.25","","1046199.82"
"2025-02-28","2025-02-28","SF FuneralFDC0000000NNBR250228","","126.5","","1046326.32"
"2025-02-28","2025-02-28","SF FuneralF1120302      250228","","126.5","","1046452.82"
"2025-02-28","2025-02-28","SF FuneralFDC0000000PPXD250228","","126.5","","1046579.32"
"2025-02-28","2025-02-28","SF FuneralF1127778      250228","","126.5","","1046705.82"
"2025-02-28","2025-02-28","SF FuneralF1127814      250228","","126.5","","1046832.32"
"2025-02-28","2025-02-28","SF FuneralFDC0000000PVHQ250228","","126.5","","1046958.82"
"2025-02-28","2025-02-28","SF FuneralF1128214      250228","","126.5","","1047085.32"
"2025-02-28","2025-02-28","SF FuneralF1129021      250228","","126.5","","1047211.82"
"2025-02-28","2025-02-28","SF FuneralF1129091      250228","","126.5","","1047338.32"
"2025-02-28","2025-02-28","SF FuneralF819723       250228","","126.5","","1047464.82"
"2025-02-28","2025-02-25","SF FuneralFDC00000007XMS250225","","126.5","","1047591.32"
"2025-02-28","2025-02-22","SF FuneralFDC000000031H0250222","","220","","1047811.32"
"2025-02-28","2025-02-26","SF FuneralF1122987      250226","","126.5","","1047937.82"
"2025-02-28","2025-02-28","SF FuneralFDC000000065BG250228","","126.5","","1048064.32"
"2025-02-28","2025-02-28","SF FuneralFDC00000006SG0250228","","126.5","","1048190.82"
"2025-02-28","2025-02-28","SF FuneralF799191       250228","","126.5","","1048317.32"
"2025-02-28","2025-02-28","SF FuneralF833775       250228","","126.5","","1048443.82"
"2025-02-28","2025-02-28","SF FuneralFDC0000000ML47250228","","126.5","","1048570.32"
"2025-02-28","2025-02-28","SF FuneralF1116815      250228","","126.5","","1048696.82"
"2025-02-28","2025-02-28","SF FuneralFDC0000000589H250228","","126.5","","1048823.32"
"2025-02-28","2025-02-28","SF FuneralFDC000000065HF250228","","126.5","","1048949.82"
"2025-02-28","2025-02-28","SF FuneralFDC000000072PT250228","","126.5","","1049076.32"
"2025-02-28","2025-02-28","SF FuneralFDC0000000741Q250228","","126.5","","1049202.82"
"2025-02-28","2025-02-28","SF FuneralFDC00000007632250228","","126.5","","1049329.32"
"2025-02-28","2025-02-28","SF FuneralFDC0000000796W250228","","126.5","","1049455.82"
"2025-02-28","2025-02-28","SF FuneralF816186       250228","","126.5","","1049582.32"
"2025-02-28","2025-02-28","SF FuneralF816993       250228","","126.5","","1049708.82"
"2025-02-28","2025-02-28","SF FuneralF831921       250228","","126.5","","1049835.32"
"2025-02-28","2025-02-28","SF FuneralF832437       250228","","126.5","","1049961.82"
"2025-02-28","2025-02-28","SF FuneralF1073144      250228","","126.5","","1050088.32"
"2025-02-28","2025-02-28","SF FuneralF1074705      250228","","126.5","","1050214.82"
"2025-02-28","2025-02-28","SF FuneralF1116945      250228","","126.5","","1050341.32"
"2025-02-28","2025-02-28","SF FuneralF1129118      250228","","126.5","","1050467.82"
"2025-02-28","2025-02-28","SF FuneralFDC00000006BNZ250228","","126.5","","1050594.32"
"2025-02-28","2025-02-28","SF FuneralF987285       250228","","126.5","","1050720.82"
"2025-02-28","2025-02-28","SF FuneralFDC0000000NPT3250228","","126.5","","1050847.32"
"2025-02-28","2025-02-19","SF FuneralF980989       250219","","126.5","","1050973.82"
"2025-02-28","2025-02-22","SF FuneralFDC00000002SR6250222","","220","","1051193.82"
"2025-02-28","2025-02-22","SF FuneralFDC00000006XPY250222","","126.5","","1051320.32"
"2025-02-28","2025-02-22","SF FuneralFDC00000007L3K250222","","126.5","","1051446.82"
"2025-02-28","2025-02-22","SF FuneralFDC0000000DJ1Q250222","","126.5","","1051573.32"
"2025-02-28","2025-02-22","SF FuneralFDC0000000LB1K250222","","126.5","","1051699.82"
"2025-02-28","2025-02-22","SF FuneralFDC0000000PNQ8250223","","126.5","","1051826.32"
"2025-02-28","2025-02-22","SF FuneralF1127686      250222","","126.5","","1051952.82"
"2025-02-28","2025-02-24","SF FuneralFDC00000006234250223","","126.5","","1052079.32"
"2025-02-28","2025-02-24","SF FuneralFDC00000006YK2250223","","126.5","","1052205.82"
"2025-02-28","2025-02-24","SF FuneralFDC00000006YKG250223","","126.5","","1052332.32"
"2025-02-28","2025-02-24","SF FuneralFDC000000077L1250224","","63.25","","1052395.57"
"2025-02-28","2025-02-24","SF FuneralFDC000000077LG250224","","110","","1052505.57"
"2025-02-28","2025-02-24","SF FuneralFDC00000007R6J250224","","63.25","","1052568.82"
"2025-02-28","2025-02-24","SF FuneralF833473       250224","","126.5","","1052695.32"
"2025-02-28","2025-02-24","SF FuneralF1059470      250224","","126.5","","1052821.82"
"2025-02-28","2025-02-24","SF FuneralF1078470      250224","","126.5","","1052948.32"
"2025-02-28","2025-02-24","SF FuneralF1120193      250224","","126.5","","1053074.82"
"2025-02-28","2025-02-24","SF FuneralF1125864      250224","","126.5","","1053201.32"
"2025-02-28","2025-02-24","SF FuneralFDC0000000Q5DS250224","","126.5","","1053327.82"
"2025-02-28","2025-02-25","SF FuneralFDC00000006FWT250225","","126.5","","1053454.32"
"2025-02-28","2025-02-25","SF FuneralFDC00000006WKK250225","","31.63","","1053485.95"
"2025-02-28","2025-02-25","SF FuneralFDC0000000751R250225","","126.5","","1053612.45"
"2025-02-28","2025-02-25","SF FuneralFDC000000077V3250225","","126.5","","1053738.95"
"2025-02-28","2025-02-25","SF FuneralFDC00000007CPB250225","","31.63","","1053770.58"
"2025-02-28","2025-02-25","SF FuneralFDC00000007MN0250225","","126.5","","1053897.08"
"2025-02-28","2025-02-25","SF FuneralFDC00000007NBZ250225","","126.5","","1054023.58"
"2025-02-28","2025-02-25","SF FuneralF793314       250225","","126.5","","1054150.08"
"2025-02-28","2025-02-25","SF FuneralF794430       250225","","126.5","","1054276.58"
"2025-02-28","2025-02-25","SF FuneralF794850       250225","","126.5","","1054403.08"
"2025-02-28","2025-02-25","SF FuneralF798261       250225","","126.5","","1054529.58"
"2025-02-28","2025-02-25","SF FuneralFDC00000008851250225","","31.63","","1054561.21"
"2025-02-28","2025-02-25","SF FuneralF817132       250225","","126.5","","1054687.71"
"2025-02-28","2025-02-25","SF FuneralF981653       250225","","63.25","","1054750.96"
"2025-02-28","2025-02-25","SF FuneralF990136       250225","","126.5","","1054877.46"
"2025-02-28","2025-02-25","SF FuneralF990255       250225","","31.63","","1054909.09"
"2025-02-28","2025-02-25","SF FuneralFDC0000000JVV6250225","","126.5","","1055035.59"
"2025-02-28","2025-02-25","SF FuneralF1052659      250225","","31.63","","1055067.22"
"2025-02-28","2025-02-25","SF FuneralF1073225      250225","","126.5","","1055193.72"
"2025-02-28","2025-02-25","SF FuneralF1074554      250225","","126.5","","1055320.22"
"2025-02-28","2025-02-25","SF FuneralF1080286      250225","","31.63","","1055351.85"
"2025-02-28","2025-02-25","SF FuneralF1114485      250225","","63.25","","1055415.1"
"2025-02-28","2025-02-25","SF FuneralF1118176      250225","","126.5","","1055541.6"
"2025-02-28","2025-02-25","SF FuneralF1122598      250225","","63.25","","1055604.85"
"2025-02-28","2025-02-25","SF FuneralF1128927      250225","","126.5","","1055731.35"
"2025-02-28","2025-02-25","SF FuneralFDC0000000Q03C250225","","126.5","","1055857.85"
"2025-02-28","2025-02-25","SF FuneralF1127539      250225","","126.5","","1055984.35"
"2025-02-28","2025-02-25","SF FuneralF1130915      250225","","126.5","","1056110.85"
"2025-02-28","2025-02-25","SF FuneralFDC0000000Q5BW250225","","126.5","","1056237.35"
"2025-02-28","2025-02-25","SF FuneralF1131583      250225","","126.5","","1056363.85"
"2025-02-28","2025-02-25","SF FuneralF1132378      250225","","31.63","","1056395.48"
"2025-02-28","2025-02-26","SF FuneralFDC000000064C2250226","","126.5","","1056521.98"
"2025-02-28","2025-02-26","SF FuneralFDC000000068W1250226","","126.5","","1056648.48"
"2025-02-28","2025-02-26","SF FuneralF793455       250226","","126.5","","1056774.98"
"2025-02-28","2025-02-26","SF FuneralF840729       250226","","126.5","","1056901.48"
"2025-02-28","2025-02-26","SF FuneralF994115       250226","","126.5","","1057027.98"
"2025-02-28","2025-02-26","SF FuneralFDC0000000JG7Z250226","","126.5","","1057154.48"
"2025-02-28","2025-02-26","SF FuneralF1022243      250226","","126.5","","1057280.98"
"2025-02-28","2025-02-27","SF FuneralFDC00000002VWG250227","","220","","1057500.98"
"2025-02-28","2025-02-27","SF FuneralFDC000000031XT250227","","220","","1057720.98"
"2025-02-28","2025-02-27","SF FuneralFDC00000003235250227","","220","","1057940.98"
"2025-02-28","2025-02-27","SF FuneralFDC000000034XG250227","","220","","1058160.98"
"2025-02-28","2025-02-27","SF FuneralFDC00000005DYC250227","","126.5","","1058287.48"
"2025-02-28","2025-02-27","SF FuneralFDC00000005KQJ250227","","126.5","","1058413.98"
"2025-02-28","2025-02-27","SF FuneralFDC00000005N7G250227","","126.5","","1058540.48"
"2025-02-28","2025-02-27","SF FuneralFDC000000065G6250227","","126.5","","1058666.98"
"2025-02-28","2025-02-27","SF FuneralFDC000000066PW250227","","126.5","","1058793.48"
"2025-02-28","2025-02-27","SF FuneralFDC000000066PY250227","","126.5","","1058919.98"
"2025-02-28","2025-02-27","SF FuneralFDC000000067KZ250227","","126.5","","1059046.48"
"2025-02-28","2025-02-27","SF FuneralFDC000000067RS250227","","126.5","","1059172.98"
"2025-02-28","2025-02-27","SF FuneralFDC00000006BHP250227","","126.5","","1059299.48"
"2025-02-28","2025-02-27","SF FuneralFDC000000073ZQ250227","","126.5","","1059425.98"
"2025-02-28","2025-02-27","SF FuneralFDC000000075NW250227","","126.5","","1059552.48"
"2025-02-28","2025-02-27","SF FuneralFDC0000000814J250227","","126.5","","1059678.98"
"2025-02-28","2025-02-27","SF FuneralFDC00000008KD5250227","","126.5","","1059805.48"
"2025-02-28","2025-02-27","SF FuneralFDC00000008KK2250227","","126.5","","1059931.98"
"2025-02-28","2025-02-27","SF FuneralF812329       250227","","126.5","","1060058.48"
"2025-02-28","2025-02-27","SF FuneralFDC0000000BJTG250227","","126.5","","1060184.98"
"2025-02-28","2025-02-27","SF FuneralF828098       250227","","126.5","","1060311.48"
"2025-02-28","2025-02-27","SF FuneralF828476       250227","","126.5","","1060437.98"
"2025-02-28","2025-02-27","SF FuneralFDC0000000BVKG250227","","126.5","","1060564.48"
"2025-02-28","2025-02-27","SF FuneralF840947       250227","","126.5","","1060690.98"
"2025-02-28","2025-02-27","SF FuneralF841625       250227","","126.5","","1060817.48"
"2025-02-28","2025-02-27","SF FuneralFDC0000000FGV1250227","","126.5","","1060943.98"
"2025-02-28","2025-02-27","SF FuneralF1054903      250227","","126.5","","1061070.48"
"2025-02-28","2025-02-27","SF FuneralF981439       250227","","126.5","","1061196.98"
"2025-02-28","2025-02-27","SF FuneralF1058745      250227","","126.5","","1061323.48"
"2025-02-28","2025-02-27","SF FuneralF831783       250227","","126.5","","1061449.98"
"2025-02-28","2025-02-27","SF FuneralF1079092      250227","","126.5","","1061576.48"
"2025-02-28","2025-02-27","SF FuneralF1104050      250227","","126.5","","1061702.98"
"2025-02-28","2025-02-27","SF FuneralF1108993      250227","","126.5","","1061829.48"
"2025-02-28","2025-02-27","SF FuneralF1112491      250227","","126.5","","1061955.98"
"2025-02-28","2025-02-27","SF FuneralF1118782      250227","","126.5","","1062082.48"
"2025-02-28","2025-02-27","SF FuneralF1120758      250227","","126.5","","1062208.98"
"2025-02-28","2025-02-27","SF FuneralFDC0000000NYK8250227","","126.5","","1062335.48"
"2025-02-28","2025-02-28","SF FuneralFDC00000002VHL250228","","220","","1062555.48"
"2025-02-28","2025-02-28","SF FuneralFDC00000003C1N250228","","220","","1062775.48"
"2025-02-28","2025-02-28","SF FuneralFDC00000005MKM250228","","126.5","","1062901.98"
"2025-02-28","2025-02-28","SF FuneralFDC000000065JX250228","","126.5","","1063028.48"
"2025-02-28","2025-02-28","SF FuneralFDC000000065QB250228","","126.5","","1063154.98"
"2025-02-28","2025-02-28","SF FuneralFDC000000065TR250228","","126.5","","1063281.48"
"2025-02-28","2025-02-28","SF FuneralFDC00000006660250228","","126.5","","1063407.98"
"2025-02-28","2025-02-28","SF FuneralFDC000000067R3250228","","220","","1063627.98"
"2025-02-28","2025-02-28","SF FuneralFDC0000000692V250228","","126.5","","1063754.48"
"2025-02-28","2025-02-28","SF FuneralFDC000000069WZ250228","","126.5","","1063880.98"
"2025-02-28","2025-02-28","SF FuneralFDC00000006BND250228","","126.5","","1064007.48"
"2025-02-28","2025-02-28","SF FuneralFDC00000006K2J250228","","126.5","","1064133.98"
"2025-02-28","2025-02-28","SF FuneralFDC00000006P6D250228","","31.63","","1064165.61"
"2025-02-28","2025-02-28","SF FuneralFDC0000000628F250228","","31.63","","1064197.24"
"2025-02-28","2025-02-28","SF FuneralFDC0000000762Z250228","","126.5","","1064323.74"
"2025-02-28","2025-02-28","SF FuneralFDC0000000770C250228","","126.5","","1064450.24"
"2025-02-28","2025-02-28","SF FuneralFDC000000079KW250228","","126.5","","1064576.74"
"2025-02-28","2025-02-28","SF FuneralFDC000000071YJ250228","","126.5","","1064703.24"
"2025-02-28","2025-02-28","SF FuneralFDC0000000722G250228","","126.5","","1064829.74"
"2025-02-28","2025-02-28","SF FuneralFDC000000074MB250228","","126.5","","1064956.24"
"2025-02-28","2025-02-28","SF FuneralFDC00000007B90250228","","126.5","","1065082.74"
"2025-02-28","2025-02-28","SF FuneralFDC00000007CPT250228","","126.5","","1065209.24"
"2025-02-28","2025-02-28","SF FuneralFDC00000007GP4250228","","126.5","","1065335.74"
"2025-02-28","2025-02-28","SF FuneralFDC00000007HC9250228","","126.5","","1065462.24"
"2025-02-28","2025-02-28","SF FuneralFDC00000007QL9250228","","126.5","","1065588.74"
"2025-02-28","2025-02-28","SF FuneralFDC000000082J1250228","","126.5","","1065715.24"
"2025-02-28","2025-02-28","SF FuneralFDC000000082NV250228","","126.5","","1065841.74"
"2025-02-28","2025-02-28","SF FuneralF798088       250228","","126.5","","1065968.24"
"2025-02-28","2025-02-28","SF FuneralF810002       250228","","126.5","","1066094.74"
"2025-02-28","2025-02-28","SF FuneralF811149       250228","","126.5","","1066221.24"
"2025-02-28","2025-02-28","SF FuneralF814334       250228","","126.5","","1066347.74"
"2025-02-28","2025-02-28","SF FuneralF818052       250228","","126.5","","1066474.24"
"2025-02-28","2025-02-28","SF FuneralF821761       250228","","126.5","","1066600.74"
"2025-02-28","2025-02-28","SF FuneralF831671       250228","","126.5","","1066727.24"
"2025-02-28","2025-02-28","SF FuneralF832563       250228","","126.5","","1066853.74"
"2025-02-28","2025-02-28","SF FuneralF832766       250228","","126.5","","1066980.24"
"2025-02-28","2025-02-28","SF FuneralF833322       250228","","126.5","","1067106.74"
"2025-02-28","2025-02-28","SF FuneralF834860       250228","","126.5","","1067233.24"
"2025-02-28","2025-02-28","SF FuneralF842650       250228","","126.5","","1067359.74"
"2025-02-28","2025-02-28","SF FuneralFDC0000000H05Q250228","","126.5","","1067486.24"
"2025-02-28","2025-02-28","SF FuneralF901000       250302","","126.5","","1067612.74"
"2025-02-28","2025-02-28","SF FuneralF986662       250301","","126.5","","1067739.24"
"2025-02-28","2025-02-28","SF FuneralF987816       250228","","126.5","","1067865.74"
"2025-02-28","2025-02-28","SF FuneralFDC0000000J1C1250228","","126.5","","1067992.24"
"2025-02-28","2025-02-28","SF FuneralF993837       250228","","31.63","","1068023.87"
"2025-02-28","2025-02-28","SF FuneralF1021364      250228","","126.5","","1068150.37"
"2025-02-28","2025-02-28","SF FuneralF1066592      250228","","126.5","","1068276.87"
"2025-02-28","2025-02-28","SF FuneralF1079684      250228","","126.5","","1068403.37"
"2025-02-28","2025-02-28","SF FuneralFDC0000000LXMN250228","","126.5","","1068529.87"
"2025-02-28","2025-02-28","SF FuneralF1084911      250228","","126.5","","1068656.37"
"2025-02-28","2025-02-28","SF FuneralF1107997      250228","","126.5","","1068782.87"
"2025-02-28","2025-02-28","SF FuneralF1108067      250228","","126.5","","1068909.37"
"2025-02-28","2025-02-28","SF FuneralF1110355      250228","","126.5","","1069035.87"
"2025-02-28","2025-02-28","SF FuneralF1111550      250228","","126.5","","1069162.37"
"2025-02-28","2025-02-28","SF FuneralF1021471      250228","","126.5","","1069288.87"
"2025-02-28","2025-02-28","SF FuneralF1125389      250228","","126.5","","1069415.37"
"2025-02-28","2025-02-28","SF FuneralFDC0000000PKN8250228","","126.5","","1069541.87"
"2025-02-28","2025-02-28","SF FuneralFDC000000066BV250228","","126.5","","1069668.37"
"2025-02-28","2025-02-28","SF FuneralF1021052      250228","","126.5","","1069794.87"
"2025-02-28","2025-02-28","SF FuneralFDC00000006P8Q250228","","213.31","","1070008.18"
"2025-02-28","2025-02-28","SF FuneralF817318       250228","","126.5","","1070134.68"
"2025-02-28","2025-02-28","SF FuneralFDC000000032JC250228","","220","","1070354.68"
"2025-02-28","2025-02-28","SF FuneralFDC00000005N37250228","","126.5","","1070481.18"
"2025-02-28","2025-02-28","SF FuneralFDC00000006758250228","","126.5","","1070607.68"
"2025-02-28","2025-02-28","SF FuneralFDC0000000B81F250228","","126.5","","1070734.18"
"2025-02-28","2025-02-28","SF FuneralFDC0000000CHNC250228","","126.5","","1070860.68"
"2025-02-28","2025-02-28","SF FuneralF900674       250228","","126.5","","1070987.18"
"2025-02-28","2025-02-28","SF FuneralF1102869      250228","","126.5","","1071113.68"
"2025-02-28","2025-02-28","SF FuneralFDC00000002V62250228","","220","","1071333.68"
"2025-02-28","2025-02-28","SF FuneralFDC00000006GJM250228","","126.5","","1071460.18"
"2025-02-28","2025-02-28","SF FuneralFDC00000006MZH250228","","126.5","","1071586.68"
"2025-02-28","2025-02-28","SF FuneralFDC00000006Z6B250228","","126.5","","1071713.18"
"2025-02-28","2025-02-28","SF FuneralF1075225      250228","","126.5","","1071839.68"
"2025-02-28","2025-02-28","SF FuneralF1083801      250228","","126.5","","1071966.18"
"2025-02-28","2025-02-28","SF FuneralFDC00000006HHM250228","","126.5","","1072092.68"
"2025-02-28","2025-02-28","SF FuneralF822592       250228","","126.5","","1072219.18"
"2025-02-28","2025-02-28","SF FuneralF844262       250228","","126.5","","1072345.68"
"2025-02-28","2025-02-28","SF FuneralF847432       250228","","126.5","","1072472.18"
"2025-02-28","2025-02-28","SF FuneralF901224       250228","","126.5","","1072598.68"
"2025-02-28","2025-02-28","SF FuneralF1108712      250228","","126.5","","1072725.18"
"2025-02-28","2025-02-28","SF FuneralF1109879      250228","","126.5","","1072851.68"
"2025-02-28","2025-02-28","SF FuneralF1115977      250228","","126.5","","1072978.18"
"2025-02-28","2025-02-28","SF FuneralFDC0000000PT0D250228","","126.5","","1073104.68"
"2025-02-28","2025-02-28","SF FuneralF1127920      250228","","126.5","","1073231.18"
"2025-02-28","2025-02-28","SF FuneralF1130223      250228","","126.5","","1073357.68"
"2025-02-28","2025-02-28","SF FuneralF808587       250228","","126.5","","1073484.18"
"2025-02-28","2025-02-28","SF FuneralF819405       250228","","126.5","","1073610.68"
"2025-02-28","2025-02-28","SF FuneralF830967       250228","","126.5","","1073737.18"
"2025-02-28","2025-02-28","SF FuneralF981854       250228","","126.5","","1073863.68"
"2025-02-28","2025-02-28","SF FuneralF1125981      250228","","126.5","","1073990.18"
"2025-02-28","2025-02-28","SF FuneralFDC000000032CP250228","","220","","1074210.18"
"2025-02-28","2025-02-28","SF FuneralFDC00000005RN5250228","","126.5","","1074336.68"
"2025-02-28","2025-02-28","SF FuneralF798132       250228","","126.5","","1074463.18"
"2025-02-28","2025-02-28","SF FuneralF813444       250228","","126.5","","1074589.68"
"2025-02-28","2025-02-28","SF FuneralF823086       250228","","126.5","","1074716.18"
"2025-02-28","2025-02-28","SF FuneralF1022178      250228","","126.5","","1074842.68"
"2025-02-28","2025-02-28","SF FuneralF796377       250228","","126.5","","1074969.18"
"2025-02-28","2025-02-28","SF FuneralF797727       250228","","126.5","","1075095.68"
"2025-02-28","2025-02-22","SF FuneralFDC0000000MRRW250222","","126.5","","1075222.18"
"2025-02-28","2025-02-20","SF FuneralFDC000000063WH250220","","126.5","","1075348.68"
"2025-02-28","2025-02-22","SF FuneralF1021390      250222","","126.5","","1075475.18"
"2025-02-28","2025-02-24","SF FuneralF1120876      250224","","126.5","","1075601.68"
"2025-02-28","2025-02-25","SF FuneralFDC0000000HLZ7250225","","126.5","","1075728.18"
"2025-02-28","2025-02-26","SF FuneralFDC00000006XYJ250226","","126.5","","1075854.68"
"2025-02-28","2025-02-26","SF FuneralF808985       250226","","126.5","","1075981.18"
"2025-02-28","2025-02-26","SF FuneralF1020629      250226","","126.5","","1076107.68"
"2025-02-28","2025-02-27","SF FuneralFDC000000065NQ250227","","126.5","","1076234.18"
"2025-02-28","2025-02-27","SF FuneralF828460       250227","","126.5","","1076360.68"
"2025-02-28","2025-02-27","SF FuneralF1067989      250227","","126.5","","1076487.18"
"2025-02-28","2025-02-27","SF FuneralFDC0000000LBZ7250227","","126.5","","1076613.68"
"2025-02-28","2025-02-18","SF FuneralFDC00000005L2K250218","","126.5","","1076740.18"
"2025-02-28","2025-02-18","SF FuneralF823520       250218","","63.25","","1076803.43"
"2025-02-28","2025-02-20","SF FuneralFDC00000007HRY250220","","126.5","","1076929.93"
"2025-02-28","2025-02-20","SF FuneralF797547       250220","","126.5","","1077056.43"
"2025-02-28","2025-02-22","SF FuneralFDC00000005D2X250222","","126.5","","1077182.93"
"2025-02-28","2025-02-22","SF FuneralFDC00000006VHL250222","","126.5","","1077309.43"
"2025-02-28","2025-02-22","SF FuneralFDC00000007LR4250222","","126.5","","1077435.93"
"2025-02-28","2025-02-22","SF FuneralF802307       250222","","126.5","","1077562.43"
"2025-02-28","2025-02-22","SF FuneralF811335       250222","","126.5","","1077688.93"
"2025-02-28","2025-02-22","SF FuneralF820280       250222","","126.5","","1077815.43"
"2025-02-28","2025-02-22","SF FuneralF821177       250222","","126.5","","1077941.93"
"2025-02-28","2025-02-22","SF FuneralF829997       250222","","126.5","","1078068.43"
"2025-02-28","2025-02-22","SF FuneralF841584       250222","","126.5","","1078194.93"
"2025-02-28","2025-02-22","SF FuneralF992076       250222","","126.5","","1078321.43"
"2025-02-28","2025-02-22","SF FuneralF1054562      250222","","126.5","","1078447.93"
"2025-02-28","2025-02-22","SF FuneralF1054924      250223","","126.5","","1078574.43"
"2025-02-28","2025-02-22","SF FuneralF1066049      250222","","126.5","","1078700.93"
"2025-02-28","2025-02-22","SF FuneralF1117250      250222","","126.5","","1078827.43"
"2025-02-28","2025-02-28","SF FuneralF1073279      250228","","126.5","","1078953.93"
"2025-02-28","2025-02-27","SF FuneralFDC000000032B1250227","","220","","1079173.93"
"2025-02-28","2025-02-27","SF FuneralFDC000000032HT250227","","220","","1079393.93"
"2025-02-28","2025-02-27","SF FuneralFDC00000003L05250227","","220","","1079613.93"
"2025-02-28","2025-02-27","SF FuneralFDC00000005FB2250227","","126.5","","1079740.43"
"2025-02-28","2025-02-27","SF FuneralFDC00000005GLQ250227","","126.5","","1079866.93"
"2025-02-28","2025-02-27","SF FuneralFDC00000005H8T250227","","126.5","","1079993.43"
"2025-02-28","2025-02-27","SF FuneralFDC00000005MQK250227","","126.5","","1080119.93"
"2025-02-28","2025-02-27","SF FuneralFDC00000005WRS250227","","126.5","","1080246.43"
"2025-02-28","2025-02-27","SF FuneralFDC000000065M0250227","","126.5","","1080372.93"
"2025-02-28","2025-02-27","SF FuneralFDC00000006B0M250227","","126.5","","1080499.43"
"2025-02-28","2025-02-27","SF FuneralFDC00000006CHB250227","","126.5","","1080625.93"
"2025-02-28","2025-02-27","SF FuneralF802156       250227","","126.5","","1080752.43"
"2025-02-28","2025-02-27","SF FuneralF802199       250227","","126.5","","1080878.93"
"2025-02-28","2025-02-27","SF FuneralFDC00000008KJX250227","","126.5","","1081005.43"
"2025-02-28","2025-02-27","SF FuneralFDC00000008LW0250227","","126.5","","1081131.93"
"2025-02-28","2025-02-27","SF FuneralF804542       250227","","126.5","","1081258.43"
"2025-02-28","2025-02-27","SF FuneralF808124       250227","","126.5","","1081384.93"
"2025-02-28","2025-02-27","SF FuneralF824003       250227","","126.5","","1081511.43"
"2025-02-28","2025-02-27","SF FuneralF827679       250227","","126.5","","1081637.93"
"2025-02-28","2025-02-27","SF FuneralF828917       250227","","126.5","","1081764.43"
"2025-02-28","2025-02-27","SF FuneralFDC0000000BVXT250227","","126.5","","1081890.93"
"2025-02-28","2025-02-27","SF FuneralF832507       250227","","126.5","","1082017.43"
"2025-02-28","2025-02-27","SF FuneralF833514       250227","","126.5","","1082143.93"
"2025-02-28","2025-02-27","SF FuneralF834832       250227","","126.5","","1082270.43"
"2025-02-28","2025-02-27","SF FuneralF841173       250227","","126.5","","1082396.93"
"2025-02-28","2025-02-27","SF FuneralF843372       250227","","126.5","","1082523.43"
"2025-02-28","2025-02-27","SF FuneralF988360       250227","","126.5","","1082649.93"
"2025-02-28","2025-02-27","SF FuneralF1020665      250227","","126.5","","1082776.43"
"2025-02-28","2025-02-27","SF FuneralF1060191      250227","","126.5","","1082902.93"
"2025-02-28","2025-02-27","SF FuneralF1060356      250227","","126.5","","1083029.43"
"2025-02-28","2025-02-27","SF FuneralF1066564      250227","","126.5","","1083155.93"
"2025-02-28","2025-02-27","SF FuneralF1084510      250227","","126.5","","1083282.43"
"2025-02-28","2025-02-27","SF FuneralF1084991      250227","","126.5","","1083408.93"
"2025-02-28","2025-02-27","SF FuneralF1108693      250227","","126.5","","1083535.43"
"2025-02-28","2025-02-27","SF FuneralF1110763      250227","","31.63","","1083567.06"
"2025-02-28","2025-02-27","SF FuneralFDC0000000MVRW250227","","126.5","","1083693.56"
"2025-02-28","2025-02-27","SF FuneralF1112373      250227","","126.5","","1083820.06"
"2025-02-28","2025-02-27","SF FuneralF1113188      250227","","126.5","","1083946.56"
"2025-02-28","2025-02-27","SF FuneralF1114492      250227","","126.5","","1084073.06"
"2025-02-28","2025-02-27","SF FuneralF1116078      250227","","126.5","","1084199.56"
"2025-02-28","2025-02-27","SF FuneralF1117198      250227","","126.5","","1084326.06"
"2025-02-28","2025-02-27","SF FuneralFDC0000000NPZG250227","","126.5","","1084452.56"
"2025-02-28","2025-02-27","SF FuneralFDC0000000NZL5250227","","126.5","","1084579.06"
"2025-02-28","2025-02-27","SF FuneralF1123182      250227","","126.5","","1084705.56"
"2025-02-28","2025-02-27","SF FuneralF1123199      250227","","126.5","","1084832.06"
"2025-02-28","2025-02-27","SF FuneralF1125123      250227","","126.5","","1084958.56"
"2025-02-28","2025-02-27","SF FuneralF1127906      250227","","126.5","","1085085.06"
"2025-02-28","2025-02-27","SF FuneralF1128168      250227","","126.5","","1085211.56"
"2025-02-28","2025-02-27","SF FuneralF1129201      250227","","126.5","","1085338.06"
"2025-02-28","2025-02-21","SF FuneralF834674       250221","","126.5","","1085464.56"
"2025-02-28","2025-02-21","SF FuneralF1066525      250221","","126.5","","1085591.06"
"2025-02-28","2025-02-26","SF FuneralFDC00000005V4Z250226","","31.63","","1085622.69"
"2025-02-28","2025-02-26","SF FuneralF986653       250226","","126.5","","1085749.19"
"2025-02-28","2025-02-26","SF FuneralF992126       250226","","126.5","","1085875.69"
"2025-02-28","2025-02-26","SF FuneralFDC0000000JD8P250226","","126.5","","1086002.19"
"2025-02-28","2025-02-26","SF FuneralF993814       250226","","126.5","","1086128.69"
"2025-02-28","2025-02-26","SF FuneralF1021586      250226","","126.5","","1086255.19"
"2025-02-28","2025-02-25","SF FuneralFDC00000003HGD250225","","220","","1086475.19"
"2025-02-28","2025-02-25","SF FuneralFDC000000065KM250225","","126.5","","1086601.69"
"2025-02-28","2025-02-25","SF FuneralFDC00000006619250225","","126.5","","1086728.19"
"2025-02-28","2025-02-25","SF FuneralFDC00000006CJJ250225","","126.5","","1086854.69"
"2025-02-28","2025-02-25","SF FuneralFDC00000006FTF250225","","126.5","","1086981.19"
"2025-02-28","2025-02-25","SF FuneralFDC00000006N7G250225","","126.5","","1087107.69"
"2025-02-28","2025-02-25","SF FuneralFDC000000072SM250225","","31.63","","1087139.32"
"2025-02-28","2025-02-25","SF FuneralFDC00000007KQW250225","","126.5","","1087265.82"
"2025-02-28","2025-02-25","SF FuneralFDC00000007MYY250225","","126.5","","1087392.32"
"2025-02-28","2025-02-25","SF FuneralF794462       250225","","126.5","","1087518.82"
"2025-02-28","2025-02-25","SF FuneralFDC00000007RY5250225","","126.5","","1087645.32"
"2025-02-28","2025-02-25","SF FuneralFDC00000007SD6250225","","126.5","","1087771.82"
"2025-02-28","2025-02-25","SF FuneralF813413       250225","","126.5","","1087898.32"
"2025-02-28","2025-02-25","SF FuneralF814465       250225","","31.63","","1087929.95"
"2025-02-28","2025-02-25","SF FuneralF815443       250225","","63.25","","1087993.2"
"2025-02-28","2025-02-25","SF FuneralF816217       250225","","126.5","","1088119.7"
"2025-02-28","2025-02-25","SF FuneralF828692       250225","","126.5","","1088246.2"
"2025-02-28","2025-02-25","SF FuneralF830046       250225","","63.25","","1088309.45"
"2025-02-28","2025-02-25","SF FuneralF986980       250225","","126.5","","1088435.95"
"2025-02-28","2025-02-25","SF FuneralF1016973      250225","","31.63","","1088467.58"
"2025-02-28","2025-02-25","SF FuneralF1022237      250225","","126.5","","1088594.08"
"2025-02-28","2025-02-25","SF FuneralF1022241      250225","","126.5","","1088720.58"
"2025-02-28","2025-02-25","SF FuneralF1052789      250225","","126.5","","1088847.08"
"2025-02-28","2025-02-25","SF FuneralFDC0000000KFFJ250225","","31.63","","1088878.71"
"2025-02-28","2025-02-25","SF FuneralF1079490      250225","","126.5","","1089005.21"
"2025-02-28","2025-02-25","SF FuneralF1080308      250225","","126.5","","1089131.71"
"2025-02-28","2025-02-25","SF FuneralF1085053      250225","","63.25","","1089194.96"
"2025-02-28","2025-02-25","SF FuneralF1112152      250225","","31.63","","1089226.59"
"2025-02-28","2025-02-25","SF FuneralF1114513      250225","","31.63","","1089258.22"
"2025-02-28","2025-02-25","SF FuneralF1115080      250225","","63.25","","1089321.47"
"2025-02-28","2025-02-25","SF FuneralF1129144      250225","","126.5","","1089447.97"
"2025-02-28","2025-02-25","SF FuneralFDC0000000PYFR250225","","126.5","","1089574.47"
"2025-02-28","2025-02-25","SF FuneralF1130277      250225","","31.63","","1089606.1"
"2025-02-28","2025-02-25","SF FuneralF1130852      250225","","126.5","","1089732.6"
"2025-02-28","2025-02-25","SF FuneralF1120557      250225","","126.5","","1089859.1"
"2025-02-28","2025-02-25","SF FuneralF1127370      250225","","126.5","","1089985.6"
"2025-02-28","2025-02-25","SF FuneralFDC0000000Q4KT250225","","126.5","","1090112.1"
"2025-02-28","2025-02-25","SF FuneralF1131281      250225","","126.5","","1090238.6"
"2025-02-28","2025-02-24","SF FuneralFDC000000063V4250224","","126.5","","1090365.1"
"2025-02-28","2025-02-24","SF FuneralFDC00000006892250224","","126.5","","1090491.6"
"2025-02-28","2025-02-24","SF FuneralFDC00000006BK1250224","","31.63","","1090523.23"
"2025-02-28","2025-02-24","SF FuneralFDC000000070CJ250224","","31.63","","1090554.86"
"2025-02-28","2025-02-24","SF FuneralFDC000000077VQ250223","","126.5","","1090681.36"
"2025-02-28","2025-02-24","SF FuneralFDC00000007GXS250224","","31.63","","1090712.99"
"2025-02-28","2025-02-24","SF FuneralF801948       250224","","126.5","","1090839.49"
"2025-02-28","2025-02-24","SF FuneralFDC00000008KX0250224","","31.63","","1090871.12"
"2025-02-28","2025-02-24","SF FuneralF809870       250224","","63.25","","1090934.37"
"2025-02-28","2025-02-24","SF FuneralF815515       250224","","126.5","","1091060.87"
"2025-02-28","2025-02-24","SF FuneralF832143       250223","","126.5","","1091187.37"
"2025-02-28","2025-02-24","SF FuneralFDC0000000KZ2C250224","","31.63","","1091219"
"2025-02-28","2025-02-24","SF FuneralF1083770      250224","","126.5","","1091345.5"
"2025-02-28","2025-02-24","SF FuneralF1085023      250224","","63.25","","1091408.75"
"2025-02-28","2025-02-24","SF FuneralF1111332      250224","","31.63","","1091440.38"
"2025-02-28","2025-02-24","SF FuneralF1115794      250224","","31.63","","1091472.01"
"2025-02-28","2025-02-24","SF FuneralFDC0000000NNDF250224","","31.63","","1091503.64"
"2025-02-28","2025-02-24","SF FuneralF1127505      250224","","31.63","","1091535.27"
"2025-02-28","2025-02-24","SF FuneralF1127535      250224","","63.25","","1091598.52"
"2025-02-28","2025-02-24","SF FuneralFDC0000000Q8ZQ250224","","126.5","","1091725.02"
"2025-02-28","2025-02-28","SF FuneralFDC000000062NG250228","","126.5","","1091851.52"
"2025-02-28","2025-02-28","SF FuneralFDC000000067VF250228","","126.5","","1091978.02"
"2025-02-28","2025-02-28","SF FuneralF816521       250228","","126.5","","1092104.52"
"2025-02-28","2025-02-28","SF FuneralF989351       250228","","126.5","","1092231.02"
"2025-02-28","2025-02-28","SF FuneralF1118870      250228","","126.5","","1092357.52"
"2025-02-28","2025-02-28","SF FuneralFDC000000069HL250228","","126.5","","1092484.02"
"2025-02-28","2025-02-28","SF FuneralFDC00000006C2W250228","","126.5","","1092610.52"
"2025-02-28","2025-02-28","SF FuneralF808550       250228","","126.5","","1092737.02"
"2025-02-28","2025-02-28","SF FuneralF810567       250228","","126.5","","1092863.52"
"2025-02-28","2025-02-28","SF FuneralF834590       250228","","126.5","","1092990.02"
"2025-02-28","2025-02-28","SF FuneralF1033691      250228","","126.5","","1093116.52"
"2025-02-28","2025-02-28","SF FuneralFDC00000005SMZ250228","","126.5","","1093243.02"
"2025-02-28","2025-02-28","SF FuneralFDC00000006913250228","","126.5","","1093369.52"
"2025-02-28","2025-02-28","SF FuneralFDC00000007J3K250228","","126.5","","1093496.02"
"2025-02-28","2025-02-28","SF FuneralFDC00000007N2N250228","","126.5","","1093622.52"
"2025-02-28","2025-02-28","SF FuneralF800698       250228","","126.5","","1093749.02"
"2025-02-28","2025-02-28","SF FuneralFDC00000005Z98250228","","126.5","","1093875.52"
"2025-02-28","2025-02-28","SF FuneralFDC000000065J4250228","","126.5","","1094002.02"
"2025-02-28","2025-02-28","SF FuneralF811139       250228","","126.5","","1094128.52"
"2025-02-28","2025-02-28","SF FuneralF820823       250228","","126.5","","1094255.02"
"2025-02-28","2025-02-28","SF FuneralF1083709      250228","","126.5","","1094381.52"
"2025-02-28","2025-02-28","SF FuneralF832745       250228","","126.5","","1094508.02"
"2025-02-28","2025-02-28","SF FuneralF1115087      250228","","126.5","","1094634.52"
"2025-02-28","2025-02-28","SF FuneralFDC0000000CTBB250228","","126.5","","1094761.02"
"2025-02-28","2025-02-28","SF FuneralF833512       250228","","126.5","","1094887.52"
"2025-02-28","2025-02-28","SF FuneralFDC000000044R7250228","","220","","1095107.52"
"2025-02-28","2025-02-28","SF FuneralFDC0000000496P250228","","220","","1095327.52"
"2025-02-28","2025-02-28","SF FuneralFDC00000006L53250228","","126.5","","1095454.02"
"2025-02-28","2025-02-28","SF FuneralFDC00000007997250228","","126.5","","1095580.52"
"2025-02-28","2025-02-28","SF FuneralF1111600      250228","","126.5","","1095707.02"
"2025-02-28","2025-02-28","SF FuneralF1117035      250228","","126.5","","1095833.52"
"2025-02-28","2025-02-28","SF FuneralF1122697      250228","","126.5","","1095960.02"
"2025-02-28","2025-02-28","SF FuneralFDC00000006QWQ250228","","126.5","","1096086.52"
"2025-02-28","2025-02-28","SF FuneralFDC00000006X9J250228","","126.5","","1096213.02"
"2025-02-28","2025-02-28","SF FuneralFDC000000068DQ250228","","126.5","","1096339.52"
"2025-02-28","2025-02-28","SF FuneralF1021761      250228","","126.5","","1096466.02"
"2025-02-28","2025-02-28","SF FuneralF1079133      250228","","126.5","","1096592.52"
"2025-02-28","2025-02-28","SF FuneralFDC0000000B7F4250228","","126.5","","1096719.02"
"2025-02-28","2025-02-27","SF FuneralFDC0000000362M250227","","220","","1096939.02"
"2025-02-28","2025-02-27","SF FuneralFDC00000005CS0250227","","126.5","","1097065.52"
"2025-02-28","2025-02-27","SF FuneralFDC00000005JZ9250227","","126.5","","1097192.02"
"2025-02-28","2025-02-27","SF FuneralFDC00000005LP7250227","","126.5","","1097318.52"
"2025-02-28","2025-02-27","SF FuneralFDC00000005N00250227","","126.5","","1097445.02"
"2025-02-28","2025-02-27","SF FuneralFDC000000062KH250227","","126.5","","1097571.52"
"2025-02-28","2025-02-27","SF FuneralFDC000000065JG250227","","126.5","","1097698.02"
"2025-02-28","2025-02-27","SF FuneralFDC0000000661K250227","","126.5","","1097824.52"
"2025-02-28","2025-02-27","SF FuneralFDC00000006BSP250227","","126.5","","1097951.02"
"2025-02-28","2025-02-27","SF FuneralFDC00000006JPV250227","","126.5","","1098077.52"
"2025-02-28","2025-02-27","SF FuneralFDC000000071C9250227","","126.5","","1098204.02"
"2025-02-28","2025-02-27","SF FuneralFDC00000008JLZ250227","","126.5","","1098330.52"
"2025-02-28","2025-02-27","SF FuneralF804720       250227","","126.5","","1098457.02"
"2025-02-28","2025-02-27","SF FuneralFDC00000008SH9250227","","126.5","","1098583.52"
"2025-02-28","2025-02-27","SF FuneralF805856       250227","","126.5","","1098710.02"
"2025-02-28","2025-02-27","SF FuneralF808910       250227","","126.5","","1098836.52"
"2025-02-28","2025-02-27","SF FuneralF810245       250227","","126.5","","1098963.02"
"2025-02-28","2025-02-27","SF FuneralFDC00000009BZG250227","","126.5","","1099089.52"
"2025-02-28","2025-02-27","SF FuneralFDC00000009LMP250227","","126.5","","1099216.02"
"2025-02-28","2025-02-27","SF FuneralF818962       250227","","126.5","","1099342.52"
"2025-02-28","2025-02-27","SF FuneralF822553       250227","","126.5","","1099469.02"
"2025-02-28","2025-02-27","SF FuneralF805939       250227","","126.5","","1099595.52"
"2025-02-28","2025-02-27","SF FuneralF827590       250227","","126.5","","1099722.02"
"2025-02-28","2025-02-27","SF FuneralF828050       250227","","126.5","","1099848.52"
"2025-02-28","2025-02-27","SF FuneralF828131       250227","","126.5","","1099975.02"
"2025-02-28","2025-02-27","SF FuneralF829736       250227","","126.5","","1100101.52"
"2025-02-28","2025-02-27","SF FuneralF832796       250227","","126.5","","1100228.02"
"2025-02-28","2025-02-27","SF FuneralF833226       250227","","126.5","","1100354.52"
"2025-02-28","2025-02-27","SF FuneralF841052       250227","","126.5","","1100481.02"
"2025-02-28","2025-02-27","SF FuneralF842040       250227","","126.5","","1100607.52"
"2025-02-28","2025-02-27","SF FuneralF842465       250227","","126.5","","1100734.02"
"2025-02-28","2025-02-27","SF FuneralF774280       250227","","126.5","","1100860.52"
"2025-02-28","2025-02-27","SF FuneralF981374       250227","","126.5","","1100987.02"
"2025-02-28","2025-02-27","SF FuneralFDC0000000HJTV250227","","126.5","","1101113.52"
"2025-02-28","2025-02-27","SF FuneralFDC0000000JJVZ250227","","126.5","","1101240.02"
"2025-02-28","2025-02-27","SF FuneralF1033574      250227","","126.5","","1101366.52"
"2025-02-28","2025-02-27","SF FuneralF1058733      250227","","126.5","","1101493.02"
"2025-02-28","2025-02-27","SF FuneralFDC0000000L42F250227","","126.5","","1101619.52"
"2025-02-28","2025-02-27","SF FuneralF1078993      250227","","126.5","","1101746.02"
"2025-02-28","2025-02-27","SF FuneralF1080259      250227","","126.5","","1101872.52"
"2025-02-28","2025-02-27","SF FuneralFDC0000000MKG3250227","","126.5","","1101999.02"
"2025-02-28","2025-02-27","SF FuneralF1111354      250227","","126.5","","1102125.52"
"2025-02-28","2025-02-27","SF FuneralFDC0000000N9QR250227","","126.5","","1102252.02"
"2025-02-28","2025-02-27","SF FuneralF1115081      250227","","126.5","","1102378.52"
"2025-02-28","2025-02-27","SF FuneralF1115773      250227","","126.5","","1102505.02"
"2025-02-28","2025-02-27","SF FuneralF1117863      250227","","126.5","","1102631.52"
"2025-02-28","2025-02-27","SF FuneralFDC0000000NPN8250227","","126.5","","1102758.02"
"2025-02-28","2025-02-27","SF FuneralFDC0000000P0BD250227","","126.5","","1102884.52"
"2025-02-28","2025-02-27","SF FuneralF1122633      250227","","126.5","","1103011.02"
"2025-02-28","2025-02-27","SF FuneralF1122785      250227","","126.5","","1103137.52"
"2025-02-28","2025-02-27","SF FuneralFDC0000000PCP4250227","","126.5","","1103264.02"
"2025-02-28","2025-02-27","SF FuneralF1127856      250227","","126.5","","1103390.52"
"2025-02-28","2025-02-21","SF FuneralFDC00000005Y6M250221","","126.5","","1103517.02"
"2025-02-28","2025-02-21","SF FuneralF986678       250222","","213.31","","1103730.33"
"2025-02-28","2025-02-21","SF FuneralF987149       250222","","126.5","","1103856.83"
"2025-02-28","2025-02-24","SF FuneralFDC00000007K9Q250223","","126.5","","1103983.33"
"2025-02-28","2025-02-24","SF FuneralF829880       250224","","126.5","","1104109.83"
"2025-02-28","2025-02-24","SF FuneralF988329       250224","","126.5","","1104236.33"
"2025-02-28","2025-02-24","SF FuneralF1113747      250224","","126.5","","1104362.83"
"2025-02-28","2025-02-26","SF FuneralF827698       250226","","126.5","","1104489.33"
"2025-02-28","2025-02-26","SF FuneralF843429       250226","","126.5","","1104615.83"
"2025-02-28","2025-02-26","SF FuneralF991987       250226","","126.5","","1104742.33"
"2025-02-28","2025-02-26","SF FuneralF992476       250226","","126.5","","1104868.83"
"2025-02-28","2025-02-26","SF FuneralF993237       250226","","126.5","","1104995.33"
"2025-02-28","2025-02-26","SF FuneralF993559       250226","","126.5","","1105121.83"
"2025-02-28","2025-02-26","SF FuneralFDC0000000JTYL250226","","126.5","","1105248.33"
"2025-02-28","2025-02-26","SF FuneralF1074496      250226","","191.5","","1105439.83"
"2025-02-28","2025-02-26","SF FuneralF1120815      250226","","31.63","","1105471.46"
"2025-02-28","2025-02-22","SF FuneralFDC00000005DGP250222","","126.5","","1105597.96"
"2025-02-28","2025-02-22","SF FuneralFDC00000005MLD250222","","126.5","","1105724.46"
"2025-02-28","2025-02-22","SF FuneralF819847       250222","","126.5","","1105850.96"
"2025-02-28","2025-02-22","SF FuneralF1059854      250222","","126.5","","1105977.46"
"2025-02-28","2025-02-25","SF FuneralFDC00000002RNL250225","","220","","1106197.46"
"2025-02-28","2025-02-25","SF FuneralFDC00000006CPG250225","","126.5","","1106323.96"
"2025-02-28","2025-02-25","SF FuneralFDC00000006NCC250225","","126.5","","1106450.46"
"2025-02-28","2025-02-25","SF FuneralFDC00000006P3F250225","","126.5","","1106576.96"
"2025-02-28","2025-02-25","SF FuneralFDC00000007CR3250225","","126.5","","1106703.46"
"2025-02-28","2025-02-25","SF FuneralFDC00000007NHV250225","","63.25","","1106766.71"
"2025-02-28","2025-02-25","SF FuneralFDC00000007TP4250225","","126.5","","1106893.21"
"2025-02-28","2025-02-25","SF FuneralF795139       250225","","126.5","","1107019.71"
"2025-02-28","2025-02-25","SF FuneralF795445       250225","","126.5","","1107146.21"
"2025-02-28","2025-02-25","SF FuneralF813106       250225","","126.5","","1107272.71"
"2025-02-28","2025-02-25","SF FuneralF813412       250225","","126.5","","1107399.21"
"2025-02-28","2025-02-25","SF FuneralF815758       250225","","126.5","","1107525.71"
"2025-02-28","2025-02-25","SF FuneralFDC00000009VCF250225","","126.5","","1107652.21"
"2025-02-28","2025-02-25","SF FuneralF819049       250225","","126.5","","1107778.71"
"2025-02-28","2025-02-25","SF FuneralF819921       250225","","126.5","","1107905.21"
"2025-02-28","2025-02-25","SF FuneralF816143       250225","","126.5","","1108031.71"
"2025-02-28","2025-02-25","SF FuneralF842847       250225","","126.5","","1108158.21"
"2025-02-28","2025-02-25","SF FuneralF844728       250225","","31.63","","1108189.84"
"2025-02-28","2025-02-25","SF FuneralF991948       250225","","126.5","","1108316.34"
"2025-02-28","2025-02-25","SF FuneralF1021297      250225","","126.5","","1108442.84"
"2025-02-28","2025-02-25","SF FuneralF1059394      250225","","63.25","","1108506.09"
"2025-02-28","2025-02-25","SF FuneralF1075012      250225","","126.5","","1108632.59"
"2025-02-28","2025-02-25","SF FuneralFDC0000000LBW9250225","","126.5","","1108759.09"
"2025-02-28","2025-02-25","SF FuneralF1108822      250225","","126.5","","1108885.59"
"2025-02-28","2025-02-25","SF FuneralF1111540      250225","","63.25","","1108948.84"
"2025-02-28","2025-02-25","SF FuneralF1111588      250225","","31.63","","1108980.47"
"2025-02-28","2025-02-25","SF FuneralFDC0000000N8HR250225","","63.25","","1109043.72"
"2025-02-28","2025-02-25","SF FuneralF1116750      250225","","126.5","","1109170.22"
"2025-02-28","2025-02-25","SF FuneralF1118308      250225","","31.63","","1109201.85"
"2025-02-28","2025-02-25","SF FuneralF1119889      250225","","31.63","","1109233.48"
"2025-02-28","2025-02-25","SF FuneralF1120333      250225","","126.5","","1109359.98"
"2025-02-28","2025-02-25","SF FuneralF1124111      250225","","63.25","","1109423.23"
"2025-02-28","2025-02-25","SF FuneralF1127611      250225","","31.63","","1109454.86"
"2025-02-28","2025-02-25","SF FuneralF1129130      250225","","126.5","","1109581.36"
"2025-02-28","2025-02-25","SF FuneralF1131894      250225","","126.5","","1109707.86"
"2025-02-28","2025-02-28","SF FuneralFDC00000006898250228","","126.5","","1109834.36"
"2025-02-28","2025-02-28","SF FuneralF808152       250228","","126.5","","1109960.86"
"2025-02-28","2025-02-28","SF FuneralF816303       250228","","126.5","","1110087.36"
"2025-02-28","2025-02-28","SF FuneralF819939       250228","","126.5","","1110213.86"
"2025-02-28","2025-02-28","SF FuneralF989308       250228","","126.5","","1110340.36"
"2025-02-28","2025-02-28","SF FuneralF990105       250228","","126.5","","1110466.86"
"2025-02-28","2025-02-28","SF FuneralF1121954      250228","","126.5","","1110593.36"
"2025-02-28","2025-02-28","SF FuneralF1124789      250228","","126.5","","1110719.86"
"2025-02-28","2025-02-28","SF FuneralF1125083      250228","","126.5","","1110846.36"
"2025-02-28","2025-02-28","SF FuneralF1127841      250228","","126.5","","1110972.86"
"2025-02-28","2025-02-28","SF FuneralF901201       250228","","126.5","","1111099.36"
"2025-02-28","2025-02-28","SF FuneralF1102939      250228","","126.5","","1111225.86"
"2025-02-28","2025-02-28","SF FuneralF1130038      250228","","126.5","","1111352.36"
"2025-02-28","2025-02-28","SF FuneralFDC00000006DH3250228","","126.5","","1111478.86"
"2025-02-28","2025-02-28","SF FuneralF805682       250228","","126.5","","1111605.36"
"2025-02-28","2025-02-28","SF FuneralF816232       250228","","126.5","","1111731.86"
"2025-02-28","2025-02-28","SF FuneralF1067006      250228","","126.5","","1111858.36"
"2025-02-28","2025-02-28","SF FuneralFDC0000000L8NN250228","","31.63","","1111889.99"
"2025-02-28","2025-02-28","SF FuneralF1108618      250228","","126.5","","1112016.49"
"2025-02-28","2025-02-27","SF FuneralFDC0000000363M250227","","220","","1112236.49"
"2025-02-28","2025-02-27","SF FuneralFDC00000005DKB250227","","126.5","","1112362.99"
"2025-02-28","2025-02-27","SF FuneralFDC00000005DX7250227","","126.5","","1112489.49"
"2025-02-28","2025-02-27","SF FuneralFDC00000005JMT250227","","126.5","","1112615.99"
"2025-02-28","2025-02-27","SF FuneralFDC00000005NF7250227","","126.5","","1112742.49"
"2025-02-28","2025-02-27","SF FuneralFDC00000005RGF250227","","126.5","","1112868.99"
"2025-02-28","2025-02-27","SF FuneralFDC000000066HH250227","","126.5","","1112995.49"
"2025-02-28","2025-02-27","SF FuneralFDC000000066J1250227","","126.5","","1113121.99"
"2025-02-28","2025-02-27","SF FuneralFDC000000066J7250227","","126.5","","1113248.49"
"2025-02-28","2025-02-27","SF FuneralFDC0000000689S250227","","126.5","","1113374.99"
"2025-02-28","2025-02-27","SF FuneralFDC000000069X0250227","","126.5","","1113501.49"
"2025-02-28","2025-02-27","SF FuneralFDC00000006BJ1250227","","126.5","","1113627.99"
"2025-02-28","2025-02-27","SF FuneralFDC00000006DJ6250227","","126.5","","1113754.49"
"2025-02-28","2025-02-27","SF FuneralFDC00000006F50250227","","126.5","","1113880.99"
"2025-02-28","2025-02-27","SF FuneralFDC00000006LCH250227","","126.5","","1114007.49"
"2025-02-28","2025-02-27","SF FuneralFDC00000006LYJ250227","","126.5","","1114133.99"
"2025-02-28","2025-02-27","SF FuneralFDC00000006LYK250227","","126.5","","1114260.49"
"2025-02-28","2025-02-27","SF FuneralFDC00000006N8P250227","","126.5","","1114386.99"
"2025-02-28","2025-02-27","SF FuneralFDC00000006NGN250227","","126.5","","1114513.49"
"2025-02-28","2025-02-27","SF FuneralFDC00000006YL1250227","","126.5","","1114639.99"
"2025-02-28","2025-02-27","SF FuneralFDC000000073BQ250227","","126.5","","1114766.49"
"2025-02-28","2025-02-27","SF FuneralFDC00000007RBZ250227","","126.5","","1114892.99"
"2025-02-28","2025-02-27","SF FuneralFDC00000008HFF250227","","126.5","","1115019.49"
"2025-02-28","2025-02-27","SF FuneralF802337       250227","","126.5","","1115145.99"
"2025-02-28","2025-02-27","SF FuneralF802378       250227","","126.5","","1115272.49"
"2025-02-28","2025-02-27","SF FuneralF803382       250227","","126.5","","1115398.99"
"2025-02-28","2025-02-27","SF FuneralF809294       250227","","126.5","","1115525.49"
"2025-02-28","2025-02-27","SF FuneralF784822       250227","","126.5","","1115651.99"
"2025-02-28","2025-02-27","SF FuneralF812220       250227","","126.5","","1115778.49"
"2025-02-28","2025-02-27","SF FuneralF813320       250227","","126.5","","1115904.99"
"2025-02-28","2025-02-27","SF FuneralF813527       250227","","126.5","","1116031.49"
"2025-02-28","2025-02-27","SF FuneralF813644       250227","","126.5","","1116157.99"
"2025-02-28","2025-02-27","SF FuneralF813697       250227","","126.5","","1116284.49"
"2025-02-28","2025-02-27","SF FuneralF816604       250227","","126.5","","1116410.99"
"2025-02-28","2025-02-27","SF FuneralF819162       250227","","126.5","","1116537.49"
"2025-02-28","2025-02-27","SF FuneralF821749       250227","","126.5","","1116663.99"
"2025-02-28","2025-02-27","SF FuneralF823892       250227","","126.5","","1116790.49"
"2025-02-28","2025-02-27","SF FuneralF820950       250227","","126.5","","1116916.99"
"2025-02-28","2025-02-27","SF FuneralF828039       250227","","126.5","","1117043.49"
"2025-02-28","2025-02-27","SF FuneralF829828       250227","","126.5","","1117169.99"
"2025-02-28","2025-02-27","SF FuneralF830978       250227","","126.5","","1117296.49"
"2025-02-28","2025-02-27","SF FuneralFDC0000000F60P250227","","126.5","","1117422.99"
"2025-02-28","2025-02-27","SF FuneralF843193       250227","","126.5","","1117549.49"
"2025-02-28","2025-02-27","SF FuneralF900865       250227","","126.5","","1117675.99"
"2025-02-28","2025-02-27","SF FuneralFDC0000000HGKV250227","","126.5","","1117802.49"
"2025-02-28","2025-02-27","SF FuneralF1011946      250227","","126.5","","1117928.99"
"2025-02-28","2025-02-27","SF FuneralF1020994      250227","","126.5","","1118055.49"
"2025-02-28","2025-02-27","SF FuneralF1055000      250227","","126.5","","1118181.99"
"2025-02-28","2025-02-27","SF FuneralF1060376      250227","","126.5","","1118308.49"
"2025-02-28","2025-02-27","SF FuneralF1060650      250227","","126.5","","1118434.99"
"2025-02-28","2025-02-27","SF FuneralF1062704      250227","","126.5","","1118561.49"
"2025-02-28","2025-02-27","SF FuneralFDC0000000LBKN250227","","126.5","","1118687.99"
"2025-02-28","2025-02-27","SF FuneralFDC0000000LDQ5250227","","126.5","","1118814.49"
"2025-02-28","2025-02-27","SF FuneralFDC0000000LX6B250227","","126.5","","1118940.99"
"2025-02-28","2025-02-27","SF FuneralF1104053      250227","","126.5","","1119067.49"
"2025-02-28","2025-02-27","SF FuneralF1108989      250227","","126.5","","1119193.99"
"2025-02-28","2025-02-27","SF FuneralF1109938      250227","","126.5","","1119320.49"
"2025-02-28","2025-02-27","SF FuneralF1112493      250227","","126.5","","1119446.99"
"2025-02-28","2025-02-27","SF FuneralF1113198      250227","","126.5","","1119573.49"
"2025-02-28","2025-02-27","SF FuneralF1114332      250227","","126.5","","1119699.99"
"2025-02-28","2025-02-27","SF FuneralF1114352      250227","","126.5","","1119826.49"
"2025-02-28","2025-02-27","SF FuneralF1114602      250227","","126.5","","1119952.99"
"2025-02-28","2025-02-27","SF FuneralF1117181      250227","","126.5","","1120079.49"
"2025-02-28","2025-02-27","SF FuneralFDC0000000NJPF250227","","126.5","","1120205.99"
"2025-02-28","2025-02-27","SF FuneralF1120771      250227","","126.5","","1120332.49"
"2025-02-28","2025-02-27","SF FuneralF1122038      250227","","126.5","","1120458.99"
"2025-02-28","2025-02-27","SF FuneralF1122369      250227","","126.5","","1120585.49"
"2025-02-28","2025-02-27","SF FuneralF1122774      250227","","126.5","","1120711.99"
"2025-02-28","2025-02-27","SF FuneralF1123511      250227","","126.5","","1120838.49"
"2025-02-28","2025-02-27","SF FuneralF1124187      250227","","126.5","","1120964.99"
"2025-02-28","2025-02-27","SF FuneralF1125741      250227","","126.5","","1121091.49"
"2025-02-28","2025-02-27","SF FuneralF1126291      250227","","126.5","","1121217.99"
"2025-02-28","2025-02-25","SF FuneralFDC00000005FX1250225","","126.5","","1121344.49"
"2025-02-28","2025-02-25","SF FuneralFDC00000006312250225","","126.5","","1121470.99"
"2025-02-28","2025-02-25","SF FuneralFDC00000006C1T250225","","126.5","","1121597.49"
"2025-02-28","2025-02-25","SF FuneralFDC00000007LDQ250225","","126.5","","1121723.99"
"2025-02-28","2025-02-25","SF FuneralFDC00000007MTQ250225","","126.5","","1121850.49"
"2025-02-28","2025-02-25","SF FuneralFDC00000007NXW250225","","191.5","","1122041.99"
"2025-02-28","2025-02-25","SF FuneralF793754       250225","","126.5","","1122168.49"
"2025-02-28","2025-02-25","SF FuneralFDC00000007QW8250225","","126.5","","1122294.99"
"2025-02-28","2025-02-25","SF FuneralF794834       250225","","63.25","","1122358.24"
"2025-02-28","2025-02-25","SF FuneralFDC00000007TPG250225","","126.5","","1122484.74"
"2025-02-28","2025-02-25","SF FuneralFDC00000007TPS250225","","126.5","","1122611.24"
"2025-02-28","2025-02-25","SF FuneralF795238       250225","","126.5","","1122737.74"
"2025-02-28","2025-02-25","SF FuneralF795781       250225","","126.5","","1122864.24"
"2025-02-28","2025-02-25","SF FuneralFDC00000007WYB250225","","126.5","","1122990.74"
"2025-02-28","2025-02-25","SF FuneralFDC00000007YCD250225","","126.5","","1123117.24"
"2025-02-28","2025-02-25","SF FuneralF800205       250225","","31.63","","1123148.87"
"2025-02-28","2025-02-25","SF FuneralF802431       250225","","126.5","","1123275.37"
"2025-02-28","2025-02-25","SF FuneralF804091       250225","","31.63","","1123307"
"2025-02-28","2025-02-25","SF FuneralF805320       250225","","126.5","","1123433.5"
"2025-02-28","2025-02-25","SF FuneralF805770       250225","","126.5","","1123560"
"2025-02-28","2025-02-25","SF FuneralF812003       250225","","126.5","","1123686.5"
"2025-02-28","2025-02-25","SF FuneralF841131       250225","","126.5","","1123813"
"2025-02-28","2025-02-25","SF FuneralF844721       250225","","126.5","","1123939.5"
"2025-02-28","2025-02-25","SF FuneralF847257       250225","","126.5","","1124066"
"2025-02-28","2025-02-25","SF FuneralF981656       250225","","126.5","","1124192.5"
"2025-02-28","2025-02-25","SF FuneralF992344       250225","","126.5","","1124319"
"2025-02-28","2025-02-25","SF FuneralF1022073      250225","","126.5","","1124445.5"
"2025-02-28","2025-02-25","SF FuneralF1061069      250225","","31.63","","1124477.13"
"2025-02-28","2025-02-25","SF FuneralFDC0000000KPCR250225","","126.5","","1124603.63"
"2025-02-28","2025-02-25","SF FuneralF1068168      250225","","126.5","","1124730.13"
"2025-02-28","2025-02-25","SF FuneralF1078209      250225","","31.63","","1124761.76"
"2025-02-28","2025-02-25","SF FuneralF1084552      250225","","126.5","","1124888.26"
"2025-02-28","2025-02-25","SF FuneralF1113939      250225","","126.5","","1125014.76"
"2025-02-28","2025-02-25","SF FuneralF1118315      250225","","126.5","","1125141.26"
"2025-02-28","2025-02-25","SF FuneralF1118892      250225","","31.63","","1125172.89"
"2025-02-28","2025-02-25","SF FuneralF1127760      250225","","126.5","","1125299.39"
"2025-02-28","2025-02-25","SF FuneralF1127985      250225","","63.25","","1125362.64"
"2025-02-28","2025-02-25","SF FuneralF1128226      250225","","126.5","","1125489.14"
"2025-02-28","2025-02-25","SF FuneralF787713       250225","","191.5","","1125680.64"
"2025-02-28","2025-02-25","SF FuneralF1131306      250225","","126.5","","1125807.14"
"2025-02-28","2025-02-25","SF FuneralF1131657      250225","","31.63","","1125838.77"
"2025-02-28","2025-02-25","SF FuneralF1131893      250225","","126.5","","1125965.27"
"2025-02-28","2025-02-25","SF FuneralF1131993      250225","","126.5","","1126091.77"
"2025-02-28","2025-02-25","SF FuneralF1132336      250225","","126.5","","1126218.27"
"2025-02-28","2025-02-19","SF FuneralFDC0000000P3M3250219","","126.5","","1126344.77"
"2025-02-28","2025-02-20","SF FuneralF991769       250220","","126.5","","1126471.27"
"2025-02-28","2025-02-21","SF FuneralF841958       250221","","126.5","","1126597.77"
"2025-02-28","2025-02-22","SF FuneralFDC00000002VCY250222","","220","","1126817.77"
"2025-02-28","2025-02-22","SF FuneralFDC00000005GV6250222","","126.5","","1126944.27"
"2025-02-28","2025-02-22","SF FuneralFDC00000006CVD250222","","126.5","","1127070.77"
"2025-02-28","2025-02-22","SF FuneralFDC0000000826X250222","","126.5","","1127197.27"
"2025-02-28","2025-02-22","SF FuneralFDC000000083SM250222","","126.5","","1127323.77"
"2025-02-28","2025-02-22","SF FuneralFDC0000000853Z250222","","126.5","","1127450.27"
"2025-02-28","2025-02-22","SF FuneralF802284       250222","","126.5","","1127576.77"
"2025-02-28","2025-02-22","SF FuneralFDC00000008MPF250222","","126.5","","1127703.27"
"2025-02-28","2025-02-22","SF FuneralF819753       250222","","126.5","","1127829.77"
"2025-02-28","2025-02-22","SF FuneralF821856       250222","","126.5","","1127956.27"
"2025-02-28","2025-02-22","SF FuneralF823625       250222","","126.5","","1128082.77"
"2025-02-28","2025-02-22","SF FuneralF992171       250222","","126.5","","1128209.27"
"2025-02-28","2025-02-22","SF FuneralF1054968      250222","","126.5","","1128335.77"
"2025-02-28","2025-02-22","SF FuneralF1080459      250222","","126.5","","1128462.27"
"2025-02-28","2025-02-22","SF FuneralFDC0000000LX0Y250223","","126.5","","1128588.77"
"2025-02-28","2025-02-22","SF FuneralF1103935      250223","","31.63","","1128620.4"
"2025-02-28","2025-02-22","SF FuneralF1108630      250222","","126.5","","1128746.9"
"2025-02-28","2025-02-22","SF FuneralF1113160      250222","","126.5","","1128873.4"
"2025-02-28","2025-02-22","SF FuneralFDC0000000PWSG250222","","126.5","","1128999.9"
"2025-02-28","2025-02-22","SF FuneralFDC0000000PWSK250222","","126.5","","1129126.4"
"2025-02-28","2025-02-24","SF FuneralFDC00000003HQP250224","","220","","1129346.4"
"2025-02-28","2025-02-24","SF FuneralFDC00000006XL3250224","","126.5","","1129472.9"
"2025-02-28","2025-02-24","SF FuneralFDC0000000704V250224","","126.5","","1129599.4"
"2025-02-28","2025-02-24","SF FuneralFDC00000007GN8250224","","126.5","","1129725.9"
"2025-02-28","2025-02-24","SF FuneralFDC00000007KQJ250224","","126.5","","1129852.4"
"2025-02-28","2025-02-24","SF FuneralFDC00000008MKX250224","","31.63","","1129884.03"
"2025-02-28","2025-02-24","SF FuneralF808607       250223","","126.5","","1130010.53"
"2025-02-28","2025-02-24","SF FuneralF1083780      250224","","126.5","","1130137.03"
"2025-02-28","2025-02-24","SF FuneralF1113168      250224","","126.5","","1130263.53"
"2025-02-28","2025-02-24","SF FuneralF1116117      250224","","126.5","","1130390.03"
"2025-02-28","2025-02-24","SF FuneralF1122769      250224","","126.5","","1130516.53"
"2025-02-28","2025-02-24","SF FuneralF1123277      250224","","31.63","","1130548.16"
"2025-02-28","2025-02-26","SF FuneralFDC000000074GL250226","","126.5","","1130674.66"
"2025-02-28","2025-02-26","SF FuneralF798875       250226","","126.5","","1130801.16"
"2025-02-28","2025-02-26","SF FuneralF819839       250226","","126.5","","1130927.66"
"2025-02-28","2025-02-26","SF FuneralF986952       250226","","126.5","","1131054.16"
"2025-02-28","2025-02-26","SF FuneralF989323       250226","","126.5","","1131180.66"
"2025-02-28","2025-02-26","SF FuneralF991687       250226","","126.5","","1131307.16"
"2025-02-28","2025-02-26","SF FuneralF993281       250226","","126.5","","1131433.66"
"2025-02-28","2025-02-26","SF FuneralF1084424      250226","","126.5","","1131560.16"
"2025-02-28","2025-02-26","SF FuneralF1122015      250226","","126.5","","1131686.66"
"2025-02-28","2025-02-28","SF FuneralFDC00000002VF9250228","","220","","1131906.66"
"2025-02-28","2025-02-28","SF FuneralFDC00000002WKX250228","","220","","1132126.66"
"2025-02-28","2025-02-28","SF FuneralFDC00000002YFL250228","","220","","1132346.66"
"2025-02-28","2025-02-28","SF FuneralFDC000000044B3250228","","220","","1132566.66"
"2025-02-28","2025-02-28","SF FuneralFDC000000062FM250228","","126.5","","1132693.16"
"2025-02-28","2025-02-28","SF FuneralFDC000000065CR250228","","126.5","","1132819.66"
"2025-02-28","2025-02-28","SF FuneralFDC000000065RV250228","","126.5","","1132946.16"
"2025-02-28","2025-02-28","SF FuneralFDC000000066P4250228","","126.5","","1133072.66"
"2025-02-28","2025-02-28","SF FuneralFDC0000000672K250228","","126.5","","1133199.16"
"2025-02-28","2025-02-28","SF FuneralFDC000000067KH250228","","126.5","","1133325.66"
"2025-02-28","2025-02-28","SF FuneralFDC000000067RP250228","","126.5","","1133452.16"
"2025-02-28","2025-02-28","SF FuneralFDC0000000681B250228","","191.5","","1133643.66"
"2025-02-28","2025-02-28","SF FuneralFDC0000000684Y250228","","126.5","","1133770.16"
"2025-02-28","2025-02-28","SF FuneralFDC00000006883250228","","126.5","","1133896.66"
"2025-02-28","2025-02-28","SF FuneralFDC000000068NB250228","","126.5","","1134023.16"
"2025-02-28","2025-02-28","SF FuneralFDC000000068NK250228","","126.5","","1134149.66"
"2025-02-28","2025-02-28","SF FuneralFDC00000006921250228","","213.31","","1134362.97"
"2025-02-28","2025-02-28","SF FuneralFDC000000069HQ250228","","126.5","","1134489.47"
"2025-02-28","2025-02-28","SF FuneralFDC000000069LW250228","","126.5","","1134615.97"
"2025-02-28","2025-02-28","SF FuneralFDC00000006BRV250228","","126.5","","1134742.47"
"2025-02-28","2025-02-28","SF FuneralFDC00000006FH3250228","","126.5","","1134868.97"
"2025-02-28","2025-02-28","SF FuneralFDC00000006H74250228","","126.5","","1134995.47"
"2025-02-28","2025-02-28","SF FuneralFDC00000006L3K250228","","126.5","","1135121.97"
"2025-02-28","2025-02-28","SF FuneralFDC00000006LP0250228","","278.31","","1135400.28"
"2025-02-28","2025-02-28","SF FuneralFDC00000006M31250228","","126.5","","1135526.78"
"2025-02-28","2025-02-28","SF FuneralFDC00000006ND6250228","","126.5","","1135653.28"
"2025-02-28","2025-02-28","SF FuneralFDC00000006P80250228","","126.5","","1135779.78"
"2025-02-28","2025-02-28","SF FuneralFDC00000006P8D250228","","126.5","","1135906.28"
"2025-02-28","2025-02-28","SF FuneralFDC00000006P9B250228","","126.5","","1136032.78"
"2025-02-28","2025-02-28","SF FuneralFDC00000006QDN250228","","126.5","","1136159.28"
"2025-02-28","2025-02-28","SF FuneralFDC00000006W33250228","","126.5","","1136285.78"
"2025-02-28","2025-02-28","SF FuneralFDC00000006Y4Y250228","","126.5","","1136412.28"
"2025-02-28","2025-02-28","SF FuneralFDC00000007154250228","","126.5","","1136538.78"
"2025-02-28","2025-02-28","SF FuneralFDC000000071SQ250228","","126.5","","1136665.28"
"2025-02-28","2025-02-28","SF FuneralFDC000000072BK250228","","213.31","","1136878.59"
"2025-02-28","2025-02-28","SF FuneralFDC000000073C1250228","","126.5","","1137005.09"
"2025-02-28","2025-02-28","SF FuneralFDC000000074B2250228","","126.5","","1137131.59"
"2025-02-28","2025-02-28","SF FuneralFDC000000077RT250228","","126.5","","1137258.09"
"2025-02-28","2025-02-28","SF FuneralFDC000000078CV250228","","126.5","","1137384.59"
"2025-02-28","2025-02-28","SF FuneralFDC00000007GDT250228","","126.5","","1137511.09"
"2025-02-28","2025-02-28","SF FuneralFDC00000007H00250228","","126.5","","1137637.59"
"2025-02-28","2025-02-28","SF FuneralFDC00000007MSD250228","","126.5","","1137764.09"
"2025-02-28","2025-02-28","SF FuneralF794329       250228","","126.5","","1137890.59"
"2025-02-28","2025-02-28","SF FuneralFDC00000007XMB250228","","126.5","","1138017.09"
"2025-02-28","2025-02-28","SF FuneralFDC00000008327250228","","126.5","","1138143.59"
"2025-02-28","2025-02-28","SF FuneralF798718       250228","","126.5","","1138270.09"
"2025-02-28","2025-02-28","SF FuneralF800095       250228","","126.5","","1138396.59"
"2025-02-28","2025-02-28","SF FuneralF800206       250228","","126.5","","1138523.09"
"2025-02-28","2025-02-28","SF FuneralF800764       250228","","126.5","","1138649.59"
"2025-02-28","2025-02-28","SF FuneralF800998       250228","","126.5","","1138776.09"
"2025-02-28","2025-02-28","SF FuneralF802467       250228","","126.5","","1138902.59"
"2025-02-28","2025-02-28","SF FuneralF804558       250228","","126.5","","1139029.09"
"2025-02-28","2025-02-28","SF FuneralF805407       250228","","126.5","","1139155.59"
"2025-02-28","2025-02-28","SF FuneralF805909       250228","","126.5","","1139282.09"
"2025-02-28","2025-02-28","SF FuneralF808207       250228","","126.5","","1139408.59"
"2025-02-28","2025-02-28","SF FuneralF808585       250228","","126.5","","1139535.09"
"2025-02-28","2025-02-28","SF FuneralFDC0000000903V250228","","191.5","","1139726.59"
"2025-02-28","2025-02-28","SF FuneralFDC000000090BY250228","","126.5","","1139853.09"
"2025-02-28","2025-02-28","SF FuneralF810063       250228","","126.5","","1139979.59"
"2025-02-28","2025-02-28","SF FuneralFDC000000095QV250228","","126.5","","1140106.09"
"2025-02-28","2025-02-28","SF FuneralF812634       250228","","126.5","","1140232.59"
"2025-02-28","2025-02-28","SF FuneralF814635       250228","","126.5","","1140359.09"
"2025-02-28","2025-02-28","SF FuneralF814917       250228","","126.5","","1140485.59"
"2025-02-28","2025-02-28","SF FuneralF816338       250228","","126.5","","1140612.09"
"2025-02-28","2025-02-28","SF FuneralFDC00000009VTM250228","","126.5","","1140738.59"
"2025-02-28","2025-02-28","SF FuneralF816501       250228","","126.5","","1140865.09"
"2025-02-28","2025-02-28","SF FuneralF817358       250228","","126.5","","1140991.59"
"2025-02-28","2025-02-28","SF FuneralF818394       250228","","126.5","","1141118.09"
"2025-02-28","2025-02-28","SF FuneralF818580       250228","","126.5","","1141244.59"
"2025-02-28","2025-02-28","SF FuneralF820078       250228","","126.5","","1141371.09"
"2025-02-28","2025-02-28","SF FuneralF820124       250228","","126.5","","1141497.59"
"2025-02-28","2025-02-28","SF FuneralF820615       250228","","126.5","","1141624.09"
"2025-02-28","2025-02-28","SF FuneralF821134       250228","","126.5","","1141750.59"
"2025-02-28","2025-02-28","SF FuneralFDC0000000B9KT250228","","126.5","","1141877.09"
"2025-02-28","2025-02-28","SF FuneralF821616       250228","","126.5","","1142003.59"
"2025-02-28","2025-02-28","SF FuneralF821662       250228","","126.5","","1142130.09"
"2025-02-28","2025-02-28","SF FuneralF822235       250228","","126.5","","1142256.59"
"2025-02-28","2025-02-28","SF FuneralF822264       250228","","126.5","","1142383.09"
"2025-02-28","2025-02-28","SF FuneralF824000       250228","","126.5","","1142509.59"
"2025-02-28","2025-02-28","SF FuneralF824007       250228","","126.5","","1142636.09"
"2025-02-28","2025-02-28","SF FuneralF829800       250228","","63.25","","1142699.34"
"2025-02-28","2025-02-28","SF FuneralF832898       250228","","126.5","","1142825.84"
"2025-02-28","2025-02-28","SF FuneralF842597       250228","","126.5","","1142952.34"
"2025-02-28","2025-02-28","SF FuneralF842768       250228","","126.5","","1143078.84"
"2025-02-28","2025-02-28","SF FuneralF844567       250228","","126.5","","1143205.34"
"2025-02-28","2025-02-28","SF FuneralF847439       250228","","126.5","","1143331.84"
"2025-02-28","2025-02-28","SF FuneralF901379       250301","","126.5","","1143458.34"
"2025-02-28","2025-02-28","SF FuneralF901430       250228","","126.5","","1143584.84"
"2025-02-28","2025-02-28","SF FuneralF980379       250228","","31.63","","1143616.47"
"2025-02-28","2025-02-28","SF FuneralF981543       250301","","126.5","","1143742.97"
"2025-02-28","2025-02-28","SF FuneralF981746       250228","","126.5","","1143869.47"
"2025-02-28","2025-02-28","SF FuneralF986659       250228","","126.5","","1143995.97"
"2025-02-28","2025-02-28","SF FuneralFDC0000000HK87250301","","126.5","","1144122.47"
"2025-02-28","2025-02-28","SF FuneralF987854       250301","","126.5","","1144248.97"
"2025-02-28","2025-02-28","SF FuneralF988333       250228","","126.5","","1144375.47"
"2025-02-28","2025-02-28","SF FuneralFDC0000000HXFN250228","","126.5","","1144501.97"
"2025-02-28","2025-02-28","SF FuneralFDC0000000HZ62250228","","126.5","","1144628.47"
"2025-02-28","2025-02-28","SF FuneralF989920       250301","","126.5","","1144754.97"
"2025-02-28","2025-02-28","SF FuneralF784810       250228","","126.5","","1144881.47"
"2025-02-28","2025-02-28","SF FuneralF1021249      250228","","126.5","","1145007.97"
"2025-02-28","2025-02-28","SF FuneralF1054997      250228","","126.5","","1145134.47"
"2025-02-28","2025-02-28","SF FuneralF1060267      250228","","126.5","","1145260.97"
"2025-02-28","2025-02-28","SF FuneralF1065823      250228","","126.5","","1145387.47"
"2025-02-28","2025-02-28","SF FuneralF1066698      250228","","126.5","","1145513.97"
"2025-02-28","2025-02-28","SF FuneralFDC0000000LH9B250228","","126.5","","1145640.47"
"2025-02-28","2025-02-28","SF FuneralF1083725      250228","","126.5","","1145766.97"
"2025-02-28","2025-02-28","SF FuneralF1084350      250228","","126.5","","1145893.47"
"2025-02-28","2025-02-28","SF FuneralF1084391      250228","","126.5","","1146019.97"
"2025-02-28","2025-02-28","SF FuneralF1096647      250228","","126.5","","1146146.47"
"2025-02-28","2025-02-28","SF FuneralF1108554      250228","","126.5","","1146272.97"
"2025-02-28","2025-02-28","SF FuneralF1110692      250228","","126.5","","1146399.47"
"2025-02-28","2025-02-28","SF FuneralF1112318      250228","","126.5","","1146525.97"
"2025-02-28","2025-02-28","SF FuneralF1112535      250228","","126.5","","1146652.47"
"2025-02-28","2025-02-28","SF FuneralF789357       250228","","256.5","","1146908.97"
"2025-02-28","2025-02-28","SF FuneralF1117169      250228","","126.5","","1147035.47"
"2025-02-28","2025-02-28","SF FuneralF1117197      250228","","126.5","","1147161.97"
"2025-02-28","2025-02-28","SF FuneralFDC0000000NLXW250228","","126.5","","1147288.47"
"2025-02-28","2025-02-28","SF FuneralF1122327      250228","","126.5","","1147414.97"
"2025-02-28","2025-02-28","SF FuneralF1123527      250228","","126.5","","1147541.47"
"2025-02-28","2025-02-28","SF FuneralF1127634      250228","","126.5","","1147667.97"
"2025-02-28","2025-02-28","SF FuneralF1127981      250228","","126.5","","1147794.47"
"2025-02-28","2025-02-28","SF FuneralF1128027      250228","","126.5","","1147920.97"
"2025-02-28","2025-02-28","SF FuneralFDC0000000PV43250228","","126.5","","1148047.47"
"2025-02-28","2025-02-28","SF FuneralFDC0000000PV47250228","","126.5","","1148173.97"
"2025-02-28","2025-02-28","SF FuneralF1128177      250228","","126.5","","1148300.47"
"2025-02-28","2025-02-28","SF FuneralF1128343      250228","","126.5","","1148426.97"
"2025-02-28","2025-02-28","SF FuneralF1129184      250228","","126.5","","1148553.47"
"2025-02-28","2025-02-27","SF FuneralF1016768      250227","","31.63","","1148585.1"
"2025-02-28","2025-02-27","SF FuneralF1109029      250227","","31.63","","1148616.73"
"2025-02-28","2025-02-25","SF FuneralFDC000000051KX250225","","31.63","","1148648.36"
"2025-02-28","2025-02-25","SF FuneralFDC0000000690Q250225","","31.63","","1148679.99"
"2025-02-28","2025-02-25","SF FuneralFDC00000006SSB250225","","31.63","","1148711.62"
"2025-02-28","2025-02-25","SF FuneralFDC00000006ST9250225","","31.63","","1148743.25"
"2025-02-28","2025-02-25","SF FuneralFDC00000006STJ250225","","31.63","","1148774.88"
"2025-02-28","2025-02-25","SF FuneralFDC00000007FBC250225","","31.63","","1148806.51"
"2025-02-28","2025-02-25","SF FuneralFDC00000007WH2250225","","47.88","","1148854.39"
"2025-02-28","2025-02-25","SF FuneralF798846       250225","","31.63","","1148886.02"
"2025-02-28","2025-02-25","SF FuneralF799673       250225","","31.63","","1148917.65"
"2025-02-28","2025-02-25","SF FuneralF801219       250225","","31.63","","1148949.28"
"2025-02-28","2025-02-25","SF FuneralF802169       250225","","31.63","","1148980.91"
"2025-02-28","2025-02-25","SF FuneralFDC00000008M07250225","","31.63","","1149012.54"
"2025-02-28","2025-02-25","SF FuneralFDC00000008M09250225","","31.63","","1149044.17"
"2025-02-28","2025-02-25","SF FuneralF805662       250225","","31.63","","1149075.8"
"2025-02-28","2025-02-25","SF FuneralF811275       250225","","31.63","","1149107.43"
"2025-02-28","2025-02-25","SF FuneralF822125       250225","","31.63","","1149139.06"
"2025-02-28","2025-02-25","SF FuneralF827761       250225","","31.63","","1149170.69"
"2025-02-28","2025-02-25","SF FuneralF827812       250225","","31.63","","1149202.32"
"2025-02-28","2025-02-25","SF FuneralF832888       250225","","31.63","","1149233.95"
"2025-02-28","2025-02-25","SF FuneralF833515       250225","","31.63","","1149265.58"
"2025-02-28","2025-02-25","SF FuneralF833824       250225","","31.63","","1149297.21"
"2025-02-28","2025-02-25","SF FuneralF843037       250225","","31.63","","1149328.84"
"2025-02-28","2025-02-25","SF FuneralF900687       250225","","31.63","","1149360.47"
"2025-02-28","2025-02-25","SF FuneralF981838       250225","","31.63","","1149392.1"
"2025-02-28","2025-02-25","SF FuneralF986709       250225","","31.63","","1149423.73"
"2025-02-28","2025-02-25","SF FuneralF988236       250225","","31.63","","1149455.36"
"2025-02-28","2025-02-25","SF FuneralF993770       250225","","31.63","","1149486.99"
"2025-02-28","2025-02-25","SF FuneralF1059867      250225","","31.63","","1149518.62"
"2025-02-28","2025-02-25","SF FuneralF1066647      250225","","31.63","","1149550.25"
"2025-02-28","2025-02-25","SF FuneralFDC0000000L215250225","","31.63","","1149581.88"
"2025-02-28","2025-02-25","SF FuneralF1073297      250225","","31.63","","1149613.51"
"2025-02-28","2025-02-25","SF FuneralF1073828      250225","","31.63","","1149645.14"
"2025-02-28","2025-02-25","SF FuneralF1074647      250225","","31.63","","1149676.77"
"2025-02-28","2025-02-25","SF FuneralF1074917      250225","","31.63","","1149708.4"
"2025-02-28","2025-02-25","SF FuneralF1078493      250225","","31.63","","1149740.03"
"2025-02-28","2025-02-25","SF FuneralF1079331      250225","","31.63","","1149771.66"
"2025-02-28","2025-02-25","SF FuneralF1084860      250225","","31.63","","1149803.29"
"2025-02-28","2025-02-25","SF FuneralF1110117      250225","","31.63","","1149834.92"
"2025-02-28","2025-02-25","SF FuneralF1112298      250225","","31.63","","1149866.55"
"2025-02-28","2025-02-25","SF FuneralF1112349      250225","","31.63","","1149898.18"
"2025-02-28","2025-02-25","SF FuneralFDC0000000NRQK250225","","31.63","","1149929.81"
"2025-02-28","2025-02-25","SF FuneralF1120226      250225","","31.63","","1149961.44"
"2025-02-28","2025-02-25","SF FuneralF1121908      250225","","31.63","","1149993.07"
"2025-02-28","2025-02-25","SF FuneralF1124052      250225","","31.63","","1150024.7"
"2025-02-28","2025-02-25","SF FuneralF1126072      250225","","31.63","","1150056.33"
"2025-02-28","2025-02-25","SF FuneralF1126086      250225","","31.63","","1150087.96"
"2025-02-28","2025-02-25","SF FuneralF1127480      250225","","31.63","","1150119.59"
"2025-02-28","2025-02-25","SF FuneralF1127528      250225","","31.63","","1150151.22"
"2025-02-28","2025-02-25","SF FuneralF1128998      250225","","31.63","","1150182.85"
"2025-02-28","2025-02-25","SF FuneralF1130733      250225","","31.63","","1150214.48"
"2025-02-28","2025-02-25","SF FuneralF1131495      250225","","31.63","","1150246.11"
"2025-02-28","2025-02-25","SF FuneralF1131622      250225","","31.63","","1150277.74"
"2025-02-28","2025-02-25","SF FuneralF1131696      250225","","31.63","","1150309.37"
"2025-02-28","2025-02-25","SF FuneralF1132209      250225","","31.63","","1150341"
"2025-02-28","2025-02-25","SF FuneralF1132381      250225","","31.63","","1150372.63"
"2025-02-28","2025-02-25","SF FuneralF1132785      250225","","31.63","","1150404.26"
"2025-02-28","2025-02-26","SF FuneralFDC00000006J82250226","","31.63","","1150435.89"
"2025-02-28","2025-02-26","SF FuneralFDC0000000L9LS250226","","31.63","","1150467.52"
"2025-02-28","2025-02-26","SF FuneralF1110314      250226","","31.63","","1150499.15"
"2025-02-28","2025-02-22","SF FuneralFDC0000000P0VX250223","","31.63","","1150530.78"
"2025-02-28","2025-02-22","SF FuneralFDC0000000P0VY250223","","31.63","","1150562.41"
"2025-02-28","2025-02-22","SF FuneralFDC0000000P0W3250223","","31.63","","1150594.04"
"2025-02-28","2025-02-22","SF FuneralF1122269      250223","","31.63","","1150625.67"
"2025-02-28","2025-02-24","SF FuneralFDC00000007GFX250223","","31.63","","1150657.3"
"2025-02-28","2025-02-24","SF FuneralFDC00000007GG1250223","","31.63","","1150688.93"
"2025-02-28","2025-02-24","SF FuneralF828566       250224","","31.63","","1150720.56"
"2025-02-28","2025-02-24","SF FuneralFDC0000000F7T2250224","","31.63","","1150752.19"
"2025-02-28","2025-02-24","SF FuneralF1052812      250224","","31.63","","1150783.82"
"2025-02-28","2025-02-24","SF FuneralF1073374      250224","","31.63","","1150815.45"
"2025-02-28","2025-02-24","SF FuneralF1079348      250224","","31.63","","1150847.08"
"2025-02-28","2025-02-24","SF FuneralF1118416      250224","","31.63","","1150878.71"
"2025-02-28","2025-02-24","SF FuneralF1123291      250224","","31.63","","1150910.34"
"2025-02-28","2025-02-28","SF FuneralFDC00000005XS3250228","","31.63","","1150941.97"
"2025-02-28","2025-02-28","SF FuneralFDC00000007TC1250228","","31.63","","1150973.6"
"2025-02-28","2025-02-28","SF FuneralFDC00000007W5M250228","","31.63","","1151005.23"
"2025-02-28","2025-02-28","SF FuneralFDC00000008GY4250228","","31.63","","1151036.86"
"2025-02-28","2025-02-28","SF FuneralF812905       250228","","31.63","","1151068.49"
"2025-02-28","2025-02-28","SF FuneralF817655       250228","","31.63","","1151100.12"
"2025-02-28","2025-02-28","SF FuneralFDC0000000B37Y250228","","31.63","","1151131.75"
"2025-02-28","2025-02-28","SF FuneralF831565       250228","","31.63","","1151163.38"
"2025-02-28","2025-02-28","SF FuneralF834570       250228","","31.63","","1151195.01"
"2025-02-28","2025-02-28","SF FuneralF840580       250228","","31.63","","1151226.64"
"2025-02-28","2025-02-28","SF FuneralFDC0000000DZCH250228","","31.63","","1151258.27"
"2025-02-28","2025-02-28","SF FuneralFDC0000000HVXH250301","","31.63","","1151289.9"
"2025-02-28","2025-02-28","SF FuneralF989273       250302","","31.63","","1151321.53"
"2025-02-28","2025-02-28","SF FuneralF990787       250301","","31.63","","1151353.16"
"2025-02-28","2025-02-28","SF FuneralF1022106      250228","","31.63","","1151384.79"
"2025-02-28","2025-02-28","SF FuneralFDC0000000JXK7250228","","31.63","","1151416.42"
"2025-02-28","2025-02-28","SF FuneralF1033704      250228","","31.63","","1151448.05"
"2025-02-28","2025-02-28","SF FuneralFDC0000000K8Y6250228","","31.63","","1151479.68"
"2025-02-28","2025-02-28","SF FuneralFDC0000000L3MT250228","","31.63","","1151511.31"
"2025-02-28","2025-02-28","SF FuneralF1078056      250228","","31.63","","1151542.94"
"2025-02-28","2025-02-28","SF FuneralF1079509      250228","","31.63","","1151574.57"
"2025-02-28","2025-02-28","SF FuneralF1079664      250228","","31.63","","1151606.2"
"2025-02-28","2025-02-28","SF FuneralF1079691      250228","","31.63","","1151637.83"
"2025-02-28","2025-02-28","SF FuneralF1121971      250228","","31.63","","1151669.46"
"2025-02-28","2025-02-28","SF FuneralF1125111      250228","","31.63","","1151701.09"
"2025-02-28","2025-02-28","SF FuneralFDC0000000PK3S250228","","31.63","","1151732.72"
"2025-02-28","2025-02-28","SF FuneralF1130684      250228","","31.63","","1151764.35"
"2025-02-28","2025-02-28","SF FuneralF1131924      250228","","31.63","","1151795.98"
"2025-02-28","2025-02-22","SF FuneralFDC000000032DV250222","","220","","1152015.98"
"2025-02-28","2025-02-22","SF FuneralFDC00000003378250222","","110","","1152125.98"
"2025-02-28","2025-02-22","SF FuneralFDC000000035YY250222","","220","","1152345.98"
"2025-02-28","2025-02-22","SF FuneralFDC000000039M7250222","","220","","1152565.98"
"2025-02-28","2025-02-22","SF FuneralFDC00000003DZ8250222","","220","","1152785.98"
"2025-02-28","2025-02-22","SF FuneralFDC00000003FFF250222","","220","","1153005.98"
"2025-02-28","2025-02-22","SF FuneralFDC000000053ZX250222","","126.5","","1153132.48"
"2025-02-28","2025-02-22","SF FuneralFDC00000005409250222","","126.5","","1153258.98"
"2025-02-28","2025-02-22","SF FuneralFDC00000005G0G250222","","126.5","","1153385.48"
"2025-02-28","2025-02-22","SF FuneralFDC00000005R8B250222","","126.5","","1153511.98"
"2025-02-28","2025-02-22","SF FuneralFDC00000005XMQ250222","","126.5","","1153638.48"
"2025-02-28","2025-02-22","SF FuneralFDC000000060B6250222","","126.5","","1153764.98"
"2025-02-28","2025-02-22","SF FuneralFDC000000060Z5250222","","126.5","","1153891.48"
"2025-02-28","2025-02-22","SF FuneralFDC000000069P1250222","","126.5","","1154017.98"
"2025-02-28","2025-02-22","SF FuneralFDC0000000717F250222","","126.5","","1154144.48"
"2025-02-28","2025-02-22","SF FuneralFDC000000073BN250222","","126.5","","1154270.98"
"2025-02-28","2025-02-22","SF FuneralFDC00000007813250222","","126.5","","1154397.48"
"2025-02-28","2025-02-22","SF FuneralFDC00000007LQ4250222","","126.5","","1154523.98"
"2025-02-28","2025-02-22","SF FuneralF798526       250222","","126.5","","1154650.48"
"2025-02-28","2025-02-22","SF FuneralF808717       250222","","126.5","","1154776.98"
"2025-02-28","2025-02-22","SF FuneralF811285       250222","","126.5","","1154903.48"
"2025-02-28","2025-02-22","SF FuneralFDC00000009PC6250222","","126.5","","1155029.98"
"2025-02-28","2025-02-22","SF FuneralF815776       250222","","126.5","","1155156.48"
"2025-02-28","2025-02-22","SF FuneralFDC00000009SL5250222","","126.5","","1155282.98"
"2025-02-28","2025-02-22","SF FuneralF817608       250222","","126.5","","1155409.48"
"2025-02-28","2025-02-22","SF FuneralF819734       250222","","126.5","","1155535.98"
"2025-02-28","2025-02-22","SF FuneralF823357       250222","","126.5","","1155662.48"
"2025-02-28","2025-02-22","SF FuneralF827801       250222","","126.5","","1155788.98"
"2025-02-28","2025-02-22","SF FuneralF831560       250222","","126.5","","1155915.48"
"2025-02-28","2025-02-22","SF FuneralF832642       250222","","126.5","","1156041.98"
"2025-02-28","2025-02-22","SF FuneralFDC0000000CTKT250222","","126.5","","1156168.48"
"2025-02-28","2025-02-22","SF FuneralF833772       250222","","126.5","","1156294.98"
"2025-02-28","2025-02-22","SF FuneralF991797       250222","","126.5","","1156421.48"
"2025-02-28","2025-02-22","SF FuneralF1020986      250222","","126.5","","1156547.98"
"2025-02-28","2025-02-22","SF FuneralF1021125      250222","","126.5","","1156674.48"
"2025-02-28","2025-02-22","SF FuneralF1055113      250222","","126.5","","1156800.98"
"2025-02-28","2025-02-22","SF FuneralF1058678      250222","","126.5","","1156927.48"
"2025-02-28","2025-02-22","SF FuneralF1060102      250223","","126.5","","1157053.98"
"2025-02-28","2025-02-22","SF FuneralF1061616      250222","","126.5","","1157180.48"
"2025-02-28","2025-02-22","SF FuneralFDC0000000KR0G250222","","126.5","","1157306.98"
"2025-02-28","2025-02-22","SF FuneralF1074690      250222","","126.5","","1157433.48"
"2025-02-28","2025-02-22","SF FuneralF1078332      250222","","126.5","","1157559.98"
"2025-02-28","2025-02-22","SF FuneralFDC0000000LJ18250222","","126.5","","1157686.48"
"2025-02-28","2025-02-22","SF FuneralFDC0000000LR68250222","","126.5","","1157812.98"
"2025-02-28","2025-02-22","SF FuneralF1083806      250222","","126.5","","1157939.48"
"2025-02-28","2025-02-22","SF FuneralF813376       250222","","126.5","","1158065.98"
"2025-02-28","2025-02-22","SF FuneralF1084376      250223","","126.5","","1158192.48"
"2025-02-28","2025-02-22","SF FuneralF1108705      250222","","126.5","","1158318.98"
"2025-02-28","2025-02-22","SF FuneralFDC0000000MJPL250222","","126.5","","1158445.48"
"2025-02-28","2025-02-22","SF FuneralF1113926      250222","","126.5","","1158571.98"
"2025-02-28","2025-02-22","SF FuneralF1116004      250223","","126.5","","1158698.48"
"2025-02-28","2025-02-22","SF FuneralFDC0000000P1SV250222","","126.5","","1158824.98"
"2025-02-28","2025-02-22","SF FuneralF1127847      250223","","63.25","","1158888.23"
"2025-02-28","2025-02-22","SF FuneralFDC0000000Q3LH250222","","126.5","","1159014.73"
"2025-02-28","2025-02-22","SF FuneralFDC0000000Q3LS250222","","126.5","","1159141.23"
"2025-02-28","2025-02-24","SF FuneralFDC00000005SVR250223","","126.5","","1159267.73"
"2025-02-28","2025-02-24","SF FuneralFDC0000000659X250224","","63.25","","1159330.98"
"2025-02-28","2025-02-24","SF FuneralFDC000000070Y8250224","","126.5","","1159457.48"
"2025-02-28","2025-02-24","SF FuneralFDC00000007F71250224","","63.25","","1159520.73"
"2025-02-28","2025-02-24","SF FuneralFDC00000007NPQ250224","","126.5","","1159647.23"
"2025-02-28","2025-02-24","SF FuneralFDC00000007P1P250224","","126.5","","1159773.73"
"2025-02-28","2025-02-24","SF FuneralFDC000000080XP250224","","126.5","","1159900.23"
"2025-02-28","2025-02-24","SF FuneralF781998       250223","","126.5","","1160026.73"
"2025-02-28","2025-02-24","SF FuneralF787433       250224","","126.5","","1160153.23"
"2025-02-28","2025-02-24","SF FuneralF816227       250224","","126.5","","1160279.73"
"2025-02-28","2025-02-24","SF FuneralF816487       250224","","126.5","","1160406.23"
"2025-02-28","2025-02-24","SF FuneralFDC0000000BGJB250224","","63.25","","1160469.48"
"2025-02-28","2025-02-24","SF FuneralF834264       250223","","126.5","","1160595.98"
"2025-02-28","2025-02-24","SF FuneralF843031       250223","","126.5","","1160722.48"
"2025-02-28","2025-02-24","SF FuneralF843997       250222","","126.5","","1160848.98"
"2025-02-28","2025-02-24","SF FuneralF981787       250224","","126.5","","1160975.48"
"2025-02-28","2025-02-24","SF FuneralF986873       250224","","126.5","","1161101.98"
"2025-02-28","2025-02-24","SF FuneralFDC0000000HT78250224","","126.5","","1161228.48"
"2025-02-28","2025-02-24","SF FuneralF987883       250224","","126.5","","1161354.98"
"2025-02-28","2025-02-24","SF FuneralF989002       250224","","63.25","","1161418.23"
"2025-02-28","2025-02-24","SF FuneralF989694       250224","","126.5","","1161544.73"
"2025-02-28","2025-02-24","SF FuneralF990149       250224","","126.5","","1161671.23"
"2025-02-28","2025-02-24","SF FuneralF993751       250224","","126.5","","1161797.73"
"2025-02-28","2025-02-24","SF FuneralF1021299      250224","","126.5","","1161924.23"
"2025-02-28","2025-02-24","SF FuneralF1022242      250224","","126.5","","1162050.73"
"2025-02-28","2025-02-24","SF FuneralF1061853      250224","","126.5","","1162177.23"
"2025-02-28","2025-02-24","SF FuneralF1066507      250224","","126.5","","1162303.73"
"2025-02-28","2025-02-24","SF FuneralF1108545      250224","","126.5","","1162430.23"
"2025-02-28","2025-02-24","SF FuneralFDC0000000MK0D250224","","126.5","","1162556.73"
"2025-02-28","2025-02-24","SF FuneralF1110179      250224","","126.5","","1162683.23"
"2025-02-28","2025-02-24","SF FuneralFDC0000000N12V250224","","126.5","","1162809.73"
"2025-02-28","2025-02-24","SF FuneralF1112404      250224","","126.5","","1162936.23"
"2025-02-28","2025-02-24","SF FuneralFDC0000000N4GG250224","","126.5","","1163062.73"
"2025-02-28","2025-02-24","SF FuneralF1113591      250224","","126.5","","1163189.23"
"2025-02-28","2025-02-24","SF FuneralF1113782      250224","","126.5","","1163315.73"
"2025-02-28","2025-02-24","SF FuneralF1113947      250224","","126.5","","1163442.23"
"2025-02-28","2025-02-24","SF FuneralF1123621      250224","","126.5","","1163568.73"
"2025-02-28","2025-02-24","SF FuneralF1124827      250224","","126.5","","1163695.23"
"2025-02-28","2025-02-24","SF FuneralFDC0000000PZ26250224","","126.5","","1163821.73"
"2025-02-28","2025-02-24","SF FuneralF1132092      250224","","126.5","","1163948.23"
"2025-02-28","2025-02-19","SF FuneralFDC00000005WHB250219","","126.5","","1164074.73"
"2025-02-28","2025-02-19","SF FuneralF1017784      250219","","126.5","","1164201.23"
"2025-02-28","2025-02-19","SF FuneralFDC0000000PW8D250219","","126.5","","1164327.73"
"2025-02-28","2025-02-19","SF FuneralF1128842      250219","","126.5","","1164454.23"
"2025-02-28","2025-02-20","SF FuneralFDC00000005F0T250220","","126.5","","1164580.73"
"2025-02-28","2025-02-20","SF FuneralFDC000000068MQ250220","","126.5","","1164707.23"
"2025-02-28","2025-02-20","SF FuneralFDC00000006BZ7250220","","126.5","","1164833.73"
"2025-02-28","2025-02-20","SF FuneralF840770       250220","","126.5","","1164960.23"
"2025-02-28","2025-02-20","SF FuneralF844601       250220","","126.5","","1165086.73"
"2025-02-28","2025-02-20","SF FuneralF844637       250220","","126.5","","1165213.23"
"2025-02-28","2025-02-20","SF FuneralF1104192      250220","","126.5","","1165339.73"
"2025-02-28","2025-02-21","SF FuneralFDC00000005QRC250221","","63.25","","1165402.98"
"2025-02-28","2025-02-21","SF FuneralF797167       250221","","126.5","","1165529.48"
"2025-02-28","2025-02-21","SF FuneralF840761       250221","","126.5","","1165655.98"
"2025-02-28","2025-02-21","SF FuneralF987232       250222","","126.5","","1165782.48"
"2025-02-28","2025-02-21","SF FuneralFDC0000000HQ1N250223","","126.5","","1165908.98"
"2025-02-28","2025-02-21","SF FuneralFDC0000000HQ1V250223","","126.5","","1166035.48"
"2025-02-28","2025-02-21","SF FuneralF987370       250223","","126.5","","1166161.98"
"2025-02-28","2025-02-21","SF FuneralF988915       250222","","126.5","","1166288.48"
"2025-02-28","2025-02-21","SF FuneralFDC0000000HYF4250222","","126.5","","1166414.98"
"2025-02-28","2025-02-21","SF FuneralF1066702      250221","","126.5","","1166541.48"
"2025-02-28","2025-02-26","SF FuneralFDC00000005GGW250226","","126.5","","1166667.98"
"2025-02-28","2025-02-26","SF FuneralFDC00000005J71250226","","126.5","","1166794.48"
"2025-02-28","2025-02-26","SF FuneralFDC00000005XF6250226","","220","","1167014.48"
"2025-02-28","2025-02-26","SF FuneralFDC000000069PR250226","","126.5","","1167140.98"
"2025-02-28","2025-02-26","SF FuneralFDC00000006DGL250226","","126.5","","1167267.48"
"2025-02-28","2025-02-26","SF FuneralFDC00000006WCL250226","","126.5","","1167393.98"
"2025-02-28","2025-02-26","SF FuneralFDC00000006WCW250226","","126.5","","1167520.48"
"2025-02-28","2025-02-26","SF FuneralFDC00000006WCZ250226","","126.5","","1167646.98"
"2025-02-28","2025-02-26","SF FuneralFDC00000006X9Y250226","","126.5","","1167773.48"
"2025-02-28","2025-02-26","SF FuneralFDC00000007W2T250226","","126.5","","1167899.98"
"2025-02-28","2025-02-26","SF FuneralF795985       250226","","126.5","","1168026.48"
"2025-02-28","2025-02-26","SF FuneralF823256       250226","","126.5","","1168152.98"
"2025-02-28","2025-02-26","SF FuneralF828827       250226","","126.5","","1168279.48"
"2025-02-28","2025-02-26","SF FuneralF829467       250226","","126.5","","1168405.98"
"2025-02-28","2025-02-26","SF FuneralF830065       250226","","126.5","","1168532.48"
"2025-02-28","2025-02-26","SF FuneralF840898       250226","","126.5","","1168658.98"
"2025-02-28","2025-02-26","SF FuneralF842812       250226","","126.5","","1168785.48"
"2025-02-28","2025-02-26","SF FuneralFDC0000000H1YY250226","","126.5","","1168911.98"
"2025-02-28","2025-02-26","SF FuneralF988623       250226","","126.5","","1169038.48"
"2025-02-28","2025-02-26","SF FuneralF992012       250226","","126.5","","1169164.98"
"2025-02-28","2025-02-26","SF FuneralFDC0000000J7LW250226","","126.5","","1169291.48"
"2025-02-28","2025-02-26","SF FuneralF992484       250226","","126.5","","1169417.98"
"2025-02-28","2025-02-26","SF FuneralFDC0000000J997250226","","126.5","","1169544.48"
"2025-02-28","2025-02-26","SF FuneralF993242       250226","","126.5","","1169670.98"
"2025-02-28","2025-02-26","SF FuneralF993391       250226","","126.5","","1169797.48"
"2025-02-28","2025-02-26","SF FuneralF993406       250226","","126.5","","1169923.98"
"2025-02-28","2025-02-26","SF FuneralF994011       250226","","126.5","","1170050.48"
"2025-02-28","2025-02-26","SF FuneralFDC0000000KRGY250226","","126.5","","1170176.98"
"2025-02-28","2025-02-26","SF FuneralF1074899      250226","","126.5","","1170303.48"
"2025-02-28","2025-02-26","SF FuneralFDC0000000LGVG250226","","126.5","","1170429.98"
"2025-02-28","2025-02-26","SF FuneralF1085200      250226","","126.5","","1170556.48"
"2025-02-28","2025-02-26","SF FuneralFDC0000000N319250226","","126.5","","1170682.98"
"2025-02-28","2025-02-26","SF FuneralF1123084      250226","","126.5","","1170809.48"
"2025-02-28","2025-02-26","SF FuneralFDC0000000P5Q2250226","","126.5","","1170935.98"
"2025-02-28","2025-02-26","SF FuneralFDC0000000P753250226","","213.31","","1171149.29"
"2025-02-28","2025-02-26","SF FuneralF1129170      250226","","126.5","","1171275.79"
"2025-02-28","2025-02-26","SF FuneralF1132803      250226","","126.5","","1171402.29"
"2025-02-28","2025-02-25","SF FuneralFDC00000003L92250225","","220","","1171622.29"
"2025-02-28","2025-02-25","SF FuneralFDC0000000500B250225","","126.5","","1171748.79"
"2025-02-28","2025-02-25","SF FuneralFDC00000005LGY250225","","126.5","","1171875.29"
"2025-02-28","2025-02-25","SF FuneralFDC00000005W77250225","","126.5","","1172001.79"
"2025-02-28","2025-02-25","SF FuneralFDC00000005X62250225","","126.5","","1172128.29"
"2025-02-28","2025-02-25","SF FuneralFDC00000005Z3K250225","","126.5","","1172254.79"
"2025-02-28","2025-02-25","SF FuneralFDC00000005ZFX250225","","126.5","","1172381.29"
"2025-02-28","2025-02-25","SF FuneralFDC000000062D3250225","","126.5","","1172507.79"
"2025-02-28","2025-02-25","SF FuneralFDC00000006CRY250225","","126.5","","1172634.29"
"2025-02-28","2025-02-25","SF FuneralFDC00000006DSH250225","","126.5","","1172760.79"
"2025-02-28","2025-02-25","SF FuneralFDC00000006P88250225","","63.25","","1172824.04"
"2025-02-28","2025-02-25","SF FuneralFDC00000006RB3250225","","126.5","","1172950.54"
"2025-02-28","2025-02-25","SF FuneralFDC00000006Y66250225","","126.5","","1173077.04"
"2025-02-28","2025-02-25","SF FuneralFDC00000007343250225","","126.5","","1173203.54"
"2025-02-28","2025-02-25","SF FuneralFDC00000007BBK250225","","220","","1173423.54"
"2025-02-28","2025-02-25","SF FuneralFDC00000007DZH250225","","126.5","","1173550.04"
"2025-02-28","2025-02-25","SF FuneralFDC00000007L17250225","","126.5","","1173676.54"
"2025-02-28","2025-02-25","SF FuneralFDC00000007MZ7250225","","126.5","","1173803.04"
"2025-02-28","2025-02-25","SF FuneralFDC00000007N71250225","","126.5","","1173929.54"
"2025-02-28","2025-02-25","SF FuneralFDC00000007N99250225","","126.5","","1174056.04"
"2025-02-28","2025-02-25","SF FuneralFDC00000007NDR250225","","126.5","","1174182.54"
"2025-02-28","2025-02-25","SF FuneralFDC00000007NFM250225","","126.5","","1174309.04"
"2025-02-28","2025-02-25","SF FuneralFDC00000007NL9250225","","126.5","","1174435.54"
"2025-02-28","2025-02-25","SF FuneralFDC00000007NTQ250225","","126.5","","1174562.04"
"2025-02-28","2025-02-25","SF FuneralFDC00000007PN2250225","","126.5","","1174688.54"
"2025-02-28","2025-02-25","SF FuneralFDC00000007PQR250225","","126.5","","1174815.04"
"2025-02-28","2025-02-25","SF FuneralFDC00000007QX3250225","","256.5","","1175071.54"
"2025-02-28","2025-02-25","SF FuneralF794313       250225","","126.5","","1175198.04"
"2025-02-28","2025-02-25","SF FuneralFDC00000007RN8250225","","126.5","","1175324.54"
"2025-02-28","2025-02-25","SF FuneralF794530       250225","","126.5","","1175451.04"
"2025-02-28","2025-02-25","SF FuneralF794564       250225","","63.25","","1175514.29"
"2025-02-28","2025-02-25","SF FuneralF795301       250225","","126.5","","1175640.79"
"2025-02-28","2025-02-25","SF FuneralFDC00000007XCF250225","","126.5","","1175767.29"
"2025-02-28","2025-02-25","SF FuneralFDC00000007XCG250225","","126.5","","1175893.79"
"2025-02-28","2025-02-25","SF FuneralFDC00000007XQN250225","","126.5","","1176020.29"
"2025-02-28","2025-02-25","SF FuneralFDC000000081DM250225","","126.5","","1176146.79"
"2025-02-28","2025-02-25","SF FuneralF797467       250225","","126.5","","1176273.29"
"2025-02-28","2025-02-25","SF FuneralFDC00000008M1T250225","","126.5","","1176399.79"
"2025-02-28","2025-02-25","SF FuneralFDC00000008P1W250225","","126.5","","1176526.29"
"2025-02-28","2025-02-25","SF FuneralF804243       250225","","126.5","","1176652.79"
"2025-02-28","2025-02-25","SF FuneralF804883       250225","","126.5","","1176779.29"
"2025-02-28","2025-02-25","SF FuneralFDC00000008XF8250225","","126.5","","1176905.79"
"2025-02-28","2025-02-25","SF FuneralF802368       250225","","126.5","","1177032.29"
"2025-02-28","2025-02-25","SF FuneralF809008       250225","","126.5","","1177158.79"
"2025-02-28","2025-02-25","SF FuneralF809352       250225","","126.5","","1177285.29"
"2025-02-28","2025-02-25","SF FuneralF810617       250225","","126.5","","1177411.79"
"2025-02-28","2025-02-25","SF FuneralF811307       250225","","126.5","","1177538.29"
"2025-02-28","2025-02-25","SF FuneralF806016       250225","","126.5","","1177664.79"
"2025-02-28","2025-02-25","SF FuneralF816505       250225","","126.5","","1177791.29"
"2025-02-28","2025-02-25","SF FuneralF816575       250225","","126.5","","1177917.79"
"2025-02-28","2025-02-25","SF FuneralF817679       250225","","126.5","","1178044.29"
"2025-02-28","2025-02-25","SF FuneralF818886       250225","","126.5","","1178170.79"
"2025-02-28","2025-02-25","SF FuneralF822630       250225","","63.25","","1178234.04"
"2025-02-28","2025-02-25","SF FuneralF822823       250225","","63.25","","1178297.29"
"2025-02-28","2025-02-25","SF FuneralF823399       250225","","126.5","","1178423.79"
"2025-02-28","2025-02-25","SF FuneralF798847       250225","","126.5","","1178550.29"
"2025-02-28","2025-02-25","SF FuneralF823481       250225","","126.5","","1178676.79"
"2025-02-28","2025-02-25","SF FuneralF829846       250225","","126.5","","1178803.29"
"2025-02-28","2025-02-25","SF FuneralF830225       250225","","126.5","","1178929.79"
"2025-02-28","2025-02-25","SF FuneralF831840       250225","","126.5","","1179056.29"
"2025-02-28","2025-02-25","SF FuneralF831927       250225","","126.5","","1179182.79"
"2025-02-28","2025-02-25","SF FuneralF832756       250225","","126.5","","1179309.29"
"2025-02-28","2025-02-25","SF FuneralF840527       250225","","126.5","","1179435.79"
"2025-02-28","2025-02-25","SF FuneralF840977       250225","","126.5","","1179562.29"
"2025-02-28","2025-02-25","SF FuneralF847362       250225","","63.25","","1179625.54"
"2025-02-28","2025-02-25","SF FuneralF900889       250225","","126.5","","1179752.04"
"2025-02-28","2025-02-25","SF FuneralF981764       250225","","126.5","","1179878.54"
"2025-02-28","2025-02-25","SF FuneralF988054       250225","","126.5","","1180005.04"
"2025-02-28","2025-02-25","SF FuneralF991773       250225","","126.5","","1180131.54"
"2025-02-28","2025-02-25","SF FuneralF992274       250225","","126.5","","1180258.04"
"2025-02-28","2025-02-25","SF FuneralF992479       250225","","63.25","","1180321.29"
"2025-02-28","2025-02-25","SF FuneralF993898       250225","","63.25","","1180384.54"
"2025-02-28","2025-02-25","SF FuneralFDC0000000JHG8250225","","126.5","","1180511.04"
"2025-02-28","2025-02-25","SF FuneralF1021253      250225","","126.5","","1180637.54"
"2025-02-28","2025-02-25","SF FuneralF1034023      250225","","126.5","","1180764.04"
"2025-02-28","2025-02-25","SF FuneralF987109       250225","","126.5","","1180890.54"
"2025-02-28","2025-02-25","SF FuneralF1052710      250225","","63.25","","1180953.79"
"2025-02-28","2025-02-25","SF FuneralF1055108      250225","","126.5","","1181080.29"
"2025-02-28","2025-02-25","SF FuneralF1060174      250225","","126.5","","1181206.79"
"2025-02-28","2025-02-25","SF FuneralF1060221      250225","","63.25","","1181270.04"
"2025-02-28","2025-02-25","SF FuneralF1060758      250225","","126.5","","1181396.54"
"2025-02-28","2025-02-25","SF FuneralF1060859      250225","","63.25","","1181459.79"
"2025-02-28","2025-02-25","SF FuneralF1060918      250225","","126.5","","1181586.29"
"2025-02-28","2025-02-25","SF FuneralF1066606      250225","","126.5","","1181712.79"
"2025-02-28","2025-02-25","SF FuneralFDC0000000KZ5V250225","","126.5","","1181839.29"
"2025-02-28","2025-02-25","SF FuneralF1068200      250225","","63.25","","1181902.54"
"2025-02-28","2025-02-25","SF FuneralF1073028      250225","","126.5","","1182029.04"
"2025-02-28","2025-02-25","SF FuneralF1078509      250225","","63.25","","1182092.29"
"2025-02-28","2025-02-25","SF FuneralF1084873      250225","","126.5","","1182218.79"
"2025-02-28","2025-02-25","SF FuneralF1085096      250225","","126.5","","1182345.29"
"2025-02-28","2025-02-25","SF FuneralF1110051      250225","","126.5","","1182471.79"
"2025-02-28","2025-02-25","SF FuneralF1111518      250225","","126.5","","1182598.29"
"2025-02-28","2025-02-25","SF FuneralF1112251      250225","","126.5","","1182724.79"
"2025-02-28","2025-02-25","SF FuneralF1114553      250225","","63.25","","1182788.04"
"2025-02-28","2025-02-25","SF FuneralF1115024      250225","","126.5","","1182914.54"
"2025-02-28","2025-02-25","SF FuneralFDC0000000NHHD250225","","126.5","","1183041.04"
"2025-02-28","2025-02-25","SF FuneralF1116917      250225","","126.5","","1183167.54"
"2025-02-28","2025-02-25","SF FuneralF1116934      250225","","126.5","","1183294.04"
"2025-02-28","2025-02-25","SF FuneralF1118433      250225","","126.5","","1183420.54"
"2025-02-28","2025-02-25","SF FuneralFDC0000000NR03250225","","126.5","","1183547.04"
"2025-02-28","2025-02-25","SF FuneralF1119681      250225","","63.25","","1183610.29"
"2025-02-28","2025-02-25","SF FuneralF1119864      250225","","63.25","","1183673.54"
"2025-02-28","2025-02-25","SF FuneralF1120278      250225","","126.5","","1183800.04"
"2025-02-28","2025-02-25","SF FuneralF1080397      250225","","63.25","","1183863.29"
"2025-02-28","2025-02-25","SF FuneralF1124584      250225","","126.5","","1183989.79"
"2025-02-28","2025-02-25","SF FuneralF1125294      250225","","126.5","","1184116.29"
"2025-02-28","2025-02-25","SF FuneralF1125462      250225","","126.5","","1184242.79"
"2025-02-28","2025-02-25","SF FuneralF1126881      250225","","126.5","","1184369.29"
"2025-02-28","2025-02-25","SF FuneralF1127112      250225","","126.5","","1184495.79"
"2025-02-28","2025-02-25","SF FuneralFDC0000000PSD7250225","","126.5","","1184622.29"
"2025-02-28","2025-02-25","SF FuneralF1127817      250225","","126.5","","1184748.79"
"2025-02-28","2025-02-25","SF FuneralFDC0000000PW05250225","","126.5","","1184875.29"
"2025-02-28","2025-02-25","SF FuneralF1128919      250225","","126.5","","1185001.79"
"2025-02-28","2025-02-25","SF FuneralF1129924      250225","","126.5","","1185128.29"
"2025-02-28","2025-02-25","SF FuneralF1130280      250225","","126.5","","1185254.79"
"2025-02-28","2025-02-25","SF FuneralF1130365      250225","","126.5","","1185381.29"
"2025-02-28","2025-02-25","SF FuneralF1130553      250225","","126.5","","1185507.79"
"2025-02-28","2025-02-25","SF FuneralF1130601      250225","","126.5","","1185634.29"
"2025-02-28","2025-02-25","SF FuneralF1130710      250225","","126.5","","1185760.79"
"2025-02-28","2025-02-25","SF FuneralF1130819      250225","","126.5","","1185887.29"
"2025-02-28","2025-02-25","SF FuneralF1130829      250225","","126.5","","1186013.79"
"2025-02-28","2025-02-25","SF FuneralFDC0000000Q34P250225","","126.5","","1186140.29"
"2025-02-28","2025-02-25","SF FuneralF1130910      250225","","126.5","","1186266.79"
"2025-02-28","2025-02-25","SF FuneralF1130911      250225","","126.5","","1186393.29"
"2025-02-28","2025-02-25","SF FuneralF900671       250225","","126.5","","1186519.79"
"2025-02-28","2025-02-25","SF FuneralF1130938      250225","","126.5","","1186646.29"
"2025-02-28","2025-02-25","SF FuneralF1130943      250225","","126.5","","1186772.79"
"2025-02-28","2025-02-25","SF FuneralFDC0000000Q3PZ250225","","126.5","","1186899.29"
"2025-02-28","2025-02-25","SF FuneralF1130979      250225","","126.5","","1187025.79"
"2025-02-28","2025-02-25","SF FuneralFDC0000000Q3TQ250225","","126.5","","1187152.29"
"2025-02-28","2025-02-25","SF FuneralF1130980      250225","","126.5","","1187278.79"
"2025-02-28","2025-02-25","SF FuneralFDC0000000Q3W0250225","","126.5","","1187405.29"
"2025-02-28","2025-02-25","SF FuneralF1131005      250225","","63.25","","1187468.54"
"2025-02-28","2025-02-25","SF FuneralFDC0000000Q41H250225","","126.5","","1187595.04"
"2025-02-28","2025-02-25","SF FuneralFDC0000000Q41N250225","","126.5","","1187721.54"
"2025-02-28","2025-02-25","SF FuneralF1131307      250225","","126.5","","1187848.04"
"2025-02-28","2025-02-25","SF FuneralFDC0000000Q53W250225","","126.5","","1187974.54"
"2025-02-28","2025-02-25","SF FuneralF1131573      250225","","126.5","","1188101.04"
"2025-02-28","2025-02-25","SF FuneralF1131788      250225","","126.5","","1188227.54"
"2025-02-28","2025-02-25","SF FuneralF1132052      250225","","126.5","","1188354.04"
"2025-02-28","2025-02-25","SF FuneralFDC0000000Q701250225","","126.5","","1188480.54"
"2025-02-28","2025-02-25","SF FuneralF1132197      250225","","126.5","","1188607.04"
"2025-02-28","2025-02-25","SF FuneralF1132235      250225","","126.5","","1188733.54"
"2025-02-28","2025-02-25","SF FuneralF1132246      250225","","126.5","","1188860.04"
"2025-02-28","2025-02-25","SF FuneralF1132280      250225","","126.5","","1188986.54"
"2025-02-28","2025-02-25","SF FuneralF1132292      250225","","126.5","","1189113.04"
"2025-02-28","2025-02-25","SF FuneralF1132357      250225","","126.5","","1189239.54"
"2025-02-28","2025-02-25","SF FuneralF1132364      250225","","126.5","","1189366.04"
"2025-02-28","2025-02-25","SF FuneralF1132377      250225","","126.5","","1189492.54"
"2025-02-28","2025-02-25","SF FuneralFDC0000000Q8DY250225","","126.5","","1189619.04"
"2025-02-28","2025-02-25","SF FuneralF1132417      250225","","126.5","","1189745.54"
"2025-02-28","2025-02-25","SF FuneralF1132463      250225","","126.5","","1189872.04"
"2025-02-28","2025-02-25","SF FuneralF1132902      250225","","126.5","","1189998.54"
"2025-02-28","2025-02-28","SF FuneralFDC0000000PSD4250228","","126.5","","1190125.04"
"2025-02-28","2025-02-28","SF FuneralF1127816      250228","","126.5","","1190251.54"
"2025-02-28","2025-02-28","SF FuneralF1127820      250228","","126.5","","1190378.04"
"2025-02-28","2025-02-28","SF FuneralF1127849      250228","","126.5","","1190504.54"
"2025-02-28","2025-02-28","SF FuneralF1127854      250228","","126.5","","1190631.04"
"2025-02-28","2025-02-28","SF FuneralF1127853      250228","","126.5","","1190757.54"
"2025-02-28","2025-02-28","SF FuneralF1127930      250228","","126.5","","1190884.04"
"2025-02-28","2025-02-28","SF FuneralFDC0000000PWBC250228","","126.5","","1191010.54"
"2025-02-28","2025-02-28","SF FuneralF1128870      250228","","126.5","","1191137.04"
"2025-02-28","2025-02-28","SF FuneralF1128875      250228","","126.5","","1191263.54"
"2025-02-28","2025-02-28","SF FuneralF1128909      250228","","126.5","","1191390.04"
"2025-02-28","2025-02-28","SF FuneralF1129311      250228","","126.5","","1191516.54"
"2025-02-28","2025-02-28","SF FuneralF1129318      250228","","126.5","","1191643.04"
"2025-02-28","2025-02-28","SF FuneralF1129363      250228","","126.5","","1191769.54"
"2025-02-28","2025-02-28","SF FuneralFDC0000000PZPX250228","","126.5","","1191896.04"
"2025-02-28","2025-02-27","SF FuneralFDC00000002XV8250227","","220","","1192116.04"
"2025-02-28","2025-02-27","SF FuneralFDC00000003219250227","","220","","1192336.04"
"2025-02-28","2025-02-27","SF FuneralFDC000000032C0250227","","220","","1192556.04"
"2025-02-28","2025-02-27","SF FuneralFDC000000032G9250227","","220","","1192776.04"
"2025-02-28","2025-02-27","SF FuneralFDC000000032PX250227","","220","","1192996.04"
"2025-02-28","2025-02-27","SF FuneralFDC00000003307250227","","220","","1193216.04"
"2025-02-28","2025-02-27","SF FuneralFDC000000033GX250227","","220","","1193436.04"
"2025-02-28","2025-02-27","SF FuneralFDC0000000351X250227","","220","","1193656.04"
"2025-02-28","2025-02-27","SF FuneralFDC00000003CY8250227","","220","","1193876.04"
"2025-02-28","2025-02-27","SF FuneralFDC00000003K0N250227","","220","","1194096.04"
"2025-02-28","2025-02-27","SF FuneralFDC00000003ML6250227","","220","","1194316.04"
"2025-02-28","2025-02-27","SF FuneralFDC00000004BXQ250227","","220","","1194536.04"
"2025-02-28","2025-02-27","SF FuneralFDC000000057NX250227","","220","","1194756.04"
"2025-02-28","2025-02-27","SF FuneralFDC000000057XC250227","","126.5","","1194882.54"
"2025-02-28","2025-02-27","SF FuneralFDC000000058VQ250227","","126","","1195008.54"
"2025-02-28","2025-02-27","SF FuneralFDC00000005DV8250227","","126.5","","1195135.04"
"2025-02-28","2025-02-27","SF FuneralFDC00000005LWD250227","","126.5","","1195261.54"
"2025-02-28","2025-02-27","SF FuneralFDC00000005M0W250227","","126.5","","1195388.04"
"2025-02-28","2025-02-27","SF FuneralFDC00000005M1B250227","","126.5","","1195514.54"
"2025-02-28","2025-02-27","SF FuneralFDC00000005MRT250227","","126.5","","1195641.04"
"2025-02-28","2025-02-27","SF FuneralFDC00000005MXC250227","","126.5","","1195767.54"
"2025-02-28","2025-02-27","SF FuneralFDC00000005P86250227","","126.5","","1195894.04"
"2025-02-28","2025-02-27","SF FuneralFDC00000005WZQ250227","","126.5","","1196020.54"
"2025-02-28","2025-02-27","SF FuneralFDC00000005ZTP250227","","126.5","","1196147.04"
"2025-02-28","2025-02-27","SF FuneralFDC000000065JT250227","","126.5","","1196273.54"
"2025-02-28","2025-02-27","SF FuneralFDC000000065L1250227","","126.5","","1196400.04"
"2025-02-28","2025-02-27","SF FuneralFDC000000065P9250227","","126.5","","1196526.54"
"2025-02-28","2025-02-27","SF FuneralFDC000000065RQ250227","","126.5","","1196653.04"
"2025-02-28","2025-02-27","SF FuneralFDC000000065RY250227","","126.5","","1196779.54"
"2025-02-28","2025-02-27","SF FuneralFDC00000006615250227","","126.5","","1196906.04"
"2025-02-28","2025-02-27","SF FuneralFDC000000066GF250227","","126.5","","1197032.54"
"2025-02-28","2025-02-27","SF FuneralFDC000000066HR250227","","126.5","","1197159.04"
"2025-02-28","2025-02-27","SF FuneralFDC000000066SJ250227","","126.5","","1197285.54"
"2025-02-28","2025-02-27","SF FuneralFDC0000000670D250227","","126.5","","1197412.04"
"2025-02-28","2025-02-27","SF FuneralFDC0000000671W250227","","126.5","","1197538.54"
"2025-02-28","2025-02-27","SF FuneralFDC00000006B5S250227","","126.5","","1197665.04"
"2025-02-28","2025-02-27","SF FuneralFDC00000006D4Q250227","","126.5","","1197791.54"
"2025-02-28","2025-02-27","SF FuneralFDC00000006JJ4250227","","126.5","","1197918.04"
"2025-02-28","2025-02-27","SF FuneralFDC00000006KJN250227","","126.5","","1198044.54"
"2025-02-28","2025-02-27","SF FuneralFDC00000006KKC250227","","126.5","","1198171.04"
"2025-02-28","2025-02-27","SF FuneralFDC00000006VQP250227","","126.5","","1198297.54"
"2025-02-28","2025-02-27","SF FuneralFDC00000006W6Q250227","","126.5","","1198424.04"
"2025-02-28","2025-02-27","SF FuneralFDC00000006W74250227","","126.5","","1198550.54"
"2025-02-28","2025-02-27","SF FuneralFDC000000073RH250227","","126.5","","1198677.04"
"2025-02-28","2025-02-27","SF FuneralF797873       250227","","126.5","","1198803.54"
"2025-02-28","2025-02-27","SF FuneralFDC000000089FT250227","","126.5","","1198930.04"
"2025-02-28","2025-02-27","SF FuneralFDC00000008CZV250227","","126.5","","1199056.54"
"2025-02-28","2025-02-27","SF FuneralF802237       250227","","126.5","","1199183.04"
"2025-02-28","2025-02-27","SF FuneralFDC00000008K09250227","","126.5","","1199309.54"
"2025-02-28","2025-02-27","SF FuneralFDC00000008LZ1250227","","126.5","","1199436.04"
"2025-02-28","2025-02-27","SF FuneralF803758       250227","","126.5","","1199562.54"
"2025-02-28","2025-02-27","SF FuneralF803853       250227","","126.5","","1199689.04"
"2025-02-28","2025-02-27","SF FuneralF803986       250227","","126.5","","1199815.54"
"2025-02-28","2025-02-27","SF FuneralFDC00000008QWP250227","","126.5","","1199942.04"
"2025-02-28","2025-02-27","SF FuneralFDC00000008RHL250227","","126.5","","1200068.54"
"2025-02-28","2025-02-27","SF FuneralF805825       250227","","126.5","","1200195.04"
"2025-02-28","2025-02-27","SF FuneralF805967       250227","","126.5","","1200321.54"
"2025-02-28","2025-02-27","SF FuneralF808632       250227","","126.5","","1200448.04"
"2025-02-28","2025-02-27","SF FuneralF809200       250227","","126.5","","1200574.54"
"2025-02-28","2025-02-27","SF FuneralF809224       250227","","126.5","","1200701.04"
"2025-02-28","2025-02-27","SF FuneralF811858       250227","","126.5","","1200827.54"
"2025-02-28","2025-02-27","SF FuneralF811927       250227","","126.5","","1200954.04"
"2025-02-28","2025-02-27","SF FuneralF811976       250227","","126.5","","1201080.54"
"2025-02-28","2025-02-27","SF FuneralF796462       250227","","126.5","","1201207.04"
"2025-02-28","2025-02-27","SF FuneralF812072       250227","","126.5","","1201333.54"
"2025-02-28","2025-02-27","SF FuneralFDC00000009DZL250227","","126.5","","1201460.04"
"2025-02-28","2025-02-27","SF FuneralF813053       250227","","126.5","","1201586.54"
"2025-02-28","2025-02-27","SF FuneralF813185       250227","","126.5","","1201713.04"
"2025-02-28","2025-02-27","SF FuneralF813261       250227","","126.5","","1201839.54"
"2025-02-28","2025-02-27","SF FuneralF813534       250227","","126.5","","1201966.04"
"2025-02-28","2025-02-27","SF FuneralF813584       250227","","126.5","","1202092.54"
"2025-02-28","2025-02-27","SF FuneralF813673       250227","","126.5","","1202219.04"
"2025-02-28","2025-02-27","SF FuneralF813806       250227","","126.5","","1202345.54"
"2025-02-28","2025-02-27","SF FuneralF813999       250227","","126.5","","1202472.04"
"2025-02-28","2025-02-27","SF FuneralF814104       250227","","126.5","","1202598.54"
"2025-02-28","2025-02-27","SF FuneralF814446       250227","","126.5","","1202725.04"
"2025-02-28","2025-02-27","SF FuneralF816045       250227","","126.5","","1202851.54"
"2025-02-28","2025-02-27","SF FuneralF817038       250227","","126.5","","1202978.04"
"2025-02-28","2025-02-27","SF FuneralF817505       250227","","126.5","","1203104.54"
"2025-02-28","2025-02-27","SF FuneralF817862       250227","","126.5","","1203231.04"
"2025-02-28","2025-02-27","SF FuneralF821741       250227","","126.5","","1203357.54"
"2025-02-28","2025-02-27","SF FuneralFDC0000000BFNQ250227","","126.5","","1203484.04"
"2025-02-28","2025-02-27","SF FuneralF822385       250227","","126.5","","1203610.54"
"2025-02-28","2025-02-27","SF FuneralF823986       250227","","126.5","","1203737.04"
"2025-02-28","2025-02-27","SF FuneralF824553       250227","","263.2","","1204000.24"
"2025-02-28","2025-02-27","SF FuneralF825178       250227","","126.5","","1204126.74"
"2025-02-28","2025-02-27","SF FuneralF827646       250227","","126.5","","1204253.24"
"2025-02-28","2025-02-27","SF FuneralF827773       250227","","126.5","","1204379.74"
"2025-02-28","2025-02-27","SF FuneralF827782       250227","","126.5","","1204506.24"
"2025-02-28","2025-02-27","SF FuneralFDC0000000BNK6250227","","126.5","","1204632.74"
"2025-02-28","2025-02-27","SF FuneralFDC0000000BP0W250227","","126.5","","1204759.24"
"2025-02-28","2025-02-27","SF FuneralFDC0000000BP51250227","","126.5","","1204885.74"
"2025-02-28","2025-02-27","SF FuneralF828449       250227","","126.5","","1205012.24"
"2025-02-28","2025-02-27","SF FuneralF828807       250227","","126.5","","1205138.74"
"2025-02-28","2025-02-27","SF FuneralF829532       250227","","126.5","","1205265.24"
"2025-02-28","2025-02-27","SF FuneralF829767       250227","","126.5","","1205391.74"
"2025-02-28","2025-02-27","SF FuneralF830039       250227","","126.5","","1205518.24"
"2025-02-28","2025-02-27","SF FuneralF830958       250227","","126.5","","1205644.74"
"2025-02-28","2025-02-27","SF FuneralF832111       250227","","126.5","","1205771.24"
"2025-02-28","2025-02-27","SF FuneralF838814       250227","","126.5","","1205897.74"
"2025-02-28","2025-02-27","SF FuneralF840731       250227","","126.5","","1206024.24"
"2025-02-28","2025-02-27","SF FuneralF841142       250227","","126.5","","1206150.74"
"2025-02-28","2025-02-27","SF FuneralFDC0000000DXX0250227","","126.5","","1206277.24"
"2025-02-28","2025-02-27","SF FuneralF841521       250227","","126.5","","1206403.74"
"2025-02-28","2025-02-27","SF FuneralF842390       250227","","126.5","","1206530.24"
"2025-02-28","2025-02-27","SF FuneralF842672       250227","","126.5","","1206656.74"
"2025-02-28","2025-02-27","SF FuneralF842789       250227","","126.5","","1206783.24"
"2025-02-28","2025-02-27","SF FuneralF842820       250227","","126.5","","1206909.74"
"2025-02-28","2025-02-27","SF FuneralF843098       250227","","126.5","","1207036.24"
"2025-02-28","2025-02-27","SF FuneralF843738       250227","","126.5","","1207162.74"
"2025-02-28","2025-02-27","SF FuneralF901222       250227","","126.5","","1207289.24"
"2025-02-28","2025-02-27","SF FuneralF981052       250227","","126.5","","1207415.74"
"2025-02-28","2025-02-27","SF FuneralF981836       250227","","126.5","","1207542.24"
"2025-02-28","2025-02-27","SF FuneralF986670       250227","","126.5","","1207668.74"
"2025-02-28","2025-02-27","SF FuneralF987799       250227","","126.5","","1207795.24"
"2025-02-28","2025-02-27","SF FuneralFDC0000000JG82250227","","126.5","","1207921.74"
"2025-02-28","2025-02-27","SF FuneralF1016881      250227","","126.5","","1208048.24"
"2025-02-28","2025-02-27","SF FuneralF1017539      250227","","191.5","","1208239.74"
"2025-02-28","2025-02-27","SF FuneralF1020939      250227","","126.5","","1208366.24"
"2025-02-28","2025-02-27","SF FuneralF1021170      250227","","126.5","","1208492.74"
"2025-02-28","2025-02-27","SF FuneralF1052054      250227","","126.5","","1208619.24"
"2025-02-28","2025-02-27","SF FuneralFDC0000000K1GY250227","","126.5","","1208745.74"
"2025-02-28","2025-02-27","SF FuneralF1052777      250227","","126.5","","1208872.24"
"2025-02-28","2025-02-27","SF FuneralF1055055      250227","","126.5","","1208998.74"
"2025-02-28","2025-02-27","SF FuneralF1055099      250227","","126.5","","1209125.24"
"2025-02-28","2025-02-27","SF FuneralF1055103      250227","","126.5","","1209251.74"
"2025-02-28","2025-02-27","SF FuneralF1055129      250227","","126.5","","1209378.24"
"2025-02-28","2025-02-27","SF FuneralF1055165      250227","","126.5","","1209504.74"
"2025-02-28","2025-02-27","SF FuneralFDC0000000K80H250227","","126.5","","1209631.24"
"2025-02-28","2025-02-27","SF FuneralF1055189      250227","","126.5","","1209757.74"
"2025-02-28","2025-02-27","SF FuneralF1055199      250227","","126.5","","1209884.24"
"2025-02-28","2025-02-27","SF FuneralF1055213      250227","","126.5","","1210010.74"
"2025-02-28","2025-02-27","SF FuneralF1055293      250227","","126.5","","1210137.24"
"2025-02-28","2025-02-27","SF FuneralF1058620      250227","","126.5","","1210263.74"
"2025-02-28","2025-02-27","SF FuneralF1058672      250227","","126.5","","1210390.24"
"2025-02-28","2025-02-27","SF FuneralF1059330      250227","","126.5","","1210516.74"
"2025-02-28","2025-02-27","SF FuneralF1059710      250227","","126.5","","1210643.24"
"2025-02-28","2025-02-27","SF FuneralF1059833      250227","","126.5","","1210769.74"
"2025-02-28","2025-02-27","SF FuneralFDC0000000KDW5250227","","126.5","","1210896.24"
"2025-02-28","2025-02-27","SF FuneralFDC0000000KFLJ250227","","256.5","","1211152.74"
"2025-02-28","2025-02-27","SF FuneralFDC0000000KJWG250227","","126.5","","1211279.24"
"2025-02-28","2025-02-27","SF FuneralF1062684      250227","","126.5","","1211405.74"
"2025-02-28","2025-02-27","SF FuneralFDC0000000KW00250227","","126.5","","1211532.24"
"2025-02-28","2025-02-27","SF FuneralF1066546      250227","","126.5","","1211658.74"
"2025-02-28","2025-02-27","SF FuneralF1073543      250227","","126.5","","1211785.24"
"2025-02-28","2025-02-27","SF FuneralF1073697      250227","","126.5","","1211911.74"
"2025-02-28","2025-02-27","SF FuneralF1074676      250227","","126.5","","1212038.24"
"2025-02-28","2025-02-27","SF FuneralF1074712      250227","","126.5","","1212164.74"
"2025-02-28","2025-02-27","SF FuneralF1074792      250227","","126.5","","1212291.24"
"2025-02-28","2025-02-27","SF FuneralF1074824      250227","","126.5","","1212417.74"
"2025-02-28","2025-02-27","SF FuneralF1074928      250227","","126.5","","1212544.24"
"2025-02-28","2025-02-27","SF FuneralF1078436      250227","","126.5","","1212670.74"
"2025-02-28","2025-02-27","SF FuneralF1078883      250227","","126.5","","1212797.24"
"2025-02-28","2025-02-27","SF FuneralF1079001      250227","","126.5","","1212923.74"
"2025-02-28","2025-02-27","SF FuneralF1079698      250227","","126.5","","1213050.24"
"2025-02-28","2025-02-27","SF FuneralF1080219      250227","","126.5","","1213176.74"
"2025-02-28","2025-02-27","SF FuneralFDC0000000LNK4250227","","126.5","","1213303.24"
"2025-02-28","2025-02-27","SF FuneralFDC0000000LS81250227","","126.5","","1213429.74"
"2025-02-28","2025-02-27","SF FuneralF1108571      250227","","126.5","","1213556.24"
"2025-02-28","2025-02-27","SF FuneralF1108677      250227","","126.5","","1213682.74"
"2025-02-28","2025-02-27","SF FuneralF1108680      250227","","126.5","","1213809.24"
"2025-02-28","2025-02-27","SF FuneralF1108966      250227","","126.5","","1213935.74"
"2025-02-28","2025-02-27","SF FuneralF1109603      250227","","126.5","","1214062.24"
"2025-02-28","2025-02-27","SF FuneralF1110517      250227","","126.5","","1214188.74"
"2025-02-28","2025-02-27","SF FuneralF1110817      250227","","63.25","","1214251.99"
"2025-02-28","2025-02-27","SF FuneralF1111585      250227","","126.5","","1214378.49"
"2025-02-28","2025-02-27","SF FuneralF1112352      250227","","126.5","","1214504.99"
"2025-02-28","2025-02-27","SF FuneralF1112405      250227","","126.5","","1214631.49"
"2025-02-28","2025-02-27","SF FuneralF1112486      250227","","126.5","","1214757.99"
"2025-02-28","2025-02-27","SF FuneralF1112541      250227","","126.5","","1214884.49"
"2025-02-28","2025-02-27","SF FuneralF1075060      250227","","126.5","","1215010.99"
"2025-02-28","2025-02-27","SF FuneralF1112553      250227","","126.5","","1215137.49"
"2025-02-28","2025-02-27","SF FuneralF1112566      250227","","126.5","","1215263.99"
"2025-02-28","2025-02-27","SF FuneralFDC0000000N3BK250227","","126.5","","1215390.49"
"2025-02-28","2025-02-27","SF FuneralF1113121      250227","","126.5","","1215516.99"
"2025-02-28","2025-02-27","SF FuneralF1113138      250227","","126.5","","1215643.49"
"2025-02-28","2025-02-27","SF FuneralFDC0000000N4F1250227","","126.5","","1215769.99"
"2025-02-28","2025-02-27","SF FuneralF1113279      250227","","126.5","","1215896.49"
"2025-02-28","2025-02-27","SF FuneralF1113293      250227","","126.5","","1216022.99"
"2025-02-28","2025-02-27","SF FuneralF1113552      250227","","126.5","","1216149.49"
"2025-02-28","2025-02-27","SF FuneralF1113634      250227","","126.5","","1216275.99"
"2025-02-28","2025-02-27","SF FuneralF1114148      250227","","126.5","","1216402.49"
"2025-02-28","2025-02-27","SF FuneralF1114605      250227","","126.5","","1216528.99"
"2025-02-28","2025-02-27","SF FuneralF1114848      250227","","126.5","","1216655.49"
"2025-02-28","2025-02-27","SF FuneralF1114931      250227","","126.5","","1216781.99"
"2025-02-28","2025-02-27","SF FuneralFDC0000000NBR0250227","","126.5","","1216908.49"
"2025-02-28","2025-02-27","SF FuneralF1116089      250227","","126.5","","1217034.99"
"2025-02-28","2025-02-27","SF FuneralF1116657      250227","","126.5","","1217161.49"
"2025-02-28","2025-02-27","SF FuneralF1116906      250227","","126.5","","1217287.99"
"2025-02-28","2025-02-27","SF FuneralFDC0000000NJ7F250227","","126.5","","1217414.49"
"2025-02-28","2025-02-27","SF FuneralFDC0000000NK7F250227","","126.5","","1217540.99"
"2025-02-28","2025-02-27","SF FuneralFDC0000000NKHH250227","","126.5","","1217667.49"
"2025-02-28","2025-02-27","SF FuneralF1118059      250227","","126.5","","1217793.99"
"2025-02-28","2025-02-27","SF FuneralF1120321      250227","","126.5","","1217920.49"
"2025-02-28","2025-02-27","SF FuneralF1120535      250227","","126.5","","1218046.99"
"2025-02-28","2025-02-27","SF FuneralF1120664      250227","","126.5","","1218173.49"
"2025-02-28","2025-02-27","SF FuneralF1120666      250227","","126.5","","1218299.99"
"2025-02-28","2025-02-27","SF FuneralF1120755      250227","","126.5","","1218426.49"
"2025-02-28","2025-02-27","SF FuneralF1120865      250227","","126.5","","1218552.99"
"2025-02-28","2025-02-27","SF FuneralF1120867      250227","","126.5","","1218679.49"
"2025-02-28","2025-02-27","SF FuneralF1120884      250227","","126.5","","1218805.99"
"2025-02-28","2025-02-27","SF FuneralF1120909      250227","","126.5","","1218932.49"
"2025-02-28","2025-02-27","SF FuneralFDC0000000NZTN250227","","126.5","","1219058.99"
"2025-02-28","2025-02-27","SF FuneralF1122070      250227","","126.5","","1219185.49"
"2025-02-28","2025-02-27","SF FuneralF1122275      250227","","126.5","","1219311.99"
"2025-02-28","2025-02-27","SF FuneralF1122315      250227","","126.5","","1219438.49"
"2025-02-28","2025-02-27","SF FuneralF1122612      250227","","126.5","","1219564.99"
"2025-02-28","2025-02-27","SF FuneralF1122700      250227","","126.5","","1219691.49"
"2025-02-28","2025-02-27","SF FuneralF1122732      250227","","126.5","","1219817.99"
"2025-02-28","2025-02-27","SF FuneralF1122933      250227","","126.5","","1219944.49"
"2025-02-28","2025-02-27","SF FuneralF1122969      250227","","126.5","","1220070.99"
"2025-02-28","2025-02-27","SF FuneralFDC0000000P2ZT250227","","126.5","","1220197.49"
"2025-02-28","2025-02-27","SF FuneralF1122999      250227","","126.5","","1220323.99"
"2025-02-28","2025-02-27","SF FuneralF1123208      250227","","126.5","","1220450.49"
"2025-02-28","2025-02-27","SF FuneralF1123263      250227","","126.5","","1220576.99"
"2025-02-28","2025-02-27","SF FuneralF1123412      250227","","126.5","","1220703.49"
"2025-02-28","2025-02-27","SF FuneralFDC0000000P4Y5250227","","126.5","","1220829.99"
"2025-02-28","2025-02-27","SF FuneralF1123552      250227","","126.5","","1220956.49"
"2025-02-28","2025-02-27","SF FuneralF1123612      250227","","126.5","","1221082.99"
"2025-02-28","2025-02-27","SF FuneralF1123913      250227","","126.5","","1221209.49"
"2025-02-28","2025-02-27","SF FuneralF1123955      250227","","126.5","","1221335.99"
"2025-02-28","2025-02-27","SF FuneralF1124176      250227","","126.5","","1221462.49"
"2025-02-28","2025-02-27","SF FuneralF1125409      250227","","126.5","","1221588.99"
"2025-02-28","2025-02-27","SF FuneralF1125428      250227","","126.5","","1221715.49"
"2025-02-28","2025-02-27","SF FuneralFDC0000000PH8C250227","","126.5","","1221841.99"
"2025-02-28","2025-02-27","SF FuneralFDC0000000PH8H250227","","126.5","","1221968.49"
"2025-02-28","2025-02-27","SF FuneralF1126118      250227","","126.5","","1222094.99"
"2025-02-28","2025-02-27","SF FuneralFDC0000000PL45250227","","126.5","","1222221.49"
"2025-02-28","2025-02-27","SF FuneralFDC0000000PXMF250227","","126.5","","1222347.99"
"2025-02-28","2025-02-27","SF FuneralFDC0000000PXMK250227","","126.5","","1222474.49"
"2025-02-28","2025-02-27","SF FuneralFDC0000000PXMP250227","","126.5","","1222600.99"
"2025-02-28","2025-02-27","SF FuneralF1129141      250227","","126.5","","1222727.49"
"2025-02-28","2025-02-28","SF FuneralFDC00000002RBG250228","","220","","1222947.49"
"2025-02-28","2025-02-28","SF FuneralFDC00000002TX8250228","","220","","1223167.49"
"2025-02-28","2025-02-28","SF FuneralFDC00000002TYK250228","","220","","1223387.49"
"2025-02-28","2025-02-28","SF FuneralFDC00000002WRT250228","","220","","1223607.49"
"2025-02-28","2025-02-28","SF FuneralFDC00000002Z0H250228","","220","","1223827.49"
"2025-02-28","2025-02-28","SF FuneralFDC0000000347H250228","","220","","1224047.49"
"2025-02-28","2025-02-28","SF FuneralFDC0000000347L250228","","220","","1224267.49"
"2025-02-28","2025-02-28","SF FuneralFDC000000035X1250228","","220","","1224487.49"
"2025-02-28","2025-02-28","SF FuneralFDC00000004ZSB250228","","220","","1224707.49"
"2025-02-28","2025-02-28","SF FuneralFDC000000051JT250228","","220","","1224927.49"
"2025-02-28","2025-02-28","SF FuneralFDC000000057WC250228","","126.5","","1225053.99"
"2025-02-28","2025-02-28","SF FuneralFDC00000005DKN250228","","126.5","","1225180.49"
"2025-02-28","2025-02-28","SF FuneralFDC00000005DZJ250228","","126.5","","1225306.99"
"2025-02-28","2025-02-28","SF FuneralFDC00000005H9H250228","","220","","1225526.99"
"2025-02-28","2025-02-28","SF FuneralFDC00000005HG0250228","","126.5","","1225653.49"
"2025-02-28","2025-02-28","SF FuneralFDC00000005MG9250228","","126.5","","1225779.99"
"2025-02-28","2025-02-28","SF FuneralFDC00000005MRB250228","","126.5","","1225906.49"
"2025-02-28","2025-02-28","SF FuneralFDC00000005N21250228","","126.5","","1226032.99"
"2025-02-28","2025-02-28","SF FuneralFDC00000005Q4G250228","","126.5","","1226159.49"
"2025-02-28","2025-02-28","SF FuneralFDC00000005QKT250228","","126.5","","1226285.99"
"2025-02-28","2025-02-28","SF FuneralFDC00000005S6H250228","","126.5","","1226412.49"
"2025-02-28","2025-02-28","SF FuneralFDC00000005SHB250228","","126.5","","1226538.99"
"2025-02-28","2025-02-28","SF FuneralFDC00000005SMG250228","","126.5","","1226665.49"
"2025-02-28","2025-02-28","SF FuneralFDC00000005SV9250228","","220","","1226885.49"
"2025-02-28","2025-02-28","SF FuneralFDC00000005T5H250228","","220","","1227105.49"
"2025-02-28","2025-02-28","SF FuneralFDC00000005TMQ250228","","126.5","","1227231.99"
"2025-02-28","2025-02-28","SF FuneralFDC00000005V1Y250228","","126.5","","1227358.49"
"2025-02-28","2025-02-28","SF FuneralFDC00000005V4Q250228","","126.5","","1227484.99"
"2025-02-28","2025-02-28","SF FuneralFDC00000005VPK250228","","126.5","","1227611.49"
"2025-02-28","2025-02-28","SF FuneralFDC00000005W02250228","","126.5","","1227737.99"
"2025-02-28","2025-02-28","SF FuneralFDC00000005W0P250228","","126.5","","1227864.49"
"2025-02-28","2025-02-28","SF FuneralFDC00000005W6H250228","","126.5","","1227990.99"
"2025-02-28","2025-02-28","SF FuneralFDC00000005XCF250228","","220","","1228210.99"
"2025-02-28","2025-02-28","SF FuneralFDC00000005XG3250228","","126.5","","1228337.49"
"2025-02-28","2025-02-28","SF FuneralFDC00000005XGC250228","","126.5","","1228463.99"
"2025-02-28","2025-02-28","SF FuneralFDC00000005XRK250228","","126.5","","1228590.49"
"2025-02-28","2025-02-28","SF FuneralFDC000000062CK250228","","126.5","","1228716.99"
"2025-02-28","2025-02-28","SF FuneralFDC000000063HM250228","","126.5","","1228843.49"
"2025-02-28","2025-02-28","SF FuneralFDC000000063T7250228","","126.5","","1228969.99"
"2025-02-28","2025-02-28","SF FuneralFDC000000064KQ250228","","126.5","","1229096.49"
"2025-02-28","2025-02-28","SF FuneralFDC000000065HV250228","","126.5","","1229222.99"
"2025-02-28","2025-02-28","SF FuneralFDC000000065P3250228","","126.5","","1229349.49"
"2025-02-28","2025-02-28","SF FuneralFDC000000065WG250228","","220","","1229569.49"
"2025-02-28","2025-02-28","SF FuneralFDC000000065Z0250228","","126.5","","1229695.99"
"2025-02-28","2025-02-28","SF FuneralFDC000000066DQ250228","","126.5","","1229822.49"
"2025-02-28","2025-02-28","SF FuneralFDC000000066NX250228","","126.5","","1229948.99"
"2025-02-28","2025-02-28","SF FuneralFDC000000066T3250228","","126.5","","1230075.49"
"2025-02-28","2025-02-28","SF FuneralFDC000000067CL250228","","126.5","","1230201.99"
"2025-02-28","2025-02-28","SF FuneralFDC000000067FB250228","","126.5","","1230328.49"
"2025-02-28","2025-02-28","SF FuneralFDC000000067L0250228","","126.5","","1230454.99"
"2025-02-28","2025-02-28","SF FuneralFDC000000067PJ250228","","126.5","","1230581.49"
"2025-02-28","2025-02-28","SF FuneralFDC000000067RK250228","","126.5","","1230707.99"
"2025-02-28","2025-02-28","SF FuneralFDC0000000684V250228","","126.5","","1230834.49"
"2025-02-28","2025-02-28","SF FuneralFDC0000000687B250228","","126.5","","1230960.99"
"2025-02-28","2025-02-28","SF FuneralFDC000000068K8250228","","126.5","","1231087.49"
"2025-02-28","2025-02-28","SF FuneralFDC000000068NP250228","","126.5","","1231213.99"
"2025-02-28","2025-02-28","SF FuneralFDC000000069KD250228","","126.5","","1231340.49"
"2025-02-28","2025-02-28","SF FuneralFDC000000069RW250228","","126.5","","1231466.99"
"2025-02-28","2025-02-28","SF FuneralFDC000000069W3250228","","126.5","","1231593.49"
"2025-02-28","2025-02-28","SF FuneralFDC00000006BTS250228","","126.5","","1231719.99"
"2025-02-28","2025-02-28","SF FuneralFDC00000006CFC250228","","126.5","","1231846.49"
"2025-02-28","2025-02-28","SF FuneralFDC00000006CSH250228","","126.5","","1231972.99"
"2025-02-28","2025-02-28","SF FuneralFDC00000006DP9250228","","126.5","","1232099.49"
"2025-02-28","2025-02-28","SF FuneralFDC00000006FTZ250228","","126.5","","1232225.99"
"2025-02-28","2025-02-28","SF FuneralFDC00000006GJB250228","","126.5","","1232352.49"
"2025-02-28","2025-02-28","SF FuneralFDC00000006GY3250228","","126.5","","1232478.99"
"2025-02-28","2025-02-28","SF FuneralFDC00000006J0T250228","","126.5","","1232605.49"
"2025-02-28","2025-02-28","SF FuneralFDC00000006LM8250228","","126.5","","1232731.99"
"2025-02-28","2025-02-28","SF FuneralFDC00000006QZT250228","","126.5","","1232858.49"
"2025-02-28","2025-02-28","SF FuneralFDC00000006R8B250228","","126.5","","1232984.99"
"2025-02-28","2025-02-28","SF FuneralFDC00000006R8Z250228","","126.5","","1233111.49"
"2025-02-28","2025-02-28","SF FuneralFDC00000006RV8250228","","126.5","","1233237.99"
"2025-02-28","2025-02-28","SF FuneralFDC00000006RWX250228","","126.5","","1233364.49"
"2025-02-28","2025-02-28","SF FuneralFDC00000006WL2250228","","126.5","","1233490.99"
"2025-02-28","2025-02-28","SF FuneralFDC00000006X2F250228","","126.5","","1233617.49"
"2025-02-28","2025-02-28","SF FuneralFDC00000006Y7V250228","","220","","1233837.49"
"2025-02-28","2025-02-28","SF FuneralFDC00000006YD5250228","","126.5","","1233963.99"
"2025-02-28","2025-02-28","SF FuneralFDC00000006YXS250228","","126.5","","1234090.49"
"2025-02-28","2025-02-28","SF FuneralFDC00000006YY0250228","","126.5","","1234216.99"
"2025-02-28","2025-02-28","SF FuneralFDC000000075LJ250228","","126.5","","1234343.49"
"2025-02-28","2025-02-28","SF FuneralFDC000000077YT250228","","126.5","","1234469.99"
"2025-02-28","2025-02-28","SF FuneralFDC0000000787V250228","","126.5","","1234596.49"
"2025-02-28","2025-02-28","SF FuneralFDC000000078DX250228","","126.5","","1234722.99"
"2025-02-28","2025-02-28","SF FuneralFDC00000007974250228","","126.5","","1234849.49"
"2025-02-28","2025-02-28","SF FuneralFDC000000079C7250228","","126.5","","1234975.99"
"2025-02-28","2025-02-28","SF FuneralFDC00000007BGR250228","","126.5","","1235102.49"
"2025-02-28","2025-02-28","SF FuneralF798192       250228","","126.5","","1235228.99"
"2025-02-28","2025-02-28","SF FuneralF798755       250228","","126.5","","1235355.49"
"2025-02-28","2025-02-28","SF FuneralF798835       250228","","126.5","","1235481.99"
"2025-02-28","2025-02-28","SF FuneralF799850       250228","","126.5","","1235608.49"
"2025-02-28","2025-02-28","SF FuneralF799934       250228","","126.5","","1235734.99"
"2025-02-28","2025-02-28","SF FuneralFDC000000089KV250228","","126.5","","1235861.49"
"2025-02-28","2025-02-28","SF FuneralF800693       250228","","126.5","","1235987.99"
"2025-02-28","2025-02-28","SF FuneralFDC00000008CY5250228","","126.5","","1236114.49"
"2025-02-28","2025-02-28","SF FuneralFDC00000008CYQ250228","","126.5","","1236240.99"
"2025-02-28","2025-02-28","SF FuneralF802418       250228","","191.5","","1236432.49"
"2025-02-28","2025-02-28","SF FuneralFDC00000008KS1250228","","126.5","","1236558.99"
"2025-02-28","2025-02-28","SF FuneralFDC00000008TZM250228","","126.5","","1236685.49"
"2025-02-28","2025-02-28","SF FuneralF808337       250228","","126.5","","1236811.99"
"2025-02-28","2025-02-28","SF FuneralF808560       250228","","126.5","","1236938.49"
"2025-02-28","2025-02-28","SF FuneralF787800       250228","","126.5","","1237064.99"
"2025-02-28","2025-02-28","SF FuneralF809167       250228","","126.5","","1237191.49"
"2025-02-28","2025-02-28","SF FuneralF809556       250228","","126.5","","1237317.99"
"2025-02-28","2025-02-28","SF FuneralF809981       250228","","126.5","","1237444.49"
"2025-02-28","2025-02-28","SF FuneralF810187       250228","","126.5","","1237570.99"
"2025-02-28","2025-02-28","SF FuneralF813173       250228","","126.5","","1237697.49"
"2025-02-28","2025-02-28","SF FuneralFDC00000009HWN250228","","126.5","","1237823.99"
"2025-02-28","2025-02-28","SF FuneralF814574       250228","","126.5","","1237950.49"
"2025-02-28","2025-02-28","SF FuneralFDC00000009P9Q250228","","126.5","","1238076.99"
"2025-02-28","2025-02-28","SF FuneralF815818       250228","","126.5","","1238203.49"
"2025-02-28","2025-02-28","SF FuneralFDC00000009R09250228","","126.5","","1238329.99"
"2025-02-28","2025-02-28","SF FuneralF816011       250228","","126.5","","1238456.49"
"2025-02-28","2025-02-28","SF FuneralFDC00000009TGM250228","","126.5","","1238582.99"
"2025-02-28","2025-02-28","SF FuneralF816299       250228","","126.5","","1238709.49"
"2025-02-28","2025-02-28","SF FuneralF816350       250228","","126.5","","1238835.99"
"2025-02-28","2025-02-28","SF FuneralF816379       250228","","126.5","","1238962.49"
"2025-02-28","2025-02-28","SF FuneralF816407       250228","","126.5","","1239088.99"
"2025-02-28","2025-02-28","SF FuneralF816559       250228","","126.5","","1239215.49"
"2025-02-28","2025-02-28","SF FuneralF816836       250228","","126.5","","1239341.99"
"2025-02-28","2025-02-28","SF FuneralF817493       250228","","126.5","","1239468.49"
"2025-02-28","2025-02-28","SF FuneralF817829       250228","","126.5","","1239594.99"
"2025-02-28","2025-02-28","SF FuneralF818008       250228","","126.5","","1239721.49"
"2025-02-28","2025-02-28","SF FuneralF818537       250228","","126.5","","1239847.99"
"2025-02-28","2025-02-28","SF FuneralF819835       250228","","126.5","","1239974.49"
"2025-02-28","2025-02-28","SF FuneralF820139       250228","","126.5","","1240100.99"
"2025-02-28","2025-02-28","SF FuneralFDC0000000B89Y250228","","126.5","","1240227.49"
"2025-02-28","2025-02-28","SF FuneralF829758       250228","","126.5","","1240353.99"
"2025-02-28","2025-02-28","SF FuneralF830449       250228","","126.5","","1240480.49"
"2025-02-28","2025-02-28","SF FuneralF832095       250228","","126.5","","1240606.99"
"2025-02-28","2025-02-28","SF FuneralF832657       250228","","126.5","","1240733.49"
"2025-02-28","2025-02-28","SF FuneralF833844       250228","","126.5","","1240859.99"
"2025-02-28","2025-02-28","SF FuneralF834676       250228","","126.5","","1240986.49"
"2025-02-28","2025-02-28","SF FuneralF834679       250228","","126.5","","1241112.99"
"2025-02-28","2025-02-28","SF FuneralF842166       250228","","126.5","","1241239.49"
"2025-02-28","2025-02-28","SF FuneralF843435       250228","","126.5","","1241365.99"
"2025-02-28","2025-02-28","SF FuneralF843724       250228","","63.25","","1241429.24"
"2025-02-28","2025-02-28","SF FuneralF900691       250228","","126.5","","1241555.74"
"2025-02-28","2025-02-28","SF FuneralF901097       250301","","126.5","","1241682.24"
"2025-02-28","2025-02-28","SF FuneralF901099       250301","","126.5","","1241808.74"
"2025-02-28","2025-02-28","SF FuneralFDC0000000H5NQ250301","","126.5","","1241935.24"
"2025-02-28","2025-02-28","SF FuneralF981106       250228","","126.5","","1242061.74"
"2025-02-28","2025-02-28","SF FuneralF981351       250301","","126.5","","1242188.24"
"2025-02-28","2025-02-28","SF FuneralF981554       250301","","126.5","","1242314.74"
"2025-02-28","2025-02-28","SF FuneralF986881       250301","","126.5","","1242441.24"
"2025-02-28","2025-02-28","SF FuneralF987840       250301","","126.5","","1242567.74"
"2025-02-28","2025-02-28","SF FuneralF987921       250301","","126.5","","1242694.24"
"2025-02-28","2025-02-28","SF FuneralF988016       250301","","126.5","","1242820.74"
"2025-02-28","2025-02-28","SF FuneralF988072       250228","","126.5","","1242947.24"
"2025-02-28","2025-02-28","SF FuneralF988144       250301","","126.5","","1243073.74"
"2025-02-28","2025-02-28","SF FuneralF988159       250228","","126.5","","1243200.24"
"2025-02-28","2025-02-28","SF FuneralF988177       250301","","126.5","","1243326.74"
"2025-02-28","2025-02-28","SF FuneralF988257       250228","","126.5","","1243453.24"
"2025-02-28","2025-02-28","SF FuneralF988303       250301","","126.5","","1243579.74"
"2025-02-28","2025-02-28","SF FuneralF988407       250301","","126.5","","1243706.24"
"2025-02-28","2025-02-28","SF FuneralF988871       250228","","126.5","","1243832.74"
"2025-02-28","2025-02-28","SF FuneralF788642       250228","","126.5","","1243959.24"
"2025-02-28","2025-02-28","SF FuneralF989166       250228","","126.5","","1244085.74"
"2025-02-28","2025-02-28","SF FuneralF990158       250228","","126.5","","1244212.24"
"2025-02-28","2025-02-28","SF FuneralF990259       250228","","126.5","","1244338.74"
"2025-02-28","2025-02-28","SF FuneralF990444       250228","","126.5","","1244465.24"
"2025-02-28","2025-02-28","SF FuneralF990833       250228","","63.25","","1244528.49"
"2025-02-28","2025-02-28","SF FuneralF981762       250228","","126.5","","1244654.99"
"2025-02-28","2025-02-28","SF FuneralF1021287      250228","","126.5","","1244781.49"
"2025-02-28","2025-02-28","SF FuneralF1021329      250228","","126.5","","1244907.99"
"2025-02-28","2025-02-28","SF FuneralFDC0000000JWGS250228","","126.5","","1245034.49"
"2025-02-28","2025-02-28","SF FuneralF1033766      250228","","126.5","","1245160.99"
"2025-02-28","2025-02-28","SF FuneralF1050844      250228","","126.5","","1245287.49"
"2025-02-28","2025-02-28","SF FuneralF802366       250228","","126.5","","1245413.99"
"2025-02-28","2025-02-28","SF FuneralF1062690      250228","","126.5","","1245540.49"
"2025-02-28","2025-02-28","SF FuneralF1062730      250228","","126.5","","1245666.99"
"2025-02-28","2025-02-28","SF FuneralFDC0000000KRJN250228","","126.5","","1245793.49"
"2025-02-28","2025-02-28","SF FuneralFDC0000000KRM2250228","","126.5","","1245919.99"
"2025-02-28","2025-02-28","SF FuneralFDC0000000KS13250228","","126.5","","1246046.49"
"2025-02-28","2025-02-28","SF FuneralF1066047      250228","","256.5","","1246302.99"
"2025-02-28","2025-02-28","SF FuneralF1066136      250228","","126.5","","1246429.49"
"2025-02-28","2025-02-28","SF FuneralFDC0000000KTDL250228","","126.5","","1246555.99"
"2025-02-28","2025-02-28","SF FuneralF1066373      250228","","126.5","","1246682.49"
"2025-02-28","2025-02-28","SF FuneralF1066602      250228","","256.5","","1246938.99"
"2025-02-28","2025-02-28","SF FuneralFDC0000000KXPG250228","","126.5","","1247065.49"
"2025-02-28","2025-02-28","SF FuneralFDC0000000KY6L250228","","126.5","","1247191.99"
"2025-02-28","2025-02-28","SF FuneralF1068338      250228","","126.5","","1247318.49"
"2025-02-28","2025-02-28","SF FuneralF1072713      250228","","126.5","","1247444.99"
"2025-02-28","2025-02-28","SF FuneralF1072718      250228","","126.5","","1247571.49"
"2025-02-28","2025-02-28","SF FuneralFDC0000000L06D250228","","126.5","","1247697.99"
"2025-02-28","2025-02-28","SF FuneralFDC0000000L1M9250228","","126.5","","1247824.49"
"2025-02-28","2025-02-28","SF FuneralF1073165      250228","","126.5","","1247950.99"
"2025-02-28","2025-02-28","SF FuneralF1078508      250228","","126.5","","1248077.49"
"2025-02-28","2025-02-28","SF FuneralF1078703      250228","","126.5","","1248203.99"
"2025-02-28","2025-02-28","SF FuneralF1079814      250228","","126.5","","1248330.49"
"2025-02-28","2025-02-28","SF FuneralFDC0000000LN1H250228","","126.5","","1248456.99"
"2025-02-28","2025-02-28","SF FuneralF1080458      250228","","126.5","","1248583.49"
"2025-02-28","2025-02-28","SF FuneralFDC0000000LT4Y250228","","126.5","","1248709.99"
"2025-02-28","2025-02-28","SF FuneralFDC0000000LTTB250228","","126.5","","1248836.49"
"2025-02-28","2025-02-28","SF FuneralF1084161      250228","","126.5","","1248962.99"
"2025-02-28","2025-02-28","SF FuneralF1084548      250228","","126.5","","1249089.49"
"2025-02-28","2025-02-28","SF FuneralFDC0000000LX38250228","","126.5","","1249215.99"
"2025-02-28","2025-02-28","SF FuneralF1084689      250228","","126.5","","1249342.49"
"2025-02-28","2025-02-28","SF FuneralF1102885      250228","","126.5","","1249468.99"
"2025-02-28","2025-02-28","SF FuneralF1103593      250228","","126.5","","1249595.49"
"2025-02-28","2025-02-28","SF FuneralF1103630      250228","","126.5","","1249721.99"
"2025-02-28","2025-02-28","SF FuneralFDC0000000M6M1250228","","126.5","","1249848.49"
"2025-02-28","2025-02-28","SF FuneralFDC0000000M91K250228","","126.5","","1249974.99"
"2025-02-28","2025-02-28","SF FuneralF1108558      250228","","126.5","","1250101.49"
"2025-02-28","2025-02-28","SF FuneralF1108580      250228","","126.5","","1250227.99"
"2025-02-28","2025-02-28","SF FuneralF1108600      250228","","126.5","","1250354.49"
"2025-02-28","2025-02-28","SF FuneralF1108647      250228","","126.5","","1250480.99"
"2025-02-28","2025-02-28","SF FuneralF1108653      250228","","126.5","","1250607.49"
"2025-02-28","2025-02-28","SF FuneralF1108671      250228","","126.5","","1250733.99"
"2025-02-28","2025-02-28","SF FuneralF1108686      250228","","126.5","","1250860.49"
"2025-02-28","2025-02-28","SF FuneralF1108733      250228","","126.5","","1250986.99"
"2025-02-28","2025-02-28","SF FuneralFDC0000000MGRV250228","","126.5","","1251113.49"
"2025-02-28","2025-02-28","SF FuneralF1108772      250228","","126.5","","1251239.99"
"2025-02-28","2025-02-28","SF FuneralF1109691      250228","","126.5","","1251366.49"
"2025-02-28","2025-02-28","SF FuneralFDC0000000MNC2250228","","126.5","","1251492.99"
"2025-02-28","2025-02-28","SF FuneralF1110513      250228","","126.5","","1251619.49"
"2025-02-28","2025-02-28","SF FuneralF1110695      250228","","126.5","","1251745.99"
"2025-02-28","2025-02-28","SF FuneralF1111315      250228","","126.5","","1251872.49"
"2025-02-28","2025-02-28","SF FuneralFDC0000000MQNQ250228","","126.5","","1251998.99"
"2025-02-28","2025-02-28","SF FuneralF1114080      250228","","126.5","","1252125.49"
"2025-02-28","2025-02-28","SF FuneralF1116065      250228","","126.5","","1252251.99"
"2025-02-28","2025-02-28","SF FuneralF1113159      250228","","191.5","","1252443.49"
"2025-02-28","2025-02-28","SF FuneralFDC0000000NGZF250228","","126.5","","1252569.99"
"2025-02-28","2025-02-28","SF FuneralF1116749      250228","","126.5","","1252696.49"
"2025-02-28","2025-02-28","SF FuneralF1116924      250228","","126.5","","1252822.99"
"2025-02-28","2025-02-28","SF FuneralFDC0000000NJ68250228","","126.5","","1252949.49"
"2025-02-28","2025-02-28","SF FuneralF1117361      250228","","126.5","","1253075.99"
"2025-02-28","2025-02-28","SF FuneralF1117374      250228","","126.5","","1253202.49"
"2025-02-28","2025-02-28","SF FuneralF1117384      250228","","126.5","","1253328.99"
"2025-02-28","2025-02-28","SF FuneralF1117424      250228","","126.5","","1253455.49"
"2025-02-28","2025-02-28","SF FuneralF1117982      250228","","126.5","","1253581.99"
"2025-02-28","2025-02-28","SF FuneralF795240       250228","","126.5","","1253708.49"
"2025-02-28","2025-02-28","SF FuneralFDC0000000NN5J250228","","126.5","","1253834.99"
"2025-02-28","2025-02-28","SF FuneralF1118390      250228","","126.5","","1253961.49"
"2025-02-28","2025-02-28","SF FuneralF1118486      250228","","126.5","","1254087.99"
"2025-02-28","2025-02-28","SF FuneralFDC0000000NPHB250228","","126.5","","1254214.49"
"2025-02-28","2025-02-28","SF FuneralF1118861      250228","","126.5","","1254340.99"
"2025-02-28","2025-02-28","SF FuneralF1119023      250228","","126.5","","1254467.49"
"2025-02-28","2025-02-28","SF FuneralF1119032      250228","","126.5","","1254593.99"
"2025-02-28","2025-02-28","SF FuneralF1119869      250228","","126.5","","1254720.49"
"2025-02-28","2025-02-28","SF FuneralF1123173      250228","","126.5","","1254846.99"
"2025-02-28","2025-02-28","SF FuneralF1123982      250228","","126.5","","1254973.49"
"2025-02-28","2025-02-28","SF FuneralF1124617      250228","","126.5","","1255099.99"
"2025-02-28","2025-02-28","SF FuneralF1125016      250228","","126.5","","1255226.49"
"2025-02-28","2025-02-28","SF FuneralF1125081      250228","","126.5","","1255352.99"
"2025-02-28","2025-02-28","SF FuneralF1125132      250228","","126.5","","1255479.49"
"2025-02-28","2025-02-28","SF FuneralF1125137      250228","","126.5","","1255605.99"
"2025-02-28","2025-02-28","SF FuneralF1125300      250228","","126.5","","1255732.49"
"2025-02-28","2025-02-28","SF FuneralF1125420      250228","","126.5","","1255858.99"
"2025-02-28","2025-02-28","SF FuneralF1125798      250228","","126.5","","1255985.49"
"2025-02-28","2025-02-28","SF FuneralF1125938      250228","","126.5","","1256111.99"
"2025-02-28","2025-02-28","SF FuneralF1126251      250228","","126.5","","1256238.49"
"2025-02-28","2025-02-28","SF FuneralFDC0000000PL33250228","","126.5","","1256364.99"
"2025-02-28","2025-02-28","SF FuneralF1126302      250228","","126.5","","1256491.49"
"2025-02-28","2025-02-28","SF FuneralF1126831      250228","","126.5","","1256617.99"
"2025-02-28","2025-02-28","SF FuneralF1126856      250228","","126.5","","1256744.49"
"2025-02-28","2025-02-28","SF FuneralF796263       250228","","213.31","","1256957.8"
"2025-02-28","2025-02-28","SF FuneralF1126964      250228","","126.5","","1257084.3"
"2025-02-28","2025-02-28","SF FuneralF1127552      250228","","126.5","","1257210.8"
"2025-02-28","2025-02-28","SF FuneralFDC0000000PRVZ250228","","126.5","","1257337.3"
"2025-02-28","2025-02-28","SF FuneralFDC00000004015250228","","220","","1257557.3"
"2025-02-28","2025-02-28","SF FuneralFDC00000005RMM250228","","220","","1257777.3"
"2025-02-28","2025-02-28","SF FuneralFDC00000005RMX250228","","126.5","","1257903.8"
"2025-02-28","2025-02-28","SF FuneralFDC00000005X36250228","","126.5","","1258030.3"
"2025-02-28","2025-02-28","SF FuneralFDC00000005X3L250228","","220","","1258250.3"
"2025-02-28","2025-02-28","SF FuneralFDC0000000634Z250228","","126.5","","1258376.8"
"2025-02-28","2025-02-28","SF FuneralFDC000000067SK250228","","126.5","","1258503.3"
"2025-02-28","2025-02-28","SF FuneralFDC0000000687P250228","","126.5","","1258629.8"
"2025-02-28","2025-02-28","SF FuneralFDC000000068BH250228","","126.5","","1258756.3"
"2025-02-28","2025-02-28","SF FuneralFDC000000068DR250228","","126.5","","1258882.8"
"2025-02-28","2025-02-28","SF FuneralFDC000000068FF250228","","126.5","","1259009.3"
"2025-02-28","2025-02-28","SF FuneralFDC000000068GB250228","","126.5","","1259135.8"
"2025-02-28","2025-02-28","SF FuneralFDC000000069M7250228","","126.5","","1259262.3"
"2025-02-28","2025-02-28","SF FuneralFDC000000069N7250228","","126.5","","1259388.8"
"2025-02-28","2025-02-28","SF FuneralFDC000000069Q9250228","","126.5","","1259515.3"
"2025-02-28","2025-02-28","SF FuneralFDC00000006CK5250228","","126.5","","1259641.8"
"2025-02-28","2025-02-28","SF FuneralFDC00000006JT4250228","","126.5","","1259768.3"
"2025-02-28","2025-02-28","SF FuneralFDC00000006JY2250228","","126.5","","1259894.8"
"2025-02-28","2025-02-28","SF FuneralFDC00000006KHS250228","","126.5","","1260021.3"
"2025-02-28","2025-02-28","SF FuneralFDC00000006KQ7250228","","126.5","","1260147.8"
"2025-02-28","2025-02-28","SF FuneralFDC00000006KVT250228","","126.5","","1260274.3"
"2025-02-28","2025-02-28","SF FuneralFDC00000006KZR250228","","126.5","","1260400.8"
"2025-02-28","2025-02-28","SF FuneralFDC00000006MDK250228","","126.5","","1260527.3"
"2025-02-28","2025-02-28","SF FuneralFDC00000006MDP250228","","126.5","","1260653.8"
"2025-02-28","2025-02-28","SF FuneralFDC00000006MK0250228","","126.5","","1260780.3"
"2025-02-28","2025-02-28","SF FuneralFDC00000006MMV250228","","126.5","","1260906.8"
"2025-02-28","2025-02-28","SF FuneralFDC00000006NS2250228","","126.5","","1261033.3"
"2025-02-28","2025-02-28","SF FuneralFDC00000006TSZ250228","","126.5","","1261159.8"
"2025-02-28","2025-02-28","SF FuneralFDC00000006ZRR250228","","126.5","","1261286.3"
"2025-02-28","2025-02-28","SF FuneralFDC000000070D4250228","","126.5","","1261412.8"
"2025-02-28","2025-02-28","SF FuneralFDC0000000718K250228","","126.5","","1261539.3"
"2025-02-28","2025-02-28","SF FuneralFDC0000000718W250228","","126.5","","1261665.8"
"2025-02-28","2025-02-28","SF FuneralFDC000000073D2250228","","126.5","","1261792.3"
"2025-02-28","2025-02-28","SF FuneralFDC000000073RL250228","","126.5","","1261918.8"
"2025-02-28","2025-02-28","SF FuneralFDC000000073VJ250228","","126.5","","1262045.3"
"2025-02-28","2025-02-28","SF FuneralFDC0000000763Q250228","","126.5","","1262171.8"
"2025-02-28","2025-02-28","SF FuneralFDC0000000764B250228","","126.5","","1262298.3"
"2025-02-28","2025-02-28","SF FuneralFDC00000007684250228","","126.5","","1262424.8"
"2025-02-28","2025-02-28","SF FuneralFDC0000000768V250228","","126.5","","1262551.3"
"2025-02-28","2025-02-28","SF FuneralFDC00000007769250228","","126.5","","1262677.8"
"2025-02-28","2025-02-28","SF FuneralFDC000000077M9250228","","126.5","","1262804.3"
"2025-02-28","2025-02-28","SF FuneralFDC000000077MM250228","","126.5","","1262930.8"
"2025-02-28","2025-02-28","SF FuneralFDC000000079ZB250228","","126.5","","1263057.3"
"2025-02-28","2025-02-28","SF FuneralFDC00000007CLH250228","","126.5","","1263183.8"
"2025-02-28","2025-02-28","SF FuneralFDC00000007CLK250228","","126.5","","1263310.3"
"2025-02-28","2025-02-28","SF FuneralFDC00000007FZ5250228","","126.5","","1263436.8"
"2025-02-28","2025-02-28","SF FuneralFDC00000007NYN250228","","126.5","","1263563.3"
"2025-02-28","2025-02-28","SF FuneralF793709       250228","","126.5","","1263689.8"
"2025-02-28","2025-02-28","SF FuneralFDC00000007R4C250228","","126.5","","1263816.3"
"2025-02-28","2025-02-28","SF FuneralFDC00000007R7B250228","","126.5","","1263942.8"
"2025-02-28","2025-02-28","SF FuneralFDC00000007VM6250228","","126.5","","1264069.3"
"2025-02-28","2025-02-28","SF FuneralF796673       250228","","126.5","","1264195.8"
"2025-02-28","2025-02-28","SF FuneralFDC00000007ZQV250228","","126.5","","1264322.3"
"2025-02-28","2025-02-28","SF FuneralF797113       250228","","126.5","","1264448.8"
"2025-02-28","2025-02-28","SF FuneralFDC000000081KJ250228","","126.5","","1264575.3"
"2025-02-28","2025-02-28","SF FuneralFDC0000000823T250228","","126.5","","1264701.8"
"2025-02-28","2025-02-28","SF FuneralFDC0000000828T250228","","126.5","","1264828.3"
"2025-02-28","2025-02-28","SF FuneralFDC000000082KD250228","","126.5","","1264954.8"
"2025-02-28","2025-02-28","SF FuneralFDC000000083CD250228","","126.5","","1265081.3"
"2025-02-28","2025-02-28","SF FuneralFDC000000083GM250228","","126.5","","1265207.8"
"2025-02-28","2025-02-28","SF FuneralFDC000000083M9250228","","126.5","","1265334.3"
"2025-02-28","2025-02-28","SF FuneralFDC000000083RT250228","","126.5","","1265460.8"
"2025-02-28","2025-02-28","SF FuneralFDC000000088Q6250228","","126.5","","1265587.3"
"2025-02-28","2025-02-28","SF FuneralFDC000000088Q7250228","","126.5","","1265713.8"
"2025-02-28","2025-02-28","SF FuneralFDC00000008BLR250228","","126.5","","1265840.3"
"2025-02-28","2025-02-28","SF FuneralF801420       250228","","126.5","","1265966.8"
"2025-02-28","2025-02-28","SF FuneralF803094       250228","","126.5","","1266093.3"
"2025-02-28","2025-02-28","SF FuneralF803213       250228","","126.5","","1266219.8"
"2025-02-28","2025-02-28","SF FuneralFDC00000008PPZ250228","","126.5","","1266346.3"
"2025-02-28","2025-02-28","SF FuneralFDC00000008PQ0250228","","126.5","","1266472.8"
"2025-02-28","2025-02-28","SF FuneralFDC00000008PQ1250228","","126.5","","1266599.3"
"2025-02-28","2025-02-28","SF FuneralFDC00000008W79250228","","126.5","","1266725.8"
"2025-02-28","2025-02-28","SF FuneralFDC00000008W95250228","","126.5","","1266852.3"
"2025-02-28","2025-02-28","SF FuneralF806002       250228","","126.5","","1266978.8"
"2025-02-28","2025-02-28","SF FuneralF808133       250228","","126.5","","1267105.3"
"2025-02-28","2025-02-28","SF FuneralFDC00000008Z2L250228","","126.5","","1267231.8"
"2025-02-28","2025-02-28","SF FuneralF808784       250228","","126.5","","1267358.3"
"2025-02-28","2025-02-28","SF FuneralF808952       250228","","126.5","","1267484.8"
"2025-02-28","2025-02-28","SF FuneralF809024       250228","","126.5","","1267611.3"
"2025-02-28","2025-02-28","SF FuneralF809743       250228","","126.5","","1267737.8"
"2025-02-28","2025-02-28","SF FuneralF809852       250228","","126.5","","1267864.3"
"2025-02-28","2025-02-28","SF FuneralF809909       250228","","126.5","","1267990.8"
"2025-02-28","2025-02-28","SF FuneralF810517       250228","","126.5","","1268117.3"
"2025-02-28","2025-02-28","SF FuneralFDC000000096RC250228","","126.5","","1268243.8"
"2025-02-28","2025-02-28","SF FuneralFDC0000000972P250228","","126.5","","1268370.3"
"2025-02-28","2025-02-28","SF FuneralFDC00000009C5X250228","","126.5","","1268496.8"
"2025-02-28","2025-02-28","SF FuneralF815922       250228","","126.5","","1268623.3"
"2025-02-28","2025-02-28","SF FuneralF815954       250228","","126.5","","1268749.8"
"2025-02-28","2025-02-28","SF FuneralFDC00000009R05250228","","126.5","","1268876.3"
"2025-02-28","2025-02-28","SF FuneralF817444       250228","","126.5","","1269002.8"
"2025-02-28","2025-02-28","SF FuneralF818385       250228","","126.5","","1269129.3"
"2025-02-28","2025-02-28","SF FuneralF818846       250228","","126.5","","1269255.8"
"2025-02-28","2025-02-28","SF FuneralF819116       250228","","63.25","","1269319.05"
"2025-02-28","2025-02-28","SF FuneralF819216       250228","","126.5","","1269445.55"
"2025-02-28","2025-02-28","SF FuneralF819861       250228","","126.5","","1269572.05"
"2025-02-28","2025-02-28","SF FuneralFDC0000000B662250228","","126.5","","1269698.55"
"2025-02-28","2025-02-28","SF FuneralF819984       250228","","126.5","","1269825.05"
"2025-02-28","2025-02-28","SF FuneralF820024       250228","","126.5","","1269951.55"
"2025-02-28","2025-02-28","SF FuneralF820100       250228","","126.5","","1270078.05"
"2025-02-28","2025-02-28","SF FuneralF820462       250228","","126.5","","1270204.55"
"2025-02-28","2025-02-28","SF FuneralFDC0000000B8LB250228","","126.5","","1270331.05"
"2025-02-28","2025-02-28","SF FuneralFDC0000000B8MC250228","","126.5","","1270457.55"
"2025-02-28","2025-02-28","SF FuneralF820816       250228","","126.5","","1270584.05"
"2025-02-28","2025-02-28","SF FuneralF820825       250228","","126.5","","1270710.55"
"2025-02-28","2025-02-28","SF FuneralF821028       250228","","126.5","","1270837.05"
"2025-02-28","2025-02-28","SF FuneralF821213       250228","","126.5","","1270963.55"
"2025-02-28","2025-02-28","SF FuneralF821514       250228","","126.5","","1271090.05"
"2025-02-28","2025-02-28","SF FuneralF821760       250228","","126.5","","1271216.55"
"2025-02-28","2025-02-28","SF FuneralF822536       250228","","126.5","","1271343.05"
"2025-02-28","2025-02-28","SF FuneralF822558       250228","","126.5","","1271469.55"
"2025-02-28","2025-02-28","SF FuneralF823032       250228","","126.5","","1271596.05"
"2025-02-28","2025-02-28","SF FuneralF831940       250228","","126.5","","1271722.55"
"2025-02-28","2025-02-28","SF FuneralF832869       250228","","126.5","","1271849.05"
"2025-02-28","2025-02-28","SF FuneralF833074       250228","","126.5","","1271975.55"
"2025-02-28","2025-02-28","SF FuneralFDC0000000CRTH250228","","126.5","","1272102.05"
"2025-02-28","2025-02-28","SF FuneralFDC0000000CRTK250228","","126.5","","1272228.55"
"2025-02-28","2025-02-28","SF FuneralFDC0000000CS3N250228","","126.5","","1272355.05"
"2025-02-28","2025-02-28","SF FuneralF833448       250228","","126.5","","1272481.55"
"2025-02-28","2025-02-28","SF FuneralF833485       250228","","126.5","","1272608.05"
"2025-02-28","2025-02-28","SF FuneralF833644       250228","","126.5","","1272734.55"
"2025-02-28","2025-02-28","SF FuneralF833681       250228","","126.5","","1272861.05"
"2025-02-28","2025-02-28","SF FuneralFDC0000000CV8Z250228","","126.5","","1272987.55"
"2025-02-28","2025-02-28","SF FuneralF834122       250228","","126.5","","1273114.05"
"2025-02-28","2025-02-28","SF FuneralF834365       250228","","126.5","","1273240.55"
"2025-02-28","2025-02-28","SF FuneralF834926       250228","","126.5","","1273367.05"
"2025-02-28","2025-02-28","SF FuneralF834975       250228","","126.5","","1273493.55"
"2025-02-28","2025-02-28","SF FuneralF900407       250228","","126.5","","1273620.05"
"2025-02-28","2025-02-28","SF FuneralFDC0000000GXXY250228","","126.5","","1273746.55"
"2025-02-28","2025-02-28","SF FuneralF900959       250228","","126.5","","1273873.05"
"2025-02-28","2025-02-28","SF FuneralF813537       250301","","126.5","","1273999.55"
"2025-02-28","2025-02-28","SF FuneralF901391       250301","","126.5","","1274126.05"
"2025-02-28","2025-02-28","SF FuneralF980260       250228","","126.5","","1274252.55"
"2025-02-28","2025-02-28","SF FuneralF980430       250301","","126.5","","1274379.05"
"2025-02-28","2025-02-28","SF FuneralF981114       250301","","126.5","","1274505.55"
"2025-02-28","2025-02-28","SF FuneralF986803       250301","","126.5","","1274632.05"
"2025-02-28","2025-02-28","SF FuneralF987101       250228","","126.5","","1274758.55"
"2025-02-28","2025-02-28","SF FuneralF987224       250301","","126.5","","1274885.05"
"2025-02-28","2025-02-28","SF FuneralF987567       250301","","126.5","","1275011.55"
"2025-02-28","2025-02-28","SF FuneralF987909       250301","","126.5","","1275138.05"
"2025-02-28","2025-02-28","SF FuneralF987946       250301","","126.5","","1275264.55"
"2025-02-28","2025-02-28","SF FuneralF987953       250228","","126.5","","1275391.05"
"2025-02-28","2025-02-28","SF FuneralF988533       250228","","126.5","","1275517.55"
"2025-02-28","2025-02-28","SF FuneralF988770       250228","","126.5","","1275644.05"
"2025-02-28","2025-02-28","SF FuneralFDC0000000HYQ5250228","","126.5","","1275770.55"
"2025-02-28","2025-02-28","SF FuneralF989485       250301","","126.5","","1275897.05"
"2025-02-28","2025-02-28","SF FuneralF989569       250301","","126.5","","1276023.55"
"2025-02-28","2025-02-28","SF FuneralF989711       250301","","126.5","","1276150.05"
"2025-02-28","2025-02-28","SF FuneralF989839       250301","","126.5","","1276276.55"
"2025-02-28","2025-02-28","SF FuneralFDC0000000JL2V250228","","191.5","","1276468.05"
"2025-02-28","2025-02-28","SF FuneralFDC0000000JR9H250228","","126.5","","1276594.55"
"2025-02-28","2025-02-28","SF FuneralF1020822      250228","","126.5","","1276721.05"
"2025-02-28","2025-02-28","SF FuneralF1020824      250228","","126.5","","1276847.55"
"2025-02-28","2025-02-28","SF FuneralF1020871      250228","","126.5","","1276974.05"
"2025-02-28","2025-02-28","SF FuneralF1021247      250228","","126.5","","1277100.55"
"2025-02-28","2025-02-28","SF FuneralFDC0000000JVBW250228","","126.5","","1277227.05"
"2025-02-28","2025-02-28","SF FuneralFDC0000000JW31250228","","126.5","","1277353.55"
"2025-02-28","2025-02-28","SF FuneralF1021577      250228","","126.5","","1277480.05"
"2025-02-28","2025-02-28","SF FuneralFDC0000000JZHK250228","","126.5","","1277606.55"
"2025-02-28","2025-02-28","SF FuneralF1061053      250228","","126.5","","1277733.05"
"2025-02-28","2025-02-28","SF FuneralF1066678      250228","","126.5","","1277859.55"
"2025-02-28","2025-02-28","SF FuneralF1067945      250228","","126.5","","1277986.05"
"2025-02-28","2025-02-28","SF FuneralF781093       250228","","126.5","","1278112.55"
"2025-02-28","2025-02-28","SF FuneralF1083694      250228","","126.5","","1278239.05"
"2025-02-28","2025-02-28","SF FuneralFDC0000000LTGV250228","","126.5","","1278365.55"
"2025-02-28","2025-02-28","SF FuneralF1083912      250228","","126.5","","1278492.05"
"2025-02-28","2025-02-28","SF FuneralF1084004      250228","","126.5","","1278618.55"
"2025-02-28","2025-02-28","SF FuneralFDC0000000MC56250228","","126.5","","1278745.05"
"2025-02-28","2025-02-28","SF FuneralF841180       250228","","126.5","","1278871.55"
"2025-02-28","2025-02-28","SF FuneralF1108809      250228","","126.5","","1278998.05"
"2025-02-28","2025-02-28","SF FuneralF1109690      250228","","126.5","","1279124.55"
"2025-02-28","2025-02-28","SF FuneralF1109949      250228","","126.5","","1279251.05"
"2025-02-28","2025-02-28","SF FuneralFDC0000000MLFC250228","","126.5","","1279377.55"
"2025-02-28","2025-02-28","SF FuneralFDC0000000MM2M250228","","126.5","","1279504.05"
"2025-02-28","2025-02-28","SF FuneralF1110370      250228","","126.5","","1279630.55"
"2025-02-28","2025-02-28","SF FuneralF1113601      250228","","126.5","","1279757.05"
"2025-02-28","2025-02-28","SF FuneralF1113887      250228","","126.5","","1279883.55"
"2025-02-28","2025-02-28","SF FuneralF1115882      250228","","126.5","","1280010.05"
"2025-02-28","2025-02-28","SF FuneralF1116792      250228","","126.5","","1280136.55"
"2025-02-28","2025-02-28","SF FuneralF1117942      250228","","126.5","","1280263.05"
"2025-02-28","2025-02-28","SF FuneralF1118024      250228","","126.5","","1280389.55"
"2025-02-28","2025-02-28","SF FuneralF1118106      250228","","126.5","","1280516.05"
"2025-02-28","2025-02-28","SF FuneralFDC0000000NR30250228","","126.5","","1280642.55"
"2025-02-28","2025-02-28","SF FuneralF1119010      250228","","126.5","","1280769.05"
"2025-02-28","2025-02-28","SF FuneralF1120883      250228","","126.5","","1280895.55"
"2025-02-28","2025-02-28","SF FuneralFDC0000000P529250228","","126.5","","1281022.05"
"2025-02-28","2025-02-28","SF FuneralFDC0000000P52F250228","","126.5","","1281148.55"
"2025-02-28","2025-02-28","SF FuneralF1124773      250228","","126.5","","1281275.05"
"2025-02-28","2025-02-28","SF FuneralF1125000      250228","","126.5","","1281401.55"
"2025-02-28","2025-02-28","SF FuneralF1125108      250228","","126.5","","1281528.05"
"2025-02-28","2025-02-28","SF FuneralF1126073      250228","","126.5","","1281654.55"
"2025-02-28","2025-02-28","SF FuneralF1127582      250228","","126.5","","1281781.05"
"2025-02-28","2025-02-28","SF FuneralFDC0000000PRNZ250228","","126.5","","1281907.55"
"2025-02-28","2025-02-28","SF FuneralF1127742      250228","","126.5","","1282034.05"
"2025-02-28","2025-02-28","SF FuneralF1128063      250228","","126.5","","1282160.55"
"2025-02-28","2025-02-28","SF FuneralF1128069      250228","","126.5","","1282287.05"
"2025-02-28","2025-02-28","SF FuneralF1128155      250228","","126.5","","1282413.55"
"2025-02-28","2025-02-28","SF FuneralFDC0000000PW8T250228","","126.5","","1282540.05"
"2025-02-28","2025-02-28","SF FuneralF1129048      250228","","126.5","","1282666.55"
"2025-02-28","2025-02-28","SF FuneralF1129052      250228","","126.5","","1282793.05"
"2025-02-28","2025-02-28","SF FuneralF1129235      250228","","126.5","","1282919.55"
"2025-02-28","2025-02-28","SF FuneralF1129884      250228","","126.5","","1283046.05"
"2025-02-28","2025-02-22","SF FuneralFDC0000000BLDN250222","","126.5","","1283172.55"
"2025-02-28","2025-02-24","SF FuneralFDC000000061HC250223","","126.5","","1283299.05"
"2025-02-28","2025-02-25","SF FuneralFDC000000085SW250225","","126.5","","1283425.55"
"2025-02-28","2025-02-25","SF FuneralF798690       250225","","126.5","","1283552.05"
"2025-02-28","2025-02-25","SF FuneralF822587       250225","","31.63","","1283583.68"
"2025-02-28","2025-02-26","SF FuneralF1062663      250226","","126.5","","1283710.18"
"2025-02-28","2025-02-27","SF FuneralFDC000000066HG250227","","126.5","","1283836.68"
"2025-02-28","2025-02-27","SF FuneralFDC00000009FH8250227","","126.5","","1283963.18"
"2025-02-28","2025-02-27","SF FuneralF841083       250227","","126.5","","1284089.68"
"2025-02-28","2025-02-27","SF FuneralF1066464      250227","","126.5","","1284216.18"
"2025-02-28","2025-01-24","Rev SF FuneralFDC0000000NPRY250127","","-126.5","","1284089.68"
"2025-02-28","2025-01-24","Rev SF FuneralF981854       250128","","-126.5","","1283963.18"
"2025-02-28","2025-02-27","SF FuneralF798590       250227","","126.5","","1284089.68"
"2025-02-28","2025-02-22","SF FuneralF1022251      250222","","126.5","","1284216.18"
"2025-02-28","2025-02-22","SF FuneralF1054983      250222","","126.5","","1284342.68"
"2025-02-28","2025-02-24","SF FuneralFDC00000006Q80250224","","31.63","","1284374.31"
"2025-02-28","2025-02-25","SF FuneralF1067978      250225","","31.63","","1284405.94"
"2025-02-28","2025-02-27","SF FuneralFDC00000007HG0250227","","126.5","","1284532.44"
"2025-02-28","2025-02-27","SF FuneralF821012       250227","","126.5","","1284658.94"
"2025-02-28","2025-02-28","SF FuneralFDC00000006KJW250228","","126.5","","1284785.44"
"2025-02-28","2025-01-24","Rev SF FuneralF816232       250128","","-126.5","","1284658.94"
"2025-02-28","2025-02-24","Rev SF FuneralFDC00000007NPQ250224","","-126.5","","1284532.44"
"2025-02-28","2025-02-24","Rev SF FuneralFDC00000007092250224","","-126.5","","1284405.94"
"2025-02-28","2025-02-24","Rev SF FuneralFDC0000000HT78250224","","-126.5","","1284279.44"
"2025-02-28","2025-02-21","Rev SF FuneralFDC0000000HJSC250223","","-126.5","","1284152.94"
"2025-02-28","2025-02-24","Rev SF FuneralFDC00000007F71250224","","-63.25","","1284089.69"
"2025-02-28","2025-02-24","Rev SF FuneralFDC00000007R5Z250224","","-63.25","","1284026.44"
"2025-02-28","2025-02-24","Rev SF FuneralFDC00000006XCF250224","","-126.5","","1283899.94"
"2025-02-28","2025-02-24","Rev SF FuneralFDC000000062RH250223","","-126.5","","1283773.44"
"2025-02-28","2025-02-22","Rev SF FuneralFDC00000003MNW250222","","-220","","1283553.44"
"2025-02-28","2025-02-22","Rev SF FuneralFDC00000007ZW7250222","","-126.5","","1283426.94"
"2025-02-28","2025-02-24","Rev SF FuneralFDC0000000PRPK250224","","-126.5","","1283300.44"
"2025-02-28","2025-02-22","Rev SF FuneralFDC00000005XG2250222","","-126.5","","1283173.94"
"2025-02-28","2025-02-22","Rev SF FuneralFDC00000005Z5P250222","","-126.5","","1283047.44"
"2025-02-28","2025-02-21","Rev SF FuneralFDC0000000HYF4250222","","-126.5","","1282920.94"
"2025-02-28","2025-02-22","Rev SF FuneralFDC0000000Q7V2250222","","-126.5","","1282794.44"
"2025-02-28","2025-02-22","Rev SF FuneralFDC00000008ZMS250222","","-126.5","","1282667.94"
"2025-02-28","2025-02-24","Rev SF FuneralFDC0000000N12V250224","","-126.5","","1282541.44"
"2025-02-28","2025-02-22","Rev SF FuneralFDC00000008NPF250222","","-126.5","","1282414.94"
"2025-02-28","2025-02-24","Rev SF FuneralFDC0000000N7M9250224","","-126.5","","1282288.44"
"2025-02-28","2025-02-22","Rev SF FuneralFDC000000035YY250222","","-220","","1282068.44"
"2025-02-28","2025-02-22","Rev SF FuneralFDC0000000BHFW250222","","-126.5","","1281941.94"
"2025-02-28","2025-02-22","Rev SF FuneralFDC0000000LJ18250222","","-126.5","","1281815.44"
"2025-02-28","2025-02-24","Rev SF FuneralFDC0000000PGQS250224","","-126.5","","1281688.94"
"2025-02-28","2025-02-22","Rev SF FuneralFDC00000003MN1250222","","-220","","1281468.94"
"2025-02-28","2025-02-22","Rev SF FuneralFDC0000000KWDK250222","","-126.5","","1281342.44"
"2025-02-28","2025-02-22","Rev SF FuneralFDC000000065D4250222","","-126.5","","1281215.94"
"2025-02-28","2025-02-22","Rev SF FuneralFDC00000007CX0250222","","-126.5","","1281089.44"
"2025-02-28","2025-02-25","Rev SF FuneralFDC000000089WZ250225","","-126.5","","1280962.94"
"2025-02-28","2025-02-25","Rev SF FuneralFDC00000009618250225","","-126.5","","1280836.44"
"2025-02-28","2025-02-25","Rev SF FuneralFDC00000006DSH250225","","-126.5","","1280709.94"
"2025-02-28","2025-02-25","Rev SF FuneralFDC0000000Q3TQ250225","","-126.5","","1280583.44"
"2025-02-28","2025-02-25","Rev SF FuneralFDC00000006RZQ250225","","-126.5","","1280456.94"
"2025-02-28","2025-02-25","Rev SF FuneralFDC00000003D2J250225","","-110","","1280346.94"
"2025-02-28","2025-02-25","Rev SF FuneralFDC00000007BBK250225","","-220","","1280126.94"
"2025-02-28","2025-02-25","Rev SF FuneralFDC00000007TNM250225","","-126.5","","1280000.44"
"2025-02-28","2025-02-25","Rev SF FuneralFDC00000007RN8250225","","-126.5","","1279873.94"
"2025-02-28","2025-02-25","Rev SF FuneralFDC00000007YRL250225","","-126.5","","1279747.44"
"2025-02-28","2025-02-25","Rev SF FuneralFDC00000008NR5250225","","-126.5","","1279620.94"
"2025-02-28","2025-02-25","Rev SF FuneralFDC00000007NFM250225","","-126.5","","1279494.44"
"2025-02-28","2025-02-25","Rev SF FuneralFDC000000082D1250225","","-126.5","","1279367.94"
"2025-02-28","2025-02-28","Rev SF FuneralFDC000000078DX250228","","-126.5","","1279241.44"
"2025-02-28","2025-02-28","Rev SF FuneralFDC0000000B89Y250228","","-126.5","","1279114.94"
"2025-02-28","2025-02-28","Rev SF FuneralFDC000000067RK250228","","-126.5","","1278988.44"
"2025-02-28","2025-02-28","Rev SF FuneralFDC00000006R8Z250228","","-126.5","","1278861.94"
"2025-02-28","2025-02-28","Rev SF FuneralFDC00000006RWX250228","","-126.5","","1278735.44"
"2025-02-28","2025-02-28","Rev SF FuneralFDC00000005W6H250228","","-126.5","","1278608.94"
"2025-02-28","2025-02-28","Rev SF FuneralFDC00000005SMG250228","","-126.5","","1278482.44"
"2025-02-28","2025-02-28","Rev SF FuneralFDC00000005XCF250228","","-220","","1278262.44"
"2025-02-28","2025-02-28","Rev SF FuneralFDC00000005SV9250228","","-220","","1278042.44"
"2025-02-28","2025-02-28","Rev SF FuneralFDC00000006YXS250228","","-126.5","","1277915.94"
"2025-02-28","2025-02-28","Rev SF FuneralFDC00000005X3L250228","","-220","","1277695.94"
"2025-02-28","2025-02-28","Rev SF FuneralFDC000000069N7250228","","-126.5","","1277569.44"
"2025-02-28","2025-02-28","Rev SF FuneralFDC00000004015250228","","-220","","1277349.44"
"2025-02-28","2025-02-28","Rev SF FuneralFDC000000077MM250228","","-126.5","","1277222.94"
"2025-02-28","2025-02-28","Rev SF FuneralFDC000000068DR250228","","-126.5","","1277096.44"
"2025-02-28","2025-02-28","Rev SF FuneralFDC00000006CK5250228","","-126.5","","1276969.94"
"2025-02-28","2025-02-28","Rev SF FuneralFDC0000000CRTK250228","","-126.5","","1276843.44"
"2025-02-28","2025-02-28","Rev SF FuneralFDC00000009R05250228","","-126.5","","1276716.94"
"2025-02-28","2025-02-28","Rev SF FuneralFDC0000000JR9H250228","","-126.5","","1276590.44"
"2025-02-28","2025-02-28","Rev SF FuneralFDC00000008PPZ250228","","-126.5","","1276463.94"
"2025-02-28","2025-02-28","Rev SF FuneralFDC00000008PQ0250228","","-126.5","","1276337.44"
"2025-02-28","2025-02-28","Rev SF FuneralFDC00000009R09250228","","-126.5","","1276210.94"
"2025-02-28","2025-02-28","Rev SF FuneralFDC00000008Z2L250228","","-126.5","","1276084.44"
"2025-02-28","2025-02-28","Rev SF FuneralFDC0000000MLFC250228","","-126.5","","1275957.94"
"2025-02-28","2025-02-28","Rev SF FuneralFDC000000082KD250228","","-126.5","","1275831.44"
"2025-02-28","2025-02-26","Rev SF FuneralFDC00000005XF6250226","","-220","","1275611.44"
"2025-02-28","2025-02-26","Rev SF FuneralFDC0000000H1YY250226","","-126.5","","1275484.94"
"2025-02-28","2025-02-26","Rev SF FuneralFDC0000000FVPK250226","","-126.5","","1275358.44"
"2025-02-28","2025-02-26","Rev SF FuneralFDC0000000P5Q2250226","","-126.5","","1275231.94"
"2025-02-28","2025-02-26","Rev SF FuneralFDC0000000KRGY250226","","-126.5","","1275105.44"
"2025-02-28","2025-02-27","Rev SF FuneralFDC0000000KFJS250227","","-321.5","","1274783.94"
"2025-02-28","2025-02-27","Rev SF FuneralFDC0000000PBGN250227","","-126.5","","1274657.44"
"2025-02-28","2025-02-27","Rev SF FuneralFDC00000009HB8250227","","-126.5","","1274530.94"
"2025-02-28","2025-02-27","Rev SF FuneralFDC0000000P2ZT250227","","-126.5","","1274404.44"
"2025-02-28","2025-02-27","Rev SF FuneralFDC0000000DQW2250227","","-126.5","","1274277.94"
"2025-02-28","2025-02-27","Rev SF FuneralFDC0000000JD19250227","","-126.5","","1274151.44"
"2025-02-28","2025-02-27","Rev SF FuneralFDC00000005Q72250227","","-126.5","","1274024.94"
"2025-02-28","2025-02-27","Rev SF FuneralFDC00000005RQQ250227","","-220","","1273804.94"
"2025-02-28","2025-02-27","Rev SF FuneralFDC00000005SQJ250227","","-126.5","","1273678.44"
"2025-02-28","2025-02-27","Rev SF FuneralFDC00000005T5M250227","","-220","","1273458.44"
"2025-02-28","2025-02-27","Rev SF FuneralFDC00000005WZQ250227","","-126.5","","1273331.94"
"2025-02-28","2025-02-27","Rev SF FuneralFDC00000005Q6V250227","","-126.5","","1273205.44"
"2025-02-28","2025-02-27","Rev SF FuneralFDC0000000N4F1250227","","-126.5","","1273078.94"
"2025-02-28","2025-02-27","Rev SF FuneralFDC0000000H9BG250227","","-126.5","","1272952.44"
"2025-02-28","2025-02-27","Rev SF FuneralFDC0000000NZTN250227","","-126.5","","1272825.94"
"2025-02-28","2025-02-27","Rev SF FuneralFDC000000032G9250227","","-220","","1272605.94"
"2025-02-28","2025-02-27","Rev SF FuneralFDC0000000N3WX250227","","-126.5","","1272479.44"
"2025-02-28","2025-02-27","Rev SF FuneralFDC000000072BP250227","","-126.5","","1272352.94"
"2025-02-28","2025-02-25","Rev SF FuneralFDC00000006ST9250225","","-31.63","","1272321.31"
"2025-02-28","2025-02-25","Rev SF FuneralFDC00000008C95250225","","-31.63","","1272289.68"
"2025-02-28","2025-02-25","Rev SF FuneralFDC00000006STJ250225","","-31.63","","1272258.05"
"2025-02-28","2025-02-25","Rev SF FuneralFDC00000005PFJ250225","","-31.63","","1272226.42"
"2025-02-28","2025-02-28","Rev SF FuneralFDC0000000L3MT250228","","-31.63","","1272194.79"
"2025-02-28","2025-02-28","Rev SF FuneralFDC0000000JXK7250228","","-31.63","","1272163.16"
"2025-02-28","2025-02-19","Rev SF FuneralFDC00000006PWT250219","","-126.5","","1272036.66"
"2025-02-28","2025-02-24","Rev SF FuneralFDC00000007GFX250223","","-31.63","","1272005.03"
"2025-02-28","2025-02-24","Rev SF FuneralFDC00000007GG1250223","","-31.63","","1271973.4"
"2025-02-28","2025-02-24","Rev SF FuneralFDC0000000KYZ5250224","","-31.63","","1271941.77"
"2025-02-28","2025-01-24","Rev SF FuneralFDC0000000BH67250127","","-126.5","","1271815.27"
"2025-02-28","2025-01-24","Rev SF FuneralFDC0000000CL62250128","","-126.5","","1271688.77"
"2025-02-28","2025-02-20","SF FuneralF991576       250220","","126.5","","1271815.27"
"2025-02-28","2025-02-21","SF FuneralFDC00000003JVX250221","","220","","1272035.27"
"2025-02-28","2025-02-21","SF FuneralF991363       250222","","126.5","","1272161.77"
"2025-02-28","2025-02-22","SF FuneralF819997       250222","","126.5","","1272288.27"
"2025-02-28","2025-02-25","SF FuneralFDC00000005P4K250225","","31.63","","1272319.9"
"2025-02-28","2025-02-25","SF FuneralF1054618      250225","","31.63","","1272351.53"
"2025-02-28","2025-02-27","SF FuneralFDC00000005NT8250227","","126.5","","1272478.03"
"2025-02-28","2025-02-27","SF FuneralF802906       250227","","126.5","","1272604.53"
"2025-02-28","2025-02-27","SF FuneralF821777       250227","","126.5","","1272731.03"
"2025-02-28","2025-02-27","SF FuneralF841835       250227","","126.5","","1272857.53"
"2025-02-28","2025-02-27","SF FuneralF843392       250227","","126.5","","1272984.03"
"2025-02-28","2025-02-28","SF FuneralFDC00000003C8S250228","","220","","1273204.03"
"2025-02-28","2025-02-28","SF FuneralFDC00000006Y2R250228","","126.5","","1273330.53"
"2025-02-28","2025-02-28","SF FuneralFDC0000000731L250228","","126.5","","1273457.03"
"2025-02-28","2025-02-28","SF FuneralF990241       250301","","126.5","","1273583.53"
"2025-02-28","2025-02-28","SF FuneralF1066270      250228","","126.5","","1273710.03"
"2025-02-28","2025-02-22","SF FuneralF809961       250222","","126.5","","1273836.53"
"2025-02-28","2025-02-24","SF FuneralFDC00000005NWL250224","","31.63","","1273868.16"
"2025-02-28","2025-02-25","SF FuneralF816802       250225","","31.63","","1273899.79"
"2025-02-28","2025-02-27","SF FuneralFDC000000073S1250227","","126.5","","1274026.29"
"2025-02-28","2025-02-27","SF FuneralFDC0000000757N250227","","126.5","","1274152.79"
"2025-02-28","2025-02-27","SF FuneralF812307       250227","","126.5","","1274279.29"
"2025-02-28","2025-02-27","SF FuneralF829782       250227","","126.5","","1274405.79"
"2025-02-28","2025-02-27","SF FuneralFDC0000000NK9S250227","","126.5","","1274532.29"
"2025-02-28","2025-02-28","SF FuneralFDC000000040YC250228","","220","","1274752.29"
"2025-02-28","2025-02-28","SF FuneralFDC000000064BV250228","","126.5","","1274878.79"
"2025-02-28","2025-02-22","Rev SF FuneralFDC0000000PS33250222","","-126.5","","1274752.29"
"2025-02-28","2025-01-22","Rev SF FuneralFDC0000000PS33250122","","-126.5","","1274625.79"
"2025-02-28","2025-02-21","SF FuneralF818322       250221","","63.25","","1274689.04"
"2025-02-28","2025-02-22","SF FuneralF804204       250222","","126.5","","1274815.54"
"2025-02-28","2025-02-22","SF FuneralFDC0000000B43F250222","","126.5","","1274942.04"
"2025-02-28","2025-02-24","SF FuneralF847274       250224","","126.5","","1275068.54"
"2025-02-28","2025-02-24","SF FuneralF1022110      250224","","126.5","","1275195.04"
"2025-02-28","2025-02-24","SF FuneralF1073039      250224","","126.5","","1275321.54"
"2025-02-28","2025-02-25","SF FuneralFDC00000006CWD250225","","55","","1275376.54"
"2025-02-28","2025-02-25","SF FuneralF803604       250225","","126.5","","1275503.04"
"2025-02-28","2025-02-25","SF FuneralF1065831      250225","","63.25","","1275566.29"
"2025-02-28","2025-02-26","SF FuneralF817757       250226","","126.5","","1275692.79"
"2025-02-28","2025-02-26","SF FuneralF1120299      250226","","126.5","","1275819.29"
"2025-02-28","2025-02-27","SF FuneralF804218       250227","","126.5","","1275945.79"
"2025-02-28","2025-02-27","SF FuneralF1109572      250227","","126.5","","1276072.29"
"2025-02-28","2025-02-27","SF FuneralF1113227      250227","","126.5","","1276198.79"
"2025-02-28","2025-02-28","SF FuneralFDC00000006CQR250228","","126.5","","1276325.29"
"2025-02-28","2025-02-28","SF FuneralF1084921      250228","","126.5","","1276451.79"
"2025-02-28","2025-02-28","SF FuneralF1128657      250228","","126.5","","1276578.29"
"2025-02-28","2025-02-28","SF FuneralFDC00000002YZ9250228","","220","","1276798.29"
"2025-02-28","2025-02-28","SF FuneralFDC00000005WQG250228","","126.5","","1276924.79"
"2025-02-28","2025-02-28","SF FuneralFDC0000000674F250228","","126.5","","1277051.29"
"2025-02-28","2025-02-28","SF FuneralFDC00000006B68250228","","126.5","","1277177.79"
"2025-02-28","2025-02-28","SF FuneralFDC00000006CJL250228","","126.5","","1277304.29"
"2025-02-28","2025-02-28","SF FuneralFDC00000006GFP250228","","126.5","","1277430.79"
"2025-02-28","2025-02-28","SF FuneralFDC000000071VH250228","","126.5","","1277557.29"
"2025-02-28","2025-02-28","SF FuneralFDC000000071VP250228","","126.5","","1277683.79"
"2025-02-28","2025-02-28","SF FuneralFDC000000077B5250228","","126.5","","1277810.29"
"2025-02-28","2025-02-28","SF FuneralF816648       250228","","126.5","","1277936.79"
"2025-02-28","2025-02-28","SF FuneralF988964       250301","","126.5","","1278063.29"
"2025-02-28","2025-02-28","SF FuneralF990042       250301","","126.5","","1278189.79"
"2025-02-28","2025-02-28","SF FuneralFDC0000000JM3K250228","","126.5","","1278316.29"
"2025-02-28","2025-02-28","SF FuneralF1085402      250228","","126.5","","1278442.79"
"2025-02-28","2025-02-28","SF FuneralFDC0000000MRWM250228","","126.5","","1278569.29"
"2025-02-28","2025-02-22","SF FuneralFDC00000007MWY250222","","126.5","","1278695.79"
"2025-02-28","2025-02-22","SF FuneralF803494       250222","","126.5","","1278822.29"
"2025-02-28","2025-02-22","SF FuneralF804120       250222","","126.5","","1278948.79"
"2025-02-28","2025-02-22","SF FuneralF1083889      250222","","126.5","","1279075.29"
"2025-02-28","2025-02-24","SF FuneralF811461       250224","","126.5","","1279201.79"
"2025-02-28","2025-02-24","SF FuneralF1125275      250224","","126.5","","1279328.29"
"2025-02-28","2025-02-25","SF FuneralFDC00000006042250225","","63.25","","1279391.54"
"2025-02-28","2025-02-25","SF FuneralFDC0000000HX1F250225","","63.25","","1279454.79"
"2025-02-28","2025-02-25","SF FuneralF1021948      250225","","126.5","","1279581.29"
"2025-02-28","2025-02-25","SF FuneralF1074872      250225","","63.25","","1279644.54"
"2025-02-28","2025-02-25","SF FuneralF1110073      250225","","63.25","","1279707.79"
"2025-02-28","2025-02-25","SF FuneralF1130930      250225","","126.5","","1279834.29"
"2025-02-28","2025-02-25","SF FuneralFDC0000000Q3YH250225","","126.5","","1279960.79"
"2025-02-28","2025-02-25","SF FuneralFDC0000000Q3YM250225","","191.5","","1280152.29"
"2025-02-28","2025-02-26","SF FuneralF830655       250226","","126.5","","1280278.79"
"2025-02-28","2025-02-27","SF FuneralFDC000000056Q8250227","","31.05","","1280309.84"
"2025-02-28","2025-02-27","SF FuneralF844737       250227","","126.5","","1280436.34"
"2025-02-28","2025-02-27","SF FuneralFDC0000000N2ZY250227","","126.5","","1280562.84"
"2025-02-28","2025-02-28","SF FuneralFDC00000006LQJ250228","","126.5","","1280689.34"
"2025-02-28","2025-02-28","SF FuneralF1108967      250228","","126.5","","1280815.84"
"2025-02-28","2025-02-28","SF FuneralF1112474      250228","","63.25","","1280879.09"
"2025-02-28","2025-02-28","SF FuneralF1127882      250228","","126.5","","1281005.59"
"2025-02-28","2025-02-28","SF FuneralF1129429      250228","","126.5","","1281132.09"
"2025-02-28","2025-02-25","SF FuneralFDC00000005NFK250225","","31.63","","1281163.72"
"2025-02-28","2025-02-25","SF FuneralFDC00000006Q68250225","","31.63","","1281195.35"
"2025-02-28","2025-02-25","SF FuneralF793715       250225","","31.63","","1281226.98"
"2025-02-28","2025-02-25","SF FuneralFDC00000007S9L250225","","31.63","","1281258.61"
"2025-02-28","2025-02-25","SF FuneralF831226       250225","","31.63","","1281290.24"
"2025-02-28","2025-02-25","SF FuneralF841781       250225","","31.63","","1281321.87"
"2025-02-28","2025-02-25","SF FuneralF988005       250225","","31.63","","1281353.5"
"2025-02-28","2025-02-25","SF FuneralF989270       250225","","31.63","","1281385.13"
"2025-02-28","2025-02-25","SF FuneralF1126262      250225","","31.63","","1281416.76"
"2025-02-28","2025-02-25","SF FuneralF1128951      250225","","31.63","","1281448.39"
"2025-02-28","2025-02-24","SF FuneralF830431       250224","","31.63","","1281480.02"
"2025-02-28","2025-02-20","SF FuneralFDC00000007CVJ250220","","126.5","","1281606.52"
"2025-02-28","2025-02-20","SF FuneralF1066148      250220","","126.5","","1281733.02"
"2025-02-28","2025-02-21","SF FuneralFDC0000000855Y250221","","126.5","","1281859.52"
"2025-02-28","2025-02-22","SF FuneralFDC00000005L0F250222","","126.5","","1281986.02"
"2025-02-28","2025-02-22","SF FuneralFDC00000006BZP250222","","126.5","","1282112.52"
"2025-02-28","2025-02-22","SF FuneralFDC000000072Z0250222","","126.5","","1282239.02"
"2025-02-28","2025-02-22","SF FuneralF805659       250222","","126.5","","1282365.52"
"2025-02-28","2025-02-22","SF FuneralF808852       250222","","126.5","","1282492.02"
"2025-02-28","2025-02-22","SF FuneralF822675       250222","","126.5","","1282618.52"
"2025-02-28","2025-02-22","SF FuneralF823286       250222","","126.5","","1282745.02"
"2025-02-28","2025-02-22","SF FuneralF842306       250222","","126.5","","1282871.52"
"2025-02-28","2025-02-22","SF FuneralFDC0000000F87P250222","","126.5","","1282998.02"
"2025-02-28","2025-02-22","SF FuneralF993654       250222","","126.5","","1283124.52"
"2025-02-28","2025-02-22","SF FuneralF1061057      250223","","126.5","","1283251.02"
"2025-02-28","2025-02-22","SF FuneralFDC0000000KP8M250222","","126.5","","1283377.52"
"2025-02-28","2025-02-22","SF FuneralF844581       250222","","126.5","","1283504.02"
"2025-02-28","2025-02-22","SF FuneralFDC0000000MYS5250223","","126.5","","1283630.52"
"2025-02-28","2025-02-24","SF FuneralFDC0000000615F250223","","126.5","","1283757.02"
"2025-02-28","2025-02-24","SF FuneralFDC0000000619Z250224","","126.5","","1283883.52"
"2025-02-28","2025-02-24","SF FuneralFDC00000006L6F250223","","126.5","","1284010.02"
"2025-02-28","2025-02-24","SF FuneralFDC000000073PV250224","","126.5","","1284136.52"
"2025-02-28","2025-02-24","SF FuneralF816306       250224","","126.5","","1284263.02"
"2025-02-28","2025-02-24","SF FuneralFDC0000000BBZL250224","","126.5","","1284389.52"
"2025-02-28","2025-02-24","SF FuneralFDC0000000BBZQ250224","","126.5","","1284516.02"
"2025-02-28","2025-02-24","SF FuneralFDC0000000F72V250224","","126.5","","1284642.52"
"2025-02-28","2025-02-24","SF FuneralF843027       250224","","126.5","","1284769.02"
"2025-02-28","2025-02-24","SF FuneralF987855       250224","","126.5","","1284895.52"
"2025-02-28","2025-02-24","SF FuneralF1054908      250224","","126.5","","1285022.02"
"2025-02-28","2025-02-24","SF FuneralF1109044      250224","","126.5","","1285148.52"
"2025-02-28","2025-02-24","SF FuneralF1112348      250224","","126.5","","1285275.02"
"2025-02-28","2025-02-24","SF FuneralFDC0000000NX3Q250224","","126.5","","1285401.52"
"2025-02-28","2025-02-24","SF FuneralF1129439      250224","","126.5","","1285528.02"
"2025-02-28","2025-02-24","SF FuneralF1131743      250224","","126.5","","1285654.52"
"2025-02-28","2025-02-25","SF FuneralFDC00000006Z1C250225","","126.5","","1285781.02"
"2025-02-28","2025-02-25","SF FuneralFDC00000007333250225","","63.25","","1285844.27"
"2025-02-28","2025-02-25","SF FuneralFDC00000007LKN250225","","126.5","","1285970.77"
"2025-02-28","2025-02-25","SF FuneralFDC00000007LRY250225","","126.5","","1286097.27"
"2025-02-28","2025-02-25","SF FuneralFDC00000007LS3250225","","126.5","","1286223.77"
"2025-02-28","2025-02-25","SF FuneralFDC00000007MJP250225","","126.5","","1286350.27"
"2025-02-28","2025-02-25","SF FuneralFDC00000007T8N250225","","126.5","","1286476.77"
"2025-02-28","2025-02-25","SF FuneralFDC00000007XMT250225","","126.5","","1286603.27"
"2025-02-28","2025-02-25","SF FuneralF802320       250225","","126.5","","1286729.77"
"2025-02-28","2025-02-25","SF FuneralF805896       250225","","126.5","","1286856.27"
"2025-02-28","2025-02-25","SF FuneralF823123       250225","","126.5","","1286982.77"
"2025-02-28","2025-02-25","SF FuneralF990253       250225","","63.25","","1287046.02"
"2025-02-28","2025-02-25","SF FuneralF992165       250225","","126.5","","1287172.52"
"2025-02-28","2025-02-25","SF FuneralF993175       250225","","126.5","","1287299.02"
"2025-02-28","2025-02-25","SF FuneralF1060565      250225","","63.25","","1287362.27"
"2025-02-28","2025-02-25","SF FuneralF1067947      250225","","63.25","","1287425.52"
"2025-02-28","2025-02-25","SF FuneralF1068052      250225","","63.25","","1287488.77"
"2025-02-28","2025-02-25","SF FuneralF1068058      250225","","63.25","","1287552.02"
"2025-02-28","2025-02-25","SF FuneralF1073735      250225","","63.25","","1287615.27"
"2025-02-28","2025-02-25","SF FuneralF1078570      250225","","126.5","","1287741.77"
"2025-02-28","2025-02-25","SF FuneralF1084020      250225","","126.5","","1287868.27"
"2025-02-28","2025-02-25","SF FuneralF1111570      250225","","126.5","","1287994.77"
"2025-02-28","2025-02-25","SF FuneralFDC0000000NPJ3250225","","126.5","","1288121.27"
"2025-02-28","2025-02-25","SF FuneralF1120336      250225","","126.5","","1288247.77"
"2025-02-28","2025-02-25","SF FuneralF1120575      250225","","126.5","","1288374.27"
"2025-02-28","2025-02-25","SF FuneralF1124752      250225","","126.5","","1288500.77"
"2025-02-28","2025-02-25","SF FuneralF1127957      250225","","126.5","","1288627.27"
"2025-02-28","2025-02-25","SF FuneralF1128356      250225","","126.5","","1288753.77"
"2025-02-28","2025-02-25","SF FuneralF1130029      250225","","126.5","","1288880.27"
"2025-02-28","2025-02-25","SF FuneralF1132372      250225","","126.5","","1289006.77"
"2025-02-28","2025-02-25","SF FuneralFDC0000000Q8ZZ250225","","126.5","","1289133.27"
"2025-02-28","2025-02-25","SF FuneralF1132901      250225","","126.5","","1289259.77"
"2025-02-28","2025-02-26","SF FuneralFDC00000007ZQR250226","","126.5","","1289386.27"
"2025-02-28","2025-02-26","SF FuneralF821404       250226","","126.5","","1289512.77"
"2025-02-28","2025-02-26","SF FuneralF842405       250226","","126.5","","1289639.27"
"2025-02-28","2025-02-26","SF FuneralF992515       250226","","126.5","","1289765.77"
"2025-02-28","2025-02-26","SF FuneralF993366       250226","","126.5","","1289892.27"
"2025-02-28","2025-02-26","SF FuneralF993733       250226","","126.5","","1290018.77"
"2025-02-28","2025-02-26","SF FuneralF1073401      250226","","126.5","","1290145.27"
"2025-02-28","2025-02-26","SF FuneralF1074881      250226","","126.5","","1290271.77"
"2025-02-28","2025-02-26","SF FuneralF1083845      250226","","126.5","","1290398.27"
"2025-02-28","2025-02-26","SF FuneralFDC0000000MHMH250226","","126.5","","1290524.77"
"2025-02-28","2025-02-26","SF FuneralF1125182      250226","","126.5","","1290651.27"
"2025-02-28","2025-02-28","SF FuneralF841714       250228","","31.63","","1290682.9"
"2025-02-28","2025-02-28","SF FuneralFDC0000000HBD0250228","","31.63","","1290714.53"
"2025-02-28","2025-02-28","SF FuneralF981670       250228","","31.63","","1290746.16"
"2025-02-28","2025-02-27","SF FuneralFDC0000000339Y250227","","220","","1290966.16"
"2025-02-28","2025-02-27","SF FuneralFDC00000005BQK250227","","126.5","","1291092.66"
"2025-02-28","2025-02-27","SF FuneralFDC00000005LZX250227","","126.5","","1291219.16"
"2025-02-28","2025-02-27","SF FuneralFDC000000060W6250227","","126.5","","1291345.66"
"2025-02-28","2025-02-27","SF FuneralFDC000000066NG250227","","126.5","","1291472.16"
"2025-02-28","2025-02-27","SF FuneralFDC000000072QK250227","","126.5","","1291598.66"
"2025-02-28","2025-02-27","SF FuneralFDC000000086H5250227","","126.5","","1291725.16"
"2025-02-28","2025-02-27","SF FuneralF802532       250227","","126.5","","1291851.66"
"2025-02-28","2025-02-27","SF FuneralFDC00000008NPP250227","","126.5","","1291978.16"
"2025-02-28","2025-02-27","SF FuneralF812261       250227","","126.5","","1292104.66"
"2025-02-28","2025-02-27","SF FuneralFDC00000009FPK250227","","126.5","","1292231.16"
"2025-02-28","2025-02-27","SF FuneralF812020       250227","","126.5","","1292357.66"
"2025-02-28","2025-02-27","SF FuneralFDC0000000BH67250227","","126.5","","1292484.16"
"2025-02-28","2025-02-27","SF FuneralF828009       250227","","126.5","","1292610.66"
"2025-02-28","2025-02-27","SF FuneralF828891       250227","","126.5","","1292737.16"
"2025-02-28","2025-02-27","SF FuneralF840793       250227","","126.5","","1292863.66"
"2025-02-28","2025-02-27","SF FuneralFDC0000000GP26250227","","126.5","","1292990.16"
"2025-02-28","2025-02-27","SF FuneralFDC0000000J1F3250227","","126.5","","1293116.66"
"2025-02-28","2025-02-27","SF FuneralF1066342      250227","","126.5","","1293243.16"
"2025-02-28","2025-02-27","SF FuneralF1074723      250227","","126.5","","1293369.66"
"2025-02-28","2025-02-27","SF FuneralF1108921      250227","","126.5","","1293496.16"
"2025-02-28","2025-02-27","SF FuneralF1111713      250227","","126.5","","1293622.66"
"2025-02-28","2025-02-27","SF FuneralFDC0000000MYV6250227","","126.5","","1293749.16"
"2025-02-28","2025-02-27","SF FuneralF1113149      250227","","126.5","","1293875.66"
"2025-02-28","2025-02-27","SF FuneralF1114024      250227","","126.5","","1294002.16"
"2025-02-28","2025-02-27","SF FuneralF1114558      250227","","126.5","","1294128.66"
"2025-02-28","2025-02-27","SF FuneralF1114915      250227","","126.5","","1294255.16"
"2025-02-28","2025-02-27","SF FuneralF1115003      250227","","126.5","","1294381.66"
"2025-02-28","2025-02-27","SF FuneralF1118019      250227","","126.5","","1294508.16"
"2025-02-28","2025-02-27","SF FuneralF1120696      250227","","126.5","","1294634.66"
"2025-02-28","2025-02-27","SF FuneralF1120779      250227","","126.5","","1294761.16"
"2025-02-28","2025-02-27","SF FuneralF1121872      250227","","126.5","","1294887.66"
"2025-02-28","2025-02-27","SF FuneralF1121984      250227","","126.5","","1295014.16"
"2025-02-28","2025-02-27","SF FuneralF1122076      250227","","126.5","","1295140.66"
"2025-02-28","2025-02-27","SF FuneralF1122194      250227","","126.5","","1295267.16"
"2025-02-28","2025-02-27","SF FuneralF1122319      250227","","126.5","","1295393.66"
"2025-02-28","2025-02-27","SF FuneralF1123227      250227","","126.5","","1295520.16"
"2025-02-28","2025-02-27","SF FuneralF1123437      250227","","126.5","","1295646.66"
"2025-02-28","2025-02-27","SF FuneralF1125483      250227","","126.5","","1295773.16"
"2025-02-28","2025-02-27","SF FuneralF1127241      250227","","126.5","","1295899.66"
"2025-02-28","2025-02-28","SF FuneralFDC00000003LB9250228","","220","","1296119.66"
"2025-02-28","2025-02-28","SF FuneralFDC00000005X9P250228","","126.5","","1296246.16"
"2025-02-28","2025-02-28","SF FuneralFDC0000000728R250228","","126.5","","1296372.66"
"2025-02-28","2025-02-28","SF FuneralFDC0000000739K250228","","126.5","","1296499.16"
"2025-02-28","2025-02-28","SF FuneralFDC000000075FY250228","","126.5","","1296625.66"
"2025-02-28","2025-02-28","SF FuneralFDC0000000767P250228","","126.5","","1296752.16"
"2025-02-28","2025-02-28","SF FuneralFDC00000007DV6250228","","126.5","","1296878.66"
"2025-02-28","2025-02-28","SF FuneralFDC00000007HRT250228","","126.5","","1297005.16"
"2025-02-28","2025-02-28","SF FuneralFDC00000007HRV250228","","126.5","","1297131.66"
"2025-02-28","2025-02-28","SF FuneralF793528       250228","","126.5","","1297258.16"
"2025-02-28","2025-02-28","SF FuneralFDC000000085P7250228","","126.5","","1297384.66"
"2025-02-28","2025-02-28","SF FuneralF799581       250228","","126.5","","1297511.16"
"2025-02-28","2025-02-28","SF FuneralF799938       250228","","126.5","","1297637.66"
"2025-02-28","2025-02-28","SF FuneralF804570       250228","","126.5","","1297764.16"
"2025-02-28","2025-02-28","SF FuneralF805111       250228","","126.5","","1297890.66"
"2025-02-28","2025-02-28","SF FuneralFDC00000008Y26250228","","126.5","","1298017.16"
"2025-02-28","2025-02-28","SF FuneralF808621       250228","","126.5","","1298143.66"
"2025-02-28","2025-02-28","SF FuneralF810363       250228","","126.5","","1298270.16"
"2025-02-28","2025-02-28","SF FuneralF820061       250228","","126.5","","1298396.66"
"2025-02-28","2025-02-28","SF FuneralFDC0000000CL62250228","","126.5","","1298523.16"
"2025-02-28","2025-02-28","SF FuneralF833106       250228","","126.5","","1298649.66"
"2025-02-28","2025-02-28","SF FuneralF980994       250301","","126.5","","1298776.16"
"2025-02-28","2025-02-28","SF FuneralF987659       250301","","126.5","","1298902.66"
"2025-02-28","2025-02-28","SF FuneralF988284       250301","","126.5","","1299029.16"
"2025-02-28","2025-02-28","SF FuneralF1021028      250228","","126.5","","1299155.66"
"2025-02-28","2025-02-28","SF FuneralF1021062      250228","","126.5","","1299282.16"
"2025-02-28","2025-02-28","SF FuneralFDC0000000JXHY250228","","126.5","","1299408.66"
"2025-02-28","2025-02-28","SF FuneralF1062716      250228","","126.5","","1299535.16"
"2025-02-28","2025-02-28","SF FuneralFDC0000000LTR0250228","","126.5","","1299661.66"
"2025-02-28","2025-02-28","SF FuneralFDC0000000LZKG250228","","126.5","","1299788.16"
"2025-02-28","2025-02-28","SF FuneralF1085029      250228","","126.5","","1299914.66"
"2025-02-28","2025-02-28","SF FuneralF1104253      250228","","126.5","","1300041.16"
"2025-02-28","2025-02-28","SF FuneralF1108594      250228","","126.5","","1300167.66"
"2025-02-28","2025-02-28","SF FuneralF1113873      250228","","126.5","","1300294.16"
"2025-02-28","2025-02-28","SF FuneralF1117938      250228","","126.5","","1300420.66"
"2025-02-28","2025-02-28","SF FuneralF1118775      250228","","126.5","","1300547.16"
"2025-02-28","2025-02-28","SF FuneralF1122754      250228","","126.5","","1300673.66"
"2025-02-28","2025-02-28","SF FuneralF1123050      250228","","126.5","","1300800.16"
"2025-02-28","2025-02-28","SF FuneralFDC0000000PL03250228","","126.5","","1300926.66"
"2025-02-28","2025-02-28","SF FuneralF1127811      250228","","126.5","","1301053.16"
"2025-02-28","2025-02-28","SF FuneralF1127829      250228","","126.5","","1301179.66"
"2025-02-28","2025-02-28","SF FuneralF1127840      250228","","126.5","","1301306.16"
"2025-02-28","2025-02-28","SF FuneralF1127883      250228","","126.5","","1301432.66"
"2025-02-28","2025-02-28","SF FuneralF1128222      250228","","126.5","","1301559.16"
"2025-02-28","2025-02-28","SF FuneralF1128993      250228","","126.5","","1301685.66"
"2025-02-28","2025-02-28","SF FuneralF1129001      250228","","126.5","","1301812.16"
"2025-02-28","2025-02-28","SF FuneralFDC00000005ZVT250228","","126.5","","1301938.66"
"2025-02-28","2025-02-28","SF FuneralFDC00000006C6V250228","","126.5","","1302065.16"
"2025-02-28","2025-02-28","SF FuneralFDC00000006K8P250228","","126.5","","1302191.66"
"2025-02-28","2025-02-28","SF FuneralFDC00000006Z6M250228","","126.5","","1302318.16"
"2025-02-28","2025-02-28","SF FuneralFDC0000000CHK6250228","","126.5","","1302444.66"
"2025-02-28","2025-02-28","SF FuneralFDC00000006992250228","","126.5","","1302571.16"
"2025-02-28","2025-02-28","SF FuneralFDC00000006PY2250228","","126.5","","1302697.66"
"2025-02-28","2025-02-28","SF FuneralFDC00000006XWL250228","","126.5","","1302824.16"
"2025-02-28","2025-02-28","SF FuneralF818916       250228","","126.5","","1302950.66"
"2025-02-28","2025-02-28","SF FuneralF832653       250228","","126.5","","1303077.16"
"2025-02-28","2025-02-28","SF FuneralF981095       250228","","126.5","","1303203.66"
"2025-02-28","2025-02-28","SF FuneralFDC0000000MRWF250228","","126.5","","1303330.16"
"2025-02-28","2025-02-22","SF FuneralFDC00000007JNV250222","","126.5","","1303456.66"
"2025-02-28","2025-02-22","SF FuneralFDC00000007JNX250222","","126.5","","1303583.16"
"2025-02-28","2025-02-27","SF FuneralF843075       250227","","126.5","","1303709.66"
"2025-02-28","2025-02-24","SF FuneralF831659       250224","","126.5","","1303836.16"
"2025-02-28","2025-02-28","SF FuneralFDC0000000446H250228","","220","","1304056.16"
"2025-02-28","2025-02-28","SF FuneralFDC00000005RX5250228","","220","","1304276.16"
"2025-02-28","2025-02-28","SF FuneralFDC00000005S80250228","","126.5","","1304402.66"
"2025-02-28","2025-02-28","SF FuneralFDC000000063LC250228","","126.5","","1304529.16"
"2025-02-28","2025-02-28","SF FuneralFDC000000065QV250228","","126.5","","1304655.66"
"2025-02-28","2025-02-28","SF FuneralFDC000000065TG250228","","126.5","","1304782.16"
"2025-02-28","2025-02-28","SF FuneralFDC000000065XM250228","","126.5","","1304908.66"
"2025-02-28","2025-02-28","SF FuneralFDC0000000662X250228","","126.5","","1305035.16"
"2025-02-28","2025-02-28","SF FuneralFDC00000006CC3250228","","126.5","","1305161.66"
"2025-02-28","2025-02-28","SF FuneralFDC0000000744Y250228","","126.5","","1305288.16"
"2025-02-28","2025-02-28","SF FuneralFDC000000076F0250228","","126.5","","1305414.66"
"2025-02-28","2025-02-28","SF FuneralFDC000000085V8250228","","126.5","","1305541.16"
"2025-02-28","2025-02-28","SF FuneralF799413       250228","","126.5","","1305667.66"
"2025-02-28","2025-02-28","SF FuneralF799574       250228","","126.5","","1305794.16"
"2025-02-28","2025-02-28","SF FuneralFDC00000008JNH250228","","126.5","","1305920.66"
"2025-02-28","2025-02-28","SF FuneralF808115       250228","","126.5","","1306047.16"
"2025-02-28","2025-02-28","SF FuneralF810323       250228","","126.5","","1306173.66"
"2025-02-28","2025-02-28","SF FuneralF820037       250228","","126.5","","1306300.16"
"2025-02-28","2025-02-28","SF FuneralF833108       250228","","126.5","","1306426.66"
"2025-02-28","2025-02-28","SF FuneralF877822       250228","","126.5","","1306553.16"
"2025-02-28","2025-02-28","SF FuneralFDC0000000JZLY250228","","126.5","","1306679.66"
"2025-02-28","2025-02-28","SF FuneralF1074883      250228","","126.5","","1306806.16"
"2025-02-28","2025-02-28","SF FuneralF1117871      250228","","126.5","","1306932.66"
"2025-02-28","2025-02-28","SF FuneralF1119679      250228","","126.5","","1307059.16"
"2025-02-28","2025-02-28","SF FuneralFDC0000000P05J250228","","126.5","","1307185.66"
"2025-02-28","2025-02-28","SF FuneralF1125801      250228","","126.5","","1307312.16"
"2025-02-28","2025-02-28","SF FuneralF1126836      250228","","126.5","","1307438.66"
"2025-02-28","2025-02-28","SF FuneralF1115022      250228","","126.5","","1307565.16"
"2025-02-28","2025-02-28","SF FuneralFDC000000062VZ250228","","126.5","","1307691.66"
"2025-02-28","2025-02-28","SF FuneralFDC000000065DL250228","","126.5","","1307818.16"
"2025-02-28","2025-02-28","SF FuneralFDC0000000661H250228","","220","","1308038.16"
"2025-02-28","2025-02-28","SF FuneralFDC000000066CJ250228","","126.5","","1308164.66"
"2025-02-28","2025-02-28","SF FuneralFDC000000067QP250228","","126.5","","1308291.16"
"2025-02-28","2025-02-28","SF FuneralFDC00000006CGF250228","","126.5","","1308417.66"
"2025-02-28","2025-02-28","SF FuneralFDC00000006MTF250228","","126.5","","1308544.16"
"2025-02-28","2025-02-28","SF FuneralFDC000000073MF250228","","126.5","","1308670.66"
"2025-02-28","2025-02-28","SF FuneralFDC00000007B73250228","","126.5","","1308797.16"
"2025-02-28","2025-02-28","SF FuneralFDC00000007FRV250228","","126.5","","1308923.66"
"2025-02-28","2025-02-28","SF FuneralF809564       250228","","126.5","","1309050.16"
"2025-02-28","2025-02-28","SF FuneralF815454       250228","","126.5","","1309176.66"
"2025-02-28","2025-02-28","SF FuneralF816077       250228","","126.5","","1309303.16"
"2025-02-28","2025-02-28","SF FuneralF817939       250228","","126.5","","1309429.66"
"2025-02-28","2025-02-28","SF FuneralFDC0000000B86P250228","","126.5","","1309556.16"
"2025-02-28","2025-02-28","SF FuneralF989560       250301","","126.5","","1309682.66"
"2025-02-28","2025-02-28","SF FuneralF990670       250301","","126.5","","1309809.16"
"2025-02-28","2025-02-28","SF FuneralF1017586      250228","","126.5","","1309935.66"
"2025-02-28","2025-02-28","SF FuneralF1108667      250228","","126.5","","1310062.16"
"2025-02-28","2025-02-28","SF FuneralF1110090      250228","","126.5","","1310188.66"
"2025-02-28","2025-02-28","SF FuneralFDC0000000MTK6250228","","126.5","","1310315.16"
"2025-02-28","2025-02-28","SF FuneralF1111682      250228","","126.5","","1310441.66"
"2025-02-28","2025-02-28","SF FuneralF784609       250228","","126.5","","1310568.16"
"2025-02-28","2025-02-28","SF FuneralFDC0000000PK90250228","","126.5","","1310694.66"
"2025-02-28","2025-02-28","SF FuneralF1127440      250228","","126.5","","1310821.16"
"2025-02-28","2025-02-28","SF FuneralF1128150      250228","","126.5","","1310947.66"
"2025-02-28","2025-02-28","SF FuneralF1131921      250228","","31.63","","1310979.29"
"2025-02-28","2025-02-22","SF FuneralFDC00000006DDM250222","","126.5","","1311105.79"
"2025-02-28","2025-02-22","SF FuneralFDC000000072PC250222","","126.5","","1311232.29"
"2025-02-28","2025-02-22","SF FuneralFDC0000000951Q250222","","126.5","","1311358.79"
"2025-02-28","2025-02-22","SF FuneralFDC0000000DDX5250222","","126.5","","1311485.29"
"2025-02-28","2025-02-22","SF FuneralF841318       250222","","126.5","","1311611.79"
"2025-02-28","2025-02-24","SF FuneralFDC00000006N6D250224","","126.5","","1311738.29"
"2025-02-28","2025-02-25","SF FuneralFDC00000006N7L250225","","126.5","","1311864.79"
"2025-02-28","2025-02-25","SF FuneralFDC0000000DDQR250225","","126.5","","1311991.29"
"2025-02-28","2025-02-25","SF FuneralF840732       250225","","126.5","","1312117.79"
"2025-02-28","2025-02-25","SF FuneralF990180       250225","","31.63","","1312149.42"
"2025-02-28","2025-02-25","SF FuneralF1068068      250225","","63.25","","1312212.67"
"2025-02-28","2025-02-25","SF FuneralF1084859      250225","","31.63","","1312244.3"
"2025-02-28","2025-02-25","SF FuneralF1114002      250225","","126.5","","1312370.8"
"2025-02-28","2025-02-25","SF FuneralF1129047      250225","","63.25","","1312434.05"
"2025-02-28","2025-02-25","SF FuneralF1130346      250225","","31.63","","1312465.68"
"2025-02-28","2025-02-27","SF FuneralF1075212      250227","","126.5","","1312592.18"
"2025-02-28","2025-02-27","SF FuneralF1120130      250227","","126.5","","1312718.68"
"2025-02-28","2025-02-28","SF FuneralFDC0000000673F250228","","126.5","","1312845.18"
"2025-02-28","2025-02-28","SF FuneralFDC0000000711R250228","","126.5","","1312971.68"
"2025-02-28","2025-02-28","SF FuneralFDC00000007JXM250228","","126.5","","1313098.18"
"2025-02-28","2025-02-28","SF FuneralFDC0000000888B250228","","126.5","","1313224.68"
"2025-02-28","2025-02-28","SF FuneralF834048       250228","","126.5","","1313351.18"
"2025-02-28","2025-02-28","SF FuneralF1050824      250228","","126.5","","1313477.68"
"2025-02-28","2025-02-28","SF FuneralF1084279      250228","","126.5","","1313604.18"
"2025-02-28","2025-02-28","SF FuneralF1085258      250228","","126.5","","1313730.68"
"2025-02-28","2025-02-22","SF FuneralF1113209      250222","","126.5","","1313857.18"
"2025-02-28","2025-02-25","SF FuneralFDC00000007TW1250225","","126.5","","1313983.68"
"2025-02-28","2025-02-25","SF FuneralFDC0000000CY56250225","","31.63","","1314015.31"
"2025-02-28","2025-02-25","SF FuneralF843011       250225","","63.25","","1314078.56"
"2025-02-28","2025-02-25","SF FuneralF1132860      250225","","126.5","","1314205.06"
"2025-02-28","2025-02-28","SF FuneralF1108704      250228","","126.5","","1314331.56"
"2025-02-28","2025-02-24","SF FuneralF1118033      250224","","31.63","","1314363.19"
"2025-02-28","2025-02-25","SF FuneralFDC00000003V68250225","","55","","1314418.19"
"2025-02-28","2025-02-25","SF FuneralFDC00000006Y7S250225","","31.63","","1314449.82"
"2025-02-28","2025-02-25","SF FuneralF830023       250225","","31.63","","1314481.45"
"2025-02-28","2025-02-25","SF FuneralF989148       250225","","31.63","","1314513.08"
"2025-02-28","2025-02-25","SF FuneralF991480       250225","","31.63","","1314544.71"
"2025-02-28","2025-02-25","SF FuneralF1067990      250225","","31.63","","1314576.34"
"2025-02-28","2025-02-25","SF FuneralF1079178      250225","","31.63","","1314607.97"
"2025-02-28","2025-02-25","SF FuneralF1079259      250225","","31.63","","1314639.6"
"2025-02-28","2025-02-25","SF FuneralF739720       250225","","64.13","","1314703.73"
"2025-02-28","2025-02-27","SF FuneralF1123949      250227","","31.63","","1314735.36"
"2025-02-28","2025-02-28","SF FuneralF1052348      250228","","31.63","","1314766.99"
"2025-02-28","2025-02-28","SF FuneralF1114116      250228","","31.63","","1314798.62"
"2025-02-28","2025-02-20","SF FuneralFDC00000007CVM250220","","126.5","","1314925.12"
"2025-02-28","2025-02-22","SF FuneralFDC00000007LKX250222","","126.5","","1315051.62"
"2025-02-28","2025-02-22","SF FuneralFDC00000008GMS250222","","126.5","","1315178.12"
"2025-02-28","2025-02-22","SF FuneralF1073547      250222","","126.5","","1315304.62"
"2025-02-28","2025-02-22","SF FuneralF1112149      250223","","126.5","","1315431.12"
"2025-02-28","2025-02-22","SF FuneralF1112492      250222","","126.5","","1315557.62"
"2025-02-28","2025-02-25","SF FuneralFDC00000005GGL250225","","63.25","","1315620.87"
"2025-02-28","2025-02-25","SF FuneralFDC000000064FL250225","","126.5","","1315747.37"
"2025-02-28","2025-02-25","SF FuneralFDC000000079JH250225","","126.5","","1315873.87"
"2025-02-28","2025-02-25","SF FuneralF811437       250225","","63.25","","1315937.12"
"2025-02-28","2025-02-25","SF FuneralFDC0000000HT6X250225","","126.5","","1316063.62"
"2025-02-28","2025-02-25","SF FuneralF1020917      250225","","63.25","","1316126.87"
"2025-02-28","2025-02-25","SF FuneralF1120337      250225","","126.5","","1316253.37"
"2025-02-28","2025-02-25","SF FuneralF1129094      250225","","63.25","","1316316.62"
"2025-02-28","2025-02-25","SF FuneralF1130060      250225","","63.25","","1316379.87"
"2025-02-28","2025-02-25","SF FuneralF1132892      250225","","63.25","","1316443.12"
"2025-02-28","2025-02-26","SF FuneralFDC000000034MB250226","","220","","1316663.12"
"2025-02-28","2025-02-26","SF FuneralF797732       250226","","126.5","","1316789.62"
"2025-02-28","2025-02-26","SF FuneralF992065       250226","","126.5","","1316916.12"
"2025-02-28","2025-02-26","SF FuneralF993908       250226","","126.5","","1317042.62"
"2025-02-28","2025-02-26","SF FuneralF1017058      250226","","126.5","","1317169.12"
"2025-02-28","2025-02-27","SF FuneralFDC00000005QDW250227","","126.5","","1317295.62"
"2025-02-28","2025-02-27","SF FuneralFDC00000005VCP250227","","126.5","","1317422.12"
"2025-02-28","2025-02-27","SF FuneralFDC000000068WX250227","","126.5","","1317548.62"
"2025-02-28","2025-02-27","SF FuneralF820887       250227","","126.5","","1317675.12"
"2025-02-28","2025-02-27","SF FuneralF829730       250227","","126.5","","1317801.62"
"2025-02-28","2025-02-27","SF FuneralF981468       250227","","126.5","","1317928.12"
"2025-02-28","2025-02-27","SF FuneralF989134       250227","","126.5","","1318054.62"
"2025-02-28","2025-02-27","SF FuneralF901109       250227","","126.5","","1318181.12"
"2025-02-28","2025-02-27","SF FuneralF1052645      250227","","126.5","","1318307.62"
"2025-02-28","2025-02-27","SF FuneralF1075294      250227","","126.5","","1318434.12"
"2025-02-28","2025-02-27","SF FuneralF1110814      250227","","126.5","","1318560.62"
"2025-02-28","2025-02-27","SF FuneralF1112528      250227","","126.5","","1318687.12"
"2025-02-28","2025-02-27","SF FuneralF1114941      250227","","126.5","","1318813.62"
"2025-02-28","2025-02-28","SF FuneralFDC00000006Z0J250228","","126.5","","1318940.12"
"2025-02-28","2025-02-28","SF FuneralF812157       250228","","126.5","","1319066.62"
"2025-02-28","2025-02-28","SF FuneralF987606       250301","","126.5","","1319193.12"
"2025-02-28","2025-02-28","SF FuneralFDC0000000HT8C250228","","126.5","","1319319.62"
"2025-02-28","2025-02-28","SF FuneralFDC0000000HT8H250228","","126.5","","1319446.12"
"2025-02-28","2025-02-28","SF FuneralF988956       250228","","126.5","","1319572.62"
"2025-02-28","2025-02-28","SF FuneralF1062712      250228","","126.5","","1319699.12"
"2025-02-28","2025-02-28","SF FuneralF1113148      250228","","126.5","","1319825.62"
"2025-02-28","2025-02-28","SF FuneralF1116119      250228","","126.5","","1319952.12"
"2025-02-28","2025-02-24","SF FuneralFDC0000000G01D250222","","126.5","","1320078.62"
"2025-02-28","2025-02-24","SF FuneralF1120395      250224","","126.5","","1320205.12"
"2025-02-28","2025-02-25","SF FuneralF802673       250225","","126.5","","1320331.62"
"2025-02-28","2025-02-25","SF FuneralF986987       250225","","126.5","","1320458.12"
"2025-02-28","2025-02-25","SF FuneralF987244       250225","","31.63","","1320489.75"
"2025-02-28","2025-02-25","SF FuneralF991428       250225","","63.25","","1320553"
"2025-02-28","2025-02-25","SF FuneralF1066071      250225","","126.5","","1320679.5"
"2025-02-28","2025-02-25","SF FuneralF1132328      250225","","126.5","","1320806"
"2025-02-28","2025-02-28","SF FuneralFDC00000006BC1250228","","126.5","","1320932.5"
"2025-02-28","2025-02-28","SF FuneralFDC00000006K1D250228","","126.5","","1321059"
"2025-02-28","2025-02-28","SF FuneralF834544       250228","","31.63","","1321090.63"
"2025-02-28","2025-02-28","SF FuneralF1080183      250228","","31.63","","1321122.26"
"2025-02-28","2025-02-28","SF FuneralF1085355      250228","","31.63","","1321153.89"
"2025-02-28","2025-02-28","SF FuneralF1117595      250228","","126.5","","1321280.39"
"2025-02-28","2025-02-22","SF FuneralFDC00000008TTC250222","","126.5","","1321406.89"
"2025-02-28","2025-02-22","SF FuneralF1020955      250222","","126.5","","1321533.39"
"2025-02-28","2025-02-22","SF FuneralFDC0000000KLT7250222","","126.5","","1321659.89"
"2025-02-28","2025-02-22","SF FuneralF1074834      250223","","126.5","","1321786.39"
"2025-02-28","2025-02-22","SF FuneralFDC0000000N2XK250223","","63.25","","1321849.64"
"2025-02-28","2025-02-22","SF FuneralF1127452      250223","","126.5","","1321976.14"
"2025-02-28","2025-02-22","SF FuneralF1129085      250223","","126.5","","1322102.64"
"2025-02-28","2025-02-24","SF FuneralF1126891      250224","","126.5","","1322229.14"
"2025-02-28","2025-02-25","SF FuneralFDC00000005MFC250225","","126.5","","1322355.64"
"2025-02-28","2025-02-25","SF FuneralFDC0000000KB9R250225","","126.5","","1322482.14"
"2025-02-28","2025-02-27","SF FuneralFDC00000005PFD250227","","126.5","","1322608.64"
"2025-02-28","2025-02-27","SF FuneralFDC00000005PKC250227","","126.5","","1322735.14"
"2025-02-28","2025-02-27","SF FuneralFDC00000006760250227","","126.5","","1322861.64"
"2025-02-28","2025-02-27","SF FuneralFDC00000006KSL250227","","126.5","","1322988.14"
"2025-02-28","2025-02-27","SF FuneralFDC00000006KSP250227","","126.5","","1323114.64"
"2025-02-28","2025-02-27","SF FuneralF900699       250227","","126.5","","1323241.14"
"2025-02-28","2025-02-27","SF FuneralF1079287      250227","","126.5","","1323367.64"
"2025-02-28","2025-02-27","SF FuneralF1113109      250227","","126.5","","1323494.14"
"2025-02-28","2025-02-27","SF FuneralF1074548      250227","","126.5","","1323620.64"
"2025-02-28","2025-02-28","SF FuneralFDC0000000637L250228","","126.5","","1323747.14"
"2025-02-28","2025-02-28","SF FuneralF802374       250228","","126.5","","1323873.64"
"2025-02-28","2025-02-28","SF FuneralFDC00000009XVX250228","","126.5","","1324000.14"
"2025-02-28","2025-02-28","SF FuneralF822539       250228","","126.5","","1324126.64"
"2025-02-28","2025-02-28","SF FuneralF986874       250228","","126.5","","1324253.14"
"2025-02-28","2025-02-28","SF FuneralFDC0000000LT3Q250228","","126.5","","1324379.64"
"2025-02-28","2025-02-28","SF FuneralF1084313      250228","","126.5","","1324506.14"
"2025-02-28","2025-02-28","SF FuneralF1117241      250228","","126.5","","1324632.64"
"2025-02-28","2025-02-28","SF FuneralFDC0000000NJS8250228","","126.5","","1324759.14"
"2025-02-28","2025-02-28","SF FuneralF1118533      250228","","126.5","","1324885.64"
"2025-02-28","2025-02-19","SF FuneralF1123551      250219","","63.25","","1324948.89"
"2025-02-28","2025-02-20","SF FuneralFDC0000000BJ1W250220","","126.5","","1325075.39"
"2025-02-28","2025-02-22","SF FuneralFDC00000006353250222","","126.5","","1325201.89"
"2025-02-28","2025-02-22","SF FuneralF796847       250222","","126.5","","1325328.39"
"2025-02-28","2025-02-22","SF FuneralF1117598      250222","","126.5","","1325454.89"
"2025-02-28","2025-02-22","SF FuneralF1127691      250222","","126.5","","1325581.39"
"2025-02-28","2025-02-24","SF FuneralFDC0000000640K250224","","126.5","","1325707.89"
"2025-02-28","2025-02-24","SF FuneralFDC000000079KK250224","","126.5","","1325834.39"
"2025-02-28","2025-02-24","SF FuneralFDC0000000HZBN250224","","278.31","","1326112.7"
"2025-02-28","2025-02-25","SF FuneralFDC00000007MPH250225","","126.5","","1326239.2"
"2025-02-28","2025-02-25","SF FuneralF816652       250225","","126.5","","1326365.7"
"2025-02-28","2025-02-25","SF FuneralF830100       250225","","63.25","","1326428.95"
"2025-02-28","2025-02-25","SF FuneralF1060636      250225","","63.25","","1326492.2"
"2025-02-28","2025-02-25","SF FuneralF1112423      250225","","126.5","","1326618.7"
"2025-02-28","2025-02-25","SF FuneralF1123396      250225","","63.25","","1326681.95"
"2025-02-28","2025-02-25","SF FuneralF1127895      250225","","126.5","","1326808.45"
"2025-02-28","2025-02-26","SF FuneralFDC0000000JCRJ250226","","126.5","","1326934.95"
"2025-02-28","2025-02-27","SF FuneralFDC00000005L0M250227","","126.5","","1327061.45"
"2025-02-28","2025-02-28","SF FuneralFDC00000003VHJ250228","","220","","1327281.45"
"2025-02-28","2025-02-28","SF FuneralFDC0000000673Y250228","","126.5","","1327407.95"
"2025-02-28","2025-02-28","SF FuneralFDC0000000694T250228","","126.5","","1327534.45"
"2025-02-28","2025-02-28","SF FuneralFDC00000007RZ3250228","","126.5","","1327660.95"
"2025-02-28","2025-02-28","SF FuneralF822797       250228","","126.5","","1327787.45"
"2025-02-28","2025-02-28","SF FuneralF901237       250228","","126.5","","1327913.95"
"2025-02-28","2025-02-28","SF FuneralF981545       250228","","126.5","","1328040.45"
"2025-02-28","2025-02-28","SF FuneralF990097       250301","","126.5","","1328166.95"
"2025-02-28","2025-02-28","SF FuneralF1050787      250228","","126.5","","1328293.45"
"2025-02-28","2025-02-28","SF FuneralF1066455      250228","","126.5","","1328419.95"
"2025-02-28","2025-02-28","SF FuneralF1085227      250228","","126.5","","1328546.45"
"2025-02-28","2025-02-28","SF FuneralF1129307      250228","","126.5","","1328672.95"
"2025-02-28","2025-02-17","Rev SF FuneralFDC0000000KLNT250217","","-126.5","","1328546.45"
"2025-02-28","2025-02-28","Fee-Teller Transactions","","-21.18","","1328525.27"
"2025-02-28","2025-02-28","Dep-Cash-SFTDC2023823084","","426.5","21.18","1328951.77"
"2025-02-28","2025-02-28","Fee-Teller Transactions","","-14.8","","1328936.97"
"2025-02-28","2025-02-28","Dep-Cash-SFTDC2023823084","","220","14.8","1329156.97"
"2025-02-28","2025-02-21","SF FuneralF1121784      250221","","126.5","","1329283.47"
"2025-02-28","2025-02-22","SF FuneralFDC000000063FG250222","","126.5","","1329409.97"
"2025-02-28","2025-02-22","SF FuneralF803273       250222","","126.5","","1329536.47"
"2025-02-28","2025-02-22","SF FuneralF842461       250222","","126.5","","1329662.97"
"2025-02-28","2025-02-22","SF FuneralF1059294      250223","","126.5","","1329789.47"
"2025-02-28","2025-02-22","SF FuneralF1085063      250222","","126.5","","1329915.97"
"2025-02-28","2025-02-22","SF FuneralFDC0000000NB6T250222","","126.5","","1330042.47"
"2025-02-28","2025-02-22","SF FuneralF1127571      250222","","126.5","","1330168.97"
"2025-02-28","2025-02-24","SF FuneralFDC00000006WS3250224","","126.5","","1330295.47"
"2025-02-28","2025-02-24","SF FuneralF823488       250224","","126.5","","1330421.97"
"2025-02-28","2025-02-25","SF FuneralFDC00000006WH1250225","","126.5","","1330548.47"
"2025-02-28","2025-02-25","SF FuneralFDC00000007MMW250225","","126.5","","1330674.97"
"2025-02-28","2025-02-25","SF FuneralF830783       250225","","63.25","","1330738.22"
"2025-02-28","2025-02-25","SF FuneralF1050745      250225","","126.5","","1330864.72"
"2025-02-28","2025-02-25","SF FuneralF1120589      250225","","126.5","","1330991.22"
"2025-02-28","2025-02-25","SF FuneralF1130722      250225","","126.5","","1331117.72"
"2025-02-28","2025-02-25","SF FuneralF1130876      250225","","126.5","","1331244.22"
"2025-02-28","2025-02-25","SF FuneralF1131670      250225","","126.5","","1331370.72"
"2025-02-28","2025-02-26","SF FuneralF1120542      250226","","126.5","","1331497.22"
"2025-02-28","2025-02-27","SF FuneralF827817       250227","","126.5","","1331623.72"
"2025-02-28","2025-02-27","SF FuneralF1079079      250227","","126.5","","1331750.22"
"2025-02-28","2025-02-27","SF FuneralF1102888      250227","","126.5","","1331876.72"
"2025-02-28","2025-02-27","SF FuneralF1118453      250227","","126.5","","1332003.22"
"2025-02-28","2025-02-27","SF FuneralFDC0000000P31J250227","","126.5","","1332129.72"
"2025-02-28","2025-02-27","SF FuneralFDC0000000P31N250227","","126.5","","1332256.22"
"2025-02-28","2025-02-27","SF FuneralF1127928      250227","","126.5","","1332382.72"
"2025-02-28","2025-02-28","SF FuneralFDC0000000507R250228","","126.5","","1332509.22"
"2025-02-28","2025-02-28","SF FuneralFDC00000006BKR250228","","126.5","","1332635.72"
"2025-02-28","2025-02-28","SF FuneralF817261       250228","","126.5","","1332762.22"
"2025-02-28","2025-02-28","SF FuneralF817283       250228","","126.5","","1332888.72"
"2025-02-28","2025-02-28","SF FuneralF821669       250228","","126.5","","1333015.22"
"2025-02-28","2025-02-28","SF FuneralF833423       250228","","126.5","","1333141.72"
"2025-02-28","2025-02-28","SF FuneralF1126192      250228","","126.5","","1333268.22"
"2025-02-28","2025-02-28","SF FuneralF1129242      250228","","126.5","","1333394.72"
"2025-02-28","2025-02-25","SF FuneralFDC00000005X2M250225","","31.63","","1333426.35"
"2025-02-28","2025-02-25","SF FuneralFDC00000006H1Y250225","","31.63","","1333457.98"
"2025-02-28","2025-02-25","SF FuneralF990591       250225","","31.63","","1333489.61"
"2025-02-28","2025-02-25","SF FuneralF1113987      250225","","31.63","","1333521.24"
"2025-02-28","2025-02-25","SF FuneralF1118471      250225","","31.63","","1333552.87"
"2025-02-28","2025-02-25","SF FuneralF1122761      250225","","31.63","","1333584.5"
"2025-02-28","2025-02-21","SF FuneralF988847       250221","","126.5","","1333711"
"2025-02-28","2025-02-22","SF FuneralFDC000000074ZN250222","","126.5","","1333837.5"
"2025-02-28","2025-02-22","SF FuneralFDC0000000BWGJ250222","","126.5","","1333964"
"2025-02-28","2025-02-22","SF FuneralF1050860      250222","","126.5","","1334090.5"
"2025-02-28","2025-02-22","SF FuneralF1072813      250222","","126.5","","1334217"
"2025-02-28","2025-02-22","SF FuneralF1116017      250222","","126.5","","1334343.5"
"2025-02-28","2025-02-25","SF FuneralF1128669      250225","","126.5","","1334470"
"2025-02-28","2025-02-25","SF FuneralF1132374      250225","","63.25","","1334533.25"
"2025-02-28","2025-02-26","SF FuneralFDC00000002VTH250226","","220","","1334753.25"
"2025-02-28","2025-02-26","SF FuneralF1123522      250226","","126.5","","1334879.75"
"2025-02-28","2025-02-27","SF FuneralFDC00000006GSP250227","","126.5","","1335006.25"
"2025-02-28","2025-02-27","SF FuneralFDC00000009FXM250227","","126.5","","1335132.75"
"2025-02-28","2025-02-27","SF FuneralF832988       250227","","126.5","","1335259.25"
"2025-02-28","2025-02-27","SF FuneralF1058797      250227","","126.5","","1335385.75"
"2025-02-28","2025-02-28","SF FuneralF802266       250228","","126.5","","1335512.25"
"2025-02-28","2025-02-28","SF FuneralF808163       250228","","126.5","","1335638.75"
"2025-02-28","2025-02-28","SF FuneralF808747       250228","","126.5","","1335765.25"
"2025-02-28","2025-02-28","SF FuneralFDC0000000KMRL250228","","126.5","","1335891.75"
"2025-02-28","2025-02-28","SF FuneralF1108816      250228","","126.5","","1336018.25"
"2025-02-28","2025-02-28","SF FuneralF1117743      250228","","126.5","","1336144.75"
"2025-02-28","2025-02-28","SF FuneralFDC0000000PFSY250228","","126.5","","1336271.25"
"2025-02-28","2025-02-28","SF FuneralF1127831      250228","","126.5","","1336397.75"
"2025-02-28","2025-02-26","Rev SF FuneralFDC00000006WCL250226","","-126.5","","1336271.25"
"2025-02-28","2025-02-26","Rev SF FuneralFDC00000006WCW250226","","-126.5","","1336144.75"
"2025-02-28","2025-01-24","Rev SF FuneralFDC00000005QRC250124","","-63.25","","1336081.5"
"2025-02-28","2025-02-22","Rev SF FuneralFDC00000008TTC250222","","-126.5","","1335955"
"2025-02-28","2025-02-22","Rev SF FuneralFDC0000000KSYY250222","","-126.5","","1335828.5"
"2025-02-28","2025-02-28","Rev SF FuneralFDC0000000CL62250228","","-126.5","","1335702"
"2025-02-28","2025-02-28","Rev SF FuneralFDC00000005MG9250228","","-126.5","","1335575.5"
"2025-02-28","2025-02-28","Rev SF FuneralFDC00000008CY5250228","","-126.5","","1335449"
"2025-02-28","2025-02-21","Rev SF FuneralFDC00000005QRC250221","","-63.25","","1335385.75"
"2025-02-28","2025-02-28","Rev SF FuneralFDC00000005H9H250228","","-220","","1335165.75"
"2025-02-28","2025-02-28","Rev SF FuneralFDC00000006QZT250228","","-126.5","","1335039.25"
"2025-02-28","2025-02-28","Rev SF FuneralFDC00000006Y7V250228","","-220","","1334819.25"
"2025-02-28","2025-02-28","Rev SF FuneralFDC00000005RMM250228","","-220","","1334599.25"
"2025-02-28","2025-02-22","Rev SF FuneralFDC00000003D66250222","","-220","","1334379.25"
"2025-02-28","2025-02-25","Rev SF FuneralFDC00000006WH1250225","","-126.5","","1334252.75"
"2025-02-28","2025-02-25","Rev SF FuneralFDC00000007MPH250225","","-126.5","","1334126.25"
"2025-02-28","2025-02-26","Rev SF FuneralFDC00000006WCZ250226","","-126.5","","1333999.75"
"2025-02-28","2025-02-26","Rev SF FuneralFDC00000006X9Y250226","","-126.5","","1333873.25"
"2025-02-28","2025-01-24","Rev SF FuneralF818008       250128","","-126.5","","1333746.75"
"2025-02-28","2025-02-20","Rev SF FuneralFDC00000007CVJ250220","","-126.5","","1333620.25"
"2025-02-28","2025-01-24","Rev SF FuneralFDC00000007MPH250125","","-126.5","","1333493.75"
"2025-02-28","2025-02-15","Rev SF FuneralFDC00000005XG6250215","","-126.5","","1333367.25"
"2025-02-28","2025-02-22","Rev SF FuneralFDC00000006NKJ250222","","-126.5","","1333240.75"
"2025-02-28","2025-02-27","Rev SF FuneralFDC000000066NG250227","","-126.5","","1333114.25"
"2025-02-28","2025-02-27","Rev SF FuneralFDC00000005PKC250227","","-126.5","","1332987.75"
"2025-02-28","2025-02-27","Rev SF FuneralFDC0000000JG82250227","","-126.5","","1332861.25"
"2025-02-28","2025-02-27","Rev SF FuneralFDC00000008NPP250227","","-126.5","","1332734.75"
"2025-02-28","2025-02-25","Rev SF FuneralFDC00000007VFN250225","","-126.5","","1332608.25"
"2025-02-28","2025-02-25","Rev SF FuneralFDC00000007VD0250225","","-126.5","","1332481.75"
"2025-02-28","2025-02-27","Rev SF FuneralFDC000000069J2250227","","-126.5","","1332355.25"
"2025-02-28","2025-02-27","Rev SF FuneralFDC00000006KSL250227","","-126.5","","1332228.75"
"2025-02-28","2025-02-27","Rev SF FuneralFDC0000000BH67250227","","-126.5","","1332102.25"
"2025-02-28","2025-02-22","Rev SF FuneralFDC000000096MY250222","","-126.5","","1331975.75"
"2025-02-28","2025-02-27","Rev SF FuneralFDC0000000LS81250227","","-126.5","","1331849.25"
"2025-02-28","2025-02-27","Rev SF FuneralFDC00000006KSP250227","","-126.5","","1331722.75"
"2025-02-28","2025-02-22","Rev SF FuneralFDC0000000PR6H250222","","-126.5","","1331596.25"
"2025-02-28","2025-02-28","Rev SF FuneralFDC00000005V4Q250228","","-126.5","","1331469.75"
"2025-02-28","2025-02-27","Rev SF FuneralFDC0000000PXMF250227","","-126.5","","1331343.25"
"2025-02-28","2025-02-27","Rev SF FuneralFDC0000000PXMP250227","","-126.5","","1331216.75"
"2025-02-28","2025-02-27","Rev SF FuneralFDC0000000NK7F250227","","-126.5","","1331090.25"
"2025-02-28","2025-02-28","Rev SF FuneralFDC0000000L06D250228","","-126.5","","1330963.75"
"2025-02-28","2025-02-28","Rev SF FuneralFDC0000000KTDL250228","","-126.5","","1330837.25"
"2025-02-28","2025-02-27","Rev SF FuneralFDC00000008QWP250227","","-126.5","","1330710.75"
"2025-02-28","2025-02-28","Rev SF FuneralFDC00000005S6H250228","","-126.5","","1330584.25"
"2025-02-28","2025-02-27","Rev SF FuneralFDC0000000PXMK250227","","-126.5","","1330457.75"
"2025-02-28","2025-02-28","Rev SF FuneralFDC00000006MDK250228","","-126.5","","1330331.25"
"2025-02-28","2025-02-28","Rev SF FuneralFDC0000000PW8T250228","","-126.5","","1330204.75"
"2025-02-28","2025-02-28","Rev SF FuneralFDC00000007HRT250228","","-126.5","","1330078.25"
"2025-02-28","2025-02-28","Rev SF FuneralFDC00000007HRV250228","","-126.5","","1329951.75"
"2025-02-28","2025-02-28","Rev SF FuneralFDC00000007W5M250228","","-31.63","","1329920.12"
"2025-02-28","2025-02-28","Rev SF FuneralFDC0000000B37Y250228","","-31.63","","1329888.49"
"2025-02-28","2025-02-28","Rev SF FuneralFDC0000000NR30250228","","-126.5","","1329761.99"
"2025-02-28","2025-02-28","Rev SF FuneralFDC0000000JXHY250228","","-126.5","","1329635.49"
"2025-02-28","2025-02-22","Rev SF FuneralFDC00000006CLB250222","","-126.5","","1329508.99"
"2025-02-28","2025-02-28","Rev SF FuneralFDC00000008W95250228","","-126.5","","1329382.49"
"2025-02-28","2025-02-22","Rev SF FuneralFDC0000000713G250222","","-126.5","","1329255.99"
"2025-02-28","2025-02-25","Rev SF FuneralFDC000000087TS250225","","-126.5","","1329129.49"
"2025-02-28","2025-02-25","Rev SF FuneralFDC0000000HT6X250225","","-126.5","","1329002.99"
"2025-02-28","2025-01-24","Rev SF FuneralFDC0000000JXHY250128","","-126.5","","1328876.49"
"2025-02-28","2025-02-22","Rev SF FuneralFDC00000005409250222","","-126.5","","1328749.99"
"2025-02-28","2025-02-22","Rev SF FuneralFDC0000000F87P250222","","-126.5","","1328623.49"
"2025-02-28","2025-02-22","Rev SF FuneralFDC000000053ZX250222","","-126.5","","1328496.99"
"2025-02-28","2025-02-24","SF FuneralFDC00000007KWX250224","","126.5","","1328623.49"
"2025-02-28","2025-02-24","SF FuneralFDC00000008MHF250224","","126.5","","1328749.99"
"2025-02-28","2025-02-24","SF FuneralFDC0000000CSY7250224","","31.63","","1328781.62"
"2025-02-28","2025-02-21","SF FuneralF986895       250223","","126.5","","1328908.12"
"2025-02-28","2025-02-26","SF FuneralF988094       250226","","126.5","","1329034.62"
"2025-02-28","2025-02-26","SF FuneralF1108941      250226","","126.5","","1329161.12"
"2025-02-28","2025-02-22","SF FuneralF1052639      250222","","126.5","","1329287.62"
"2025-02-28","2025-02-22","SF FuneralF1060581      250223","","126.5","","1329414.12"
"2025-02-28","2025-02-22","SF FuneralFDC0000000LQKZ250223","","126.5","","1329540.62"
"2025-02-28","2025-02-22","SF FuneralF1083958      250223","","126.5","","1329667.12"
"2025-02-28","2025-02-22","SF FuneralF1118265      250223","","126.5","","1329793.62"
"2025-02-28","2025-02-22","SF FuneralF1120384      250222","","126.5","","1329920.12"
"2025-02-28","2025-02-22","SF FuneralF1122270      250222","","126.5","","1330046.62"
"2025-02-28","2025-02-21","SF FuneralFDC0000000HY4J250222","","126.5","","1330173.12"
"2025-02-28","2025-02-21","SF FuneralFDC0000000HY4N250222","","126.5","","1330299.62"
"2025-02-28","2025-02-22","SF FuneralFDC00000008HXR250222","","126.5","","1330426.12"
"2025-02-28","2025-02-22","SF FuneralF992485       250222","","126.5","","1330552.62"
"2025-02-28","2025-02-22","SF FuneralF1054856      250222","","126.5","","1330679.12"
"2025-02-28","2025-02-25","SF FuneralFDC000000061YD250225","","31.63","","1330710.75"
"2025-02-28","2025-02-25","SF FuneralFDC00000007RDL250225","","126.5","","1330837.25"
"2025-02-28","2025-02-27","SF FuneralFDC000000032DW250227","","220","","1331057.25"
"2025-02-28","2025-02-27","SF FuneralFDC00000005X3Z250227","","126.5","","1331183.75"
"2025-02-28","2025-02-27","SF FuneralFDC00000007R93250227","","126.5","","1331310.25"
"2025-02-28","2025-02-27","SF FuneralF1068173      250227","","126.5","","1331436.75"
"2025-02-28","2025-02-28","SF FuneralF1068021      250228","","126.5","","1331563.25"
"2025-02-28","2025-02-27","SF FuneralFDC00000005CNV250227","","365.12","","1331928.37"
"2025-02-28","2025-02-27","SF FuneralFDC00000005GZP250227","","126.5","","1332054.87"
"2025-02-28","2025-02-27","SF FuneralFDC000000065T8250227","","126.5","","1332181.37"
"2025-02-28","2025-02-27","SF FuneralFDC00000006YKF250227","","126.5","","1332307.87"
"2025-02-28","2025-02-27","SF FuneralF812325       250227","","126.5","","1332434.37"
"2025-02-28","2025-02-27","SF FuneralF812575       250227","","126.5","","1332560.87"
"2025-02-28","2025-02-27","SF FuneralF827814       250227","","126.5","","1332687.37"
"2025-02-28","2025-02-27","SF FuneralFDC0000000BX71250227","","126.5","","1332813.87"
"2025-02-28","2025-02-27","SF FuneralF831772       250227","","126.5","","1332940.37"
"2025-02-28","2025-02-27","SF FuneralF843243       250227","","126.5","","1333066.87"
"2025-02-28","2025-02-27","SF FuneralFDC0000000HJT5250227","","126.5","","1333193.37"
"2025-02-28","2025-02-27","SF FuneralF1055326      250227","","126.5","","1333319.87"
"2025-02-28","2025-02-27","SF FuneralF1112441      250227","","126.5","","1333446.37"
"2025-02-28","2025-02-27","SF FuneralF1120819      250227","","126.5","","1333572.87"
"2025-02-28","2025-02-27","SF FuneralF1123074      250227","","126.5","","1333699.37"
"2025-02-28","2025-02-27","SF FuneralFDC0000000P3MJ250227","","126.5","","1333825.87"
"2025-02-28","2025-02-27","SF FuneralFDC0000000P3MY250227","","126.5","","1333952.37"
"2025-02-28","2025-02-27","SF FuneralFDC0000000P5G5250227","","126.5","","1334078.87"
"2025-02-28","2025-02-23","SF FuneralF803714       250223","","126.5","","1334205.37"
"2025-02-28","2025-02-25","SF FuneralF1123027      250225","","31.63","","1334237"
"2025-02-28","2025-02-22","Rev SF FuneralFDC00000008G40250222","","-126.5","","1334110.5"
"2025-02-28","2025-01-22","Rev SF FuneralFDC00000008G40250122","","-126.5","","1333984"
"2025-02-28","2025-01-24","Rev SF FuneralF1073123      250128","","-126.5","","1333857.5"
"2025-02-28","2025-02-28","Rev SF FuneralFDC00000006Y2R250228","","-126.5","","1333731"
"2025-02-28","2025-01-17","Rev SF FuneralFDC00000006CXK250117","","-126.5","","1333604.5"
"2025-02-28","2025-02-17","Rev SF FuneralFDC00000006CXK250217","","-126.5","","1333478"
"2025-02-28","2025-02-28","SF FuneralFDC00000007326250228","","126.5","","1333604.5"
"2025-02-28","2025-02-28","SF FuneralFDC000000078SQ250228","","126.5","","1333731"
"2025-02-28","2025-02-28","SF FuneralF1116990      250228","","126.5","","1333857.5"
"2025-02-28","2025-02-28","SF FuneralF1118280      250228","","126.5","","1333984"
"2025-02-28","2025-02-28","SF FuneralFDC00000005G7P250228","","126.5","","1334110.5"
"2025-02-28","2025-02-28","SF FuneralFDC00000005R18250228","","126.5","","1334237"
"2025-02-28","2025-02-28","SF FuneralF797555       250228","","126.5","","1334363.5"
"2025-02-28","2025-02-28","SF FuneralF821794       250228","","126.5","","1334490"
"2025-02-28","2025-02-28","SF FuneralF821850       250228","","126.5","","1334616.5"
"2025-02-28","2025-02-28","SF FuneralF794461       250228","","126.5","","1334743"
"2025-02-28","2025-02-28","SF FuneralF831938       250228","","126.5","","1334869.5"
"2025-02-28","2025-02-28","SF FuneralF843119       250228","","126.5","","1334996"
"2025-02-28","2025-02-28","SF FuneralF901251       250228","","126.5","","1335122.5"
"2025-02-28","2025-02-28","SF FuneralF1068043      250228","","126.5","","1335249"
"2025-02-28","2025-02-28","SF FuneralF1123302      250228","","126.5","","1335375.5"
"2025-02-28","2025-02-28","SF FuneralF1128207      250228","","126.5","","1335502"
"2025-02-28","2025-02-28","SF FuneralF1129847      250228","","126.5","","1335628.5"
"2025-02-28","2025-02-25","SF FuneralFDC0000000595N250225","","31.62","","1335660.12"
"2025-02-28","2025-02-25","SF FuneralFDC000000061NF250225","","31.63","","1335691.75"
"2025-02-28","2025-02-25","SF FuneralFDC000000085C1250225","","126.5","","1335818.25"
"2025-02-28","2025-02-25","SF FuneralF809001       250225","","126.5","","1335944.75"
"2025-02-28","2025-02-25","SF FuneralF809435       250225","","31.63","","1335976.38"
"2025-02-28","2025-02-25","SF FuneralF827942       250225","","126.5","","1336102.88"
"2025-02-28","2025-02-25","SF FuneralF829557       250225","","31.63","","1336134.51"
"2025-02-28","2025-02-25","SF FuneralF986694       250225","","31.63","","1336166.14"
"2025-02-28","2025-02-25","SF FuneralF987161       250225","","63.25","","1336229.39"
"2025-02-28","2025-02-25","SF FuneralFDC0000000J23L250225","","31.63","","1336261.02"
"2025-02-28","2025-02-25","SF FuneralF1022115      250225","","31.63","","1336292.65"
"2025-02-28","2025-02-25","SF FuneralF1050752      250225","","126.5","","1336419.15"
"2025-02-28","2025-02-25","SF FuneralF1052200      250225","","31.63","","1336450.78"
"2025-02-28","2025-02-25","SF FuneralF843649       250225","","31.63","","1336482.41"
"2025-02-28","2025-02-25","SF FuneralF1061075      250225","","31.63","","1336514.04"
"2025-02-28","2025-02-25","SF FuneralF1068023      250225","","31.63","","1336545.67"
"2025-02-28","2025-02-25","SF FuneralF1111329      250225","","31.63","","1336577.3"
"2025-02-28","2025-02-25","SF FuneralF1111658      250225","","63.25","","1336640.55"
"2025-02-28","2025-02-25","SF FuneralF1117702      250225","","31.63","","1336672.18"
"2025-02-28","2025-02-25","SF FuneralF820999       250225","","31.63","","1336703.81"
"2025-02-28","2025-02-25","SF FuneralF1125142      250225","","31.63","","1336735.44"
"2025-02-28","2025-02-25","SF FuneralF990319       250225","","160.75","","1336896.19"
"2025-02-28","2025-02-25","SF FuneralF1130345      250225","","31.63","","1336927.82"
"2025-02-28","2025-02-25","SF FuneralF1131995      250225","","126.5","","1337054.32"
"2025-02-28","2025-02-22","SF FuneralF1083728      250223","","126.5","","1337180.82"
"2025-02-28","2025-02-22","SF FuneralF1117602      250222","","126.5","","1337307.32"
"2025-02-28","2025-02-22","SF FuneralF1121898      250222","","126.5","","1337433.82"
"2025-02-28","2025-02-24","SF FuneralFDC00000006RJX250224","","126.5","","1337560.32"
"2025-02-28","2025-02-24","SF FuneralFDC000000079DD250224","","126.5","","1337686.82"
"2025-02-28","2025-02-24","SF FuneralFDC00000007FPS250224","","31.63","","1337718.45"
"2025-02-28","2025-02-24","SF FuneralFDC00000007M01250224","","126.5","","1337844.95"
"2025-02-28","2025-02-25","SF FuneralF818397       250225","","126.5","","1337971.45"
"2025-02-28","2025-02-25","SF FuneralF843616       250225","","63.25","","1338034.7"
"2025-02-28","2025-02-25","SF FuneralF989085       250225","","31.63","","1338066.33"
"2025-02-28","2025-02-25","SF FuneralF1084995      250225","","31.63","","1338097.96"
"2025-02-28","2025-02-25","SF FuneralF1125405      250225","","126.5","","1338224.46"
"2025-02-28","2025-02-25","SF FuneralF1126864      250225","","126.5","","1338350.96"
"2025-02-28","2025-02-25","SF FuneralF1129002      250225","","126.5","","1338477.46"
"2025-02-28","2025-02-25","SF FuneralF1129385      250225","","126.5","","1338603.96"
"2025-02-28","2025-02-26","SF FuneralFDC0000000H86X250226","","126.5","","1338730.46"
"2025-02-28","2025-02-26","SF FuneralF1021156      250226","","126.5","","1338856.96"
"2025-02-28","2025-02-27","SF FuneralFDC000000030KZ250227","","220","","1339076.96"
"2025-02-28","2025-02-27","SF FuneralFDC00000005GJ0250227","","126.5","","1339203.46"
"2025-02-28","2025-02-27","SF FuneralFDC000000061W8250227","","126.5","","1339329.96"
"2025-02-28","2025-02-27","SF FuneralFDC000000084B2250227","","126.5","","1339456.46"
"2025-02-28","2025-02-27","SF FuneralF819975       250227","","126.5","","1339582.96"
"2025-02-28","2025-02-27","SF FuneralF829612       250227","","126.5","","1339709.46"
"2025-02-28","2025-02-27","SF FuneralF841857       250227","","126.5","","1339835.96"
"2025-02-28","2025-02-27","SF FuneralF842107       250227","","126.5","","1339962.46"
"2025-02-28","2025-02-27","SF FuneralF1113598      250227","","126.5","","1340088.96"
"2025-02-28","2025-02-28","SF FuneralF1050815      250228","","126.5","","1340215.46"
"2025-02-28","2025-02-28","SF FuneralF1126115      250228","","126.5","","1340341.96"
"2025-02-28","2025-02-28","SF FuneralF1127958      250228","","126.5","","1340468.46"
"2025-02-28","2025-02-22","Rev SF FuneralFDC00000003H19250222","","-220.01","","1340248.45"
"2025-02-28","2025-02-28","EFT-ABSA BANK 5006010045088","","126","","1340374.45"
"2025-02-28","2025-02-28","Fee-Administration","","-100","","1340274.45"
