"Txn date","Effective","Description","Truncated card number","Amount","Charges","Balance"
"2025-03-23","2025-03-17","SF FuneralFDC0000000756L250316","","31.63","","485206.38"
"2025-03-23","2025-03-17","SF FuneralFDC0000000Q9HH250317","","31.63","","485238.01"
"2025-03-23","2025-03-18","SF FuneralF990432       250318","","126.5","","485364.51"
"2025-03-23","2025-03-19","SF FuneralF1127823      250319","","126.5","","485491.01"
"2025-03-23","2025-03-20","SF FuneralFDC00000005RTM250320","","220","","485711.01"
"2025-03-23","2025-03-20","SF FuneralF990274       250322","","126.5","","485837.51"
"2025-03-23","2025-03-20","SF FuneralF1079649      250320","","126.5","","485964.01"
"2025-03-23","2025-03-22","SF FuneralFDC00000007KDV250322","","126.5","","486090.51"
"2025-03-23","2025-03-22","SF FuneralFDC000000086P0250322","","126.5","","486217.01"
"2025-03-23","2025-03-22","SF FuneralFDC00000008H1L250322","","126.5","","486343.51"
"2025-03-23","2025-03-22","SF FuneralFDC00000008H1M250322","","126.5","","486470.01"
"2025-03-23","2025-03-22","SF FuneralF816739       250322","","126.5","","486596.51"
"2025-03-23","2025-03-22","SF FuneralFDC0000000B439250322","","126.5","","486723.01"
"2025-03-23","2025-03-22","SF FuneralFDC0000000BNCC250322","","126.5","","486849.51"
"2025-03-23","2025-03-22","SF FuneralFDC0000000BVXW250322","","126.5","","486976.01"
"2025-03-23","2025-03-22","SF FuneralF1124823      250322","","126.5","","487102.51"
"2025-03-23","2025-03-18","SF FuneralF989170       250318","","63.25","","487165.76"
"2025-03-23","2025-03-22","SF FuneralFDC00000009JQJ250322","","126.5","","487292.26"
"2025-03-23","2025-03-22","SF FuneralF814925       250322","","126.5","","487418.76"
"2025-03-23","2025-03-22","SF FuneralFDC0000000LNQZ250322","","126.5","","487545.26"
"2025-03-23","2025-03-22","SF FuneralF1127636      250322","","126.5","","487671.76"
"2025-03-23","2025-03-20","SF FuneralF988179       250320","","126.5","","487798.26"
"2025-03-23","2025-03-20","SF FuneralFDC0000000J3VD250323","","126.5","","487924.76"
"2025-03-23","2025-03-20","SF FuneralF1104192      250320","","126.5","","488051.26"
"2025-03-23","2025-03-22","SF FuneralF778484       250322","","126.5","","488177.76"
"2025-03-23","2025-03-22","SF FuneralF832336       250322","","126.5","","488304.26"
"2025-03-23","2025-03-22","SF FuneralF833907       250322","","126.5","","488430.76"
"2025-03-23","2025-03-22","SF FuneralF842381       250322","","126.5","","488557.26"
"2025-03-23","2025-03-22","SF FuneralF1017837      250322","","126.5","","488683.76"
"2025-03-23","2025-03-22","SF FuneralF1054538      250322","","126.5","","488810.26"
"2025-03-23","2025-03-22","SF FuneralFDC0000000LPZL250322","","126.5","","488936.76"
"2025-03-23","2025-03-22","SF FuneralF1118890      250322","","126.5","","489063.26"
"2025-03-23","2025-03-22","SF FuneralF1135103      250323","","126.5","","489189.76"
"2025-03-23","2025-03-18","SF FuneralF822857       250318","","126.5","","489316.26"
"2025-03-23","2025-03-19","SF FuneralFDC0000000873B250319","","126.5","","489442.76"
"2025-03-23","2025-03-19","SF FuneralF1127493      250319","","31.63","","489474.39"
"2025-03-23","2025-03-20","SF FuneralFDC00000005R3Q250320","","126.5","","489600.89"
"2025-03-23","2025-03-20","SF FuneralFDC00000006339250320","","126.5","","489727.39"
"2025-03-23","2025-03-20","SF FuneralF1078056      250321","","31.63","","489759.02"
"2025-03-23","2025-03-22","SF FuneralFDC000000034JT250322","","220","","489979.02"
"2025-03-23","2025-03-22","SF FuneralFDC00000005GWY250322","","126.5","","490105.52"
"2025-03-23","2025-03-22","SF FuneralFDC00000005HCN250322","","126.5","","490232.02"
"2025-03-23","2025-03-22","SF FuneralFDC00000005SD7250322","","126.5","","490358.52"
"2025-03-23","2025-03-22","SF FuneralFDC0000000697X250322","","126.5","","490485.02"
"2025-03-23","2025-03-22","SF FuneralFDC00000006BCN250322","","126.5","","490611.52"
"2025-03-23","2025-03-22","SF FuneralF804495       250322","","126.5","","490738.02"
"2025-03-23","2025-03-22","SF FuneralFDC00000008TTC250322","","126.5","","490864.52"
"2025-03-23","2025-03-22","SF FuneralF832185       250321","","31.63","","490896.15"
"2025-03-23","2025-03-22","SF FuneralF842750       250321","","126.5","","491022.65"
"2025-03-23","2025-03-22","SF FuneralFDC0000000JD04250322","","126.5","","491149.15"
"2025-03-23","2025-03-22","SF FuneralF1020826      250322","","126.5","","491275.65"
"2025-03-23","2025-03-22","SF FuneralFDC0000000K4YT250322","","126.5","","491402.15"
"2025-03-23","2025-03-22","SF FuneralF1054773      250322","","126.5","","491528.65"
"2025-03-23","2025-03-22","SF FuneralFDC0000000LF6T250322","","126.5","","491655.15"
"2025-03-23","2025-03-22","SF FuneralF1084539      250323","","31.63","","491686.78"
"2025-03-23","2025-03-22","SF FuneralFDC0000000NFML250322","","126.5","","491813.28"
"2025-03-23","2025-03-22","SF FuneralFDC0000000NVX8250322","","126.5","","491939.78"
"2025-03-23","2025-03-22","SF FuneralF1130341      250322","","126.5","","492066.28"
"2025-03-23","2025-03-22","SF FuneralFDC00000002XNK250322","","220","","492286.28"
"2025-03-23","2025-03-22","SF FuneralFDC000000061R7250322","","126.5","","492412.78"
"2025-03-23","2025-03-22","SF FuneralF801566       250322","","126.5","","492539.28"
"2025-03-23","2025-03-22","SF FuneralF1120783      250322","","126.5","","492665.78"
"2025-03-23","2025-03-22","SF FuneralF1120753      250322","","126.5","","492792.28"
"2025-03-23","2025-03-22","SF FuneralF1127325      250322","","126.5","","492918.78"
"2025-03-23","2025-03-20","SF FuneralF832011       250320","","63.25","","492982.03"
"2025-03-23","2025-03-20","SF FuneralF840625       250320","","126.5","","493108.53"
"2025-03-23","2025-03-17","SF FuneralF808988       250317","","31.63","","493140.16"
"2025-03-23","2025-03-18","SF FuneralF1073281      250318","","63.25","","493203.41"
"2025-03-23","2025-03-22","SF FuneralFDC00000007BHX250322","","126.5","","493329.91"
"2025-03-23","2025-03-22","SF FuneralFDC00000008W9F250322","","126.5","","493456.41"
"2025-03-23","2025-03-22","SF FuneralF814211       250322","","31.63","","493488.04"
"2025-03-23","2025-03-22","SF FuneralF823750       250321","","31.63","","493519.67"
"2025-03-23","2025-03-22","SF FuneralF833650       250322","","126.5","","493646.17"
"2025-03-23","2025-03-22","SF FuneralF1074570      250322","","126.5","","493772.67"
"2025-03-23","2025-03-22","SF FuneralF1079718      250322","","126.5","","493899.17"
"2025-03-23","2025-03-22","SF FuneralF1109885      250322","","126.5","","494025.67"
"2025-03-23","2025-03-22","SF FuneralFDC0000000NPH3250322","","126.5","","494152.17"
"2025-03-23","2025-03-22","SF FuneralF1128980      250322","","126.5","","494278.67"
"2025-03-23","2025-03-22","SF FuneralF1130825      250322","","31.63","","494310.3"
"2025-03-23","2025-03-23","SF FuneralF803714       250323","","126.5","","494436.8"
"2025-03-23","2025-03-23","SF FuneralF812335       250323","","126.5","","494563.3"
"2025-03-23","2025-03-23","SF FuneralF831418       250323","","126.5","","494689.8"
"2025-03-23","2025-03-23","SF FuneralF833253       250323","","31.63","","494721.43"
"2025-03-23","2025-03-23","SF FuneralF840458       250323","","126.5","","494847.93"
"2025-03-23","2025-03-16","SF FuneralFDC00000008V16250316","","126.5","","494974.43"
"2025-03-23","2025-03-18","SF FuneralFDC00000007CPB250318","","31.63","","495006.06"
"2025-03-23","2025-03-22","SF FuneralFDC0000000JZDF250322","","126.5","","495132.56"
"2025-03-23","2025-03-22","SF FuneralF1113994      250322","","126.5","","495259.06"
"2025-03-23","2025-03-22","SF FuneralF1132368      250322","","126.5","","495385.56"
"2025-03-23","2025-03-22","SF FuneralF1129067      250322","","126.5","","495512.06"
"2025-03-23","2025-03-20","SF FuneralF1112400      250320","","126.5","","495638.56"
"2025-03-23","2025-03-22","SF FuneralF805717       250322","","126.5","","495765.06"
"2025-03-23","2025-03-22","SF FuneralF828166       250322","","126.5","","495891.56"
"2025-03-23","2025-03-22","SF FuneralF1074868      250322","","126.5","","496018.06"
"2025-03-23","2025-03-22","SF FuneralF1112455      250323","","126.5","","496144.56"
"2025-03-23","2025-03-22","SF FuneralFDC00000007W4F250322","","126.5","","496271.06"
"2025-03-23","2025-03-22","SF FuneralFDC0000000BL93250322","","126.5","","496397.56"
"2025-03-24","2025-03-22","SF FuneralFDC00000007098250322","","126.5","","496524.06"
"2025-03-24","2025-03-22","SF FuneralFDC000000073LP250322","","126.5","","496650.56"
"2025-03-24","2025-03-22","SF FuneralFDC00000008TZK250322","","126.5","","496777.06"
"2025-03-24","2025-03-22","SF FuneralF817548       250322","","126.5","","496903.56"
"2025-03-24","2025-03-22","SF FuneralF832267       250322","","126.5","","497030.06"
"2025-03-24","2025-03-22","SF FuneralF993651       250322","","126.5","","497156.56"
"2025-03-24","2025-03-22","SF FuneralF1078516      250322","","126.5","","497283.06"
"2025-03-24","2025-03-22","SF FuneralF1079244      250322","","126.5","","497409.56"
"2025-03-24","2025-03-22","SF FuneralF1129200      250322","","126.5","","497536.06"
"2025-03-24","2025-03-22","SF FuneralF1130667      250322","","126.5","","497662.56"
"2025-03-24","2025-03-20","SF FuneralFDC00000007C8J250320","","126.5","","497789.06"
"2025-03-24","2025-03-20","SF FuneralFDC0000000JM55250320","","126.5","","497915.56"
"2025-03-24","2025-03-20","SF FuneralF1017774      250320","","126.5","","498042.06"
"2025-03-24","2025-03-22","SF FuneralF833825       250322","","126.5","","498168.56"
"2025-03-24","2025-03-22","SF FuneralF1108714      250322","","126.5","","498295.06"
"2025-03-24","2025-03-22","SF FuneralFDC0000000NXVF250323","","126.5","","498421.56"
"2025-03-24","2025-03-22","SF FuneralF1120649      250323","","126.5","","498548.06"
"2025-03-24","2025-03-22","SF FuneralF1130765      250322","","126.5","","498674.56"
"2025-03-24","2025-03-19","SF FuneralFDC00000003Q8Z250319","","220","","498894.56"
"2025-03-24","2025-03-22","SF FuneralF798432       250322","","126.5","","499021.06"
"2025-03-24","2025-03-22","SF FuneralF1126282      250322","","126.5","","499147.56"
"2025-03-24","2025-03-22","SF FuneralFDC00000007GR6250322","","31.63","","499179.19"
"2025-03-24","2025-03-18","SF FuneralF834645       250318","","31.63","","499210.82"
"2025-03-24","2025-03-22","SF FuneralFDC0000000611J250322","","126.5","","499337.32"
"2025-03-24","2025-03-22","SF FuneralF1124381      250323","","126.5","","499463.82"
"2025-03-24","2025-03-22","SF FuneralF1130679      250322","","126.5","","499590.32"
"2025-03-24","2025-03-17","SF FuneralF1052805      250317","","126.5","","499716.82"
"2025-03-24","2025-03-18","SF FuneralF830587       250318","","63.25","","499780.07"
"2025-03-24","2025-03-20","SF FuneralF1073760      250321","","126.5","","499906.57"
"2025-03-24","2025-03-22","SF FuneralF815772       250322","","126.5","","500033.07"
"2025-03-24","2025-03-22","SF FuneralF1067956      250322","","126.5","","500159.57"
"2025-03-24","2025-03-22","SF FuneralF779346       250321","","31.63","","500191.2"
"2025-03-24","2025-03-20","SF FuneralF831016       250320","","126.5","","500317.7"
"2025-03-24","2025-03-20","SF FuneralF834045       250320","","126.5","","500444.2"
"2025-03-24","2025-03-20","SF FuneralFDC0000000L8B0250321","","31.63","","500475.83"
"2025-03-24","2025-03-20","SF FuneralF1126874      250321","","31.63","","500507.46"
"2025-03-24","2025-03-20","SF FuneralFDC0000000Q065250321","","126.5","","500633.96"
"2025-03-24","2025-03-20","SF FuneralF1132992      250320","","126.5","","500760.46"
"2025-03-24","2025-03-22","SF FuneralFDC00000003332250322","","220","","500980.46"
"2025-03-24","2025-03-22","SF FuneralFDC00000003XLZ250321","","220","","501200.46"
"2025-03-24","2025-03-22","SF FuneralFDC00000004C5R250322","","220","","501420.46"
"2025-03-24","2025-03-22","SF FuneralFDC000000060P0250322","","126.5","","501546.96"
"2025-03-24","2025-03-22","SF FuneralFDC00000006PSF250321","","31.63","","501578.59"
"2025-03-24","2025-03-22","SF FuneralFDC00000006SQF250322","","126.5","","501705.09"
"2025-03-24","2025-03-22","SF FuneralF822267       250321","","31.63","","501736.72"
"2025-03-24","2025-03-22","SF FuneralF1060968      250323","","31.63","","501768.35"
"2025-03-24","2025-03-22","SF FuneralF1116790      250322","","126.5","","501894.85"
"2025-03-24","2025-03-24","SF FuneralFDC00000003HCL250324","","220","","502114.85"
"2025-03-24","2025-03-24","SF FuneralFDC00000005F2L250323","","126.5","","502241.35"
"2025-03-24","2025-03-24","SF FuneralFDC00000005H8J250323","","31.63","","502272.98"
"2025-03-24","2025-03-24","SF FuneralFDC00000006N6D250324","","126.5","","502399.48"
"2025-03-24","2025-03-24","SF FuneralFDC00000007MJH250324","","126.5","","502525.98"
"2025-03-24","2025-03-24","SF FuneralF789266       250324","","126.5","","502652.48"
"2025-03-24","2025-03-24","SF FuneralF843842       250324","","63.25","","502715.73"
"2025-03-24","2025-03-24","SF FuneralFDC0000000GBJJ250322","","126.5","","502842.23"
"2025-03-24","2025-03-24","SF FuneralF1114923      250324","","126.5","","502968.73"
"2025-03-24","2025-03-24","SF FuneralF1130798      250324","","126.5","","503095.23"
"2025-03-24","2025-03-20","SF FuneralFDC0000000HBD0250321","","31.63","","503126.86"
"2025-03-24","2025-03-20","SF FuneralF774474       250321","","156.28","","503283.14"
"2025-03-24","2025-03-20","SF FuneralF986934       250321","","31.63","","503314.77"
"2025-03-24","2025-03-20","SF FuneralFDC0000000HXHK250321","","47.88","","503362.65"
"2025-03-24","2025-03-20","SF FuneralFDC0000000J2XM250323","","31.63","","503394.28"
"2025-03-24","2025-03-20","SF FuneralF992752       250321","","31.63","","503425.91"
"2025-03-24","2025-03-20","SF FuneralF993205       250321","","31.63","","503457.54"
"2025-03-24","2025-03-20","SF FuneralF993478       250321","","31.63","","503489.17"
"2025-03-24","2025-03-20","SF FuneralFDC0000000JFC4250321","","31.63","","503520.8"
"2025-03-24","2025-03-20","SF FuneralF1033620      250321","","31.63","","503552.43"
"2025-03-24","2025-03-20","SF FuneralF1052348      250321","","31.63","","503584.06"
"2025-03-24","2025-03-20","SF FuneralFDC0000000K7CQ250321","","31.63","","503615.69"
"2025-03-24","2025-03-20","SF FuneralFDC0000000KLCD250321","","31.63","","503647.32"
"2025-03-24","2025-03-20","SF FuneralF1061613      250321","","31.63","","503678.95"
"2025-03-24","2025-03-20","SF FuneralF1065649      250321","","31.63","","503710.58"
"2025-03-24","2025-03-20","SF FuneralF1068145      250321","","31.63","","503742.21"
"2025-03-24","2025-03-20","SF FuneralF1072884      250321","","31.63","","503773.84"
"2025-03-24","2025-03-20","SF FuneralFDC0000000L3MT250321","","31.63","","503805.47"
"2025-03-24","2025-03-20","SF FuneralF1080183      250321","","31.63","","503837.1"
"2025-03-24","2025-03-20","SF FuneralF1084400      250321","","31.63","","503868.73"
"2025-03-24","2025-03-20","SF FuneralF1085168      250320","","31.63","","503900.36"
"2025-03-24","2025-03-20","SF FuneralF1104196      250321","","31.63","","503931.99"
"2025-03-24","2025-03-20","SF FuneralF1104243      250321","","31.63","","503963.62"
"2025-03-24","2025-03-20","SF FuneralF1108113      250320","","31.63","","503995.25"
"2025-03-24","2025-03-20","SF FuneralF1115119      250321","","31.63","","504026.88"
"2025-03-24","2025-03-20","SF FuneralFDC0000000NNGY250321","","31.63","","504058.51"
"2025-03-24","2025-03-20","SF FuneralF1122752      250321","","31.63","","504090.14"
"2025-03-24","2025-03-20","SF FuneralF1123008      250321","","31.63","","504121.77"
"2025-03-24","2025-03-20","SF FuneralF1127351      250321","","31.63","","504153.4"
"2025-03-24","2025-03-20","SF FuneralF1130369      250321","","31.63","","504185.03"
"2025-03-24","2025-03-20","SF FuneralF1130684      250321","","31.63","","504216.66"
"2025-03-24","2025-03-20","SF FuneralF1131924      250321","","31.63","","504248.29"
"2025-03-24","2025-03-20","SF FuneralFDC0000000Q7FQ250321","","31.63","","504279.92"
"2025-03-24","2025-03-20","SF FuneralF1132194      250321","","31.63","","504311.55"
"2025-03-24","2025-03-20","SF FuneralFDC0000000Q9Z0250321","","31.63","","504343.18"
"2025-03-24","2025-03-20","SF FuneralF1132933      250321","","31.63","","504374.81"
"2025-03-24","2025-03-20","SF FuneralF1134821      250321","","31.63","","504406.44"
"2025-03-24","2025-03-20","SF FuneralF1135092      250321","","31.63","","504438.07"
"2025-03-24","2025-03-22","SF FuneralFDC00000005GY1250321","","31.63","","504469.7"
"2025-03-24","2025-03-22","SF FuneralFDC00000005PXF250321","","31.63","","504501.33"
"2025-03-24","2025-03-22","SF FuneralFDC00000005QCT250321","","31.63","","504532.96"
"2025-03-24","2025-03-22","SF FuneralFDC00000005V4S250321","","31.63","","504564.59"
"2025-03-24","2025-03-22","SF FuneralFDC000000069RZ250321","","31.63","","504596.22"
"2025-03-24","2025-03-22","SF FuneralFDC00000006HHY250322","","31.63","","504627.85"
"2025-03-24","2025-03-22","SF FuneralFDC00000006R81250321","","31.63","","504659.48"
"2025-03-24","2025-03-22","SF FuneralFDC00000007MW5250321","","31.63","","504691.11"
"2025-03-24","2025-03-22","SF FuneralFDC00000007Q48250321","","31.63","","504722.74"
"2025-03-24","2025-03-22","SF FuneralFDC00000007WBL250321","","31.63","","504754.37"
"2025-03-24","2025-03-22","SF FuneralFDC00000007WJL250321","","31.63","","504786"
"2025-03-24","2025-03-22","SF FuneralF795812       250321","","31.63","","504817.63"
"2025-03-24","2025-03-22","SF FuneralFDC000000086Y9250321","","31.63","","504849.26"
"2025-03-24","2025-03-22","SF FuneralFDC00000008NYM250321","","31.63","","504880.89"
"2025-03-24","2025-03-22","SF FuneralF790399       250321","","47.88","","504928.77"
"2025-03-24","2025-03-22","SF FuneralF811119       250321","","31.63","","504960.4"
"2025-03-24","2025-03-22","SF FuneralF813030       250321","","31.63","","504992.03"
"2025-03-24","2025-03-22","SF FuneralF815340       250321","","31.63","","505023.66"
"2025-03-24","2025-03-22","SF FuneralF817463       250321","","31.63","","505055.29"
"2025-03-24","2025-03-22","SF FuneralF817655       250321","","31.63","","505086.92"
"2025-03-24","2025-03-22","SF FuneralF829118       250321","","31.63","","505118.55"
"2025-03-24","2025-03-22","SF FuneralF830931       250321","","31.63","","505150.18"
"2025-03-24","2025-03-22","SF FuneralF832777       250321","","31.63","","505181.81"
"2025-03-24","2025-03-22","SF FuneralF819053       250321","","31.63","","505213.44"
"2025-03-24","2025-03-22","SF FuneralF1060024      250322","","31.63","","505245.07"
"2025-03-24","2025-03-24","SF FuneralFDC0000000376D250324","","55","","505300.07"
"2025-03-24","2025-03-24","SF FuneralFDC000000069C5250324","","31.63","","505331.7"
"2025-03-24","2025-03-24","SF FuneralFDC000000070Z5250323","","31.63","","505363.33"
"2025-03-24","2025-03-24","SF FuneralFDC000000071S5250324","","31.63","","505394.96"
"2025-03-24","2025-03-24","SF FuneralFDC00000007BGG250323","","31.63","","505426.59"
"2025-03-24","2025-03-24","SF FuneralFDC00000007DSV250324","","31.63","","505458.22"
"2025-03-24","2025-03-24","SF FuneralFDC00000007GS9250324","","31.63","","505489.85"
"2025-03-24","2025-03-24","SF FuneralFDC000000086PX250323","","31.63","","505521.48"
"2025-03-24","2025-03-24","SF FuneralF801722       250324","","31.63","","505553.11"
"2025-03-24","2025-03-24","SF FuneralF811593       250324","","31.63","","505584.74"
"2025-03-24","2025-03-24","SF FuneralF831617       250324","","31.63","","505616.37"
"2025-03-24","2025-03-24","SF FuneralF841850       250324","","31.63","","505648"
"2025-03-24","2025-03-24","SF FuneralF843596       250321","","31.63","","505679.63"
"2025-03-24","2025-03-24","SF FuneralF843757       250321","","31.63","","505711.26"
"2025-03-24","2025-03-24","SF FuneralFDC0000000FQWF250321","","31.63","","505742.89"
"2025-03-24","2025-03-24","SF FuneralFDC0000000FVPD250324","","31.63","","505774.52"
"2025-03-24","2025-03-24","SF FuneralF844636       250321","","31.63","","505806.15"
"2025-03-24","2025-03-24","SF FuneralF986911       250324","","31.63","","505837.78"
"2025-03-24","2025-03-24","SF FuneralF1017111      250324","","31.63","","505869.41"
"2025-03-24","2025-03-24","SF FuneralF1052717      250324","","31.63","","505901.04"
"2025-03-24","2025-03-24","SF FuneralF1060944      250324","","31.63","","505932.67"
"2025-03-24","2025-03-24","SF FuneralF1115136      250324","","31.63","","505964.3"
"2025-03-24","2025-03-24","SF FuneralF1117767      250324","","31.63","","505995.93"
"2025-03-24","2025-03-24","SF FuneralF1118005      250324","","31.63","","506027.56"
"2025-03-24","2025-03-24","SF FuneralF1118181      250324","","31.63","","506059.19"
"2025-03-24","2025-03-24","SF FuneralF1123098      250324","","31.63","","506090.82"
"2025-03-24","2025-03-24","SF FuneralF1124411      250324","","31.63","","506122.45"
"2025-03-24","2025-03-24","SF FuneralF1129904      250324","","31.63","","506154.08"
"2025-03-24","2025-03-24","SF FuneralF1132115      250324","","31.63","","506185.71"
"2025-03-24","2025-03-22","SF FuneralFDC00000005CSP250321","","63.25","","506248.96"
"2025-03-24","2025-03-24","SF FuneralF815537       250324","","126.5","","506375.46"
"2025-03-24","2025-03-20","SF FuneralFDC00000005WC5250320","","126.5","","506501.96"
"2025-03-24","2025-03-20","SF FuneralFDC00000005ZWQ250320","","126.5","","506628.46"
"2025-03-24","2025-03-20","SF FuneralFDC00000006571250320","","126.5","","506754.96"
"2025-03-24","2025-03-20","SF FuneralFDC00000006B1H250320","","126.5","","506881.46"
"2025-03-24","2025-03-20","SF FuneralFDC00000006D6Y250320","","126.5","","507007.96"
"2025-03-24","2025-03-20","SF FuneralFDC00000006NRK250320","","191.5","","507199.46"
"2025-03-24","2025-03-20","SF FuneralFDC00000007P0T250320","","126.5","","507325.96"
"2025-03-24","2025-03-20","SF FuneralFDC000000081LH250320","","126.5","","507452.46"
"2025-03-24","2025-03-20","SF FuneralFDC00000008X0L250320","","126.5","","507578.96"
"2025-03-24","2025-03-20","SF FuneralF831721       250320","","126.5","","507705.46"
"2025-03-24","2025-03-20","SF FuneralF901253       250320","","126.5","","507831.96"
"2025-03-24","2025-03-20","SF FuneralF993402       250320","","126.5","","507958.46"
"2025-03-24","2025-03-20","SF FuneralF1108151      250320","","126.5","","508084.96"
"2025-03-24","2025-03-20","SF FuneralF1108922      250320","","126.5","","508211.46"
"2025-03-24","2025-03-20","SF FuneralF1111957      250321","","126.5","","508337.96"
"2025-03-24","2025-03-20","SF FuneralF1112198      250320","","126.5","","508464.46"
"2025-03-24","2025-03-20","SF FuneralFDC0000000N3BQ250321","","126.5","","508590.96"
"2025-03-24","2025-03-20","SF FuneralF1112578      250321","","126.5","","508717.46"
"2025-03-24","2025-03-20","SF FuneralF1124829      250320","","126.5","","508843.96"
"2025-03-24","2025-03-20","SF FuneralF1130767      250321","","126.5","","508970.46"
"2025-03-24","2025-03-20","SF FuneralFDC0000000QKR5250321","","126.5","","509096.96"
"2025-03-24","2025-03-20","SF FuneralFDC0000000QKR6250321","","126.5","","509223.46"
"2025-03-24","2025-03-20","SF FuneralFDC0000000QLFD250321","","126.5","","509349.96"
"2025-03-24","2025-03-22","SF FuneralFDC0000000308B250322","","220","","509569.96"
"2025-03-24","2025-03-22","SF FuneralFDC000000059HX250322","","126.5","","509696.46"
"2025-03-24","2025-03-22","SF FuneralFDC00000005G0G250322","","126.5","","509822.96"
"2025-03-24","2025-03-22","SF FuneralFDC00000007592250322","","126.5","","509949.46"
"2025-03-24","2025-03-22","SF FuneralFDC00000007QP1250321","","126.5","","510075.96"
"2025-03-24","2025-03-22","SF FuneralFDC00000008190250322","","126.5","","510202.46"
"2025-03-24","2025-03-22","SF FuneralFDC000000087ZF250321","","126.5","","510328.96"
"2025-03-24","2025-03-22","SF FuneralF812915       250321","","126.5","","510455.46"
"2025-03-24","2025-03-22","SF FuneralF785875       250321","","451.5","","510906.96"
"2025-03-24","2025-03-22","SF FuneralFDC0000000BH7D250321","","126.5","","511033.46"
"2025-03-24","2025-03-22","SF FuneralF823202       250322","","126.5","","511159.96"
"2025-03-24","2025-03-22","SF FuneralF830666       250322","","126.5","","511286.46"
"2025-03-24","2025-03-22","SF FuneralF833772       250322","","126.5","","511412.96"
"2025-03-24","2025-03-22","SF FuneralF779782       250322","","126.5","","511539.46"
"2025-03-24","2025-03-22","SF FuneralF840763       250321","","126.5","","511665.96"
"2025-03-24","2025-03-22","SF FuneralF1075052      250322","","126.5","","511792.46"
"2025-03-24","2025-03-22","SF FuneralF1112188      250322","","126.5","","511918.96"
"2025-03-24","2025-03-22","SF FuneralFDC0000000PFLM250322","","126.5","","512045.46"
"2025-03-24","2025-03-22","SF FuneralF1125155      250322","","126.5","","512171.96"
"2025-03-24","2025-03-22","SF FuneralFDC0000000PFT6250322","","126.5","","512298.46"
"2025-03-24","2025-03-22","SF FuneralF1125301      250322","","126.5","","512424.96"
"2025-03-24","2025-03-22","SF FuneralF1131125      250322","","126.5","","512551.46"
"2025-03-24","2025-03-22","SF FuneralF1134348      250323","","126.5","","512677.96"
"2025-03-24","2025-03-22","SF FuneralF1134809      250322","","126.5","","512804.46"
"2025-03-24","2025-03-24","SF FuneralFDC000000076M4250323","","126.5","","512930.96"
"2025-03-24","2025-03-24","SF FuneralFDC00000008P48250324","","126.5","","513057.46"
"2025-03-24","2025-03-24","SF FuneralFDC000000096XP250323","","126.5","","513183.96"
"2025-03-24","2025-03-24","SF FuneralF811747       250323","","126.5","","513310.46"
"2025-03-24","2025-03-24","SF FuneralFDC00000009CQS250324","","126.5","","513436.96"
"2025-03-24","2025-03-24","SF FuneralF813447       250324","","63.25","","513500.21"
"2025-03-24","2025-03-24","SF FuneralF822455       250324","","126.5","","513626.71"
"2025-03-24","2025-03-24","SF FuneralF832946       250323","","126.5","","513753.21"
"2025-03-24","2025-03-24","SF FuneralF840907       250324","","126.5","","513879.71"
"2025-03-24","2025-03-24","SF FuneralF847256       250324","","126.5","","514006.21"
"2025-03-24","2025-03-24","SF FuneralFDC00000003Z7R250324","","220","","514226.21"
"2025-03-24","2025-03-24","SF FuneralFDC00000005LX1250323","","63.25","","514289.46"
"2025-03-24","2025-03-24","SF FuneralFDC00000006JTQ250324","","126.5","","514415.96"
"2025-03-24","2025-03-24","SF FuneralFDC00000006KCD250323","","126.5","","514542.46"
"2025-03-24","2025-03-24","SF FuneralF816165       250323","","126.5","","514668.96"
"2025-03-24","2025-03-24","SF FuneralF831806       250324","","126.5","","514795.46"
"2025-03-24","2025-03-24","SF FuneralF992520       250324","","126.5","","514921.96"
"2025-03-24","2025-03-24","SF FuneralF1020942      250324","","63.25","","514985.21"
"2025-03-24","2025-03-24","SF FuneralF1104033      250324","","63.25","","515048.46"
"2025-03-24","2025-03-24","SF FuneralF1109044      250324","","126.5","","515174.96"
"2025-03-24","2025-03-24","SF FuneralF1121936      250324","","126.5","","515301.46"
"2025-03-24","2025-03-24","SF FuneralF1130823      250324","","126.5","","515427.96"
"2025-03-24","2025-03-24","SF FuneralF1131274      250324","","126.5","","515554.46"
"2025-03-24","2025-03-24","SF FuneralF1133105      250324","","126.5","","515680.96"
"2025-03-24","2025-03-24","SF FuneralFDC00000005P04250323","","126.5","","515807.46"
"2025-03-24","2025-03-24","SF FuneralFDC00000006V13250323","","126.5","","515933.96"
"2025-03-24","2025-03-24","SF FuneralFDC000000078PD250324","","126.5","","516060.46"
"2025-03-24","2025-03-24","SF FuneralFDC00000007FWQ250323","","220","","516280.46"
"2025-03-24","2025-03-24","SF FuneralFDC00000007NXK250324","","126.5","","516406.96"
"2025-03-24","2025-03-24","SF FuneralF844597       250324","","63.25","","516470.21"
"2025-03-24","2025-03-24","SF FuneralFDC0000000GDJ7250322","","126.5","","516596.71"
"2025-03-24","2025-03-24","SF FuneralF986646       250324","","126.5","","516723.21"
"2025-03-24","2025-03-24","SF FuneralF1022242      250324","","126.5","","516849.71"
"2025-03-24","2025-03-24","SF FuneralF1115885      250324","","126.5","","516976.21"
"2025-03-24","2025-03-24","SF FuneralF1122762      250324","","126.5","","517102.71"
"2025-03-24","2025-03-24","SF FuneralF1122992      250324","","126.5","","517229.21"
"2025-03-24","2025-03-24","SF FuneralFDC0000000606G250323","","126.5","","517355.71"
"2025-03-24","2025-03-24","SF FuneralFDC000000060YY250323","","126.5","","517482.21"
"2025-03-24","2025-03-24","SF FuneralFDC00000006T1R250323","","126.5","","517608.71"
"2025-03-24","2025-03-24","SF FuneralFDC000000083F6250324","","126.5","","517735.21"
"2025-03-24","2025-03-24","SF FuneralF811504       250324","","126.5","","517861.71"
"2025-03-24","2025-03-24","SF FuneralF819950       250324","","63.25","","517924.96"
"2025-03-24","2025-03-24","SF FuneralF900366       250322","","126.5","","518051.46"
"2025-03-24","2025-03-24","SF FuneralF987913       250324","","126.5","","518177.96"
"2025-03-24","2025-03-24","SF FuneralF1059325      250324","","63.25","","518241.21"
"2025-03-24","2025-03-24","SF FuneralF1123301      250324","","126.5","","518367.71"
"2025-03-24","2025-03-24","SF FuneralFDC0000000PRPK250324","","126.5","","518494.21"
"2025-03-24","2025-03-24","SF FuneralF1129483      250324","","126.5","","518620.71"
"2025-03-24","2025-03-22","SF FuneralFDC00000005TX1250321","","31.63","","518652.34"
"2025-03-24","2025-03-22","SF FuneralFDC00000005XWC250321","","126.5","","518778.84"
"2025-03-24","2025-03-22","SF FuneralFDC00000006NFW250321","","31.63","","518810.47"
"2025-03-24","2025-03-22","SF FuneralFDC00000006NJG250321","","126.5","","518936.97"
"2025-03-24","2025-03-20","SF FuneralF815134       250320","","126.5","","519063.47"
"2025-03-24","2025-03-20","SF FuneralF980425       250322","","126.5","","519189.97"
"2025-03-24","2025-03-20","SF FuneralF1061510      250320","","126.5","","519316.47"
"2025-03-24","2025-03-20","SF FuneralFDC0000000L8NN250321","","31.63","","519348.1"
"2025-03-24","2025-03-20","SF FuneralF1120242      250320","","126.5","","519474.6"
"2025-03-24","2025-03-20","SF FuneralF1120926      250320","","126.5","","519601.1"
"2025-03-24","2025-03-24","SF FuneralF1125114      250324","","31.63","","519632.73"
"2025-03-24","2025-03-20","SF FuneralF993140       250320","","126.5","","519759.23"
"2025-03-24","2025-03-20","SF FuneralF1114550      250320","","126.5","","519885.73"
"2025-03-24","2025-03-20","SF FuneralF1123167      250321","","31.63","","519917.36"
"2025-03-24","2025-03-20","SF FuneralF1128958      250320","","126.5","","520043.86"
"2025-03-24","2025-03-20","SF FuneralF1134491      250321","","31.63","","520075.49"
"2025-03-24","2025-03-20","SF FuneralF1134817      250321","","31.63","","520107.12"
"2025-03-24","2025-03-22","SF FuneralFDC00000005YCR250321","","126.5","","520233.62"
"2025-03-24","2025-03-22","SF FuneralFDC000000078QJ250322","","126.5","","520360.12"
"2025-03-24","2025-03-22","SF FuneralF805319       250321","","31.63","","520391.75"
"2025-03-24","2025-03-22","SF FuneralF821927       250321","","31.63","","520423.38"
"2025-03-24","2025-03-24","SF FuneralF814476       250324","","126.5","","520549.88"
"2025-03-24","2025-03-24","SF FuneralFDC0000000MR2H250324","","31.63","","520581.51"
"2025-03-24","2025-03-24","SF FuneralFDC00000005Z25250324","","31.63","","520613.14"
"2025-03-24","2025-03-24","SF FuneralFDC000000060Y2250323","","126.5","","520739.64"
"2025-03-24","2025-03-24","SF FuneralFDC0000000650X250324","","126.5","","520866.14"
"2025-03-24","2025-03-24","SF FuneralFDC000000069CL250324","","31.63","","520897.77"
"2025-03-24","2025-03-24","SF FuneralFDC000000070CJ250324","","31.63","","520929.4"
"2025-03-24","2025-03-24","SF FuneralFDC00000007BF0250323","","126.5","","521055.9"
"2025-03-24","2025-03-24","SF FuneralFDC00000007CP9250323","","126.5","","521182.4"
"2025-03-24","2025-03-24","SF FuneralFDC00000008KX0250324","","31.63","","521214.03"
"2025-03-24","2025-03-24","SF FuneralF820956       250323","","31.63","","521245.66"
"2025-03-24","2025-03-24","SF FuneralFDC0000000CFFG250324","","126.5","","521372.16"
"2025-03-24","2025-03-24","SF FuneralF847241       250322","","126.5","","521498.66"
"2025-03-24","2025-03-24","SF FuneralFDC000000060ZT250323","","126.5","","521625.16"
"2025-03-24","2025-03-24","SF FuneralFDC00000006354250324","","126.5","","521751.66"
"2025-03-24","2025-03-24","SF FuneralFDC00000007DLH250324","","126.5","","521878.16"
"2025-03-24","2025-03-24","SF FuneralFDC00000007NVB250323","","126.5","","522004.66"
"2025-03-24","2025-03-24","SF FuneralFDC000000089G2250323","","31.63","","522036.29"
"2025-03-24","2025-03-24","SF FuneralF900559       250322","","126.5","","522162.79"
"2025-03-24","2025-03-24","SF FuneralF787015       250324","","126.5","","522289.29"
"2025-03-24","2025-03-24","SF FuneralF1127801      250324","","31.63","","522320.92"
"2025-03-24","2025-03-24","SF FuneralF1134018      250324","","126.5","","522447.42"
"2025-03-24","2025-03-19","SF FuneralFDC000000030VF250319","","220","","522667.42"
"2025-03-24","2025-03-20","SF FuneralFDC000000067GC250320","","126.5","","522793.92"
"2025-03-24","2025-03-20","SF FuneralFDC0000000830B250320","","126.5","","522920.42"
"2025-03-24","2025-03-20","SF FuneralF1104255      250321","","31.63","","522952.05"
"2025-03-24","2025-03-20","SF FuneralF1128672      250321","","31.63","","522983.68"
"2025-03-24","2025-03-22","SF FuneralFDC00000003153250322","","220","","523203.68"
"2025-03-24","2025-03-22","SF FuneralFDC00000006P6D250321","","31.63","","523235.31"
"2025-03-24","2025-03-22","SF FuneralFDC000000070CD250321","","31.63","","523266.94"
"2025-03-24","2025-03-22","SF FuneralFDC00000007Q2S250321","","126.5","","523393.44"
"2025-03-24","2025-03-21","SF FuneralF814074       250321","","31.63","","523425.07"
"2025-03-24","2025-03-22","SF FuneralF1133563      250322","","126.5","","523551.57"
"2025-03-24","2025-03-24","SF FuneralFDC00000005G3N250323","","126.5","","523678.07"
"2025-03-24","2025-03-24","SF FuneralFDC00000005NWL250324","","31.63","","523709.7"
"2025-03-24","2025-03-24","SF FuneralFDC00000005NX7250324","","31.63","","523741.33"
"2025-03-24","2025-03-24","SF FuneralFDC00000006GNR250324","","31.63","","523772.96"
"2025-03-24","2025-03-24","SF FuneralFDC00000006X6B250323","","126.5","","523899.46"
"2025-03-24","2025-03-24","SF FuneralFDC00000006XFM250324","","31.63","","523931.09"
"2025-03-24","2025-03-24","SF FuneralFDC00000007CJH250324","","126.5","","524057.59"
"2025-03-24","2025-03-24","SF FuneralFDC00000007F3C250323","","126.5","","524184.09"
"2025-03-24","2025-03-24","SF FuneralF1073862      250324","","31.63","","524215.72"
"2025-03-24","2025-03-24","SF FuneralFDC0000000MSC7250324","","47.88","","524263.6"
"2025-03-24","2025-03-24","SF FuneralF1112136      250324","","31.63","","524295.23"
"2025-03-24","2025-03-24","SF FuneralF1124114      250324","","31.63","","524326.86"
"2025-03-24","2025-03-20","Rev SF FuneralFDC00000005RTM250320","","-220","","524106.86"
"2025-03-24","2025-03-22","Rev SF FuneralFDC00000007RJK250322","","-126.5","","523980.36"
"2025-03-24","2025-03-22","Rev SF FuneralFDC0000000KDK6250322","","-126.5","","523853.86"
"2025-03-24","2025-03-22","Rev SF FuneralFDC00000008H1M250322","","-126.5","","523727.36"
"2025-03-24","2025-03-22","Rev SF FuneralFDC0000000LNQZ250322","","-126.5","","523600.86"
"2025-03-24","2025-03-22","Rev SF FuneralFDC00000008HLZ250322","","-126.5","","523474.36"
"2025-03-24","2025-03-22","Rev SF FuneralFDC0000000BVXW250322","","-126.5","","523347.86"
"2025-03-24","2025-03-22","Rev SF FuneralFDC00000005SD7250322","","-126.5","","523221.36"
"2025-03-24","2025-03-22","Rev SF FuneralFDC000000034HX250322","","-220","","523001.36"
"2025-03-24","2025-03-22","Rev SF FuneralFDC000000034JT250322","","-220","","522781.36"
"2025-03-24","2025-03-22","Rev SF FuneralFDC0000000K4YT250322","","-126.5","","522654.86"
"2025-03-24","2025-03-22","Rev SF FuneralFDC0000000N9R4250322","","-126.5","","522528.36"
"2025-03-24","2025-03-22","Rev SF FuneralFDC00000008TTC250322","","-126.5","","522401.86"
"2025-03-24","2025-03-22","Rev SF FuneralFDC0000000837V250322","","-126.5","","522275.36"
"2025-03-24","2025-03-22","Rev SF FuneralFDC0000000NQZN250322","","-126.5","","522148.86"
"2025-03-24","2025-03-22","Rev SF FuneralFDC00000008H1L250322","","-126.5","","522022.36"
"2025-03-24","2025-03-20","Rev SF FuneralFDC0000000HYF4250322","","-126.5","","521895.86"
"2025-03-24","2025-03-22","Rev SF FuneralFDC000000085TB250322","","-126.5","","521769.36"
"2025-03-24","2025-02-12","Rev SF FuneralFDC00000005V3N250212","","-126.5","","521642.86"
"2025-03-24","2025-03-22","Rev SF FuneralFDC0000000LPZL250322","","-126.5","","521516.36"
"2025-03-24","2025-03-22","Rev SF FuneralFDC0000000770G250322","","-126.5","","521389.86"
"2025-03-24","2025-03-12","Rev SF FuneralFDC00000005V3N250312","","-126.5","","521263.36"
"2025-03-24","2025-03-22","Rev SF FuneralFDC00000003BYY250322","","-220","","521043.36"
"2025-03-24","2025-03-22","Rev SF FuneralFDC000000063FL250322","","-126.5","","520916.86"
"2025-03-24","2025-02-28","Rev SF FuneralFDC0000000H6N1250301","","-126.5","","520790.36"
"2025-03-24","2025-03-20","Rev SF FuneralFDC0000000J3VD250323","","-126.5","","520663.86"
"2025-03-24","2025-03-22","Rev SF FuneralFDC0000000NVX8250322","","-126.5","","520537.36"
"2025-03-24","2025-03-22","Rev SF FuneralFDC00000005GWY250322","","-126.5","","520410.86"
"2025-03-24","2025-03-22","Rev SF FuneralFDC00000005HCN250322","","-126.5","","520284.36"
"2025-03-24","2025-03-17","Rev SF FuneralFDC000000069C5250317","","-31.63","","520252.73"
"2025-03-24","2025-03-18","Rev SF FuneralFDC00000005L57250318","","-31.63","","520221.1"
"2025-03-24","2025-03-22","Rev SF FuneralFDC0000000KH3D250323","","-31.63","","520189.47"
"2025-03-24","2025-03-10","Rev SF FuneralFDC000000069C5250310","","-31.63","","520157.84"
"2025-03-24","2025-03-11","Rev SF FuneralFDC00000005L57250311","","-31.63","","520126.21"
"2025-03-24","2025-03-15","Rev SF FuneralFDC0000000KH3D250316","","-31.63","","520094.58"
"2025-03-24","2025-03-18","Rev SF FuneralFDC0000000HN9N250318","","-31.63","","520062.95"
"2025-03-24","2025-03-19","Rev SF FuneralFDC0000000LG2D250319","","-31.63","","520031.32"
"2025-03-24","2025-03-20","Rev SF FuneralFDC0000000JFC4250321","","-31.63","","519999.69"
"2025-03-24","2025-03-20","Rev SF FuneralFDC0000000KLCD250321","","-31.63","","519968.06"
"2025-03-24","2025-03-22","Rev SF FuneralFDC0000000B37Y250321","","-31.63","","519936.43"
"2025-03-24","2025-03-19","Rev SF FuneralFDC000000068V7250319","","-126.5","","519809.93"
"2025-03-24","2025-03-19","Rev SF FuneralFDC0000000KY1M250319","","-126.5","","519683.43"
"2025-03-24","2025-03-22","Rev SF FuneralFDC00000007BHX250322","","-126.5","","519556.93"
"2025-03-24","2025-03-22","Rev SF FuneralFDC0000000NPH3250322","","-126.5","","519430.43"
"2025-03-24","2025-03-20","SF FuneralF1066246      250321","","126.5","","519556.93"
"2025-03-24","2025-03-20","SF FuneralF991496       250320","","126.5","","519683.43"
"2025-03-24","2025-03-17","SF FuneralFDC00000009HK1250317","","63.25","","519746.68"
"2025-03-24","2025-03-18","SF FuneralFDC0000000HXY2250318","","31.63","","519778.31"
"2025-03-24","2025-03-18","SF FuneralF1103795      250318","","31.63","","519809.94"
"2025-03-24","2025-03-19","SF FuneralF844044       250319","","31.63","","519841.57"
"2025-03-24","2025-03-20","SF FuneralF989974       250322","","126.5","","519968.07"
"2025-03-24","2025-03-20","SF FuneralFDC0000000J4L3250322","","126.5","","520094.57"
"2025-03-24","2025-03-20","SF FuneralF1124561      250320","","126.5","","520221.07"
"2025-03-24","2025-03-20","SF FuneralF1130754      250321","","31.63","","520252.7"
"2025-03-24","2025-03-20","SF FuneralFDC0000000QD7T250321","","126.5","","520379.2"
"2025-03-24","2025-03-20","SF FuneralF1133490      250321","","126.5","","520505.7"
"2025-03-24","2025-03-22","SF FuneralFDC00000005YG4250322","","126.5","","520632.2"
"2025-03-24","2025-03-22","SF FuneralFDC00000006LK0250322","","126.5","","520758.7"
"2025-03-24","2025-03-22","SF FuneralFDC00000006LK1250322","","126.5","","520885.2"
"2025-03-24","2025-03-22","SF FuneralFDC00000006WX4250322","","126.5","","521011.7"
"2025-03-24","2025-03-22","SF FuneralFDC00000007JK4250322","","126.5","","521138.2"
"2025-03-24","2025-03-22","SF FuneralFDC00000007JR4250322","","126.5","","521264.7"
"2025-03-24","2025-03-22","SF FuneralFDC00000007KS4250321","","126.5","","521391.2"
"2025-03-24","2025-03-22","SF FuneralF812991       250322","","126.5","","521517.7"
"2025-03-24","2025-03-22","SF FuneralF813701       250322","","126.5","","521644.2"
"2025-03-24","2025-03-22","SF FuneralF815402       250322","","126.5","","521770.7"
"2025-03-24","2025-03-22","SF FuneralF993080       250322","","126.5","","521897.2"
"2025-03-24","2025-03-22","SF FuneralF819521       250322","","126.5","","522023.7"
"2025-03-24","2025-03-22","SF FuneralF1065838      250322","","126.5","","522150.2"
"2025-03-24","2025-03-22","SF FuneralF1115734      250322","","126.5","","522276.7"
"2025-03-24","2025-03-22","SF FuneralF1116719      250322","","126.5","","522403.2"
"2025-03-24","2025-03-22","SF FuneralFDC0000000NL14250322","","126.5","","522529.7"
"2025-03-24","2025-03-22","SF FuneralF1127813      250322","","126.5","","522656.2"
"2025-03-24","2025-03-22","SF FuneralF1133201      250322","","126.5","","522782.7"
"2025-03-24","2025-03-22","SF FuneralF1135377      250322","","126.5","","522909.2"
"2025-03-24","2025-03-24","SF FuneralFDC00000005F1K250324","","31.63","","522940.83"
"2025-03-24","2025-03-24","SF FuneralFDC00000005NT1250324","","31.63","","522972.46"
"2025-03-24","2025-03-24","SF FuneralF779205       250324","","191.5","","523163.96"
"2025-03-24","2025-03-24","SF FuneralFDC0000000HBTQ250324","","126.5","","523290.46"
"2025-03-24","2025-03-20","SF FuneralFDC000000067N9250320","","126.5","","523416.96"
"2025-03-24","2025-03-20","SF FuneralFDC00000006QDX250320","","126.5","","523543.46"
"2025-03-24","2025-03-22","SF FuneralFDC00000005YTT250321","","126.5","","523669.96"
"2025-03-24","2025-03-22","SF FuneralF1054796      250322","","126.5","","523796.46"
"2025-03-24","2025-03-22","SF FuneralF1110315      250322","","126.5","","523922.96"
"2025-03-24","2025-03-24","SF FuneralF832110       250324","","126.5","","524049.46"
"2025-03-24","2025-03-22","SF FuneralFDC000000068X9250322","","126.5","","524175.96"
"2025-03-24","2025-03-22","SF FuneralFDC00000005X71250322","","126.5","","524302.46"
"2025-03-24","2025-03-20","SF FuneralFDC00000004950250320","","220","","524522.46"
"2025-03-24","2025-03-20","SF FuneralF1132536      250321","","63.25","","524585.71"
"2025-03-24","2025-03-22","SF FuneralFDC0000000733P250322","","126.5","","524712.21"
"2025-03-24","2025-03-22","SF FuneralFDC00000008TQS250322","","126.5","","524838.71"
"2025-03-24","2025-03-22","SF FuneralF784736       250322","","31.63","","524870.34"
"2025-03-24","2025-03-22","SF FuneralF819977       250322","","126.5","","524996.84"
"2025-03-24","2025-03-22","SF FuneralF1104094      250322","","126.5","","525123.34"
"2025-03-24","2025-03-22","SF FuneralF1112113      250322","","126.5","","525249.84"
"2025-03-24","2025-03-22","SF FuneralF1114951      250323","","126.5","","525376.34"
"2025-03-24","2025-03-24","SF FuneralFDC0000000LF3C250324","","126.5","","525502.84"
"2025-03-24","2025-03-24","SF FuneralFDC0000000NNR0250324","","126.5","","525629.34"
"2025-03-24","2025-03-24","SF FuneralF1118466      250324","","126.5","","525755.84"
"2025-03-24","2025-03-24","SF FuneralFDC0000000PRW8250324","","126.5","","525882.34"
"2025-03-24","2025-03-24","SF FuneralF1131975      250324","","126.5","","526008.84"
"2025-03-24","2025-03-22","SF FuneralFDC0000000314X250322","","220","","526228.84"
"2025-03-24","2025-03-22","SF FuneralFDC00000003P8S250322","","220","","526448.84"
"2025-03-24","2025-03-22","SF FuneralFDC00000007GYW250322","","126.5","","526575.34"
"2025-03-24","2025-03-22","SF FuneralFDC00000008M85250322","","126.5","","526701.84"
"2025-03-24","2025-03-22","SF FuneralF791589       250322","","191.5","","526893.34"
"2025-03-24","2025-03-20","SF FuneralFDC0000000NCR8250321","","213.31","","527106.65"
"2025-03-24","2025-03-22","SF FuneralFDC000000061ZF250322","","126.5","","527233.15"
"2025-03-24","2025-03-22","SF FuneralF811537       250321","","126.5","","527359.65"
"2025-03-24","2025-03-22","SF FuneralF1073758      250322","","126.5","","527486.15"
"2025-03-24","2025-03-20","SF FuneralF1033704      250321","","31.63","","527517.78"
"2025-03-24","2025-03-20","SF FuneralF1121971      250321","","31.63","","527549.41"
"2025-03-24","2025-03-20","SF FuneralF1127614      250321","","31.63","","527581.04"
"2025-03-24","2025-03-22","SF FuneralFDC000000063WK250322","","126.5","","527707.54"
"2025-03-24","2025-03-22","SF FuneralFDC000000087MB250322","","126.5","","527834.04"
"2025-03-24","2025-03-22","SF FuneralFDC00000008HH0250322","","126.5","","527960.54"
"2025-03-24","2025-03-22","SF FuneralFDC00000009CNZ250322","","126.5","","528087.04"
"2025-03-24","2025-03-22","SF FuneralF812966       250321","","126.5","","528213.54"
"2025-03-24","2025-03-22","SF FuneralF813672       250321","","126.5","","528340.04"
"2025-03-24","2025-03-22","SF FuneralF834544       250321","","31.63","","528371.67"
"2025-03-24","2025-03-22","SF FuneralFDC0000000D8BK250321","","126.5","","528498.17"
"2025-03-24","2025-03-22","SF FuneralF840932       250322","","126.5","","528624.67"
"2025-03-24","2025-03-22","SF FuneralFDC0000000PB79250322","","126.5","","528751.17"
"2025-03-24","2025-03-22","SF FuneralF1130787      250322","","126.5","","528877.67"
"2025-03-24","2025-03-22","SF FuneralF1133796      250322","","126.5","","529004.17"
"2025-03-24","2025-03-24","SF FuneralF847452       250321","","31.63","","529035.8"
"2025-03-24","2025-03-17","SF FuneralF1060604      250317","","126.5","","529162.3"
"2025-03-24","2025-03-19","SF FuneralFDC00000005VH8250319","","126.5","","529288.8"
"2025-03-24","2025-03-20","SF FuneralF1124295      250320","","126.5","","529415.3"
"2025-03-24","2025-03-20","SF FuneralF1128160      250320","","126.5","","529541.8"
"2025-03-24","2025-03-20","SF FuneralF1134762      250321","","63.25","","529605.05"
"2025-03-24","2025-03-22","SF FuneralFDC0000000607F250322","","126.5","","529731.55"
"2025-03-24","2025-03-22","SF FuneralFDC0000000616Y250322","","126.5","","529858.05"
"2025-03-24","2025-03-22","SF FuneralFDC00000006M3C250322","","126.5","","529984.55"
"2025-03-24","2025-03-22","SF FuneralFDC00000007LNV250322","","126.5","","530111.05"
"2025-03-24","2025-03-22","SF FuneralF799648       250322","","126.5","","530237.55"
"2025-03-24","2025-03-22","SF FuneralF1060159      250322","","126.5","","530364.05"
"2025-03-24","2025-03-22","SF FuneralF1073840      250322","","126.5","","530490.55"
"2025-03-24","2025-03-22","SF FuneralFDC0000000LRYK250322","","126.5","","530617.05"
"2025-03-24","2025-03-22","SF FuneralF1115732      250322","","126.5","","530743.55"
"2025-03-24","2025-03-22","SF FuneralF1116780      250322","","63.25","","530806.8"
"2025-03-24","2025-03-22","SF FuneralF1131544      250322","","126.5","","530933.3"
"2025-03-24","2025-03-24","SF FuneralF805990       250324","","126.5","","531059.8"
"2025-03-24","2025-03-24","SF FuneralF818631       250324","","126.5","","531186.3"
"2025-03-24","2025-03-24","SF FuneralFDC0000000M35Z250324","","126.5","","531312.8"
"2025-03-24","2025-03-22","SF FuneralF1072916      250322","","126.5","","531439.3"
"2025-03-24","2025-03-20","SF FuneralF810906       250320","","126.5","","531565.8"
"2025-03-24","2025-03-22","SF FuneralFDC00000006S9M250322","","126.5","","531692.3"
"2025-03-24","2025-03-22","SF FuneralFDC00000006V4X250322","","126.5","","531818.8"
"2025-03-24","2025-03-22","SF FuneralFDC000000078V1250322","","126.5","","531945.3"
"2025-03-24","2025-03-22","SF FuneralF801362       250322","","126.5","","532071.8"
"2025-03-24","2025-03-22","SF FuneralF831349       250322","","126.5","","532198.3"
"2025-03-24","2025-03-22","SF FuneralF1118375      250322","","126.5","","532324.8"
"2025-03-24","2025-03-22","SF FuneralFDC0000000Q0LM250322","","126.5","","532451.3"
"2025-03-24","2025-03-22","SF FuneralFDC000000067WF250321","","126.5","","532577.8"
"2025-03-24","2025-03-22","SF FuneralF805891       250322","","126.5","","532704.3"
"2025-03-24","2025-03-22","SF FuneralF1054608      250323","","126.5","","532830.8"
"2025-03-24","2025-03-22","SF FuneralF1059858      250322","","126.5","","532957.3"
"2025-03-24","2025-03-22","SF FuneralF1083701      250322","","126.5","","533083.8"
"2025-03-24","2025-03-22","SF FuneralF1112497      250322","","126.5","","533210.3"
"2025-03-24","2025-03-20","SF FuneralF1115955      250321","","126.5","","533336.8"
"2025-03-24","2025-03-20","SF FuneralF987341       250322","","126.5","","533463.3"
"2025-03-24","2025-03-20","SF FuneralF1116706      250320","","126.5","","533589.8"
"2025-03-24","2025-03-22","SF FuneralF812562       250322","","126.5","","533716.3"
"2025-03-24","2025-03-22","SF FuneralF832932       250322","","31.63","","533747.93"
"2025-03-24","2025-03-22","SF FuneralFDC0000000L3LS250322","","126.5","","533874.43"
"2025-03-24","2025-03-22","SF FuneralF1073405      250322","","126.5","","534000.93"
"2025-03-24","2025-03-22","SF FuneralF1121918      250322","","126.5","","534127.43"
"2025-03-24","2025-03-24","SF FuneralF841615       250324","","31.63","","534159.06"
"2025-03-24","2025-03-22","SF FuneralFDC000000061N0250322","","126.5","","534285.56"
"2025-03-24","2025-03-22","SF FuneralF817661       250322","","126.5","","534412.06"
"2025-03-24","2025-03-22","SF FuneralF1072786      250322","","126.5","","534538.56"
"2025-03-24","2025-03-22","SF FuneralF1074816      250322","","126.5","","534665.06"
"2025-03-24","2025-03-22","SF FuneralF1130985      250322","","126.5","","534791.56"
"2025-03-24","2025-03-24","SF FuneralF841712       250324","","126.5","","534918.06"
"2025-03-24","2025-03-17","SF FuneralF819080       250317","","126.5","","535044.56"
"2025-03-24","2025-03-18","SF FuneralFDC0000000NL0D250318","","63.25","","535107.81"
"2025-03-24","2025-03-20","SF FuneralF1120647      250320","","126.5","","535234.31"
"2025-03-24","2025-03-22","SF FuneralFDC00000005LJL250321","","126.5","","535360.81"
"2025-03-24","2025-03-22","SF FuneralFDC00000005QYG250321","","63.25","","535424.06"
"2025-03-24","2025-03-22","SF FuneralFDC00000006092250322","","126.5","","535550.56"
"2025-03-24","2025-03-22","SF FuneralFDC00000007K2Y250321","","126.5","","535677.06"
"2025-03-24","2025-03-22","SF FuneralFDC00000008HGX250322","","126.5","","535803.56"
"2025-03-24","2025-03-22","SF FuneralF811918       250322","","126.5","","535930.06"
"2025-03-24","2025-03-22","SF FuneralF812923       250322","","126.5","","536056.56"
"2025-03-24","2025-03-22","SF FuneralF819398       250322","","126.5","","536183.06"
"2025-03-24","2025-03-22","SF FuneralF819522       250322","","126.5","","536309.56"
"2025-03-24","2025-03-22","SF FuneralF820331       250322","","126.5","","536436.06"
"2025-03-24","2025-03-22","SF FuneralF823282       250322","","126.5","","536562.56"
"2025-03-24","2025-03-22","SF FuneralF823452       250322","","126.5","","536689.06"
"2025-03-24","2025-03-22","SF FuneralF823718       250322","","126.5","","536815.56"
"2025-03-24","2025-03-22","SF FuneralF829644       250322","","126.5","","536942.06"
"2025-03-24","2025-03-22","SF FuneralF831142       250322","","126.5","","537068.56"
"2025-03-24","2025-03-22","SF FuneralF1017710      250322","","126.5","","537195.06"
"2025-03-24","2025-03-22","SF FuneralF1017839      250322","","126.5","","537321.56"
"2025-03-24","2025-03-22","SF FuneralFDC0000000JV7V250322","","126.5","","537448.06"
"2025-03-24","2025-03-22","SF FuneralFDC0000000K4RL250322","","126.5","","537574.56"
"2025-03-24","2025-03-22","SF FuneralF1060775      250322","","126.5","","537701.06"
"2025-03-24","2025-03-22","SF FuneralF1073558      250322","","126.5","","537827.56"
"2025-03-24","2025-03-22","SF FuneralF1085031      250322","","126.5","","537954.06"
"2025-03-24","2025-03-22","SF FuneralF1108236      250322","","126.5","","538080.56"
"2025-03-24","2025-03-22","SF FuneralFDC0000000MHGN250322","","126.5","","538207.06"
"2025-03-24","2025-03-22","SF FuneralF1065756      250322","","126.5","","538333.56"
"2025-03-24","2025-03-22","SF FuneralF1125992      250322","","126.5","","538460.06"
"2025-03-24","2025-03-22","SF FuneralF1126236      250322","","126.5","","538586.56"
"2025-03-24","2025-03-22","SF FuneralF1127988      250322","","126.5","","538713.06"
"2025-03-24","2025-03-22","SF FuneralF1132352      250322","","126.5","","538839.56"
"2025-03-24","2025-03-22","SF FuneralF1132429      250322","","126.5","","538966.06"
"2025-03-24","2025-03-24","SF FuneralFDC0000000FFH8250321","","126.5","","539092.56"
"2025-03-24","2025-03-24","SF FuneralF1113769      250324","","63.25","","539155.81"
"2025-03-24","2025-03-24","SF FuneralF1122808      250324","","126.5","","539282.31"
"2025-03-24","2025-03-22","Rev SF FuneralFDC00000007WBL250321","","-31.63","","539250.68"
"2025-03-24","2025-03-22","Rev SF FuneralFDC000000069RZ250321","","-31.63","","539219.05"
"2025-03-24","2025-03-18","Rev SF FuneralFDC0000000NRVB250318","","-31.63","","539187.42"
"2025-03-24","2025-03-22","Rev SF FuneralFDC000000087ZF250321","","-126.5","","539060.92"
"2025-03-24","2025-02-17","Rev SF FuneralFDC0000000LT6F250217","","-126.5","","538934.42"
"2025-03-24","2025-03-17","Rev SF FuneralFDC0000000LT6F250317","","-126.5","","538807.92"
"2025-03-24","2025-03-17","Rev SF FuneralFDC00000009HK1250317","","-63.25","","538744.67"
"2025-03-24","2025-03-22","Rev SF FuneralFDC00000007JR4250322","","-126.5","","538618.17"
"2025-03-24","2025-03-22","Rev SF FuneralFDC0000000D8BK250321","","-126.5","","538491.67"
"2025-03-24","2025-03-22","Rev SF FuneralFDC00000008TQS250322","","-126.5","","538365.17"
"2025-03-24","2025-03-20","Rev SF FuneralFDC00000006QDX250320","","-126.5","","538238.67"
"2025-03-24","2025-03-20","Rev SF FuneralFDC0000000N3BQ250321","","-126.5","","538112.17"
"2025-03-24","2025-03-24","Rev SF FuneralFDC00000009CQS250324","","-126.5","","537985.67"
"2025-03-24","2025-03-20","SF FuneralF1126933      250321","","126.5","","538112.17"
"2025-03-24","2025-03-22","SF FuneralFDC00000005G9T250322","","126.5","","538238.67"
"2025-03-24","2025-03-22","SF FuneralFDC000000060TK250322","","220","","538458.67"
"2025-03-24","2025-03-22","SF FuneralFDC000000062HJ250322","","126.5","","538585.17"
"2025-03-24","2025-03-22","SF FuneralFDC00000007J5L250322","","126.5","","538711.67"
"2025-03-24","2025-03-22","SF FuneralF842514       250322","","126.5","","538838.17"
"2025-03-24","2025-03-22","SF FuneralF1103734      250322","","126.5","","538964.67"
"2025-03-24","2025-03-17","SF FuneralF844510       250315","","126.5","","539091.17"
"2025-03-24","2025-03-22","SF FuneralF1124545      250322","","126.5","","539217.67"
"2025-03-24","2025-03-22","SF FuneralF805718       250322","","126.5","","539344.17"
"2025-03-24","2025-03-22","SF FuneralF805857       250322","","126.5","","539470.67"
"2025-03-24","2025-03-22","SF FuneralF822383       250322","","126.5","","539597.17"
"2025-03-24","2025-03-22","SF FuneralF823219       250322","","126.5","","539723.67"
"2025-03-24","2025-03-22","SF FuneralF1061985      250322","","126.5","","539850.17"
"2025-03-24","2025-03-22","SF FuneralF1116770      250322","","126.5","","539976.67"
"2025-03-24","2025-03-22","SF FuneralFDC0000000PL2B250322","","126.5","","540103.17"
"2025-03-24","2025-03-22","SF FuneralF1126298      250322","","126.5","","540229.67"
"2025-03-24","2025-03-22","SF FuneralF1127591      250322","","126.5","","540356.17"
"2025-03-24","2025-03-24","SF FuneralFDC00000007FPS250324","","31.63","","540387.8"
"2025-03-24","2025-03-22","SF FuneralFDC000000061M2250322","","126.5","","540514.3"
"2025-03-24","2025-03-22","SF FuneralFDC000000067S8250322","","126.5","","540640.8"
"2025-03-24","2025-03-22","SF FuneralFDC00000006KKS250322","","126.5","","540767.3"
"2025-03-24","2025-03-22","SF FuneralFDC00000006XTQ250322","","126.5","","540893.8"
"2025-03-24","2025-03-22","SF FuneralFDC00000006ZQ6250322","","126.5","","541020.3"
"2025-03-24","2025-03-22","SF FuneralFDC00000006ZQJ250322","","126.5","","541146.8"
"2025-03-24","2025-03-22","SF FuneralFDC00000006ZWS250321","","126.5","","541273.3"
"2025-03-24","2025-03-22","SF FuneralFDC00000007187250322","","126.5","","541399.8"
"2025-03-24","2025-03-22","SF FuneralFDC00000007604250322","","126.5","","541526.3"
"2025-03-24","2025-03-22","SF FuneralFDC00000007MLW250321","","126.5","","541652.8"
"2025-03-24","2025-03-22","SF FuneralFDC00000008TZ1250322","","126.5","","541779.3"
"2025-03-24","2025-03-22","SF FuneralFDC00000008VGN250322","","126.5","","541905.8"
"2025-03-24","2025-03-22","SF FuneralF819588       250322","","126.5","","542032.3"
"2025-03-24","2025-03-22","SF FuneralF788778       250322","","126.5","","542158.8"
"2025-03-24","2025-03-22","SF FuneralF1033874      250323","","126.5","","542285.3"
"2025-03-24","2025-03-22","SF FuneralF1052903      250322","","126.5","","542411.8"
"2025-03-24","2025-03-22","SF FuneralF1054693      250322","","126.5","","542538.3"
"2025-03-24","2025-03-22","SF FuneralF1074635      250322","","126.5","","542664.8"
"2025-03-24","2025-03-22","SF FuneralF1074880      250322","","126.5","","542791.3"
"2025-03-24","2025-03-22","SF FuneralF1083758      250322","","126.5","","542917.8"
"2025-03-24","2025-03-22","SF FuneralF1102847      250322","","126.5","","543044.3"
"2025-03-24","2025-03-22","SF FuneralF788991       250322","","213.31","","543257.61"
"2025-03-24","2025-03-22","SF FuneralF1108179      250322","","126.5","","543384.11"
"2025-03-24","2025-03-22","SF FuneralF1127931      250322","","126.5","","543510.61"
"2025-03-24","2025-03-22","SF FuneralF1128862      250322","","126.5","","543637.11"
"2025-03-24","2025-03-22","SF FuneralF1129456      250323","","126.5","","543763.61"
"2025-03-24","2025-03-22","SF FuneralF1130997      250322","","126.5","","543890.11"
"2025-03-24","2025-03-22","SF FuneralFDC0000000QHMC250322","","126.5","","544016.61"
"2025-03-24","2025-03-19","SF FuneralF1127568      250319","","126.5","","544143.11"
"2025-03-24","2025-03-19","SF FuneralFDC0000000QCG1250319","","126.5","","544269.61"
