"Txn date","Effective","Description","Truncated card number","Amount","Charges","Balance"
"2025-02-01","2025-01-22","SF FuneralF802870       250122","","126.5","","1391629.29"
"2025-02-01","2025-01-22","SF FuneralF820021       250122","","126.5","","1391755.79"
"2025-02-01","2025-01-22","SF FuneralF840792       250122","","126.5","","1391882.29"
"2025-02-01","2025-01-22","SF FuneralF988455       250122","","126.5","","1392008.79"
"2025-02-01","2025-01-22","SF FuneralF991457       250122","","126.5","","1392135.29"
"2025-02-01","2025-01-22","SF FuneralF991753       250122","","126.5","","1392261.79"
"2025-02-01","2025-01-22","SF FuneralF1061976      250122","","126.5","","1392388.29"
"2025-02-01","2025-01-24","SF FuneralFDC00000002SMZ250124","","220","","1392608.29"
"2025-02-01","2025-01-24","SF FuneralFDC00000007NTY250125","","126.5","","1392734.79"
"2025-02-01","2025-01-24","SF FuneralFDC00000007Q2R250125","","126.5","","1392861.29"
"2025-02-01","2025-01-24","SF FuneralFDC00000007Q5P250125","","126.5","","1392987.79"
"2025-02-01","2025-01-24","SF FuneralFDC000000086C7250127","","126.5","","1393114.29"
"2025-02-01","2025-01-24","SF FuneralF809383       250128","","126.5","","1393240.79"
"2025-02-01","2025-01-24","SF FuneralF817194       250125","","126.5","","1393367.29"
"2025-02-01","2025-01-24","SF FuneralF817312       250128","","126.5","","1393493.79"
"2025-02-01","2025-01-24","SF FuneralFDC0000000B3H1250128","","126.5","","1393620.29"
"2025-02-01","2025-01-24","SF FuneralF1065771      250128","","126.5","","1393746.79"
"2025-02-01","2025-01-24","SF FuneralFDC0000000LLZK250127","","191.5","","1393938.29"
"2025-02-01","2025-01-24","SF FuneralF1108894      250125","","126.5","","1394064.79"
"2025-02-01","2025-01-27","SF FuneralFDC0000000831X250126","","63.25","","1394128.04"
"2025-02-01","2025-01-31","SF FuneralFDC00000009VGG250131","","126.5","","1394254.54"
"2025-02-01","2025-01-31","SF FuneralFDC0000000H1QJ250201","","126.5","","1394381.04"
"2025-02-01","2025-01-31","SF FuneralF986803       250201","","126.5","","1394507.54"
"2025-02-01","2025-01-31","SF FuneralFDC0000000JMVM250131","","63.25","","1394570.79"
"2025-02-01","2025-01-31","SF FuneralF1116800      250131","","126.5","","1394697.29"
"2025-02-01","2025-01-22","SF FuneralF828632       250122","","126.5","","1394823.79"
"2025-02-01","2025-01-22","SF FuneralF986886       250122","","126.5","","1394950.29"
"2025-02-01","2025-01-22","SF FuneralF1020955      250122","","126.5","","1395076.79"
"2025-02-01","2025-01-23","SF FuneralF842646       250123","","126.5","","1395203.29"
"2025-02-01","2025-01-23","SF FuneralF782860       250123","","126.5","","1395329.79"
"2025-02-01","2025-01-24","SF FuneralFDC00000006CPQ250127","","126.5","","1395456.29"
"2025-02-01","2025-01-24","SF FuneralF797076       250128","","126.5","","1395582.79"
"2025-02-01","2025-01-24","SF FuneralF809052       250128","","126.5","","1395709.29"
"2025-02-01","2025-01-24","SF FuneralF820887       250127","","126.5","","1395835.79"
"2025-02-01","2025-01-24","SF FuneralF822006       250128","","126.5","","1395962.29"
"2025-02-01","2025-01-24","SF FuneralF992165       250125","","126.5","","1396088.79"
"2025-02-01","2025-01-24","SF FuneralF1020934      250124","","126.5","","1396215.29"
"2025-02-01","2025-01-24","SF FuneralF1021062      250128","","126.5","","1396341.79"
"2025-02-01","2025-01-24","SF FuneralF1021067      250128","","126.5","","1396468.29"
"2025-02-01","2025-01-24","SF FuneralF1078536      250127","","126.5","","1396594.79"
"2025-02-01","2025-01-24","SF FuneralF1084353      250128","","126.5","","1396721.29"
"2025-02-01","2025-01-24","SF FuneralF1103175      250127","","126.5","","1396847.79"
"2025-02-01","2025-01-24","SF FuneralF1108732      250124","","126.5","","1396974.29"
"2025-02-01","2025-01-24","SF FuneralF1108767      250128","","126.5","","1397100.79"
"2025-02-01","2025-01-24","SF FuneralFDC0000000NHCZ250127","","126.5","","1397227.29"
"2025-02-01","2025-01-24","SF FuneralFDC0000000NHD0250127","","126.5","","1397353.79"
"2025-02-01","2025-01-24","SF FuneralFDC0000000PNPD250127","","126.5","","1397480.29"
"2025-02-01","2025-01-28","SF FuneralF813480       250128","","63.25","","1397543.54"
"2025-02-01","2025-01-28","SF FuneralF821871       250128","","63.25","","1397606.79"
"2025-02-01","2025-01-28","SF FuneralF830783       250128","","63.25","","1397670.04"
"2025-02-01","2025-01-28","SF FuneralFDC0000000FQV0250128","","63.25","","1397733.29"
"2025-02-01","2025-01-28","SF FuneralF992474       250128","","63.25","","1397796.54"
"2025-02-01","2025-01-28","SF FuneralF1021955      250128","","63.25","","1397859.79"
"2025-02-01","2025-01-28","SF FuneralF1052117      250128","","63.25","","1397923.04"
"2025-02-01","2025-01-28","SF FuneralF1120220      250128","","63.25","","1397986.29"
"2025-02-01","2025-01-29","SF FuneralFDC000000051JT250129","","220","","1398206.29"
"2025-02-01","2025-01-29","SF FuneralF828051       250129","","126.5","","1398332.79"
"2025-02-01","2025-01-29","SF FuneralFDC0000000M74G250129","","126.5","","1398459.29"
"2025-02-01","2025-01-29","SF FuneralF1125869      250129","","126.5","","1398585.79"
"2025-02-01","2025-01-28","SF FuneralFDC00000006Y7S250128","","31.63","","1398617.42"
"2025-02-01","2025-01-28","SF FuneralF987244       250128","","31.63","","1398649.05"
"2025-02-01","2025-01-28","SF FuneralF988005       250128","","31.63","","1398680.68"
"2025-02-01","2025-01-28","SF FuneralF1050698      250128","","31.63","","1398712.31"
"2025-02-01","2025-01-28","SF FuneralF1085179      250128","","31.63","","1398743.94"
"2025-02-01","2025-01-28","SF FuneralF1116010      250128","","31.63","","1398775.57"
"2025-02-01","2025-01-29","SF FuneralF842872       250129","","31.63","","1398807.2"
"2025-02-01","2025-01-29","SF FuneralF1129376      250129","","31.63","","1398838.83"
"2025-02-01","2025-01-22","SF FuneralFDC000000069FB250122","","126.5","","1398965.33"
"2025-02-01","2025-01-22","SF FuneralF815772       250122","","126.5","","1399091.83"
"2025-02-01","2025-01-24","SF FuneralFDC00000005MQV250127","","126.5","","1399218.33"
"2025-02-01","2025-01-24","SF FuneralFDC00000006KGR250127","","126.5","","1399344.83"
"2025-02-01","2025-01-24","SF FuneralFDC000000087YC250128","","126.5","","1399471.33"
"2025-02-01","2025-01-24","SF FuneralFDC00000008FKG250128","","126.5","","1399597.83"
"2025-02-01","2025-01-24","SF FuneralF802288       250124","","126.5","","1399724.33"
"2025-02-01","2025-01-24","SF FuneralFDC00000009TGM250128","","126.5","","1399850.83"
"2025-02-01","2025-01-24","SF FuneralF831939       250124","","126.5","","1399977.33"
"2025-02-01","2025-01-24","SF FuneralF841104       250127","","126.5","","1400103.83"
"2025-02-01","2025-01-24","SF FuneralF841155       250127","","126.5","","1400230.33"
"2025-02-01","2025-01-24","SF FuneralF841285       250127","","126.5","","1400356.83"
"2025-02-01","2025-01-24","SF FuneralF1021463      250127","","126.5","","1400483.33"
"2025-02-01","2025-01-24","SF FuneralF1074940      250125","","126.5","","1400609.83"
"2025-02-01","2025-01-24","SF FuneralF1078570      250125","","126.5","","1400736.33"
"2025-02-01","2025-01-24","SF FuneralF1078585      250127","","126.5","","1400862.83"
"2025-02-01","2025-01-24","SF FuneralF1079287      250127","","126.5","","1400989.33"
"2025-02-01","2025-01-24","SF FuneralFDC0000000MLB3250124","","126.5","","1401115.83"
"2025-02-01","2025-01-24","SF FuneralF1112129      250127","","126.5","","1401242.33"
"2025-02-01","2025-01-24","SF FuneralF1113281      250127","","126.5","","1401368.83"
"2025-02-01","2025-01-24","SF FuneralFDC0000000N4K7250124","","126.5","","1401495.33"
"2025-02-01","2025-01-24","SF FuneralFDC0000000N5N9250128","","126.5","","1401621.83"
"2025-02-01","2025-01-24","SF FuneralFDC0000000N7TL250127","","126.5","","1401748.33"
"2025-02-01","2025-01-24","SF FuneralF1117034      250127","","126.5","","1401874.83"
"2025-02-01","2025-01-24","SF FuneralF1117203      250127","","126.5","","1402001.33"
"2025-02-01","2025-01-24","SF FuneralF1118453      250127","","126.5","","1402127.83"
"2025-02-01","2025-01-24","SF FuneralF1120679      250127","","126.5","","1402254.33"
"2025-02-01","2025-01-24","SF FuneralF1120843      250128","","126.5","","1402380.83"
"2025-02-01","2025-01-24","SF FuneralF1121980      250128","","126.5","","1402507.33"
"2025-02-01","2025-01-24","SF FuneralFDC0000000PG88250127","","126.5","","1402633.83"
"2025-02-01","2025-01-24","SF FuneralF1126203      250128","","126.5","","1402760.33"
"2025-02-01","2025-01-24","SF FuneralF1126903      250128","","126.5","","1402886.83"
"2025-02-01","2025-01-24","SF FuneralFDC0000000PQLR250127","","191.5","","1403078.33"
"2025-02-01","2025-01-24","SF FuneralF1128066      250127","","126.5","","1403204.83"
"2025-02-01","2025-01-24","SF FuneralF1128229      250128","","126.5","","1403331.33"
"2025-02-01","2025-01-27","SF FuneralFDC00000005PH9250127","","63.25","","1403394.58"
"2025-02-01","2025-01-28","SF FuneralF1067947      250128","","63.25","","1403457.83"
"2025-02-01","2025-01-28","SF FuneralF1072850      250128","","63.25","","1403521.08"
"2025-02-01","2025-01-28","SF FuneralF1078528      250128","","63.25","","1403584.33"
"2025-02-01","2025-01-28","SF FuneralF1114745      250128","","63.25","","1403647.58"
"2025-02-01","2025-01-29","SF FuneralFDC00000007SPS250129","","63.25","","1403710.83"
"2025-02-01","2025-01-29","SF FuneralF809727       250129","","126.5","","1403837.33"
"2025-02-01","2025-01-27","SF FuneralFDC00000005XG9250127","","31.63","","1403868.96"
"2025-02-01","2025-01-28","SF FuneralFDC000000073P4250128","","31.63","","1403900.59"
"2025-02-01","2025-01-28","SF FuneralF798676       250128","","31.63","","1403932.22"
"2025-02-01","2025-01-28","SF FuneralFDC00000008G43250128","","31.63","","1403963.85"
"2025-02-01","2025-01-28","SF FuneralF808707       250128","","31.63","","1403995.48"
"2025-02-01","2025-01-28","SF FuneralF813552       250128","","31.63","","1404027.11"
"2025-02-01","2025-01-28","SF FuneralF820929       250128","","31.63","","1404058.74"
"2025-02-01","2025-01-28","SF FuneralF833123       250128","","31.63","","1404090.37"
"2025-02-01","2025-01-28","SF FuneralF991415       250128","","31.63","","1404122"
"2025-02-01","2025-01-28","SF FuneralF1017666      250128","","31.63","","1404153.63"
"2025-02-01","2025-01-28","SF FuneralF1060838      250128","","31.63","","1404185.26"
"2025-02-01","2025-01-28","SF FuneralF1061865      250128","","31.63","","1404216.89"
"2025-02-01","2025-01-28","SF FuneralF1062646      250128","","31.63","","1404248.52"
"2025-02-01","2025-01-28","SF FuneralF1073379      250128","","31.63","","1404280.15"
"2025-02-01","2025-01-28","SF FuneralF1073746      250128","","31.63","","1404311.78"
"2025-02-01","2025-01-28","SF FuneralF1074598      250128","","31.63","","1404343.41"
"2025-02-01","2025-01-28","SF FuneralF1113741      250128","","31.63","","1404375.04"
"2025-02-01","2025-01-28","SF FuneralF1117422      250128","","31.63","","1404406.67"
"2025-02-01","2025-01-28","SF FuneralF1123497      250128","","31.63","","1404438.3"
"2025-02-01","2025-01-28","SF FuneralF1127719      250128","","31.63","","1404469.93"
"2025-02-01","2025-01-28","SF FuneralF1129064      250128","","31.63","","1404501.56"
"2025-02-01","2025-01-28","SF FuneralF1129417      250128","","31.63","","1404533.19"
"2025-02-01","2025-01-22","SF FuneralF1108969      250122","","126.5","","1404659.69"
"2025-02-01","2025-01-23","SF FuneralF831656       250123","","126.5","","1404786.19"
"2025-02-01","2025-01-24","SF FuneralFDC00000005WSD250128","","220","","1405006.19"
"2025-02-01","2025-01-24","SF FuneralFDC00000006BC6250128","","126.5","","1405132.69"
"2025-02-01","2025-01-24","SF FuneralFDC00000006D4Q250127","","126.5","","1405259.19"
"2025-02-01","2025-01-24","SF FuneralFDC00000006RNF250128","","126.5","","1405385.69"
"2025-02-01","2025-01-24","SF FuneralFDC0000000716X250127","","126.5","","1405512.19"
"2025-02-01","2025-01-24","SF FuneralFDC0000000751F250128","","386.5","","1405898.69"
"2025-02-01","2025-01-24","SF FuneralFDC000000075FH250128","","126.5","","1406025.19"
"2025-02-01","2025-01-24","SF FuneralF793712       250125","","126.5","","1406151.69"
"2025-02-01","2025-01-24","SF FuneralF802315       250124","","126.5","","1406278.19"
"2025-02-01","2025-01-24","SF FuneralF808328       250128","","126.5","","1406404.69"
"2025-02-01","2025-01-24","SF FuneralF808597       250128","","126.5","","1406531.19"
"2025-02-01","2025-01-24","SF FuneralF808621       250128","","126.5","","1406657.69"
"2025-02-01","2025-01-24","SF FuneralF816288       250128","","126.5","","1406784.19"
"2025-02-01","2025-01-24","SF FuneralFDC0000000BBS5250126","","126.5","","1406910.69"
"2025-02-01","2025-01-24","SF FuneralF822207       250128","","126.5","","1407037.19"
"2025-02-01","2025-01-24","SF FuneralF834685       250128","","126.5","","1407163.69"
"2025-02-01","2025-01-24","SF FuneralFDC0000000JFXT250126","","126.5","","1407290.19"
"2025-02-01","2025-01-24","SF FuneralF1021087      250128","","126.5","","1407416.69"
"2025-02-01","2025-01-24","SF FuneralF1060379      250127","","126.5","","1407543.19"
"2025-02-01","2025-01-24","SF FuneralF1074881      250126","","126.5","","1407669.69"
"2025-02-01","2025-01-24","SF FuneralF1074938      250127","","126.5","","1407796.19"
"2025-02-01","2025-01-24","SF FuneralF1075123      250127","","126.5","","1407922.69"
"2025-02-01","2025-01-24","SF FuneralF1083803      250128","","126.5","","1408049.19"
"2025-02-01","2025-01-24","SF FuneralF1102874      250127","","126.5","","1408175.69"
"2025-02-01","2025-01-24","SF FuneralF1109044      250124","","126.5","","1408302.19"
"2025-02-01","2025-01-24","SF FuneralF1110018      250127","","126.5","","1408428.69"
"2025-02-01","2025-01-24","SF FuneralF1113148      250128","","126.5","","1408555.19"
"2025-02-01","2025-01-24","SF FuneralF1116125      250128","","126.5","","1408681.69"
"2025-02-01","2025-01-24","SF FuneralFDC0000000NJSC250127","","126.5","","1408808.19"
"2025-02-01","2025-01-24","SF FuneralF1117395      250128","","126.5","","1408934.69"
"2025-02-01","2025-01-24","SF FuneralF1117620      250128","","126.5","","1409061.19"
"2025-02-01","2025-01-24","SF FuneralF1123418      250126","","126.5","","1409187.69"
"2025-02-01","2025-01-24","SF FuneralF1123498      250125","","126.5","","1409314.19"
"2025-02-01","2025-01-24","SF FuneralF1125243      250127","","126.5","","1409440.69"
"2025-02-01","2025-01-24","SF FuneralF1125843      250127","","126.5","","1409567.19"
"2025-02-01","2025-01-24","SF FuneralF1126044      250128","","126.5","","1409693.69"
"2025-02-01","2025-01-24","SF FuneralF1126166      250128","","126.5","","1409820.19"
"2025-02-01","2025-01-24","SF FuneralF1127831      250128","","126.5","","1409946.69"
"2025-02-01","2025-01-27","SF FuneralFDC0000000832F250126","","63.25","","1410009.94"
"2025-02-01","2025-01-28","SF FuneralF1130232      250128","","126.5","","1410136.44"
"2025-02-01","2025-01-31","SF FuneralF1066678      250131","","126.5","","1410262.94"
"2025-02-01","2025-01-24","SF FuneralFDC000000063H3250124","","126.5","","1410389.44"
"2025-02-01","2025-01-24","SF FuneralF820134       250127","","126.5","","1410515.94"
"2025-02-01","2025-01-24","SF FuneralFDC0000000LJWS250127","","126.5","","1410642.44"
"2025-02-01","2025-01-24","SF FuneralF1117355      250128","","126.5","","1410768.94"
"2025-02-01","2025-01-24","SF FuneralFDC0000000PL03250128","","126.5","","1410895.44"
"2025-02-01","2025-01-22","SF FuneralFDC000000070QW250122","","126.5","","1411021.94"
"2025-02-01","2025-01-22","SF FuneralF1117187      250122","","126.5","","1411148.44"
"2025-02-01","2025-01-23","SF FuneralF990262       250123","","126.5","","1411274.94"
"2025-02-01","2025-01-24","SF FuneralFDC00000003VHJ250128","","220","","1411494.94"
"2025-02-01","2025-01-24","SF FuneralFDC0000000622W250124","","126.5","","1411621.44"
"2025-02-01","2025-01-24","SF FuneralFDC0000000684P250128","","126.5","","1411747.94"
"2025-02-01","2025-01-24","SF FuneralFDC00000006SKH250127","","126.5","","1411874.44"
"2025-02-01","2025-01-24","SF FuneralFDC000000075FG250128","","126.5","","1412000.94"
"2025-02-01","2025-01-24","SF FuneralF793528       250128","","126.5","","1412127.44"
"2025-02-01","2025-01-24","SF FuneralF793801       250125","","126.5","","1412253.94"
"2025-02-01","2025-01-24","SF FuneralF803758       250127","","126.5","","1412380.44"
"2025-02-01","2025-01-24","SF FuneralF809675       250128","","126.5","","1412506.94"
"2025-02-01","2025-01-24","SF FuneralF812127       250127","","126.5","","1412633.44"
"2025-02-01","2025-01-24","SF FuneralF816171       250125","","126.5","","1412759.94"
"2025-02-01","2025-01-24","SF FuneralF816365       250125","","126.5","","1412886.44"
"2025-02-01","2025-01-24","SF FuneralF823488       250124","","126.5","","1413012.94"
"2025-02-01","2025-01-24","SF FuneralF828100       250127","","126.5","","1413139.44"
"2025-02-01","2025-01-24","SF FuneralF831599       250126","","126.5","","1413265.94"
"2025-02-01","2025-01-24","SF FuneralF832925       250128","","126.5","","1413392.44"
"2025-02-01","2025-01-24","SF FuneralFDC0000000CYRM250124","","126.5","","1413518.94"
"2025-02-01","2025-01-24","SF FuneralF842234       250128","","126.5","","1413645.44"
"2025-02-01","2025-01-24","SF FuneralFDC0000000H0V3250127","","126.5","","1413771.94"
"2025-02-01","2025-01-24","SF FuneralF1016673      250126","","126.5","","1413898.44"
"2025-02-01","2025-01-24","SF FuneralF1016896      250127","","126.5","","1414024.94"
"2025-02-01","2025-01-24","SF FuneralFDC0000000JWS9250128","","126.5","","1414151.44"
"2025-02-01","2025-01-24","SF FuneralF1055176      250127","","126.5","","1414277.94"
"2025-02-01","2025-01-24","SF FuneralF1065732      250127","","126.5","","1414404.44"
"2025-02-01","2025-01-24","SF FuneralF1068031      250124","","126.5","","1414530.94"
"2025-02-01","2025-01-24","SF FuneralF1110814      250127","","126.5","","1414657.44"
"2025-02-01","2025-01-24","SF FuneralF1113292      250127","","126.5","","1414783.94"
"2025-02-01","2025-01-24","SF FuneralF1119767      250124","","126.5","","1414910.44"
"2025-02-01","2025-01-24","SF FuneralF1120395      250124","","126.5","","1415036.94"
"2025-02-01","2025-01-24","SF FuneralF1122648      250127","","126.5","","1415163.44"
"2025-02-01","2025-01-24","SF FuneralF1127950      250128","","126.5","","1415289.94"
"2025-02-01","2025-01-28","SF FuneralFDC000000067FT250128","","63.25","","1415353.19"
"2025-02-01","2025-01-28","SF FuneralFDC00000009CP1250128","","95.75","","1415448.94"
"2025-02-01","2025-01-28","SF FuneralF1080351      250128","","63.25","","1415512.19"
"2025-02-01","2025-01-28","SF FuneralF1127919      250128","","63.25","","1415575.44"
"2025-02-01","2025-01-28","SF FuneralF1129508      250128","","126.5","","1415701.94"
"2025-02-01","2025-01-29","SF FuneralF1118345      250129","","126.5","","1415828.44"
"2025-02-01","2025-01-30","SF FuneralF1060982      250130","","126.5","","1415954.94"
"2025-02-01","2025-01-31","SF FuneralF990279       250201","","126.5","","1416081.44"
"2025-02-01","2025-01-24","SF FuneralFDC00000005FV6250127","","126.5","","1416207.94"
"2025-02-01","2025-01-24","SF FuneralFDC000000060NQ250128","","126.5","","1416334.44"
"2025-02-01","2025-01-24","SF FuneralFDC0000000630V250127","","126.5","","1416460.94"
"2025-02-01","2025-01-24","SF FuneralFDC000000065GW250127","","126.5","","1416587.44"
"2025-02-01","2025-01-24","SF FuneralFDC00000006D77250128","","126.5","","1416713.94"
"2025-02-01","2025-01-24","SF FuneralFDC00000006HRX250128","","126.5","","1416840.44"
"2025-02-01","2025-01-24","SF FuneralFDC00000006R8B250128","","126.5","","1416966.94"
"2025-02-01","2025-01-24","SF FuneralFDC00000006R8Z250128","","126.5","","1417093.44"
"2025-02-01","2025-01-24","SF FuneralFDC00000006XP2250127","","126.5","","1417219.94"
"2025-02-01","2025-01-24","SF FuneralFDC00000006ZY7250125","","126.5","","1417346.44"
"2025-02-01","2025-01-24","SF FuneralFDC0000000718K250128","","126.5","","1417472.94"
"2025-02-01","2025-01-24","SF FuneralFDC00000007191250128","","126.5","","1417599.44"
"2025-02-01","2025-01-24","SF FuneralFDC000000071SG250128","","126.5","","1417725.94"
"2025-02-01","2025-01-24","SF FuneralFDC000000071VJ250127","","126.5","","1417852.44"
"2025-02-01","2025-01-24","SF FuneralFDC0000000772K250128","","126.5","","1417978.94"
"2025-02-01","2025-01-24","SF FuneralFDC00000007BG2250125","","126.5","","1418105.44"
"2025-02-01","2025-01-24","SF FuneralFDC00000007V9V250125","","126.5","","1418231.94"
"2025-02-01","2025-01-24","SF FuneralFDC00000008741250128","","126.5","","1418358.44"
"2025-02-01","2025-01-24","SF FuneralF800824       250128","","126.5","","1418484.94"
"2025-02-01","2025-01-24","SF FuneralF803738       250125","","126.5","","1418611.44"
"2025-02-01","2025-01-24","SF FuneralF805122       250127","","126.5","","1418737.94"
"2025-02-01","2025-01-24","SF FuneralF808656       250126","","126.5","","1418864.44"
"2025-02-01","2025-01-24","SF FuneralF810997       250128","","126.5","","1418990.94"
"2025-02-01","2025-01-24","SF FuneralF811007       250128","","126.5","","1419117.44"
"2025-02-01","2025-01-24","SF FuneralF812891       250127","","126.5","","1419243.94"
"2025-02-01","2025-01-24","SF FuneralF812976       250127","","126.5","","1419370.44"
"2025-02-01","2025-01-24","SF FuneralF816546       250128","","126.5","","1419496.94"
"2025-02-01","2025-01-24","SF FuneralF817492       250128","","126.5","","1419623.44"
"2025-02-01","2025-01-24","SF FuneralF817862       250127","","126.5","","1419749.94"
"2025-02-01","2025-01-24","SF FuneralFDC0000000B6KL250127","","126.5","","1419876.44"
"2025-02-01","2025-01-24","SF FuneralF820700       250128","","126.5","","1420002.94"
"2025-02-01","2025-01-24","SF FuneralF827826       250126","","126.5","","1420129.44"
"2025-02-01","2025-01-24","SF FuneralF827962       250127","","126.5","","1420255.94"
"2025-02-01","2025-01-24","SF FuneralF828754       250127","","126.5","","1420382.44"
"2025-02-01","2025-01-24","SF FuneralF830961       250127","","126.5","","1420508.94"
"2025-02-01","2025-01-24","SF FuneralFDC0000000CBLF250128","","126.5","","1420635.44"
"2025-02-01","2025-01-24","SF FuneralF832435       250128","","126.5","","1420761.94"
"2025-02-01","2025-01-24","SF FuneralF834276       250128","","126.5","","1420888.44"
"2025-02-01","2025-01-24","SF FuneralF841276       250128","","126.5","","1421014.94"
"2025-02-01","2025-01-24","SF FuneralFDC0000000DZGG250127","","126.5","","1421141.44"
"2025-02-01","2025-01-24","SF FuneralF842141       250128","","126.5","","1421267.94"
"2025-02-01","2025-01-24","SF FuneralF900562       250128","","126.5","","1421394.44"
"2025-02-01","2025-01-24","SF FuneralF987462       250128","","126.5","","1421520.94"
"2025-02-01","2025-01-24","SF FuneralF988041       250128","","126.5","","1421647.44"
"2025-02-01","2025-01-24","SF FuneralF990512       250125","","126.5","","1421773.94"
"2025-02-01","2025-01-24","SF FuneralF992445       250126","","126.5","","1421900.44"
"2025-02-01","2025-01-24","SF FuneralF993452       250126","","126.5","","1422026.94"
"2025-02-01","2025-01-24","SF FuneralF1016844      250126","","191.5","","1422218.44"
"2025-02-01","2025-01-24","SF FuneralF1020571      250128","","126.5","","1422344.94"
"2025-02-01","2025-01-24","SF FuneralF1020935      250127","","126.5","","1422471.44"
"2025-02-01","2025-01-24","SF FuneralF1020953      250128","","126.5","","1422597.94"
"2025-02-01","2025-01-24","SF FuneralF1022136      250128","","126.5","","1422724.44"
"2025-02-01","2025-01-24","SF FuneralFDC0000000JZ0C250128","","126.5","","1422850.94"
"2025-02-01","2025-01-24","SF FuneralF1054492      250128","","126.5","","1422977.44"
"2025-02-01","2025-01-24","SF FuneralF1058802      250127","","126.5","","1423103.94"
"2025-02-01","2025-01-24","SF FuneralF1060520      250127","","126.5","","1423230.44"
"2025-02-01","2025-01-24","SF FuneralF1060811      250127","","126.5","","1423356.94"
"2025-02-01","2025-01-24","SF FuneralFDC0000000KJBJ250127","","126.5","","1423483.44"
"2025-02-01","2025-01-24","SF FuneralFDC0000000KS96250127","","126.5","","1423609.94"
"2025-02-01","2025-01-24","SF FuneralF1066623      250128","","126.5","","1423736.44"
"2025-02-01","2025-01-24","SF FuneralFDC0000000KYQT250128","","126.5","","1423862.94"
"2025-02-01","2025-01-24","SF FuneralF1072699      250127","","126.5","","1423989.44"
"2025-02-01","2025-01-24","SF FuneralF1079080      250127","","126.5","","1424115.94"
"2025-02-01","2025-01-24","SF FuneralFDC0000000LT4Y250128","","126.5","","1424242.44"
"2025-02-01","2025-01-24","SF FuneralF1103732      250127","","126.5","","1424368.94"
"2025-02-01","2025-01-24","SF FuneralF1104123      250125","","126.5","","1424495.44"
"2025-02-01","2025-01-24","SF FuneralF1104130      250128","","126.5","","1424621.94"
"2025-02-01","2025-01-24","SF FuneralF992956       250126","","126.5","","1424748.44"
"2025-02-01","2025-01-24","SF FuneralF1109752      250128","","126.5","","1424874.94"
"2025-02-01","2025-01-24","SF FuneralF1109858      250128","","126.5","","1425001.44"
"2025-02-01","2025-01-24","SF FuneralF1109921      250128","","126.5","","1425127.94"
"2025-02-01","2025-01-24","SF FuneralF1110198      250128","","126.5","","1425254.44"
"2025-02-01","2025-01-24","SF FuneralF1111614      250127","","126.5","","1425380.94"
"2025-02-01","2025-01-24","SF FuneralF1113101      250128","","126.5","","1425507.44"
"2025-02-01","2025-01-24","SF FuneralF1113192      250128","","126.5","","1425633.94"
"2025-02-01","2025-01-24","SF FuneralF1113212      250127","","126.5","","1425760.44"
"2025-02-01","2025-01-24","SF FuneralF1114524      250125","","126.5","","1425886.94"
"2025-02-01","2025-01-24","SF FuneralF1114695      250127","","126.5","","1426013.44"
"2025-02-01","2025-01-24","SF FuneralFDC0000000NFY1250128","","126.5","","1426139.94"
"2025-02-01","2025-01-24","SF FuneralF1116002      250128","","126.5","","1426266.44"
"2025-02-01","2025-01-24","SF FuneralF1117211      250128","","126.5","","1426392.94"
"2025-02-01","2025-01-24","SF FuneralFDC0000000NK23250127","","126.5","","1426519.44"
"2025-02-01","2025-01-24","SF FuneralF1117662      250128","","126.5","","1426645.94"
"2025-02-01","2025-01-24","SF FuneralF1117933      250128","","126.5","","1426772.44"
"2025-02-01","2025-01-24","SF FuneralF1118173      250128","","126.5","","1426898.94"
"2025-02-01","2025-01-24","SF FuneralFDC0000000NPT2250128","","126.5","","1427025.44"
"2025-02-01","2025-01-24","SF FuneralF1118769      250128","","126.5","","1427151.94"
"2025-02-01","2025-01-24","SF FuneralFDC0000000NR0L250127","","126.5","","1427278.44"
"2025-02-01","2025-01-24","SF FuneralFDC0000000NWX1250124","","191.5","","1427469.94"
"2025-02-01","2025-01-24","SF FuneralF1121872      250127","","126.5","","1427596.44"
"2025-02-01","2025-01-24","SF FuneralF1121976      250127","","126.5","","1427722.94"
"2025-02-01","2025-01-24","SF FuneralF1122924      250127","","126.5","","1427849.44"
"2025-02-01","2025-01-24","SF FuneralFDC0000000P3YP250127","","126.5","","1427975.94"
"2025-02-01","2025-01-24","SF FuneralFDC0000000P3YR250127","","126.5","","1428102.44"
"2025-02-01","2025-01-24","SF FuneralF1123611      250127","","126.5","","1428228.94"
"2025-02-01","2025-01-24","SF FuneralFDC0000000PBN3250128","","126.5","","1428355.44"
"2025-02-01","2025-01-24","SF FuneralFDC0000000PFSY250128","","126.5","","1428481.94"
"2025-02-01","2025-01-24","SF FuneralF1125710      250128","","126.5","","1428608.44"
"2025-02-01","2025-01-24","SF FuneralF1125730      250128","","126.5","","1428734.94"
"2025-02-01","2025-01-24","SF FuneralFDC0000000PJKW250128","","126.5","","1428861.44"
"2025-02-01","2025-01-24","SF FuneralF1126030      250127","","126.5","","1428987.94"
"2025-02-01","2025-01-24","SF FuneralF1126254      250128","","126.5","","1429114.44"
"2025-02-01","2025-01-24","SF FuneralF1127320      250128","","126.5","","1429240.94"
"2025-02-01","2025-01-24","SF FuneralF1127982      250128","","126.5","","1429367.44"
"2025-02-01","2025-01-24","SF FuneralF1128208      250128","","126.5","","1429493.94"
"2025-02-01","2025-01-24","SF FuneralF1128835      250128","","126.5","","1429620.44"
"2025-02-01","2025-01-24","SF FuneralF1128926      250128","","126.5","","1429746.94"
"2025-02-01","2025-01-24","SF FuneralFDC0000000PWXG250128","","126.5","","1429873.44"
"2025-02-01","2025-01-24","SF FuneralF1129276      250128","","126.5","","1429999.94"
"2025-02-01","2025-01-24","SF FuneralF1129371      250128","","126.5","","1430126.44"
"2025-02-01","2025-01-23","SF FuneralF1114951      250123","","126.5","","1430252.94"
"2025-02-01","2025-01-22","SF FuneralFDC00000005S1Y250122","","126.5","","1430379.44"
"2025-02-01","2025-01-22","SF FuneralFDC000000082DL250122","","126.5","","1430505.94"
"2025-02-01","2025-01-30","SF FuneralF990088       250130","","126.5","","1430632.44"
"2025-02-01","2025-01-30","SF FuneralFDC0000000P1LP250130","","126.5","","1430758.94"
"2025-02-01","2025-01-30","SF FuneralFDC0000000PXGC250130","","126.5","","1430885.44"
"2025-02-01","2025-01-30","SF FuneralF1129098      250130","","126.5","","1431011.94"
"2025-02-01","2025-01-31","SF FuneralF988284       250201","","126.5","","1431138.44"
"2025-02-01","2025-01-31","SF FuneralFDC0000000J3HR250201","","126.5","","1431264.94"
"2025-02-01","2025-01-29","SF FuneralFDC000000068K4250129","","126.5","","1431391.44"
"2025-02-01","2025-01-29","SF FuneralFDC000000068MY250129","","126.5","","1431517.94"
"2025-02-01","2025-01-29","SF FuneralFDC00000006FW4250129","","126.5","","1431644.44"
"2025-02-01","2025-01-31","SF FuneralF798583       250131","","31.63","","1431676.07"
"2025-02-01","2025-01-24","SF FuneralFDC00000003N5L250127","","220","","1431896.07"
"2025-02-01","2025-01-24","SF FuneralFDC000000068VR250128","","126.5","","1432022.57"
"2025-02-01","2025-01-24","SF FuneralFDC0000000693K250127","","126.5","","1432149.07"
"2025-02-01","2025-01-24","SF FuneralFDC00000006BWQ250128","","126.5","","1432275.57"
"2025-02-01","2025-01-24","SF FuneralFDC00000006CJL250128","","126.5","","1432402.07"
"2025-02-01","2025-01-24","SF FuneralFDC0000000754D250127","","126.5","","1432528.57"
"2025-02-01","2025-01-24","SF FuneralFDC00000007DS9250128","","126.5","","1432655.07"
"2025-02-01","2025-01-24","SF FuneralFDC00000007MV5250125","","126.5","","1432781.57"
"2025-02-01","2025-01-24","SF FuneralFDC00000008SNL250127","","126.5","","1432908.07"
"2025-02-01","2025-01-24","SF FuneralF808115       250128","","126.5","","1433034.57"
"2025-02-01","2025-01-24","SF FuneralF816167       250128","","126.5","","1433161.07"
"2025-02-01","2025-01-24","SF FuneralF842925       250128","","126.5","","1433287.57"
"2025-02-01","2025-01-24","SF FuneralF900949       250128","","126.5","","1433414.07"
"2025-02-01","2025-01-24","SF FuneralF993213       250126","","126.5","","1433540.57"
"2025-02-01","2025-01-24","SF FuneralF1066048      250128","","126.5","","1433667.07"
"2025-02-01","2025-01-24","SF FuneralF1111282      250127","","126.5","","1433793.57"
"2025-02-01","2025-01-24","SF FuneralF1114235      250128","","126.5","","1433920.07"
"2025-02-01","2025-01-24","SF FuneralF1116078      250127","","126.5","","1434046.57"
"2025-02-01","2025-01-24","SF FuneralF1117698      250128","","126.5","","1434173.07"
"2025-02-01","2025-01-24","SF FuneralF1118919      250124","","126.5","","1434299.57"
"2025-02-01","2025-01-24","SF FuneralF1123311      250128","","126.5","","1434426.07"
"2025-02-01","2025-01-24","SF FuneralF1123602      250127","","126.5","","1434552.57"
"2025-02-01","2025-01-24","SF FuneralF1125699      250128","","126.5","","1434679.07"
"2025-02-01","2025-01-24","SF FuneralF1128859      250128","","126.5","","1434805.57"
"2025-02-01","2025-01-22","SF FuneralF815467       250122","","126.5","","1434932.07"
"2025-02-01","2025-01-28","SF FuneralFDC00000006NCH250128","","63.25","","1434995.32"
"2025-02-01","2025-01-28","SF FuneralFDC0000000738X250128","","63.25","","1435058.57"
"2025-02-01","2025-01-28","SF FuneralF823118       250128","","63.25","","1435121.82"
"2025-02-01","2025-01-28","SF FuneralF987990       250128","","63.25","","1435185.07"
"2025-02-01","2025-01-28","SF FuneralF993377       250128","","63.25","","1435248.32"
"2025-02-01","2025-01-28","SF FuneralF1083636      250128","","63.25","","1435311.57"
"2025-02-01","2025-01-28","SF FuneralF1120149      250128","","63.25","","1435374.82"
"2025-02-01","2025-01-28","SF FuneralF1127561      250128","","63.25","","1435438.07"
"2025-02-01","2025-01-28","SF FuneralFDC0000000PYJQ250128","","126.5","","1435564.57"
"2025-02-01","2025-01-29","SF FuneralFDC00000006JS2250129","","126.5","","1435691.07"
"2025-02-01","2025-01-29","SF FuneralF823032       250129","","126.5","","1435817.57"
"2025-02-01","2025-01-29","SF FuneralF833367       250129","","126.5","","1435944.07"
"2025-02-01","2025-01-29","SF FuneralF1021798      250129","","126.5","","1436070.57"
"2025-02-01","2025-01-29","SF FuneralF1021896      250129","","126.5","","1436197.07"
"2025-02-01","2025-01-31","SF FuneralF831922       250131","","31.63","","1436228.7"
"2025-02-01","2025-01-31","SF FuneralF834544       250131","","31.63","","1436260.33"
"2025-02-01","2025-01-31","SF FuneralF843266       250131","","31.63","","1436291.96"
"2025-02-01","2025-01-31","SF FuneralF981788       250131","","31.63","","1436323.59"
"2025-02-01","2025-01-25","SF FuneralFDC0000000752S250125","","63.25","","1436386.84"
"2025-02-01","2025-01-27","SF FuneralF1113979      250127","","63.25","","1436450.09"
"2025-02-01","2025-01-28","SF FuneralFDC00000005P6R250128","","63.25","","1436513.34"
"2025-02-01","2025-01-28","SF FuneralFDC00000005ZVT250128","","126.5","","1436639.84"
"2025-02-01","2025-01-28","SF FuneralFDC00000006B9G250128","","31.63","","1436671.47"
"2025-02-01","2025-01-28","SF FuneralF832776       250128","","63.25","","1436734.72"
"2025-02-01","2025-01-28","SF FuneralF1016973      250128","","31.63","","1436766.35"
"2025-02-01","2025-01-28","SF FuneralF1110349      250128","","31.63","","1436797.98"
"2025-02-01","2025-01-28","SF FuneralF1120411      250128","","63.25","","1436861.23"
"2025-02-01","2025-01-28","SF FuneralF1122862      250128","","31.63","","1436892.86"
"2025-02-01","2025-01-25","SF FuneralFDC0000000795L250125","","31.63","","1436924.49"
"2025-02-01","2025-01-27","SF FuneralF810327       250127","","31.63","","1436956.12"
"2025-02-01","2025-01-27","SF FuneralF1079340      250127","","31.63","","1436987.75"
"2025-02-01","2025-01-28","SF FuneralFDC00000005L57250128","","31.63","","1437019.38"
"2025-02-01","2025-01-28","SF FuneralF805200       250128","","31.63","","1437051.01"
"2025-02-01","2025-01-28","SF FuneralF814338       250128","","31.63","","1437082.64"
"2025-02-01","2025-01-28","SF FuneralF817682       250128","","31.63","","1437114.27"
"2025-02-01","2025-01-28","SF FuneralF1020608      250128","","31.63","","1437145.9"
"2025-02-01","2025-01-28","SF FuneralF1020683      250128","","31.63","","1437177.53"
"2025-02-01","2025-01-28","SF FuneralF1033680      250128","","31.63","","1437209.16"
"2025-02-01","2025-01-28","SF FuneralF1103795      250128","","31.63","","1437240.79"
"2025-02-01","2025-01-28","SF FuneralF1115225      250128","","31.63","","1437272.42"
"2025-02-01","2025-01-28","SF FuneralF1127417      250128","","31.63","","1437304.05"
"2025-02-01","2025-02-01","SF FuneralFDC00000002TWN250201","","220","","1437524.05"
"2025-02-01","2025-02-01","SF FuneralFDC00000002XNC250201","","220","","1437744.05"
"2025-02-01","2025-02-01","SF FuneralFDC00000002Y47250201","","220","","1437964.05"
"2025-02-01","2025-02-01","SF FuneralFDC0000000330V250201","","220","","1438184.05"
"2025-02-01","2025-02-01","SF FuneralFDC000000033PC250201","","220","","1438404.05"
"2025-02-01","2025-02-01","SF FuneralFDC00000003SJP250201","","220","","1438624.05"
"2025-02-01","2025-02-01","SF FuneralFDC00000005PS4250201","","126.5","","1438750.55"
"2025-02-01","2025-02-01","SF FuneralFDC00000005VZW250201","","126.5","","1438877.05"
"2025-02-01","2025-02-01","SF FuneralFDC000000067XS250201","","126.5","","1439003.55"
"2025-02-01","2025-02-01","SF FuneralFDC00000006817250201","","126.5","","1439130.05"
"2025-02-01","2025-02-01","SF FuneralFDC000000069HR250201","","126.5","","1439256.55"
"2025-02-01","2025-02-01","SF FuneralFDC00000006BYL250201","","126.5","","1439383.05"
"2025-02-01","2025-02-01","SF FuneralFDC00000006C64250201","","126.5","","1439509.55"
"2025-02-01","2025-02-01","SF FuneralFDC00000006GPJ250201","","126.5","","1439636.05"
"2025-02-01","2025-02-01","SF FuneralFDC00000006GS5250201","","126.5","","1439762.55"
"2025-02-01","2025-02-01","SF FuneralFDC00000006GY4250201","","126.5","","1439889.05"
"2025-02-01","2025-02-01","SF FuneralFDC00000006H56250201","","126.5","","1440015.55"
"2025-02-01","2025-02-01","SF FuneralFDC00000006MW6250201","","220","","1440235.55"
"2025-02-01","2025-02-01","SF FuneralFDC000000072MQ250201","","126.5","","1440362.05"
"2025-02-01","2025-02-01","SF FuneralFDC000000073GL250201","","126.5","","1440488.55"
"2025-02-01","2025-02-01","SF FuneralFDC000000075DL250201","","126.5","","1440615.05"
"2025-02-01","2025-02-01","SF FuneralFDC000000075DM250201","","126.5","","1440741.55"
"2025-02-01","2025-02-01","SF FuneralFDC000000075DS250201","","126.5","","1440868.05"
"2025-02-01","2025-02-01","SF FuneralFDC000000075MV250201","","126.5","","1440994.55"
"2025-02-01","2025-02-01","SF FuneralFDC000000075R1250201","","126.5","","1441121.05"
"2025-02-01","2025-02-01","SF FuneralFDC0000000785G250201","","126.5","","1441247.55"
"2025-02-01","2025-02-01","SF FuneralFDC00000007888250201","","126.5","","1441374.05"
"2025-02-01","2025-02-01","SF FuneralFDC00000007B45250201","","126.5","","1441500.55"
"2025-02-01","2025-02-01","SF FuneralFDC00000007B4K250201","","126.5","","1441627.05"
"2025-02-01","2025-02-01","SF FuneralFDC00000007BSH250201","","126.5","","1441753.55"
"2025-02-01","2025-02-01","SF FuneralFDC00000007QCR250201","","126.5","","1441880.05"
"2025-02-01","2025-02-01","SF FuneralFDC000000085SN250201","","126.5","","1442006.55"
"2025-02-01","2025-02-01","SF FuneralF811466       250201","","126.5","","1442133.05"
"2025-02-01","2025-02-01","SF FuneralF813052       250201","","126.5","","1442259.55"
"2025-02-01","2025-02-01","SF FuneralF814205       250201","","126.5","","1442386.05"
"2025-02-01","2025-02-01","SF FuneralF818319       250201","","126.5","","1442512.55"
"2025-02-01","2025-02-01","SF FuneralF821379       250201","","126.5","","1442639.05"
"2025-02-01","2025-02-01","SF FuneralF821868       250201","","126.5","","1442765.55"
"2025-02-01","2025-02-01","SF FuneralF832890       250201","","126.5","","1442892.05"
"2025-02-01","2025-02-01","SF FuneralFDC0000000CYMQ250201","","126.5","","1443018.55"
"2025-02-01","2025-02-01","SF FuneralF840498       250201","","126.5","","1443145.05"
"2025-02-01","2025-02-01","SF FuneralF841475       250201","","126.5","","1443271.55"
"2025-02-01","2025-02-01","SF FuneralF841905       250201","","126.5","","1443398.05"
"2025-02-01","2025-02-01","SF FuneralF992192       250201","","126.5","","1443524.55"
"2025-02-01","2025-02-01","SF FuneralF1075152      250201","","126.5","","1443651.05"
"2025-02-01","2025-02-01","SF FuneralFDC0000000M8FT250201","","126.5","","1443777.55"
"2025-02-01","2025-02-01","SF FuneralF1114708      250201","","126.5","","1443904.05"
"2025-02-01","2025-01-28","SF FuneralFDC0000000595N250128","","31.62","","1443935.67"
"2025-02-01","2025-01-28","SF FuneralFDC00000007CQV250128","","31.63","","1443967.3"
"2025-02-01","2025-01-28","SF FuneralF1118348      250128","","31.63","","1443998.93"
"2025-02-01","2025-01-28","SF FuneralF1073279      250128","","126.5","","1444125.43"
"2025-02-01","2025-01-28","SF FuneralF1130344      250128","","31.63","","1444157.06"
"2025-02-01","2025-01-24","SF FuneralFDC00000006CMJ250128","","126.5","","1444283.56"
"2025-02-01","2025-01-24","SF FuneralFDC0000000782L250127","","126.5","","1444410.06"
"2025-02-01","2025-01-24","SF FuneralFDC00000007DCR250124","","126.5","","1444536.56"
"2025-02-01","2025-01-24","SF FuneralF797727       250128","","126.5","","1444663.06"
"2025-02-01","2025-01-24","SF FuneralF800236       250128","","126.5","","1444789.56"
"2025-02-01","2025-01-24","SF FuneralFDC00000008KGQ250128","","126.5","","1444916.06"
"2025-02-01","2025-01-24","SF FuneralF803343       250127","","126.5","","1445042.56"
"2025-02-01","2025-01-24","SF FuneralF803481       250127","","126.5","","1445169.06"
"2025-02-01","2025-01-24","SF FuneralF805145       250127","","126.5","","1445295.56"
"2025-02-01","2025-01-24","SF FuneralF808009       250127","","126.5","","1445422.06"
"2025-02-01","2025-01-24","SF FuneralF812363       250127","","126.5","","1445548.56"
"2025-02-01","2025-01-24","SF FuneralF812565       250127","","126.5","","1445675.06"
"2025-02-01","2025-01-24","SF FuneralF812575       250127","","126.5","","1445801.56"
"2025-02-01","2025-01-24","SF FuneralF823086       250128","","126.5","","1445928.06"
"2025-02-01","2025-01-24","SF FuneralF830762       250127","","126.5","","1446054.56"
"2025-02-01","2025-01-24","SF FuneralFDC0000000CHNC250128","","126.5","","1446181.06"
"2025-02-01","2025-01-24","SF FuneralF841298       250126","","126.5","","1446307.56"
"2025-02-01","2025-01-24","SF FuneralF844225       250127","","126.5","","1446434.06"
"2025-02-01","2025-01-24","SF FuneralF992365       250126","","126.5","","1446560.56"
"2025-02-01","2025-01-24","SF FuneralFDC0000000J8SN250126","","126.5","","1446687.06"
"2025-02-01","2025-01-24","SF FuneralFDC0000000J8SR250126","","126.5","","1446813.56"
"2025-02-01","2025-01-24","SF FuneralFDC0000000JSPN250128","","126.5","","1446940.06"
"2025-02-01","2025-01-24","SF FuneralFDC0000000K7C4250127","","126.5","","1447066.56"
"2025-02-01","2025-01-24","SF FuneralF1055044      250127","","126.5","","1447193.06"
"2025-02-01","2025-01-24","SF FuneralF1075084      250127","","126.5","","1447319.56"
"2025-02-01","2025-01-24","SF FuneralF1084928      250127","","126.5","","1447446.06"
"2025-02-01","2025-01-24","SF FuneralF1108759      250128","","126.5","","1447572.56"
"2025-02-01","2025-01-24","SF FuneralF1112550      250126","","126.5","","1447699.06"
"2025-02-01","2025-01-24","SF FuneralF1113303      250127","","126.5","","1447825.56"
"2025-02-01","2025-01-24","SF FuneralF1114013      250125","","126.5","","1447952.06"
"2025-02-01","2025-01-24","SF FuneralF1114285      250127","","126.5","","1448078.56"
"2025-02-01","2025-01-24","SF FuneralF1115197      250128","","126.5","","1448205.06"
"2025-02-01","2025-01-24","SF FuneralF1118215      250128","","126.5","","1448331.56"
"2025-02-01","2025-01-24","SF FuneralF1118220      250128","","126.5","","1448458.06"
"2025-02-01","2025-01-24","SF FuneralF1118964      250127","","126.5","","1448584.56"
"2025-02-01","2025-01-24","SF FuneralF1122196      250127","","126.5","","1448711.06"
"2025-02-01","2025-01-24","SF FuneralF1122826      250127","","126.5","","1448837.56"
"2025-02-01","2025-01-24","SF FuneralF1123063      250124","","126.5","","1448964.06"
"2025-02-01","2025-01-24","SF FuneralF1125083      250128","","126.5","","1449090.56"
"2025-02-01","2025-01-24","SF FuneralF1125174      250124","","126.5","","1449217.06"
"2025-02-01","2025-01-29","SF FuneralF802401       250129","","63.25","","1449280.31"
"2025-02-01","2025-01-29","SF FuneralF1022131      250129","","126.5","","1449406.81"
"2025-02-01","2025-01-22","SF FuneralF820988       250122","","126.5","","1449533.31"
"2025-02-01","2025-01-22","SF FuneralF823590       250122","","126.5","","1449659.81"
"2025-02-01","2025-01-30","SF FuneralF833637       250130","","126.5","","1449786.31"
"2025-02-01","2025-01-30","SF FuneralF1079631      250130","","31.63","","1449817.94"
"2025-02-01","2025-01-23","SF FuneralF1118265      250123","","126.5","","1449944.44"
"2025-02-01","2025-01-24","SF FuneralFDC00000006DJR250127","","126.5","","1450070.94"
"2025-02-01","2025-01-24","SF FuneralF1021699      250128","","126.5","","1450197.44"
"2025-02-01","2025-01-22","SF FuneralFDC000000031H0250122","","220","","1450417.44"
"2025-02-01","2025-01-22","SF FuneralF1083889      250122","","126.5","","1450543.94"
"2025-02-01","2025-01-22","SF FuneralF1125088      250122","","126.5","","1450670.44"
"2025-02-01","2025-01-23","SF FuneralF1120822      250123","","126.5","","1450796.94"
"2025-02-01","2025-01-24","SF FuneralFDC000000069BF250128","","126.5","","1450923.44"
"2025-02-01","2025-01-24","SF FuneralFDC000000071MZ250128","","126.5","","1451049.94"
"2025-02-01","2025-01-24","SF FuneralFDC00000007LMS250125","","126.5","","1451176.44"
"2025-02-01","2025-01-24","SF FuneralFDC00000007PV3250126","","126.5","","1451302.94"
"2025-02-01","2025-01-24","SF FuneralF798564       250128","","126.5","","1451429.44"
"2025-02-01","2025-01-24","SF FuneralF799091       250126","","126.5","","1451555.94"
"2025-02-01","2025-01-24","SF FuneralF816819       250128","","126.5","","1451682.44"
"2025-02-01","2025-01-24","SF FuneralF833060       250124","","126.5","","1451808.94"
"2025-02-01","2025-01-24","SF FuneralF987216       250128","","126.5","","1451935.44"
"2025-02-01","2025-01-24","SF FuneralF987464       250128","","126.5","","1452061.94"
"2025-02-01","2025-01-24","SF FuneralFDC0000000J5P3250126","","126.5","","1452188.44"
"2025-02-01","2025-01-24","SF FuneralF993286       250126","","126.5","","1452314.94"
"2025-02-01","2025-01-24","SF FuneralF1050845      250128","","126.5","","1452441.44"
"2025-02-01","2025-01-24","SF FuneralF1075249      250127","","126.5","","1452567.94"
"2025-02-01","2025-01-24","SF FuneralF1078860      250127","","126.5","","1452694.44"
"2025-02-01","2025-01-24","SF FuneralF1109839      250128","","126.5","","1452820.94"
"2025-02-01","2025-01-24","SF FuneralF1111353      250128","","126.5","","1452947.44"
"2025-02-01","2025-01-24","SF FuneralF1111579      250128","","126.5","","1453073.94"
"2025-02-01","2025-01-24","SF FuneralFDC0000000N7RM250127","","126.5","","1453200.44"
"2025-02-01","2025-01-24","SF FuneralF1118512      250127","","126.5","","1453326.94"
"2025-02-01","2025-01-24","SF FuneralF1129342      250128","","126.5","","1453453.44"
"2025-02-01","2025-01-28","SF FuneralFDC000000079QY250128","","31.63","","1453485.07"
"2025-02-01","2025-01-28","SF FuneralF802375       250128","","31.63","","1453516.7"
"2025-02-01","2025-01-28","SF FuneralF1020916      250128","","31.63","","1453548.33"
"2025-02-01","2025-01-28","SF FuneralF1068221      250128","","31.63","","1453579.96"
"2025-02-01","2025-01-28","SF FuneralF981451       250128","","31.63","","1453611.59"
"2025-02-01","2025-01-29","SF FuneralF1085236      250129","","126.5","","1453738.09"
"2025-02-01","2025-01-31","SF FuneralF981156       250131","","126.5","","1453864.59"
"2025-02-01","2025-02-01","SF FuneralFDC00000002T8D250201","","220","","1454084.59"
"2025-02-01","2025-02-01","SF FuneralFDC00000005CFV250201","","126.5","","1454211.09"
"2025-02-01","2025-02-01","SF FuneralFDC00000006B1W250201","","126.5","","1454337.59"
"2025-02-01","2025-02-01","SF FuneralFDC00000006FCK250201","","126.5","","1454464.09"
"2025-02-01","2025-02-01","SF FuneralFDC00000006G15250201","","126.5","","1454590.59"
"2025-02-01","2025-02-01","SF FuneralFDC00000006HKQ250201","","126.5","","1454717.09"
"2025-02-01","2025-02-01","SF FuneralFDC00000006KDQ250201","","126.5","","1454843.59"
"2025-02-01","2025-02-01","SF FuneralFDC00000007163250201","","63.25","","1454906.84"
"2025-02-01","2025-02-01","SF FuneralFDC000000078RV250201","","126.5","","1455033.34"
"2025-02-01","2025-02-01","SF FuneralFDC000000085DR250201","","126.5","","1455159.84"
"2025-02-01","2025-02-01","SF FuneralF800123       250201","","126.5","","1455286.34"
"2025-02-01","2025-02-01","SF FuneralF808720       250201","","126.5","","1455412.84"
"2025-02-01","2025-02-01","SF FuneralF813764       250201","","126.5","","1455539.34"
"2025-02-01","2025-02-01","SF FuneralF818109       250201","","126.5","","1455665.84"
"2025-02-01","2025-02-01","SF FuneralF828112       250201","","126.5","","1455792.34"
"2025-02-01","2025-02-01","SF FuneralF832037       250201","","126.5","","1455918.84"
"2025-02-01","2025-02-01","SF FuneralF841532       250201","","126.5","","1456045.34"
"2025-02-01","2025-02-01","SF FuneralFDC0000000J8XY250201","","126.5","","1456171.84"
"2025-02-01","2025-02-01","SF FuneralF1021760      250201","","126.5","","1456298.34"
"2025-02-01","2025-02-01","SF FuneralF1021968      250201","","126.5","","1456424.84"
"2025-02-01","2025-02-01","SF FuneralF781742       250201","","126.5","","1456551.34"
"2025-02-01","2025-02-01","SF FuneralF1065993      250201","","126.5","","1456677.84"
"2025-02-01","2025-02-01","SF FuneralF1066765      250201","","126.5","","1456804.34"
"2025-02-01","2025-02-01","SF FuneralF1079007      250201","","126.5","","1456930.84"
"2025-02-01","2025-02-01","SF FuneralF1103729      250201","","126.5","","1457057.34"
"2025-02-01","2025-02-01","SF FuneralF1109100      250201","","126.5","","1457183.84"
"2025-02-01","2025-02-01","SF FuneralF1111762      250201","","126.5","","1457310.34"
"2025-02-01","2025-02-01","SF FuneralF1113613      250201","","126.5","","1457436.84"
"2025-02-01","2025-02-01","SF FuneralF1113870      250201","","126.5","","1457563.34"
"2025-02-01","2025-02-01","SF FuneralF1120521      250201","","126.5","","1457689.84"
"2025-02-01","2025-02-01","SF FuneralF1125662      250201","","31.63","","1457721.47"
"2025-02-01","2025-02-01","SF FuneralF1126213      250201","","126.5","","1457847.97"
"2025-02-01","2025-02-01","SF FuneralF1127938      250201","","126.5","","1457974.47"
"2025-02-01","2025-02-01","SF FuneralFDC0000000PW0G250201","","126.5","","1458100.97"
"2025-02-01","2025-01-22","SF FuneralFDC00000008HXR250122","","126.5","","1458227.47"
"2025-02-01","2025-01-22","SF FuneralF832472       250122","","126.5","","1458353.97"
"2025-02-01","2025-01-22","SF FuneralF992485       250122","","126.5","","1458480.47"
"2025-02-01","2025-01-22","SF FuneralF1059298      250122","","126.5","","1458606.97"
"2025-02-01","2025-01-24","SF FuneralFDC00000005V57250126","","126.5","","1458733.47"
"2025-02-01","2025-01-24","SF FuneralFDC00000007QL9250128","","126.5","","1458859.97"
"2025-02-01","2025-01-24","SF FuneralF993540       250126","","126.5","","1458986.47"
"2025-02-01","2025-01-24","SF FuneralF1021641      250128","","126.5","","1459112.97"
"2025-02-01","2025-01-24","SF FuneralF1021780      250125","","126.5","","1459239.47"
"2025-02-01","2025-01-24","SF FuneralFDC0000000N7RF250127","","126.5","","1459365.97"
"2025-02-01","2025-01-24","SF FuneralFDC0000000N7RJ250127","","126.5","","1459492.47"
"2025-02-01","2025-01-28","SF FuneralFDC00000007GVV250128","","63.25","","1459555.72"
"2025-02-01","2025-01-28","SF FuneralF1129429      250128","","126.5","","1459682.22"
"2025-02-01","2025-01-30","SF FuneralF804166       250130","","126.5","","1459808.72"
"2025-02-01","2025-01-31","SF FuneralF832849       250131","","126.5","","1459935.22"
"2025-02-01","2025-02-01","SF FuneralFDC000000067RQ250201","","126.5","","1460061.72"
"2025-02-01","2025-02-01","SF FuneralFDC00000006T7Y250201","","126.5","","1460188.22"
"2025-02-01","2025-02-01","SF FuneralFDC000000075J7250201","","126.5","","1460314.72"
"2025-02-01","2025-02-01","SF FuneralFDC00000007C9H250201","","126.5","","1460441.22"
"2025-02-01","2025-02-01","SF FuneralF813100       250201","","126.5","","1460567.72"
"2025-02-01","2025-02-01","SF FuneralF817183       250201","","126.5","","1460694.22"
"2025-02-01","2025-02-01","SF FuneralF828739       250201","","126.5","","1460820.72"
"2025-02-01","2025-02-01","SF FuneralF993296       250201","","126.5","","1460947.22"
"2025-02-01","2025-02-01","SF FuneralF1060321      250201","","126.5","","1461073.72"
"2025-02-01","2025-02-01","SF FuneralF1052159      250201","","126.5","","1461200.22"
"2025-02-01","2025-02-01","SF FuneralFDC00000006NKC250201","","126.5","","1461326.72"
"2025-02-01","2025-02-01","SF FuneralFDC000000085XD250201","","126.5","","1461453.22"
"2025-02-01","2025-02-01","SF FuneralF810014       250201","","126.5","","1461579.72"
"2025-02-01","2025-02-01","SF FuneralF814461       250201","","126.5","","1461706.22"
"2025-02-01","2025-02-01","SF FuneralF814867       250201","","126.5","","1461832.72"
"2025-02-01","2025-02-01","SF FuneralF829868       250201","","126.5","","1461959.22"
"2025-02-01","2025-02-01","SF FuneralF1110082      250202","","63.25","","1462022.47"
"2025-02-01","2025-02-01","SF FuneralF1122274      250201","","126.5","","1462148.97"
"2025-02-01","2025-02-01","SF FuneralF1125249      250202","","126.5","","1462275.47"
"2025-02-01","2025-01-24","SF FuneralFDC0000000796W250128","","126.5","","1462401.97"
"2025-02-01","2025-01-24","SF FuneralF833226       250127","","126.5","","1462528.47"
"2025-02-01","2025-01-24","SF FuneralF991987       250126","","126.5","","1462654.97"
"2025-02-01","2025-01-24","SF FuneralF992258       250127","","126.5","","1462781.47"
"2025-02-01","2025-01-24","SF FuneralF1065795      250128","","126.5","","1462907.97"
"2025-02-01","2025-01-31","SF FuneralF1127880      250131","","126.5","","1463034.47"
"2025-02-01","2025-01-31","SF FuneralFDC0000000PSXJ250131","","126.5","","1463160.97"
"2025-02-01","2025-02-01","SF FuneralFDC00000006897250201","","126.5","","1463287.47"
"2025-02-01","2025-02-01","SF FuneralFDC00000006PSN250201","","126.5","","1463413.97"
"2025-02-01","2025-02-01","SF FuneralF798788       250201","","126.5","","1463540.47"
"2025-02-01","2025-02-01","SF FuneralF804271       250201","","126.5","","1463666.97"
"2025-02-01","2025-02-01","SF FuneralF809380       250201","","126.5","","1463793.47"
"2025-02-01","2025-02-01","SF FuneralF813467       250201","","126.5","","1463919.97"
"2025-02-01","2025-02-01","SF FuneralF817795       250201","","126.5","","1464046.47"
"2025-02-01","2025-02-01","SF FuneralFDC0000000JY4C250201","","126.5","","1464172.97"
"2025-02-01","2025-02-01","SF FuneralF1060571      250201","","126.5","","1464299.47"
"2025-02-01","2025-02-01","SF FuneralF1109061      250201","","126.5","","1464425.97"
"2025-02-01","2025-01-29","SF FuneralFDC0000000HZCK250129","","126.5","","1464552.47"
"2025-02-01","2025-01-29","SF FuneralF1117720      250129","","126.5","","1464678.97"
"2025-02-01","2025-02-01","SF FuneralFDC000000035X4250201","","220","","1464898.97"
"2025-02-01","2025-02-01","SF FuneralFDC00000005QD7250201","","126.5","","1465025.47"
"2025-02-01","2025-02-01","SF FuneralFDC000000073TL250201","","126.5","","1465151.97"
"2025-02-01","2025-02-01","SF FuneralFDC0000000761X250201","","126.5","","1465278.47"
"2025-02-01","2025-02-01","SF FuneralFDC00000007RXP250201","","126.5","","1465404.97"
"2025-02-01","2025-02-01","SF FuneralF803749       250201","","126.5","","1465531.47"
"2025-02-01","2025-02-01","SF FuneralF1075207      250201","","126.5","","1465657.97"
"2025-02-01","2025-02-01","SF FuneralF1079150      250201","","126.5","","1465784.47"
"2025-02-01","2025-02-01","SF FuneralF1084522      250201","","126.5","","1465910.97"
"2025-02-01","2025-02-01","SF FuneralF1118450      250201","","126.5","","1466037.47"
"2025-02-01","2025-02-01","SF FuneralFDC0000000700Z250201","","126.5","","1466163.97"
"2025-02-01","2025-02-01","SF FuneralFDC00000005T43250201","","126.5","","1466290.47"
"2025-02-01","2025-02-01","SF FuneralFDC00000006F1M250201","","126.5","","1466416.97"
"2025-02-01","2025-02-01","SF FuneralF809141       250201","","126.5","","1466543.47"
"2025-02-01","2025-02-01","SF FuneralF818218       250201","","126.5","","1466669.97"
"2025-02-01","2025-02-01","SF FuneralF820376       250201","","126.5","","1466796.47"
"2025-02-01","2025-02-01","SF FuneralF992581       250202","","126.5","","1466922.97"
"2025-02-01","2025-02-01","SF FuneralF1073358      250201","","126.5","","1467049.47"
"2025-02-01","2025-02-01","SF FuneralFDC0000000L3XW250201","","126.5","","1467175.97"
"2025-02-01","2025-02-01","SF FuneralF1085128      250201","","126.5","","1467302.47"
"2025-02-01","2025-02-01","SF FuneralF1085158      250201","","126.5","","1467428.97"
"2025-02-01","2025-02-01","SF FuneralF1122048      250201","","126.5","","1467555.47"
"2025-02-01","2025-02-01","SF FuneralF1125106      250201","","126.5","","1467681.97"
"2025-02-01","2025-02-01","SF FuneralFDC00000002V5X250201","","220","","1467901.97"
"2025-02-01","2025-02-01","SF FuneralFDC00000005HP7250201","","126.5","","1468028.47"
"2025-02-01","2025-02-01","SF FuneralFDC00000005NP7250201","","126.5","","1468154.97"
"2025-02-01","2025-02-01","SF FuneralFDC00000006QRS250201","","220","","1468374.97"
"2025-02-01","2025-02-01","SF FuneralFDC00000007RVS250201","","191.5","","1468566.47"
"2025-02-01","2025-02-01","SF FuneralFDC00000007RVY250201","","220","","1468786.47"
"2025-02-01","2025-02-01","SF FuneralF812866       250201","","126.5","","1468912.97"
"2025-02-01","2025-02-01","SF FuneralFDC0000000B1SQ250201","","126.5","","1469039.47"
"2025-02-01","2025-02-01","SF FuneralF820564       250201","","126.5","","1469165.97"
"2025-02-01","2025-02-01","SF FuneralFDC0000000CKL3250201","","191.5","","1469357.47"
"2025-02-01","2025-02-01","SF FuneralF992710       250201","","126.5","","1469483.97"
"2025-02-01","2025-02-01","SF FuneralF1079091      250201","","126.5","","1469610.47"
"2025-02-01","2025-02-01","SF FuneralF1085192      250201","","126.5","","1469736.97"
"2025-02-01","2025-02-01","SF FuneralF1122656      250201","","126.5","","1469863.47"
"2025-02-01","2025-01-22","SF FuneralFDC0000000616V250122","","126.5","","1469989.97"
"2025-02-01","2025-01-22","SF FuneralFDC0000000BLDN250122","","126.5","","1470116.47"
"2025-02-01","2025-01-24","SF FuneralFDC000000036YQ250124","","220","","1470336.47"
"2025-02-01","2025-01-24","SF FuneralFDC00000005DP1250128","","126.5","","1470462.97"
"2025-02-01","2025-01-24","SF FuneralFDC00000006CN0250126","","126.5","","1470589.47"
"2025-02-01","2025-01-24","SF FuneralFDC00000006DKR250128","","126.5","","1470715.97"
"2025-02-01","2025-01-24","SF FuneralFDC00000007GXN250125","","126.5","","1470842.47"
"2025-02-01","2025-01-24","SF FuneralFDC00000007GYF250124","","126.5","","1470968.97"
"2025-02-01","2025-01-24","SF FuneralFDC00000007LL1250125","","126.5","","1471095.47"
"2025-02-01","2025-01-24","SF FuneralFDC00000007LQZ250125","","126.5","","1471221.97"
"2025-02-01","2025-01-24","SF FuneralFDC00000007RGW250125","","126.5","","1471348.47"
"2025-02-01","2025-01-24","SF FuneralF802338       250127","","126.5","","1471474.97"
"2025-02-01","2025-01-24","SF FuneralF802906       250127","","126.5","","1471601.47"
"2025-02-01","2025-01-24","SF FuneralF808104       250125","","126.5","","1471727.97"
"2025-02-01","2025-01-24","SF FuneralF808326       250128","","126.5","","1471854.47"
"2025-02-01","2025-01-24","SF FuneralF821662       250128","","126.5","","1471980.97"
"2025-02-01","2025-01-24","SF FuneralF833038       250124","","126.5","","1472107.47"
"2025-02-01","2025-01-24","SF FuneralF841835       250127","","126.5","","1472233.97"
"2025-02-01","2025-01-24","SF FuneralF841857       250127","","126.5","","1472360.47"
"2025-02-01","2025-01-24","SF FuneralF900666       250124","","126.5","","1472486.97"
"2025-02-01","2025-01-24","SF FuneralFDC0000000H8PW250126","","126.5","","1472613.47"
"2025-02-01","2025-01-24","SF FuneralF1060650      250127","","126.5","","1472739.97"
"2025-02-01","2025-01-24","SF FuneralF1068241      250128","","126.5","","1472866.47"
"2025-02-01","2025-01-24","SF FuneralF1083805      250124","","126.5","","1472992.97"
"2025-02-01","2025-01-24","SF FuneralF1083877      250128","","126.5","","1473119.47"
"2025-02-01","2025-01-24","SF FuneralF1084874      250128","","126.5","","1473245.97"
"2025-02-01","2025-01-24","SF FuneralF1112521      250127","","126.5","","1473372.47"
"2025-02-01","2025-01-24","SF FuneralF1113168      250124","","126.5","","1473498.97"
"2025-02-01","2025-01-24","SF FuneralF1113598      250127","","126.5","","1473625.47"
"2025-02-01","2025-01-24","SF FuneralF1117143      250127","","126.5","","1473751.97"
"2025-02-01","2025-01-24","SF FuneralF1118315      250125","","126.5","","1473878.47"
"2025-02-01","2025-01-24","SF FuneralFDC0000000NXVW250127","","126.5","","1474004.97"
"2025-02-01","2025-01-24","SF FuneralF1123085      250128","","126.5","","1474131.47"
"2025-02-01","2025-01-24","SF FuneralF1123147      250127","","126.5","","1474257.97"
"2025-02-01","2025-01-24","SF FuneralF1129019      250128","","126.5","","1474384.47"
"2025-02-01","2025-01-28","SF FuneralF822239       250128","","31.63","","1474416.1"
"2025-02-01","2025-01-28","SF FuneralF1111603      250128","","31.63","","1474447.73"
"2025-02-01","2025-01-28","SF FuneralFDC0000000PZNV250128","","63.25","","1474510.98"
"2025-02-01","2025-01-29","SF FuneralF817800       250129","","126.5","","1474637.48"
"2025-02-01","2025-01-29","SF FuneralF1021080      250129","","126.5","","1474763.98"
"2025-02-01","2025-01-31","SF FuneralF1126874      250131","","31.63","","1474795.61"
"2025-02-01","2025-02-01","SF FuneralFDC00000005N09250201","","126.5","","1474922.11"
"2025-02-01","2025-02-01","SF FuneralFDC00000005PRL250201","","126.5","","1475048.61"
"2025-02-01","2025-02-01","SF FuneralFDC00000005XP7250201","","126.5","","1475175.11"
"2025-02-01","2025-02-01","SF FuneralFDC000000069MB250201","","126.5","","1475301.61"
"2025-02-01","2025-02-01","SF FuneralFDC00000006JFL250201","","126.5","","1475428.11"
"2025-02-01","2025-02-01","SF FuneralFDC00000006JVV250201","","126.5","","1475554.61"
"2025-02-01","2025-02-01","SF FuneralFDC00000006M6P250201","","126.5","","1475681.11"
"2025-02-01","2025-02-01","SF FuneralFDC000000075FQ250201","","126.5","","1475807.61"
"2025-02-01","2025-02-01","SF FuneralF798149       250201","","126.5","","1475934.11"
"2025-02-01","2025-02-01","SF FuneralF805671       250201","","126.5","","1476060.61"
"2025-02-01","2025-02-01","SF FuneralF808698       250201","","126.5","","1476187.11"
"2025-02-01","2025-02-01","SF FuneralF817612       250201","","126.5","","1476313.61"
"2025-02-01","2025-02-01","SF FuneralF820849       250201","","126.5","","1476440.11"
"2025-02-01","2025-02-01","SF FuneralF829821       250201","","126.5","","1476566.61"
"2025-02-01","2025-02-01","SF FuneralF832312       250201","","126.5","","1476693.11"
"2025-02-01","2025-02-01","SF FuneralF832529       250201","","126.5","","1476819.61"
"2025-02-01","2025-02-01","SF FuneralF841954       250201","","126.5","","1476946.11"
"2025-02-01","2025-02-01","SF FuneralF842366       250201","","126.5","","1477072.61"
"2025-02-01","2025-02-01","SF FuneralF992731       250201","","126.5","","1477199.11"
"2025-02-01","2025-02-01","SF FuneralFDC0000000JY24250202","","31.63","","1477230.74"
"2025-02-01","2025-02-01","SF FuneralF1066574      250201","","126.5","","1477357.24"
"2025-02-01","2025-02-01","SF FuneralF1066780      250201","","126.5","","1477483.74"
"2025-02-01","2025-02-01","SF FuneralF1068019      250201","","126.5","","1477610.24"
"2025-02-01","2025-02-01","SF FuneralF1080353      250201","","126.5","","1477736.74"
"2025-02-01","2025-02-01","SF FuneralF1123044      250201","","126.5","","1477863.24"
"2025-02-01","2025-02-01","SF FuneralF1128185      250201","","126.5","","1477989.74"
"2025-02-01","2025-01-24","SF FuneralF1068173      250127","","126.5","","1478116.24"
"2025-02-01","2025-01-28","SF FuneralF834882       250128","","31.63","","1478147.87"
"2025-02-01","2025-01-28","SF FuneralF1104234      250128","","31.63","","1478179.5"
"2025-02-01","2025-01-31","SF FuneralF1085355      250131","","31.63","","1478211.13"
"2025-02-01","2025-02-01","SF FuneralFDC0000000795L250201","","31.63","","1478242.76"
"2025-02-01","2025-02-01","SF FuneralFDC00000007VKH250201","","31.63","","1478274.39"
"2025-02-01","2025-02-01","SF FuneralF1084539      250202","","31.63","","1478306.02"
"2025-02-01","2025-02-01","SF FuneralFDC0000000N7NT250202","","31.63","","1478337.65"
"2025-02-01","2025-02-01","SF FuneralF1120593      250202","","31.63","","1478369.28"
"2025-02-01","2025-02-01","SF FuneralFDC00000005MWG250201","","31.63","","1478400.91"
"2025-02-01","2025-02-01","SF FuneralFDC00000007GR6250201","","31.63","","1478432.54"
"2025-02-01","2025-02-01","SF FuneralF832932       250201","","31.63","","1478464.17"
"2025-02-01","2025-02-01","SF FuneralF1054743      250202","","31.63","","1478495.8"
"2025-02-01","2025-02-01","SF FuneralF1078645      250201","","126.5","","1478622.3"
"2025-02-01","2025-02-01","SF FuneralF1080457      250201","","126.5","","1478748.8"
"2025-02-01","2025-02-01","SF FuneralF1080506      250201","","126.5","","1478875.3"
"2025-02-01","2025-02-01","SF FuneralF1084605      250201","","126.5","","1479001.8"
"2025-02-01","2025-02-01","SF FuneralF1109686      250201","","126.5","","1479128.3"
"2025-02-01","2025-02-01","SF FuneralF1110268      250201","","126.5","","1479254.8"
"2025-02-01","2025-02-01","SF FuneralF1110408      250201","","126.5","","1479381.3"
"2025-02-01","2025-02-01","SF FuneralF1110558      250201","","126.5","","1479507.8"
"2025-02-01","2025-02-01","SF FuneralFDC0000000N38D250201","","126.5","","1479634.3"
"2025-02-01","2025-02-01","SF FuneralF1114227      250201","","126.5","","1479760.8"
"2025-02-01","2025-02-01","SF FuneralF1114251      250201","","126.5","","1479887.3"
"2025-02-01","2025-02-01","SF FuneralF1114261      250201","","126.5","","1480013.8"
"2025-02-01","2025-02-01","SF FuneralF1116915      250201","","126.5","","1480140.3"
"2025-02-01","2025-02-01","SF FuneralF1118028      250201","","126.5","","1480266.8"
"2025-02-01","2025-02-01","SF FuneralF1118038      250201","","126.5","","1480393.3"
"2025-02-01","2025-02-01","SF FuneralF1118262      250201","","126.5","","1480519.8"
"2025-02-01","2025-02-01","SF FuneralF1118862      250201","","126.5","","1480646.3"
"2025-02-01","2025-02-01","SF FuneralFDC0000000P09M250201","","126.5","","1480772.8"
"2025-02-01","2025-02-01","SF FuneralF1122004      250201","","126.5","","1480899.3"
"2025-02-01","2025-02-01","SF FuneralF1122911      250201","","126.5","","1481025.8"
"2025-02-01","2025-02-01","SF FuneralF1124774      250201","","126.5","","1481152.3"
"2025-02-01","2025-02-01","SF FuneralF1126259      250201","","126.5","","1481278.8"
"2025-02-01","2025-02-01","SF FuneralFDC0000000PLXB250201","","126.5","","1481405.3"
"2025-02-01","2025-02-01","SF FuneralF1068120      250201","","126.5","","1481531.8"
"2025-02-01","2025-02-01","SF FuneralF1073610      250201","","126.5","","1481658.3"
"2025-02-01","2025-02-01","SF FuneralF1073641      250201","","126.5","","1481784.8"
"2025-02-01","2025-02-01","SF FuneralF1075160      250201","","126.5","","1481911.3"
"2025-02-01","2025-02-01","SF FuneralF1078918      250201","","126.5","","1482037.8"
"2025-02-01","2025-02-01","SF FuneralF1079291      250201","","126.5","","1482164.3"
"2025-02-01","2025-02-01","SF FuneralF1080390      250201","","126.5","","1482290.8"
"2025-02-01","2025-02-01","SF FuneralFDC0000000LQML250201","","126.5","","1482417.3"
"2025-02-01","2025-02-01","SF FuneralF1084343      250201","","126.5","","1482543.8"
"2025-02-01","2025-02-01","SF FuneralF1084371      250201","","126.5","","1482670.3"
"2025-02-01","2025-02-01","SF FuneralF1084981      250202","","126.5","","1482796.8"
"2025-02-01","2025-02-01","SF FuneralFDC0000000M031250201","","126.5","","1482923.3"
"2025-02-01","2025-02-01","SF FuneralF1085062      250201","","126.5","","1483049.8"
"2025-02-01","2025-02-01","SF FuneralF1085330      250201","","126.5","","1483176.3"
"2025-02-01","2025-02-01","SF FuneralF1104031      250201","","126.5","","1483302.8"
"2025-02-01","2025-02-01","SF FuneralFDC0000000MJM7250202","","126.5","","1483429.3"
"2025-02-01","2025-02-01","SF FuneralF1109063      250201","","126.5","","1483555.8"
"2025-02-01","2025-02-01","SF FuneralF1110696      250201","","126.5","","1483682.3"
"2025-02-01","2025-02-01","SF FuneralF1113730      250201","","126.5","","1483808.8"
"2025-02-01","2025-02-01","SF FuneralF1114406      250201","","126.5","","1483935.3"
"2025-02-01","2025-02-01","SF FuneralF1114423      250201","","63.25","","1483998.55"
"2025-02-01","2025-02-01","SF FuneralFDC0000000NJHM250201","","63.25","","1484061.8"
"2025-02-01","2025-02-01","SF FuneralF1117220      250201","","126.5","","1484188.3"
"2025-02-01","2025-02-01","SF FuneralF1117235      250201","","126.5","","1484314.8"
"2025-02-01","2025-02-01","SF FuneralF1117418      250201","","126.5","","1484441.3"
"2025-02-01","2025-02-01","SF FuneralF1117858      250201","","126.5","","1484567.8"
"2025-02-01","2025-02-01","SF FuneralF1118656      250201","","126.5","","1484694.3"
"2025-02-01","2025-02-01","SF FuneralF1119797      250201","","126.5","","1484820.8"
"2025-02-01","2025-02-01","SF FuneralF1122768      250201","","126.5","","1484947.3"
"2025-02-01","2025-02-01","SF FuneralFDC000000066PM250201","","126.5","","1485073.8"
"2025-02-01","2025-02-01","SF FuneralFDC00000006G2H250201","","126.5","","1485200.3"
"2025-02-01","2025-02-01","SF FuneralFDC00000006GRL250201","","126.5","","1485326.8"
"2025-02-01","2025-02-01","SF FuneralFDC00000007P6C250201","","126.5","","1485453.3"
"2025-02-01","2025-02-01","SF FuneralF793818       250201","","126.5","","1485579.8"
"2025-02-01","2025-02-01","SF FuneralFDC00000007ZCB250201","","126.5","","1485706.3"
"2025-02-01","2025-02-01","SF FuneralF800420       250201","","126.5","","1485832.8"
"2025-02-01","2025-02-01","SF FuneralFDC00000008BHC250201","","126.5","","1485959.3"
"2025-02-01","2025-02-01","SF FuneralFDC00000008PW7250201","","126.5","","1486085.8"
"2025-02-01","2025-02-01","SF FuneralF808012       250201","","126.5","","1486212.3"
"2025-02-01","2025-02-01","SF FuneralF808469       250201","","126.5","","1486338.8"
"2025-02-01","2025-02-01","SF FuneralF808964       250201","","126.5","","1486465.3"
"2025-02-01","2025-02-01","SF FuneralF817935       250201","","126.5","","1486591.8"
"2025-02-01","2025-02-01","SF FuneralF829075       250201","","126.5","","1486718.3"
"2025-02-01","2025-02-01","SF FuneralF1052090      250202","","126.5","","1486844.8"
"2025-02-01","2025-02-01","SF FuneralFDC0000000N372250201","","126.5","","1486971.3"
"2025-02-01","2025-02-01","SF FuneralF1114495      250201","","126.5","","1487097.8"
"2025-02-01","2025-02-01","SF FuneralFDC0000000P6KV250201","","126.5","","1487224.3"
"2025-02-01","2025-02-01","SF FuneralF1128779      250201","","126.5","","1487350.8"
"2025-02-01","2025-02-01","SF FuneralFDC00000002Y4R250201","","220","","1487570.8"
"2025-02-01","2025-02-01","SF FuneralFDC00000005H11250201","","126.5","","1487697.3"
"2025-02-01","2025-02-01","SF FuneralFDC00000005MF9250201","","126.5","","1487823.8"
"2025-02-01","2025-02-01","SF FuneralFDC00000005SWG250201","","126.5","","1487950.3"
"2025-02-01","2025-02-01","SF FuneralFDC00000006167250201","","126.5","","1488076.8"
"2025-02-01","2025-02-01","SF FuneralFDC000000067FF250201","","126.5","","1488203.3"
"2025-02-01","2025-02-01","SF FuneralFDC0000000687D250201","","126.5","","1488329.8"
"2025-02-01","2025-02-01","SF FuneralFDC000000068WC250201","","126.5","","1488456.3"
"2025-02-01","2025-02-01","SF FuneralFDC000000069D7250201","","126.5","","1488582.8"
"2025-02-01","2025-02-01","SF FuneralFDC000000069J0250201","","126.5","","1488709.3"
"2025-02-01","2025-02-01","SF FuneralFDC00000006F2S250201","","126.5","","1488835.8"
"2025-02-01","2025-02-01","SF FuneralFDC00000006FD0250201","","126.5","","1488962.3"
"2025-02-01","2025-02-01","SF FuneralFDC00000006FJ6250201","","126.5","","1489088.8"
"2025-02-01","2025-02-01","SF FuneralFDC00000006H36250201","","126.5","","1489215.3"
"2025-02-01","2025-02-01","SF FuneralFDC00000006H45250201","","126.5","","1489341.8"
"2025-02-01","2025-02-01","SF FuneralFDC00000006HGP250201","","126.5","","1489468.3"
"2025-02-01","2025-02-01","SF FuneralFDC00000006K17250201","","126.5","","1489594.8"
"2025-02-01","2025-02-01","SF FuneralFDC00000006KJF250201","","126.5","","1489721.3"
"2025-02-01","2025-02-01","SF FuneralFDC00000006KZN250201","","126.5","","1489847.8"
"2025-02-01","2025-02-01","SF FuneralFDC00000006R98250201","","126.5","","1489974.3"
"2025-02-01","2025-02-01","SF FuneralFDC00000006RM7250201","","126.5","","1490100.8"
"2025-02-01","2025-02-01","SF FuneralFDC00000006SVM250201","","126.5","","1490227.3"
"2025-02-01","2025-02-01","SF FuneralFDC00000006THF250201","","126.5","","1490353.8"
"2025-02-01","2025-02-01","SF FuneralFDC00000006VXL250201","","126.5","","1490480.3"
"2025-02-01","2025-02-01","SF FuneralFDC000000073XX250201","","126.5","","1490606.8"
"2025-02-01","2025-02-01","SF FuneralFDC000000075BV250201","","126.5","","1490733.3"
"2025-02-01","2025-02-01","SF FuneralFDC00000007D4X250201","","126.5","","1490859.8"
"2025-02-01","2025-02-01","SF FuneralF798396       250201","","126.5","","1490986.3"
"2025-02-01","2025-02-01","SF FuneralF798588       250201","","126.5","","1491112.8"
"2025-02-01","2025-02-01","SF FuneralFDC000000086K1250201","","126.5","","1491239.3"
"2025-02-01","2025-02-01","SF FuneralF800022       250201","","126.5","","1491365.8"
"2025-02-01","2025-02-01","SF FuneralF800029       250201","","126.5","","1491492.3"
"2025-02-01","2025-02-01","SF FuneralF804756       250201","","126.5","","1491618.8"
"2025-02-01","2025-02-01","SF FuneralF808510       250201","","126.5","","1491745.3"
"2025-02-01","2025-02-01","SF FuneralF809687       250201","","126.5","","1491871.8"
"2025-02-01","2025-02-01","SF FuneralF810436       250201","","126.5","","1491998.3"
"2025-02-01","2025-02-01","SF FuneralF810607       250201","","126.5","","1492124.8"
"2025-02-01","2025-02-01","SF FuneralF812188       250201","","126.5","","1492251.3"
"2025-02-01","2025-02-01","SF FuneralF812460       250201","","126.5","","1492377.8"
"2025-02-01","2025-02-01","SF FuneralF812589       250201","","126.5","","1492504.3"
"2025-02-01","2025-02-01","SF FuneralF812888       250201","","126.5","","1492630.8"
"2025-02-01","2025-02-01","SF FuneralF813470       250201","","126.5","","1492757.3"
"2025-02-01","2025-02-01","SF FuneralF814213       250201","","126.5","","1492883.8"
"2025-02-01","2025-02-01","SF FuneralF822526       250201","","126.5","","1493010.3"
"2025-02-01","2025-02-01","SF FuneralF828028       250201","","126.5","","1493136.8"
"2025-02-01","2025-02-01","SF FuneralF828142       250201","","126.5","","1493263.3"
"2025-02-01","2025-02-01","SF FuneralF828334       250201","","126.5","","1493389.8"
"2025-02-01","2025-02-01","SF FuneralFDC0000000BPG3250201","","126.5","","1493516.3"
"2025-02-01","2025-02-01","SF FuneralF828974       250201","","126.5","","1493642.8"
"2025-02-01","2025-02-01","SF FuneralF829794       250201","","126.5","","1493769.3"
"2025-02-01","2025-02-01","SF FuneralF829799       250201","","126.5","","1493895.8"
"2025-02-01","2025-02-01","SF FuneralF830532       250201","","126.5","","1494022.3"
"2025-02-01","2025-02-01","SF FuneralF830850       250201","","126.5","","1494148.8"
"2025-02-01","2025-02-01","SF FuneralF830945       250201","","126.5","","1494275.3"
"2025-02-01","2025-02-01","SF FuneralF832088       250201","","191.5","","1494466.8"
"2025-02-01","2025-02-01","SF FuneralF833309       250201","","126.5","","1494593.3"
"2025-02-01","2025-02-01","SF FuneralFDC0000000CS69250201","","126.5","","1494719.8"
"2025-02-01","2025-02-01","SF FuneralF834395       250201","","126.5","","1494846.3"
"2025-02-01","2025-02-01","SF FuneralF834598       250201","","126.5","","1494972.8"
"2025-02-01","2025-02-01","SF FuneralF838838       250201","","126.5","","1495099.3"
"2025-02-01","2025-02-01","SF FuneralF842099       250201","","126.5","","1495225.8"
"2025-02-01","2025-02-01","SF FuneralF842254       250201","","126.5","","1495352.3"
"2025-02-01","2025-02-01","SF FuneralF842714       250201","","126.5","","1495478.8"
"2025-02-01","2025-02-01","SF FuneralF993965       250201","","126.5","","1495605.3"
"2025-02-01","2025-02-01","SF FuneralF810774       250201","","126.5","","1495731.8"
"2025-02-01","2025-02-01","SF FuneralF1058631      250201","","126.5","","1495858.3"
"2025-02-01","2025-02-01","SF FuneralF1061553      250201","","126.5","","1495984.8"
"2025-02-01","2025-02-01","SF FuneralF1066298      250201","","126.5","","1496111.3"
"2025-02-01","2025-02-01","SF FuneralFDC0000000KWQH250201","","126.5","","1496237.8"
"2025-02-01","2025-02-01","SF FuneralF1127307      250201","","126.5","","1496364.3"
"2025-02-01","2025-02-01","SF FuneralFDC0000000PPDH250201","","126.5","","1496490.8"
"2025-02-01","2025-02-01","SF FuneralFDC0000000PPDL250201","","126.5","","1496617.3"
"2025-02-01","2025-02-01","SF FuneralF1127864      250201","","126.5","","1496743.8"
"2025-02-01","2025-02-01","SF FuneralF1128804      250201","","126.5","","1496870.3"
"2025-02-01","2025-02-01","SF FuneralF1129176      250201","","126.5","","1496996.8"
"2025-02-01","2025-02-01","SF FuneralF1130062      250201","","126.5","","1497123.3"
"2025-02-01","2025-01-24","SF FuneralFDC000000032R9250127","","220","","1497343.3"
"2025-02-01","2025-01-24","SF FuneralFDC00000003VK7250128","","220","","1497563.3"
"2025-02-01","2025-01-24","SF FuneralFDC00000005H0S250127","","126.5","","1497689.8"
"2025-02-01","2025-01-24","SF FuneralFDC0000000605Z250125","","126.5","","1497816.3"
"2025-02-01","2025-01-24","SF FuneralFDC000000067T8250128","","126.5","","1497942.8"
"2025-02-01","2025-01-24","SF FuneralFDC000000067TC250128","","126.5","","1498069.3"
"2025-02-01","2025-01-24","SF FuneralFDC0000000684S250128","","126.5","","1498195.8"
"2025-02-01","2025-01-24","SF FuneralFDC00000006MWK250127","","126.5","","1498322.3"
"2025-02-01","2025-01-24","SF FuneralFDC00000006Z0J250128","","126.5","","1498448.8"
"2025-02-01","2025-01-24","SF FuneralFDC00000007P1V250126","","126.5","","1498575.3"
"2025-02-01","2025-01-24","SF FuneralF809985       250125","","126.5","","1498701.8"
"2025-02-01","2025-01-24","SF FuneralF816407       250128","","126.5","","1498828.3"
"2025-02-01","2025-01-24","SF FuneralF817252       250124","","126.5","","1498954.8"
"2025-02-01","2025-01-24","SF FuneralF829778       250126","","126.5","","1499081.3"
"2025-02-01","2025-01-24","SF FuneralFDC0000000JBQD250127","","126.5","","1499207.8"
"2025-02-01","2025-01-24","SF FuneralF1052297      250128","","126.5","","1499334.3"
"2025-02-01","2025-01-24","SF FuneralF1058676      250125","","126.5","","1499460.8"
"2025-02-01","2025-01-24","SF FuneralFDC0000000KBBD250127","","126.5","","1499587.3"
"2025-02-01","2025-01-24","SF FuneralF1061007      250127","","126.5","","1499713.8"
"2025-02-01","2025-01-24","SF FuneralF1078666      250128","","126.5","","1499840.3"
"2025-02-01","2025-01-24","SF FuneralF1112179      250124","","126.5","","1499966.8"
"2025-02-01","2025-01-24","SF FuneralFDC0000000N3SL250128","","126.5","","1500093.3"
"2025-02-01","2025-01-24","SF FuneralF1114154      250124","","126.5","","1500219.8"
"2025-02-01","2025-01-24","SF FuneralF1114281      250128","","126.5","","1500346.3"
"2025-02-01","2025-01-24","SF FuneralFDC0000000N7WM250124","","126.5","","1500472.8"
"2025-02-01","2025-01-24","SF FuneralF1115894      250125","","126.5","","1500599.3"
"2025-02-01","2025-01-24","SF FuneralF1116760      250128","","126.5","","1500725.8"
"2025-02-01","2025-01-24","SF FuneralF1118349      250124","","126.5","","1500852.3"
"2025-02-01","2025-01-24","SF FuneralFDC0000000NY14250128","","126.5","","1500978.8"
"2025-02-01","2025-01-24","SF FuneralF1122687      250128","","126.5","","1501105.3"
"2025-02-01","2025-01-24","SF FuneralFDC0000000PPGM250128","","126.5","","1501231.8"
"2025-02-01","2025-01-29","SF FuneralFDC00000006W2N250129","","126.5","","1501358.3"
"2025-02-01","2025-01-29","SF FuneralFDC000000077W6250129","","126.5","","1501484.8"
"2025-02-01","2025-01-29","SF FuneralFDC0000000BDTB250129","","126.5","","1501611.3"
"2025-02-01","2025-01-29","SF FuneralF831115       250129","","126.5","","1501737.8"
"2025-02-01","2025-01-29","SF FuneralF1068205      250129","","126.5","","1501864.3"
"2025-02-01","2025-01-29","SF FuneralF1117011      250129","","126.5","","1501990.8"
"2025-02-01","2025-01-29","SF FuneralFDC0000000PQNK250129","","63.25","","1502054.05"
"2025-02-01","2025-02-01","SF FuneralFDC00000002VK9250201","","220","","1502274.05"
"2025-02-01","2025-02-01","SF FuneralFDC00000002W34250201","","220","","1502494.05"
"2025-02-01","2025-02-01","SF FuneralFDC00000003KGW250201","","220","","1502714.05"
"2025-02-01","2025-02-01","SF FuneralFDC00000005BW8250201","","126.5","","1502840.55"
"2025-02-01","2025-02-01","SF FuneralFDC000000069ZQ250201","","126.5","","1502967.05"
"2025-02-01","2025-02-01","SF FuneralFDC00000006BJR250201","","126.5","","1503093.55"
"2025-02-01","2025-02-01","SF FuneralFDC00000006HJV250201","","126.5","","1503220.05"
"2025-02-01","2025-02-01","SF FuneralFDC00000006JCP250201","","126.5","","1503346.55"
"2025-02-01","2025-02-01","SF FuneralFDC00000006KQZ250201","","220","","1503566.55"
"2025-02-01","2025-02-01","SF FuneralFDC00000006RS5250201","","126.5","","1503693.05"
"2025-02-01","2025-02-01","SF FuneralFDC000000073P9250201","","126.5","","1503819.55"
"2025-02-01","2025-02-01","SF FuneralFDC00000007516250201","","126.5","","1503946.05"
"2025-02-01","2025-02-01","SF FuneralFDC000000076KT250201","","126.5","","1504072.55"
"2025-02-01","2025-02-01","SF FuneralFDC00000007HGZ250201","","126.5","","1504199.05"
"2025-02-01","2025-02-01","SF FuneralFDC00000007J7X250201","","126.5","","1504325.55"
"2025-02-01","2025-02-01","SF FuneralFDC00000007N51250201","","126.5","","1504452.05"
"2025-02-01","2025-02-01","SF FuneralFDC00000007PMC250201","","126.5","","1504578.55"
"2025-02-01","2025-02-01","SF FuneralFDC00000007SRR250201","","126.5","","1504705.05"
"2025-02-01","2025-02-01","SF FuneralFDC00000007TJJ250201","","126.5","","1504831.55"
"2025-02-01","2025-02-01","SF FuneralFDC00000007TNR250201","","126.5","","1504958.05"
"2025-02-01","2025-02-01","SF FuneralFDC00000007TYW250201","","126.5","","1505084.55"
"2025-02-01","2025-02-01","SF FuneralFDC00000007Y7R250201","","126.5","","1505211.05"
"2025-02-01","2025-02-01","SF FuneralFDC00000007YF9250201","","126.5","","1505337.55"
"2025-02-01","2025-02-01","SF FuneralF797987       250201","","126.5","","1505464.05"
"2025-02-01","2025-02-01","SF FuneralFDC0000000867Q250201","","126.5","","1505590.55"
"2025-02-01","2025-02-01","SF FuneralFDC000000086CF250201","","126.5","","1505717.05"
"2025-02-01","2025-02-01","SF FuneralF799362       250201","","126.5","","1505843.55"
"2025-02-01","2025-02-01","SF FuneralF808596       250201","","126.5","","1505970.05"
"2025-02-01","2025-02-01","SF FuneralF809808       250201","","126.5","","1506096.55"
"2025-02-01","2025-02-01","SF FuneralF810282       250201","","126.5","","1506223.05"
"2025-02-01","2025-02-01","SF FuneralF812709       250201","","126.5","","1506349.55"
"2025-02-01","2025-02-01","SF FuneralF812681       250201","","126.5","","1506476.05"
"2025-02-01","2025-02-01","SF FuneralF815855       250201","","126.5","","1506602.55"
"2025-02-01","2025-02-01","SF FuneralF816808       250201","","126.5","","1506729.05"
"2025-02-01","2025-02-01","SF FuneralF816904       250201","","126.5","","1506855.55"
"2025-02-01","2025-02-01","SF FuneralF821472       250201","","126.5","","1506982.05"
"2025-02-01","2025-02-01","SF FuneralF823232       250201","","126.5","","1507108.55"
"2025-02-01","2025-02-01","SF FuneralF832421       250201","","126.5","","1507235.05"
"2025-02-01","2025-02-01","SF FuneralF832468       250201","","126.5","","1507361.55"
"2025-02-01","2025-02-01","SF FuneralF832660       250201","","126.5","","1507488.05"
"2025-02-01","2025-02-01","SF FuneralF833246       250201","","126.5","","1507614.55"
"2025-02-01","2025-02-01","SF FuneralF993057       250201","","126.5","","1507741.05"
"2025-02-01","2025-02-01","SF FuneralF993119       250201","","126.5","","1507867.55"
"2025-02-01","2025-02-01","SF FuneralFDC0000000JC4G250201","","126.5","","1507994.05"
"2025-02-01","2025-02-01","SF FuneralF1033828      250201","","126.5","","1508120.55"
"2025-02-01","2025-02-01","SF FuneralF1033846      250201","","126.5","","1508247.05"
"2025-02-01","2025-02-01","SF FuneralF1059499      250201","","126.5","","1508373.55"
"2025-02-01","2025-02-01","SF FuneralF1060661      250201","","126.5","","1508500.05"
"2025-02-01","2025-02-01","SF FuneralF1060755      250201","","126.5","","1508626.55"
"2025-02-01","2025-02-01","SF FuneralF1061071      250202","","63.25","","1508689.8"
"2025-02-01","2025-02-01","SF FuneralFDC0000000KLD6250201","","126.5","","1508816.3"
"2025-02-01","2025-02-01","SF FuneralF1066219      250201","","126.5","","1508942.8"
"2025-02-01","2025-02-01","SF FuneralF1066495      250201","","126.5","","1509069.3"
"2025-02-01","2025-02-01","SF FuneralF1066581      250201","","126.5","","1509195.8"
"2025-02-01","2025-02-01","SF FuneralF1067965      250201","","126.5","","1509322.3"
"2025-02-01","2025-01-22","SF FuneralF1117602      250122","","126.5","","1509448.8"
"2025-02-01","2025-01-24","SF FuneralF843296       250127","","126.5","","1509575.3"
"2025-02-01","2025-01-24","Rev SF FuneralF820246       250128","","-126.5","","1509448.8"
"2025-02-01","2025-01-24","Rev SF FuneralF1033691      250128","","-126.5","","1509322.3"
"2025-02-01","2024-08-27","Rev SF FuneralFDC00000006ZHS240827","","-126.5","","1509195.8"
"2025-02-01","2024-09-27","Rev SF FuneralFDC00000006ZHS240927","","-126.5","","1509069.3"
"2025-02-01","2024-12-23","Rev SF FuneralFDC0000000KPGY241222","","-126.5","","1508942.8"
"2025-02-01","2024-10-28","Rev SF FuneralFDC00000006ZHS241027","","-126.5","","1508816.3"
"2025-02-01","2024-12-23","Rev SF FuneralFDC00000006D8J241226","","-126.5","","1508689.8"
"2025-02-01","2024-11-27","Rev SF FuneralFDC00000006ZHS241127","","-126.5","","1508563.3"
"2025-02-01","2024-12-11","Rev SF FuneralFDC00000006ZHS241227","","-126.5","","1508436.8"
"2025-02-01","2024-12-11","Rev SF FuneralFDC0000000K9FS241229","","-126.5","","1508310.3"
"2025-02-01","2024-12-11","Rev SF FuneralF1058756      241229","","-126.5","","1508183.8"
"2025-02-01","2024-12-11","Rev SF FuneralFDC0000000L90R241228","","-126.5","","1508057.3"
"2025-02-01","2025-01-14","Rev SF FuneralFDC00000009CP1250114","","-95.75","","1507961.55"
"2025-02-01","2025-01-22","Rev SF FuneralFDC00000007DJF250122","","-126.5","","1507835.05"
"2025-02-01","2025-01-22","Rev SF FuneralFDC00000005S1Y250122","","-126.5","","1507708.55"
"2025-02-01","2025-01-22","Rev SF FuneralFDC000000070QW250122","","-126.5","","1507582.05"
"2025-02-01","2025-01-24","Rev SF FuneralF818589       250128","","-126.5","","1507455.55"
"2025-02-01","2025-01-25","Rev SF FuneralFDC0000000LNR4250126","","-31.63","","1507423.92"
"2025-02-01","2025-01-28","Rev SF FuneralFDC00000005L57250128","","-31.63","","1507392.29"
"2025-02-01","2025-01-24","Rev SF FuneralFDC00000006P68250124","","-63.25","","1507329.04"
"2025-02-01","2025-01-24","Rev SF FuneralFDC000000067T8250128","","-126.5","","1507202.54"
"2025-02-01","2025-01-24","Rev SF FuneralFDC000000075FG250128","","-126.5","","1507076.04"
"2025-02-01","2025-01-24","Rev SF FuneralFDC000000075FH250128","","-126.5","","1506949.54"
"2025-02-01","2025-01-24","Rev SF FuneralFDC00000007684250128","","-126.5","","1506823.04"
"2025-02-01","2025-01-24","Rev SF FuneralFDC00000006KGR250127","","-126.5","","1506696.54"
"2025-02-01","2025-01-24","Rev SF FuneralFDC00000006ZHS250127","","-126.5","","1506570.04"
"2025-02-01","2025-01-24","Rev SF FuneralFDC00000004GM0250127","","-220","","1506350.04"
"2025-02-01","2025-01-24","Rev SF FuneralFDC00000007Q5P250125","","-126.5","","1506223.54"
"2025-02-01","2025-01-24","Rev SF FuneralFDC0000000N4K7250124","","-126.5","","1506097.04"
"2025-02-01","2025-01-24","Rev SF FuneralFDC0000000NR0L250127","","-126.5","","1505970.54"
"2025-02-01","2025-01-24","Rev SF FuneralFDC00000007L89250125","","-126.5","","1505844.04"
"2025-02-01","2025-01-24","Rev SF FuneralFDC0000000NK23250127","","-126.5","","1505717.54"
"2025-02-01","2025-01-24","Rev SF FuneralFDC00000005WSD250128","","-220","","1505497.54"
"2025-02-01","2025-01-24","Rev SF FuneralFDC00000007T44250128","","-126.5","","1505371.04"
"2025-02-01","2025-01-24","Rev SF FuneralFDC0000000L90R250128","","-126.5","","1505244.54"
"2025-02-01","2025-01-24","Rev SF FuneralFDC0000000JW31250128","","-126.5","","1505118.04"
"2025-02-01","2025-01-29","Rev SF FuneralFDC00000006JS2250129","","-126.5","","1504991.54"
"2025-02-01","2025-01-28","Rev SF FuneralFDC00000009CP1250128","","-95.75","","1504895.79"
"2025-02-01","2025-01-30","Rev SF FuneralFDC00000008PQ1250130","","-126.5","","1504769.29"
"2025-02-01","2025-01-29","Rev SF FuneralFDC00000005W9N250129","","-220","","1504549.29"
"2025-02-01","2025-01-24","Rev SF FuneralFDC0000000CHNC250128","","-126.5","","1504422.79"
"2025-02-01","2025-01-24","SF FuneralFDC00000006KJW250128","","126.5","","1504549.29"
"2025-02-01","2025-01-24","SF FuneralFDC000000085LB250127","","126.5","","1504675.79"
"2025-02-01","2025-01-24","SF FuneralF834094       250127","","126.5","","1504802.29"
"2025-02-01","2025-01-24","SF FuneralFDC0000000DZLN250128","","126.5","","1504928.79"
"2025-02-01","2025-01-24","SF FuneralF1060329      250125","","126.5","","1505055.29"
"2025-02-01","2025-01-24","SF FuneralF1129393      250128","","126.5","","1505181.79"
"2025-02-01","2025-01-29","SF FuneralFDC0000000NL44250129","","126.5","","1505308.29"
"2025-02-01","2025-02-01","SF FuneralFDC000000069HZ250201","","126.5","","1505434.79"
"2025-02-01","2025-02-01","SF FuneralF1052038      250201","","126.5","","1505561.29"
"2025-02-01","2025-01-23","SF FuneralFDC00000006JQ8250123","","126.5","","1505687.79"
"2025-02-01","2025-01-24","SF FuneralFDC000000069J2250127","","126.5","","1505814.29"
"2025-02-01","2025-01-24","SF FuneralFDC000000073PV250124","","126.5","","1505940.79"
"2025-02-01","2025-01-24","SF FuneralFDC000000075XG250128","","126.5","","1506067.29"
"2025-02-01","2025-01-24","SF FuneralFDC0000000HTT8250125","","126.5","","1506193.79"
"2025-02-01","2025-01-24","SF FuneralF1078541      250125","","126.5","","1506320.29"
"2025-02-01","2025-01-24","SF FuneralF1120157      250127","","126.5","","1506446.79"
"2025-02-01","2025-01-28","SF FuneralF990246       250128","","63.25","","1506510.04"
"2025-02-01","2025-01-28","SF FuneralF1119054      250128","","126.5","","1506636.54"
"2025-02-01","2025-01-29","SF FuneralFDC00000005NPY250129","","126.5","","1506763.04"
"2025-02-01","2025-01-29","SF FuneralF820916       250129","","126.5","","1506889.54"
"2025-02-01","2025-01-30","SF FuneralFDC00000006Z5Y250130","","126.5","","1507016.04"
"2025-02-01","2025-02-01","SF FuneralF796536       250201","","126.5","","1507142.54"
"2025-02-01","2025-02-01","SF FuneralF805072       250201","","126.5","","1507269.04"
"2025-02-01","2025-02-01","SF FuneralF1021945      250201","","126.5","","1507395.54"
"2025-02-01","2025-01-23","SF FuneralF1125102      250123","","126.5","","1507522.04"
"2025-02-01","2025-01-23","SF FuneralF1125104      250123","","126.5","","1507648.54"
"2025-02-01","2025-01-24","SF FuneralFDC000000069VK250125","","126.5","","1507775.04"
"2025-02-01","2025-01-24","SF FuneralFDC000000069VR250125","","126.5","","1507901.54"
"2025-02-01","2025-01-24","SF FuneralFDC00000006KD3250127","","126.5","","1508028.04"
"2025-02-01","2025-01-24","SF FuneralFDC00000007MMW250125","","126.5","","1508154.54"
"2025-02-01","2025-01-24","SF FuneralF816457       250128","","126.5","","1508281.04"
"2025-02-01","2025-01-24","SF FuneralF817924       250127","","126.5","","1508407.54"
"2025-02-01","2025-01-24","SF FuneralF823120       250128","","126.5","","1508534.04"
"2025-02-01","2025-01-24","SF FuneralF833106       250128","","126.5","","1508660.54"
"2025-02-01","2025-01-24","SF FuneralF1021094      250128","","126.5","","1508787.04"
"2025-02-01","2025-01-24","SF FuneralF1021577      250128","","126.5","","1508913.54"
"2025-02-01","2025-01-24","SF FuneralF1055273      250128","","126.5","","1509040.04"
"2025-02-01","2025-01-24","SF FuneralF1074831      250124","","126.5","","1509166.54"
"2025-02-01","2025-01-24","SF FuneralF1112356      250127","","126.5","","1509293.04"
"2025-02-01","2025-01-24","SF FuneralF1112484      250127","","126.5","","1509419.54"
"2025-02-01","2025-01-24","SF FuneralF1112546      250124","","126.5","","1509546.04"
"2025-02-01","2025-01-24","SF FuneralF1114025      250124","","126.5","","1509672.54"
"2025-02-01","2025-01-24","SF FuneralF784966       250128","","126.5","","1509799.04"
"2025-02-01","2025-01-24","SF FuneralF1123062      250126","","126.5","","1509925.54"
"2025-02-01","2025-01-24","SF FuneralFDC0000000PBPL250127","","126.5","","1510052.04"
"2025-02-01","2025-01-27","SF FuneralFDC0000000BNGL250126","","126.5","","1510178.54"
"2025-02-01","2025-01-29","SF FuneralF993362       250129","","126.5","","1510305.04"
"2025-02-01","2025-01-31","SF FuneralF990352       250201","","126.5","","1510431.54"
"2025-02-01","2025-02-01","SF FuneralFDC00000006CG1250201","","126.5","","1510558.04"
"2025-02-01","2025-02-01","SF FuneralFDC00000006FB5250201","","126.5","","1510684.54"
"2025-02-01","2025-02-01","SF FuneralF992345       250201","","126.5","","1510811.04"
"2025-02-01","2025-02-01","SF FuneralF1020540      250201","","126.5","","1510937.54"
"2025-02-01","2025-02-01","SF FuneralF842131       250201","","126.5","","1511064.04"
"2025-02-01","2025-02-01","SF FuneralF1066375      250201","","126.5","","1511190.54"
"2025-02-01","2025-02-01","SF FuneralFDC0000000KXTD250201","","126.5","","1511317.04"
"2025-02-01","2025-02-01","SF FuneralF1068160      250202","","126.5","","1511443.54"
"2025-02-01","2025-02-01","SF FuneralF1085060      250201","","126.5","","1511570.04"
"2025-02-01","2025-02-01","SF FuneralF1109679      250201","","126.5","","1511696.54"
"2025-02-01","2025-02-01","SF FuneralF1119778      250201","","126.5","","1511823.04"
"2025-02-01","2025-02-01","SF FuneralF1126139      250201","","126.5","","1511949.54"
"2025-02-01","2025-02-01","SF FuneralF1128036      250201","","126.5","","1512076.04"
"2025-02-01","2025-01-29","SF FuneralFDC000000067MS250129","","126.5","","1512202.54"
"2025-02-01","2025-01-29","SF FuneralF1128076      250129","","63.25","","1512265.79"
"2025-02-01","2025-01-31","SF FuneralF987110       250201","","126.5","","1512392.29"
"2025-02-01","2025-01-31","SF FuneralF987319       250201","","126.5","","1512518.79"
"2025-02-01","2025-01-31","SF FuneralF1126950      250131","","126.5","","1512645.29"
"2025-02-01","2025-01-28","SF FuneralF812125       250128","","31.63","","1512676.92"
"2025-02-01","2025-01-28","SF FuneralF833072       250128","","31.63","","1512708.55"
"2025-02-01","2025-01-24","Rev SF FuneralFDC00000006W33250128","","-126.5","","1512582.05"
"2025-02-01","2024-12-11","Rev SF FuneralF986659       241228","","-126.5","","1512455.55"
"2025-02-01","2025-01-24","Rev SF FuneralF986659       250128","","-126.5","","1512329.05"
"2025-02-01","2024-12-11","Rev SF FuneralFDC00000006J5R241227","","-126.5","","1512202.55"
"2025-02-01","2025-01-24","Rev SF FuneralFDC00000006J5R250127","","-126.5","","1512076.05"
"2025-02-01","2025-01-24","Rev SF FuneralF1125386      250128","","-126.5","","1511949.55"
"2025-02-01","2025-01-24","Rev SF FuneralFDC000000087TS250125","","-126.5","","1511823.05"
"2025-02-01","2025-01-24","Rev SF FuneralFDC00000006KD3250127","","-126.5","","1511696.55"
"2025-02-01","2025-01-24","Rev SF FuneralFDC000000069VK250125","","-126.5","","1511570.05"
"2025-02-01","2025-01-24","Rev SF FuneralFDC0000000FRBY250127","","-126.5","","1511443.55"
"2025-02-01","2025-01-27","Rev SF FuneralFDC0000000BNK6250127","","-126.5","","1511317.05"
"2025-02-01","2025-01-24","Rev SF FuneralF1074938      250127","","-126.5","","1511190.55"
"2025-02-01","2025-01-24","Rev SF FuneralF1083697      250127","","-126.5","","1511064.05"
"2025-02-01","2025-01-13","Rev SF FuneralFDC00000006YNY250112","","-126.5","","1510937.55"
"2025-02-01","2025-02-01","Rev SF FuneralFDC00000007TNR250201","","-126.5","","1510811.05"
"2025-02-01","2025-02-01","Rev SF FuneralFDC0000000N7NT250202","","-31.63","","1510779.42"
"2025-02-01","2025-01-29","SF FuneralF844044       250129","","31.63","","1510811.05"
"2025-02-01","2025-01-31","SF FuneralFDC00000007MW5250131","","31.63","","1510842.68"
"2025-02-01","2025-02-01","SF FuneralF1079004      250202","","31.63","","1510874.31"
"2025-02-01","2025-01-24","SF FuneralFDC00000005MZR250128","","126.5","","1511000.81"
"2025-02-01","2025-01-24","SF FuneralFDC00000008XXY250128","","126.5","","1511127.31"
"2025-02-01","2025-01-24","SF FuneralF1083829      250127","","126.5","","1511253.81"
"2025-02-01","2025-01-24","SF FuneralF1109597      250127","","126.5","","1511380.31"
"2025-02-01","2025-01-24","SF FuneralF1125483      250127","","126.5","","1511506.81"
"2025-02-01","2025-02-01","SF FuneralFDC00000006TP2250201","","126.5","","1511633.31"
"2025-02-01","2025-02-01","SF FuneralFDC00000007570250201","","220","","1511853.31"
"2025-02-01","2025-02-01","SF FuneralF800410       250201","","126.5","","1511979.81"
"2025-02-01","2025-02-01","SF FuneralF805530       250201","","126.5","","1512106.31"
"2025-02-01","2025-02-01","SF FuneralF1074580      250201","","63.25","","1512169.56"
"2025-02-01","2025-02-01","SF FuneralF1084022      250201","","126.5","","1512296.06"
"2025-02-01","2025-02-01","SF FuneralF1085353      250201","","126.5","","1512422.56"
"2025-02-01","2025-02-01","SF FuneralF1109067      250202","","126.5","","1512549.06"
"2025-02-01","2025-02-01","SF FuneralF1109109      250201","","126.5","","1512675.56"
"2025-02-01","2025-02-01","SF FuneralF1120257      250201","","126.5","","1512802.06"
"2025-02-01","2025-02-01","SF FuneralFDC0000000PV3T250202","","126.5","","1512928.56"
"2025-02-01","2025-02-01","SF FuneralF1129950      250201","","126.5","","1513055.06"
"2025-02-01","2025-01-24","Rev SF FuneralFDC0000000BX71250127","","-126.5","","1512928.56"
"2025-02-01","2025-01-24","SF FuneralFDC000000070FN250128","","126.5","","1513055.06"
"2025-02-01","2025-01-24","SF FuneralF812307       250127","","126.5","","1513181.56"
"2025-02-01","2025-01-24","SF FuneralF1068021      250128","","126.5","","1513308.06"
"2025-02-01","2025-02-01","SF FuneralF833240       250201","","126.5","","1513434.56"
"2025-02-01","2025-02-01","SF FuneralF1114030      250201","","126.5","","1513561.06"
"2025-02-01","2025-02-01","SF FuneralF1125812      250201","","126.5","","1513687.56"
"2025-02-01","2025-01-28","SF FuneralF1117702      250128","","31.63","","1513719.19"
"2025-02-01","2025-01-28","SF FuneralF1127611      250128","","31.63","","1513750.82"
"2025-02-01","2025-01-31","SF FuneralF989153       250201","","126.5","","1513877.32"
"2025-02-01","2025-01-24","SF FuneralFDC00000005GV2250128","","126.5","","1514003.82"
"2025-02-01","2025-01-24","SF FuneralFDC00000008SRR250128","","126.5","","1514130.32"
"2025-02-01","2025-01-24","SF FuneralF811986       250127","","126.5","","1514256.82"
"2025-02-01","2025-01-24","SF FuneralFDC0000000MK39250127","","126.5","","1514383.32"
"2025-02-01","2025-01-24","SF FuneralF1118897      250127","","126.5","","1514509.82"
"2025-02-01","2025-01-24","SF FuneralF1108943      250128","","126.5","","1514636.32"
"2025-02-01","2025-01-28","SF FuneralFDC00000005P4K250128","","31.63","","1514667.95"
"2025-02-01","2025-01-29","SF FuneralFDC00000006GQV250129","","126.5","","1514794.45"
"2025-02-01","2025-01-29","SF FuneralF981579       250129","","126.5","","1514920.95"
"2025-02-01","2025-01-29","SF FuneralF990706       250129","","63.25","","1514984.2"
"2025-02-01","2025-01-29","SF FuneralF1017085      250129","","63.25","","1515047.45"
"2025-02-01","2025-01-29","SF FuneralFDC0000000M2N1250129","","63.25","","1515110.7"
"2025-02-01","2025-01-29","SF FuneralF1117907      250129","","126.5","","1515237.2"
"2025-02-02","2025-01-24","SF FuneralFDC00000007C9Y250128","","126.5","","1515363.7"
"2025-02-02","2025-01-24","SF FuneralF799581       250128","","126.5","","1515490.2"
"2025-02-02","2025-01-24","SF FuneralF834242       250125","","126.5","","1515616.7"
"2025-02-02","2025-01-24","SF FuneralF1060252      250124","","126.5","","1515743.2"
"2025-02-02","2025-01-24","SF FuneralF1109851      250128","","126.5","","1515869.7"
"2025-02-02","2025-01-24","SF FuneralF1128195      250128","","126.5","","1515996.2"
"2025-02-02","2025-01-31","SF FuneralF980369       250201","","126.5","","1516122.7"
"2025-02-02","2025-02-01","SF FuneralFDC00000006748250201","","126.5","","1516249.2"
"2025-02-02","2025-02-01","SF FuneralFDC000000073CQ250201","","126.5","","1516375.7"
"2025-02-02","2025-02-01","SF FuneralF798644       250201","","126.5","","1516502.2"
"2025-02-02","2025-02-01","SF FuneralFDC000000094YH250201","","126.5","","1516628.7"
"2025-02-02","2025-02-01","SF FuneralF812707       250201","","126.5","","1516755.2"
"2025-02-02","2025-02-01","SF FuneralF842319       250201","","126.5","","1516881.7"
"2025-02-02","2025-02-01","SF FuneralF1017411      250201","","126.5","","1517008.2"
"2025-02-02","2025-02-01","SF FuneralFDC0000000K1KB250201","","126.5","","1517134.7"
"2025-02-02","2025-02-01","SF FuneralF1066547      250201","","126.5","","1517261.2"
"2025-02-02","2025-02-01","SF FuneralF1109948      250201","","126.5","","1517387.7"
"2025-02-02","2025-02-01","SF FuneralF1113915      250201","","126.5","","1517514.2"
"2025-02-02","2025-02-01","SF FuneralF1122243      250201","","126.5","","1517640.7"
"2025-02-02","2025-01-24","SF FuneralFDC000000065ZR250124","","126.5","","1517767.2"
"2025-02-02","2025-01-24","SF FuneralFDC00000007389250128","","126.5","","1517893.7"
"2025-02-02","2025-01-24","SF FuneralFDC000000073K5250127","","126.5","","1518020.2"
"2025-02-02","2025-01-24","SF FuneralF803722       250127","","126.5","","1518146.7"
"2025-02-02","2025-01-24","SF FuneralFDC00000009H0N250128","","126.5","","1518273.2"
"2025-02-02","2025-01-24","SF FuneralF813927       250127","","126.5","","1518399.7"
"2025-02-02","2025-01-24","SF FuneralF817334       250128","","126.5","","1518526.2"
"2025-02-02","2025-01-24","SF FuneralF841404       250127","","126.5","","1518652.7"
"2025-02-02","2025-01-24","SF FuneralF842477       250127","","126.5","","1518779.2"
"2025-02-02","2025-01-24","SF FuneralF990283       250126","","126.5","","1518905.7"
"2025-02-02","2025-01-24","SF FuneralF1055292      250127","","126.5","","1519032.2"
"2025-02-02","2025-01-24","SF FuneralF1073391      250128","","126.5","","1519158.7"
"2025-02-02","2025-01-24","SF FuneralF1113225      250124","","126.5","","1519285.2"
"2025-02-02","2025-01-24","SF FuneralF1113549      250128","","126.5","","1519411.7"
"2025-02-02","2025-01-24","SF FuneralF1117729      250128","","126.5","","1519538.2"
"2025-02-02","2025-01-24","SF FuneralF1118068      250128","","126.5","","1519664.7"
"2025-02-02","2025-01-24","SF FuneralFDC0000000P1RD250127","","126.5","","1519791.2"
"2025-02-02","2025-01-24","SF FuneralFDC0000000NZ2T250127","","126.5","","1519917.7"
"2025-02-02","2025-01-28","SF FuneralF1021235      250128","","31.63","","1519949.33"
"2025-02-02","2025-01-28","SF FuneralFDC0000000NZV5250128","","31.63","","1519980.96"
"2025-02-02","2025-01-28","SF FuneralF1121873      250128","","31.63","","1520012.59"
"2025-02-02","2025-01-31","SF FuneralF988162       250201","","126.5","","1520139.09"
"2025-02-02","2025-02-01","SF FuneralF1017903      250201","","126.5","","1520265.59"
"2025-02-02","2025-02-01","SF FuneralF1072684      250201","","31.63","","1520297.22"
"2025-02-02","2025-01-28","SF FuneralFDC00000006QTN250128","","31.63","","1520328.85"
"2025-02-02","2025-01-28","SF FuneralF828954       250128","","31.63","","1520360.48"
"2025-02-02","2025-01-28","SF FuneralF993633       250128","","31.63","","1520392.11"
"2025-02-02","2025-02-01","SF FuneralF1017512      250202","","31.63","","1520423.74"
"2025-02-02","2025-01-23","SF FuneralF990290       250123","","126.5","","1520550.24"
"2025-02-02","2025-01-31","SF FuneralFDC000000039Y2250131","","220","","1520770.24"
"2025-02-02","2025-01-31","SF FuneralF1080434      250131","","126.5","","1520896.74"
"2025-02-02","2025-02-01","SF FuneralFDC00000006B8V250201","","126.5","","1521023.24"
"2025-02-02","2025-02-01","SF FuneralFDC00000006DYM250201","","126.5","","1521149.74"
"2025-02-02","2025-02-01","SF FuneralFDC00000006HYZ250201","","126.5","","1521276.24"
"2025-02-02","2025-02-01","SF FuneralFDC00000007GTT250201","","126.5","","1521402.74"
"2025-02-02","2025-02-01","SF FuneralFDC00000007J2C250201","","126.5","","1521529.24"
"2025-02-02","2025-02-01","SF FuneralFDC000000084FK250201","","126.5","","1521655.74"
"2025-02-02","2025-02-01","SF FuneralFDC000000084N4250201","","126.5","","1521782.24"
"2025-02-02","2025-02-01","SF FuneralF809917       250201","","126.5","","1521908.74"
"2025-02-02","2025-02-01","SF FuneralF812641       250201","","126.5","","1522035.24"
"2025-02-02","2025-02-01","SF FuneralF819221       250201","","126.5","","1522161.74"
"2025-02-02","2025-02-01","SF FuneralF993161       250201","","126.5","","1522288.24"
"2025-02-02","2025-02-01","SF FuneralFDC0000000JF13250201","","126.5","","1522414.74"
"2025-02-02","2025-02-01","SF FuneralF1079654      250201","","126.5","","1522541.24"
"2025-02-02","2025-02-01","SF FuneralFDC0000000LWV0250201","","126.5","","1522667.74"
"2025-02-02","2025-02-01","SF FuneralFDC0000000NCRN250201","","63.25","","1522730.99"
"2025-02-02","2025-01-28","SF FuneralF840821       250128","","63.25","","1522794.24"
"2025-02-02","2025-01-28","SF FuneralF1130273      250128","","126.5","","1522920.74"
"2025-02-02","2025-01-29","SF FuneralFDC00000002XBX250129","","220","","1523140.74"
"2025-02-02","2025-01-29","SF FuneralF834145       250129","","126.5","","1523267.24"
"2025-02-02","2025-01-29","SF FuneralF1125665      250129","","126.5","","1523393.74"
"2025-02-02","2025-01-28","SF FuneralFDC00000006L9F250128","","31.63","","1523425.37"
"2025-02-02","2025-01-24","SF FuneralFDC0000000JV0H250128","","126.5","","1523551.87"
"2025-02-02","2025-01-24","SF FuneralF1068043      250128","","126.5","","1523678.37"
"2025-02-02","2025-01-24","SF FuneralF1079496      250127","","126.5","","1523804.87"
"2025-02-02","2025-02-02","SF FuneralF833253       250202","","31.63","","1523836.5"
"2025-02-02","2025-01-24","SF FuneralF1125895      250128","","126.5","","1523963"
"2025-02-02","2025-01-30","SF FuneralF800285       250130","","126.5","","1524089.5"
"2025-02-02","2025-02-01","SF FuneralF1123289      250201","","126.5","","1524216"
"2025-02-02","2025-02-01","SF FuneralF1125800      250201","","126.5","","1524342.5"
"2025-02-02","2025-01-28","SF FuneralF1083898      250128","","63.25","","1524405.75"
"2025-02-02","2025-01-24","SF FuneralF1122867      250127","","126.5","","1524532.25"
"2025-02-02","2025-01-29","SF FuneralF821760       250129","","126.5","","1524658.75"
"2025-02-02","2025-01-31","SF FuneralF1020830      250131","","126.5","","1524785.25"
"2025-02-02","2025-02-01","SF FuneralF821212       250201","","126.5","","1524911.75"
"2025-02-02","2025-02-01","SF FuneralF832006       250201","","126.5","","1525038.25"
"2025-02-02","2025-02-01","SF FuneralF833327       250201","","126.5","","1525164.75"
"2025-02-02","2025-02-01","SF FuneralF842535       250201","","126.5","","1525291.25"
"2025-02-02","2025-02-01","SF FuneralF993697       250201","","126.5","","1525417.75"
"2025-02-02","2025-02-01","SF FuneralF1033734      250201","","126.5","","1525544.25"
"2025-02-02","2025-02-01","SF FuneralF1125692      250201","","126.5","","1525670.75"
"2025-02-02","2025-02-01","SF FuneralF1114176      250201","","126.5","","1525797.25"
"2025-02-02","2025-02-01","SF FuneralF1129331      250201","","126.5","","1525923.75"
"2025-02-03","2025-02-01","SF FuneralF774436       250201","","191.5","","1526115.25"
"2025-02-03","2025-01-24","SF FuneralF831018       250128","","126.5","","1526241.75"
"2025-02-03","2025-01-24","SF FuneralFDC0000000822J250125","","126.5","","1526368.25"
"2025-02-03","2025-02-03","SF FuneralFDC000000030LF250202","","220","","1526588.25"
"2025-02-03","2025-01-30","SF FuneralF843570       250130","","31.63","","1526619.88"
"2025-02-03","2025-01-30","SF FuneralF1124328      250130","","31.63","","1526651.51"
"2025-02-03","2025-01-24","SF FuneralF1075037      250125","","126.5","","1526778.01"
"2025-02-03","2025-01-24","SF FuneralF1104020      250128","","126.5","","1526904.51"
"2025-02-03","2025-01-24","SF FuneralF1122617      250127","","126.5","","1527031.01"
"2025-02-03","2025-01-29","SF FuneralF981544       250129","","126.5","","1527157.51"
"2025-02-03","2025-01-31","SF FuneralFDC00000006PSF250131","","31.63","","1527189.14"
"2025-02-03","2025-01-31","SF FuneralF822267       250131","","31.63","","1527220.77"
"2025-02-03","2025-01-31","SF FuneralFDC0000000L8B0250131","","31.63","","1527252.4"
"2025-02-03","2025-01-31","SF FuneralF1120280      250131","","31.63","","1527284.03"
"2025-02-03","2025-02-01","SF FuneralF809893       250201","","126.5","","1527410.53"
"2025-02-03","2025-02-01","SF FuneralF1128686      250201","","126.5","","1527537.03"
"2025-02-03","2025-02-03","SF FuneralFDC000000088TJ250203","","191.5","","1527728.53"
"2025-02-03","2025-02-03","SF FuneralFDC000000089NB250202","","126.5","","1527855.03"
"2025-02-03","2025-02-03","SF FuneralFDC00000008MKX250203","","31.63","","1527886.66"
"2025-02-03","2025-02-03","SF FuneralF804342       250202","","126.5","","1528013.16"
"2025-02-03","2025-02-03","SF FuneralF822549       250203","","31.63","","1528044.79"
"2025-02-03","2025-02-03","SF FuneralF844600       250201","","126.5","","1528171.29"
"2025-02-03","2025-02-03","SF FuneralF1066274      250203","","31.63","","1528202.92"
"2025-02-03","2025-01-24","SF FuneralFDC00000006DJ4250128","","126.5","","1528329.42"
"2025-02-03","2025-01-24","SF FuneralF1121905      250124","","126.5","","1528455.92"
"2025-02-03","2025-01-29","SF FuneralFDC00000005MMP250129","","126.5","","1528582.42"
"2025-02-03","2025-01-29","SF FuneralF812388       250129","","126.5","","1528708.92"
"2025-02-03","2025-01-29","SF FuneralF817496       250129","","126.5","","1528835.42"
"2025-02-03","2025-01-30","SF FuneralF798144       250130","","126.5","","1528961.92"
"2025-02-03","2025-02-01","SF FuneralFDC00000007VDH250201","","126.5","","1529088.42"
"2025-02-03","2025-02-01","SF FuneralF812406       250201","","126.5","","1529214.92"
"2025-02-03","2025-02-01","SF FuneralF814943       250201","","126.5","","1529341.42"
"2025-02-03","2025-02-01","SF FuneralF823096       250201","","126.5","","1529467.92"
"2025-02-03","2025-02-01","SF FuneralF833167       250201","","126.5","","1529594.42"
"2025-02-03","2025-02-01","SF FuneralF1084985      250201","","126.5","","1529720.92"
"2025-02-03","2025-02-01","SF FuneralF1118722      250201","","126.5","","1529847.42"
"2025-02-03","2025-02-01","SF FuneralFDC0000000PK3B250201","","126.5","","1529973.92"
"2025-02-03","2025-02-01","SF FuneralF1129472      250201","","126.5","","1530100.42"
"2025-02-03","2025-02-03","SF FuneralF1017480      250203","","126.5","","1530226.92"
"2025-02-03","2025-01-24","SF FuneralF1117930      250128","","126.5","","1530353.42"
"2025-02-03","2025-01-28","SF FuneralF1054884      250128","","31.63","","1530385.05"
"2025-02-03","2025-01-31","SF FuneralFDC000000076F0250131","","126.5","","1530511.55"
"2025-02-03","2025-01-31","SF FuneralFDC00000007G54250131","","31.63","","1530543.18"
"2025-02-03","2025-01-31","SF FuneralF805319       250131","","31.63","","1530574.81"
"2025-02-03","2025-01-31","SF FuneralF821927       250131","","31.63","","1530606.44"
"2025-02-03","2025-01-31","SF FuneralF994001       250131","","31.63","","1530638.07"
"2025-02-03","2025-01-31","SF FuneralF1078955      250131","","31.63","","1530669.7"
"2025-02-03","2025-01-31","SF FuneralF1123167      250131","","31.63","","1530701.33"
"2025-02-03","2025-01-31","SF FuneralF1126869      250131","","31.63","","1530732.96"
"2025-02-03","2025-01-28","SF FuneralFDC0000000PK37250128","","126.5","","1530859.46"
"2025-02-03","2025-02-03","SF FuneralFDC00000005LWP250202","","31.63","","1530891.09"
"2025-02-03","2025-02-03","SF FuneralFDC000000069CL250203","","31.63","","1530922.72"
"2025-02-03","2025-02-03","SF FuneralFDC00000006XZP250203","","31.63","","1530954.35"
"2025-02-03","2025-02-03","SF FuneralF812202       250203","","31.63","","1530985.98"
"2025-02-03","2025-02-03","SF FuneralF987310       250203","","31.63","","1531017.61"
"2025-02-03","2025-02-03","SF FuneralF1060055      250203","","31.63","","1531049.24"
"2025-02-03","2025-01-28","SF FuneralF1104197      250128","","31.63","","1531080.87"
"2025-02-03","2025-01-30","SF FuneralF1108113      250130","","31.63","","1531112.5"
"2025-02-03","2025-02-03","SF FuneralF1066299      250203","","31.63","","1531144.13"
"2025-02-03","2025-01-31","SF FuneralFDC000000069RZ250131","","31.63","","1531175.76"
"2025-02-03","2025-01-31","SF FuneralFDC000000086Y9250131","","31.63","","1531207.39"
"2025-02-03","2025-01-31","SF FuneralF814303       250131","","31.63","","1531239.02"
"2025-02-03","2025-01-31","SF FuneralF817655       250131","","31.63","","1531270.65"
"2025-02-03","2025-01-31","SF FuneralFDC0000000B37Y250131","","31.63","","1531302.28"
"2025-02-03","2025-01-31","SF FuneralF819362       250131","","31.63","","1531333.91"
"2025-02-03","2025-01-31","SF FuneralF823750       250131","","31.63","","1531365.54"
"2025-02-03","2025-01-31","SF FuneralF832185       250131","","31.63","","1531397.17"
"2025-02-03","2025-01-31","SF FuneralF832777       250131","","31.63","","1531428.8"
"2025-02-03","2025-01-31","SF FuneralFDC0000000FQWF250131","","31.63","","1531460.43"
"2025-02-03","2025-01-31","SF FuneralF844636       250131","","31.63","","1531492.06"
"2025-02-03","2025-01-31","SF FuneralFDC0000000HXHK250131","","47.88","","1531539.94"
"2025-02-03","2025-01-31","SF FuneralFDC0000000J2XM250202","","31.63","","1531571.57"
"2025-02-03","2025-01-31","SF FuneralFDC0000000JFC4250131","","31.63","","1531603.2"
"2025-02-03","2025-01-31","SF FuneralF1033620      250131","","31.63","","1531634.83"
"2025-02-03","2025-01-31","SF FuneralF1068145      250131","","31.63","","1531666.46"
"2025-02-03","2025-01-31","SF FuneralF1078457      250131","","31.63","","1531698.09"
"2025-02-03","2025-01-31","SF FuneralFDC0000000NNGY250131","","31.63","","1531729.72"
"2025-02-03","2025-01-31","SF FuneralF1130338      250131","","31.63","","1531761.35"
"2025-02-03","2025-01-31","SF FuneralF1130369      250131","","31.63","","1531792.98"
"2025-02-03","2025-02-03","SF FuneralF1079351      250203","","31.63","","1531824.61"
"2025-02-03","2025-01-31","SF FuneralF811119       250131","","31.63","","1531856.24"
"2025-02-03","2025-01-31","SF FuneralF819053       250131","","31.63","","1531887.87"
"2025-02-03","2025-01-31","SF FuneralF843596       250131","","31.63","","1531919.5"
"2025-02-03","2025-01-31","SF FuneralFDC0000000KLCD250131","","31.63","","1531951.13"
"2025-02-03","2025-01-31","SF FuneralF1061613      250131","","31.63","","1531982.76"
"2025-02-03","2025-01-31","SF FuneralFDC0000000LMH8250131","","31.63","","1532014.39"
"2025-02-03","2025-01-31","SF FuneralF1104285      250131","","31.63","","1532046.02"
"2025-02-03","2025-02-03","SF FuneralFDC00000005F1K250203","","31.63","","1532077.65"
"2025-02-03","2025-02-03","SF FuneralFDC00000007DSV250203","","31.63","","1532109.28"
"2025-02-03","2025-02-03","SF FuneralF810327       250203","","31.63","","1532140.91"
"2025-02-03","2025-02-03","SF FuneralF831617       250203","","31.63","","1532172.54"
"2025-02-03","2025-02-03","SF FuneralFDC0000000K09V250203","","31.63","","1532204.17"
"2025-02-03","2025-01-31","SF FuneralFDC00000005GY1250131","","31.63","","1532235.8"
"2025-02-03","2025-01-31","SF FuneralFDC00000005PXF250131","","31.63","","1532267.43"
"2025-02-03","2025-01-31","SF FuneralFDC00000005QCT250131","","31.63","","1532299.06"
"2025-02-03","2025-01-31","SF FuneralFDC00000005V4S250131","","31.63","","1532330.69"
"2025-02-03","2025-01-31","SF FuneralFDC00000006C7B250131","","31.63","","1532362.32"
"2025-02-03","2025-01-31","SF FuneralFDC00000007Q48250131","","31.63","","1532393.95"
"2025-02-03","2025-01-31","SF FuneralF795812       250131","","31.63","","1532425.58"
"2025-02-03","2025-01-31","SF FuneralF901122       250131","","31.63","","1532457.21"
"2025-02-03","2025-01-31","SF FuneralF774474       250131","","156.28","","1532613.49"
"2025-02-03","2025-01-31","SF FuneralF1065649      250131","","31.63","","1532645.12"
"2025-02-03","2025-01-31","SF FuneralF1072884      250131","","31.63","","1532676.75"
"2025-02-03","2025-01-31","SF FuneralF1073030      250131","","31.63","","1532708.38"
"2025-02-03","2025-01-31","SF FuneralF1111672      250131","","31.63","","1532740.01"
"2025-02-03","2025-01-31","SF FuneralF1120399      250131","","31.63","","1532771.64"
"2025-02-03","2025-01-31","SF FuneralF1127351      250131","","31.63","","1532803.27"
"2025-02-03","2025-02-01","SF FuneralFDC00000006HHY250201","","31.63","","1532834.9"
"2025-02-03","2025-02-03","SF FuneralFDC00000007GS9250203","","31.63","","1532866.53"
"2025-02-03","2025-02-03","SF FuneralF803226       250203","","31.63","","1532898.16"
"2025-02-03","2025-02-03","SF FuneralF1084856      250203","","31.63","","1532929.79"
"2025-02-03","2025-01-31","SF FuneralFDC00000006R81250131","","31.63","","1532961.42"
"2025-02-03","2025-01-31","SF FuneralF1084400      250131","","31.63","","1532993.05"
"2025-02-03","2025-01-31","SF FuneralF1122752      250131","","31.63","","1533024.68"
"2025-02-03","2025-02-03","SF FuneralFDC00000004NQP250202","","31.63","","1533056.31"
"2025-02-03","2025-02-03","SF FuneralFDC000000086PW250202","","31.63","","1533087.94"
"2025-02-03","2025-02-03","SF FuneralFDC000000086PX250202","","31.63","","1533119.57"
"2025-02-03","2025-02-03","SF FuneralF828566       250203","","31.63","","1533151.2"
"2025-02-03","2025-02-03","SF FuneralF1017111      250203","","31.63","","1533182.83"
"2025-02-03","2025-02-03","SF FuneralF1110362      250203","","31.63","","1533214.46"
"2025-02-03","2025-02-03","SF FuneralFDC0000000PYVQ250203","","31.63","","1533246.09"
"2025-02-03","2025-02-03","SF FuneralF1129402      250203","","31.63","","1533277.72"
"2025-02-03","2025-01-31","SF FuneralF830931       250131","","31.63","","1533309.35"
"2025-02-03","2025-01-31","SF FuneralF1104196      250131","","31.63","","1533340.98"
"2025-02-03","2025-01-31","SF FuneralF1104243      250131","","31.63","","1533372.61"
"2025-02-03","2025-01-31","SF FuneralF1115119      250131","","31.63","","1533404.24"
"2025-02-03","2025-02-01","SF FuneralFDC00000007G0S250201","","31.63","","1533435.87"
"2025-02-03","2025-02-03","SF FuneralF841615       250203","","31.63","","1533467.5"
"2025-02-03","2025-02-03","SF FuneralF1052717      250203","","31.63","","1533499.13"
"2025-02-03","2025-02-03","SF FuneralF1052812      250203","","31.63","","1533530.76"
"2025-02-03","2025-02-03","SF FuneralF1068000      250203","","31.63","","1533562.39"
"2025-02-03","2025-02-03","SF FuneralFDC0000000KYZ5250203","","31.63","","1533594.02"
"2025-02-03","2025-01-30","SF FuneralF1085168      250130","","31.63","","1533625.65"
"2025-02-03","2025-01-31","SF FuneralFDC00000007WBL250131","","31.63","","1533657.28"
"2025-02-03","2025-01-31","SF FuneralFDC00000007WJL250131","","31.63","","1533688.91"
"2025-02-03","2025-01-31","SF FuneralFDC0000000HBD0250131","","31.63","","1533720.54"
"2025-02-03","2025-01-31","SF FuneralF993205       250131","","31.63","","1533752.17"
"2025-02-03","2025-01-31","SF FuneralF1078056      250131","","31.63","","1533783.8"
"2025-02-03","2025-02-03","SF FuneralFDC00000006RQ8250202","","31.63","","1533815.43"
"2025-02-03","2025-02-03","SF FuneralFDC00000007BGG250202","","31.63","","1533847.06"
"2025-02-03","2025-02-03","SF FuneralF1123166      250203","","31.63","","1533878.69"
"2025-02-03","2025-02-03","SF FuneralF810184       250202","","126.5","","1534005.19"
"2025-02-03","2025-01-31","SF FuneralF815340       250131","","31.63","","1534036.82"
"2025-02-03","2025-01-31","SF FuneralF815510       250131","","31.63","","1534068.45"
"2025-02-03","2025-01-31","SF FuneralF817463       250131","","31.63","","1534100.08"
"2025-02-03","2025-01-31","SF FuneralF992752       250131","","31.63","","1534131.71"
"2025-02-03","2025-01-31","SF FuneralF993478       250131","","31.63","","1534163.34"
"2025-02-03","2025-01-31","SF FuneralF1052348      250131","","31.63","","1534194.97"
"2025-02-03","2025-01-31","SF FuneralF1123008      250131","","31.63","","1534226.6"
"2025-02-03","2025-02-01","SF FuneralF1060024      250201","","31.63","","1534258.23"
"2025-02-03","2025-02-03","SF FuneralF822865       250203","","31.63","","1534289.86"
"2025-02-03","2025-01-31","SF FuneralFDC00000005TX1250131","","31.63","","1534321.49"
"2025-02-03","2025-01-31","SF FuneralFDC00000006NFW250131","","31.63","","1534353.12"
"2025-02-03","2025-01-31","SF FuneralF779346       250131","","31.63","","1534384.75"
"2025-02-03","2025-01-31","SF FuneralFDC0000000L8NN250131","","31.63","","1534416.38"
"2025-02-03","2025-01-31","SF FuneralF1075226      250131","","31.63","","1534448.01"
"2025-02-03","2025-02-03","SF FuneralFDC00000008JTK250203","","63.25","","1534511.26"
"2025-02-03","2025-02-03","SF FuneralFDC00000008JXH250203","","63.25","","1534574.51"
"2025-02-03","2025-02-03","SF FuneralFDC00000008JYZ250203","","63.25","","1534637.76"
"2025-02-03","2025-02-03","SF FuneralF830438       250203","","126.5","","1534764.26"
"2025-02-03","2025-02-03","SF FuneralFDC0000000PKBK250203","","126.5","","1534890.76"
"2025-02-03","2025-02-03","SF FuneralFDC00000005SZ4250203","","63.25","","1534954.01"
"2025-02-03","2025-02-03","SF FuneralF822308       250203","","63.25","","1535017.26"
"2025-02-03","2025-02-03","SF FuneralF822919       250203","","63.25","","1535080.51"
"2025-02-03","2025-02-03","SF FuneralFDC00000006Z79250203","","126.5","","1535207.01"
"2025-02-03","2025-02-03","SF FuneralFDC000000071RV250203","","126.5","","1535333.51"
"2025-02-03","2025-02-03","SF FuneralFDC000000072B6250203","","63.25","","1535396.76"
"2025-02-03","2025-02-03","SF FuneralFDC00000007MVX250203","","126.5","","1535523.26"
"2025-02-03","2025-02-03","SF FuneralF828246       250203","","126.5","","1535649.76"
"2025-02-03","2025-02-03","SF FuneralFDC0000000F5ZS250202","","126.5","","1535776.26"
"2025-02-03","2025-02-03","SF FuneralF842918       250201","","126.5","","1535902.76"
"2025-02-03","2025-02-03","SF FuneralF900542       250201","","126.5","","1536029.26"
"2025-02-03","2025-02-03","SF FuneralF804562       250202","","126.5","","1536155.76"
"2025-02-03","2025-02-03","SF FuneralF843978       250201","","126.5","","1536282.26"
"2025-02-03","2025-02-03","SF FuneralF1113810      250203","","126.5","","1536408.76"
"2025-02-03","2025-02-03","SF FuneralF1066517      250203","","63.25","","1536472.01"
"2025-02-03","2025-02-03","SF FuneralF1079120      250203","","126.5","","1536598.51"
"2025-02-03","2025-01-31","SF FuneralFDC0000000HYW8250131","","63.25","","1536661.76"
"2025-02-03","2025-02-03","SF FuneralFDC00000003B4L250203","","220","","1536881.76"
"2025-02-03","2025-02-03","SF FuneralFDC00000005NYD250203","","63.25","","1536945.01"
"2025-02-03","2025-02-03","SF FuneralFDC00000008JTG250203","","63.25","","1537008.26"
"2025-02-03","2025-01-28","SF FuneralF811655       250128","","31.63","","1537039.89"
"2025-02-03","2025-02-01","SF FuneralFDC000000087KM250201","","126.5","","1537166.39"
"2025-02-03","2025-02-01","SF FuneralF1108560      250202","","126.5","","1537292.89"
"2025-02-03","2025-02-03","SF FuneralFDC000000085QB250203","","126.5","","1537419.39"
"2025-02-03","2025-02-03","SF FuneralF816957       250203","","126.5","","1537545.89"
"2025-02-03","2025-02-03","SF FuneralF1117357      250203","","126.5","","1537672.39"
"2025-02-03","2025-02-03","SF FuneralFDC0000000MR2H250203","","31.63","","1537704.02"
"2025-02-03","2025-02-03","SF FuneralFDC000000089G2250202","","31.63","","1537735.65"
"2025-02-03","2025-02-03","SF FuneralF1061948      250203","","126.5","","1537862.15"
"2025-02-03","2025-02-03","SF FuneralF1130847      250203","","31.63","","1537893.78"
"2025-02-03","2025-01-31","SF FuneralFDC000000070CD250131","","31.63","","1537925.41"
"2025-02-03","2025-01-31","SF FuneralF814074       250131","","31.63","","1537957.04"
"2025-02-03","2025-01-31","SF FuneralF993809       250131","","31.63","","1537988.67"
"2025-02-03","2025-01-31","SF FuneralF1104255      250131","","31.63","","1538020.3"
"2025-02-03","2025-01-31","SF FuneralF1128672      250131","","31.63","","1538051.93"
"2025-02-03","2025-02-01","SF FuneralFDC00000006KS3250201","","126.5","","1538178.43"
"2025-02-03","2025-02-03","SF FuneralFDC0000000MSC7250203","","47.88","","1538226.31"
"2025-02-03","2025-02-03","SF FuneralF1112136      250203","","31.63","","1538257.94"
"2025-02-03","2025-01-29","SF FuneralF987016       250129","","31.63","","1538289.57"
"2025-02-03","2025-02-01","SF FuneralFDC000000075P7250201","","126.5","","1538416.07"
"2025-02-03","2025-02-03","SF FuneralFDC00000005H8J250202","","31.63","","1538447.7"
"2025-02-03","2025-01-24","Rev SF FuneralF993269       250128","","-126.5","","1538321.2"
"2025-02-03","2025-01-28","Rev SF FuneralF1111658      250128","","-63.25","","1538257.95"
"2025-02-03","2025-01-31","Rev SF FuneralFDC0000000K7CQ250131","","-31.63","","1538226.32"
"2025-02-03","2025-01-24","Rev SF FuneralFDC00000006BTS250128","","-126.5","","1538099.82"
"2025-02-03","2025-01-28","Rev SF FuneralFDC0000000B89Y250128","","-126.5","","1537973.32"
"2025-02-03","2025-01-27","Rev SF FuneralFDC00000007F6S250126","","-63.25","","1537910.07"
"2025-02-03","2025-01-24","Rev SF FuneralFDC00000007NZG250125","","-126.5","","1537783.57"
"2025-02-03","2025-01-24","Rev SF FuneralFDC0000000JD19250127","","-126.5","","1537657.07"
"2025-02-03","2025-01-24","Rev SF FuneralFDC00000006RNF250128","","-126.5","","1537530.57"
"2025-02-03","2025-01-29","Rev SF FuneralFDC00000005MMP250129","","-126.5","","1537404.07"
"2025-02-03","2025-02-01","SF FuneralF803234       250201","","126.5","","1537530.57"
"2025-02-03","2025-02-01","SF FuneralF1078059      250201","","126.5","","1537657.07"
"2025-02-03","2025-01-28","SF FuneralFDC00000005Z3F250128","","63.25","","1537720.32"
"2025-02-03","2025-01-29","SF FuneralF832730       250129","","126.5","","1537846.82"
"2025-02-03","2025-01-29","SF FuneralFDC0000000KVYX250129","","126.5","","1537973.32"
"2025-02-03","2025-01-30","SF FuneralF809003       250130","","126.5","","1538099.82"
"2025-02-03","2025-01-31","SF FuneralF1118332      250131","","63.25","","1538163.07"
"2025-02-03","2025-02-01","SF FuneralF1084578      250201","","126.5","","1538289.57"
"2025-02-03","2025-02-01","SF FuneralF1129846      250201","","126.5","","1538416.07"
"2025-02-03","2025-01-28","SF FuneralFDC00000008YCZ250128","","31.63","","1538447.7"
"2025-02-03","2025-01-29","SF FuneralF1061004      250129","","63.25","","1538510.95"
"2025-02-03","2025-01-31","SF FuneralF987840       250201","","126.5","","1538637.45"
"2025-02-03","2025-02-01","SF FuneralFDC00000007VYC250201","","126.5","","1538763.95"
"2025-02-03","2025-02-01","SF FuneralFDC0000000868R250201","","126.5","","1538890.45"
"2025-02-03","2025-02-01","SF FuneralFDC000000089X7250201","","126.5","","1539016.95"
"2025-02-03","2025-02-01","SF FuneralFDC000000092TF250201","","126.5","","1539143.45"
"2025-02-03","2025-02-01","SF FuneralF1052150      250201","","126.5","","1539269.95"
"2025-02-03","2025-02-01","SF FuneralF1058608      250201","","126.5","","1539396.45"
"2025-02-03","2025-02-01","SF FuneralF1079378      250202","","126.5","","1539522.95"
"2025-02-03","2025-02-01","SF FuneralF1110321      250201","","126.5","","1539649.45"
"2025-02-03","2025-02-01","SF FuneralF1125904      250201","","126.5","","1539775.95"
"2025-02-03","2025-01-27","Rev SF FuneralFDC000000066HH250127","","-126.5","","1539649.45"
"2025-02-03","2025-01-27","Rev SF FuneralFDC000000066J1250127","","-126.5","","1539522.95"
"2025-02-03","2025-01-24","Rev SF FuneralFDC00000008CZH250128","","-126.5","","1539396.45"
"2025-02-03","2025-01-24","Rev SF FuneralF1120771      250127","","-126.5","","1539269.95"
"2025-02-03","2025-01-24","Rev SF FuneralFDC00000006Y2R250128","","-126.5","","1539143.45"
"2025-02-03","2025-01-22","Rev SF FuneralFDC00000008HY7250122","","-126.5","","1539016.95"
"2025-02-03","2025-01-24","SF FuneralF828502       250127","","126.5","","1539143.45"
"2025-02-03","2025-01-24","SF FuneralF1118789      250124","","126.5","","1539269.95"
"2025-02-03","2025-01-24","SF FuneralFDC0000000P5V9250127","","213.31","","1539483.26"
"2025-02-03","2025-01-31","SF FuneralFDC00000008NYM250131","","31.63","","1539514.89"
"2025-02-03","2025-01-31","SF FuneralF990787       250201","","31.63","","1539546.52"
"2025-02-03","2025-02-01","SF FuneralFDC000000078B2250201","","126.5","","1539673.02"
"2025-02-03","2025-02-01","SF FuneralF840900       250201","","126.5","","1539799.52"
"2025-02-03","2025-02-01","SF FuneralF1021483      250201","","126.5","","1539926.02"
"2025-02-03","2025-01-24","Rev SF FuneralFDC0000000K9DR250127","","-126.5","","1539799.52"
"2025-02-03","2025-01-29","SF FuneralFDC00000007DMT250129","","31.63","","1539831.15"
"2025-02-03","2025-01-29","SF FuneralF1108879      250129","","126.5","","1539957.65"
"2025-02-03","2025-01-31","SF FuneralF1061782      250131","","31.63","","1539989.28"
"2025-02-03","2025-02-01","SF FuneralFDC00000006FFH250201","","126.5","","1540115.78"
"2025-02-03","2025-02-01","SF FuneralFDC00000007DMS250201","","126.5","","1540242.28"
"2025-02-03","2025-02-01","SF FuneralF1075304      250201","","126.5","","1540368.78"
"2025-02-03","2025-02-01","SF FuneralF1084322      250201","","126.5","","1540495.28"
"2025-02-03","2025-02-01","SF FuneralF1118299      250201","","126.5","","1540621.78"
"2025-02-03","2025-02-03","SF FuneralF1067017      250203","","126.5","","1540748.28"
"2025-02-03","2025-01-24","Rev SF FuneralFDC00000009HWN250128","","-126.5","","1540621.78"
"2025-02-03","2025-01-24","Rev SF FuneralFDC0000000BQQ3250127","","-126.5","","1540495.28"
"2025-02-03","2025-01-24","Rev SF FuneralFDC00000006RWX250128","","-126.5","","1540368.78"
"2025-02-03","2025-01-24","Rev SF FuneralF1078290      250127","","-126.5","","1540242.28"
"2025-02-03","2025-01-24","Rev SF FuneralF800881       250127","","-126.5","","1540115.78"
"2025-02-03","2025-01-24","Rev SF FuneralFDC00000007HWV250128","","-126.5","","1539989.28"
"2025-02-03","2025-01-24","Rev SF FuneralFDC0000000KYQT250128","","-126.5","","1539862.78"
"2025-02-03","2025-01-24","Rev SF FuneralFDC0000000N7NV250124","","-126.5","","1539736.28"
"2025-02-03","2025-01-27","Rev SF FuneralFDC00000003ML6250127","","-220","","1539516.28"
"2025-02-03","2025-01-27","Rev SF FuneralFDC0000000P2ZT250127","","-126.5","","1539389.78"
"2025-02-03","2025-01-28","Rev SF FuneralFDC0000000FQV0250128","","-63.25","","1539326.53"
"2025-02-03","2025-02-01","Rev SF FuneralFDC0000000JF13250201","","-126.5","","1539200.03"
"2025-02-03","2025-02-01","Rev SF FuneralFDC00000006CG1250201","","-126.5","","1539073.53"
"2025-02-03","2025-02-01","Rev SF FuneralFDC0000000NCRN250201","","-63.25","","1539010.28"
"2025-02-03","2024-12-11","Rev SF FuneralF800881       241227","","-126.5","","1538883.78"
"2025-02-03","2024-12-03","Rev SF FuneralFDC0000000NRQK241203","","-31.63","","1538852.15"
"2025-02-03","2024-12-10","Rev SF FuneralFDC0000000NRQK241210","","-31.63","","1538820.52"
"2025-02-03","2024-12-17","Rev SF FuneralFDC0000000NRQK241217","","-31.63","","1538788.89"
"2025-02-03","2025-01-14","Rev SF FuneralFDC0000000NRQK250114","","-31.63","","1538757.26"
"2025-02-03","2025-01-25","Rev SF FuneralFDC0000000N7NT250126","","-31.63","","1538725.63"
"2025-02-03","2025-01-07","Rev SF FuneralFDC0000000NRQK250107","","-31.63","","1538694"
"2025-02-03","2025-01-21","Rev SF FuneralFDC0000000NRQK250121","","-31.63","","1538662.37"
"2025-02-03","2025-01-27","Rev SF FuneralFDC00000005XG9250127","","-31.63","","1538630.74"
"2025-02-03","2025-01-28","Rev SF FuneralFDC0000000NRQK250128","","-31.63","","1538599.11"
"2025-02-03","2025-01-31","Rev SF FuneralFDC00000007MW5250131","","-31.63","","1538567.48"
"2025-02-03","2025-01-31","Rev SF FuneralFDC0000000JXK7250131","","-31.63","","1538535.85"
"2025-02-03","2024-12-23","Rev SF FuneralFDC00000005YRG241222","","-126.5","","1538409.35"
"2025-02-03","2024-12-23","Rev SF FuneralFDC00000007BG2241225","","-126.5","","1538282.85"
"2025-02-03","2025-01-22","Rev SF FuneralFDC0000000874K250122","","-126.5","","1538156.35"
"2025-02-03","2025-01-22","Rev SF FuneralFDC0000000BD9L250122","","-126.5","","1538029.85"
"2025-02-03","2025-01-24","Rev SF FuneralFDC00000007BG2250125","","-126.5","","1537903.35"
"2025-02-03","2025-01-24","Rev SF FuneralFDC0000000605Z250125","","-126.5","","1537776.85"
"2025-02-03","2025-01-24","Rev SF FuneralFDC0000000B3H1250128","","-126.5","","1537650.35"
"2025-02-03","2025-02-03","Fee-Teller Transactions","","-11.91","","1537638.44"
"2025-02-03","2025-02-03","Dep-Cash-SFTAP2023804554","","126.5","11.91","1537764.94"
"2025-02-03","2025-01-24","Rev SF FuneralF1108759      250128","","-126.5","","1537638.44"
"2025-02-03","2025-01-29","SF FuneralF1085281      250129","","126.5","","1537764.94"
"2025-02-03","2025-01-31","SF FuneralF843757       250131","","31.63","","1537796.57"
"2025-02-03","2025-01-31","SF FuneralF1073818      250131","","31.63","","1537828.2"
"2025-02-03","2025-01-31","SF FuneralF1127614      250131","","31.63","","1537859.83"
"2025-02-03","2025-02-01","SF FuneralFDC00000006NLG250201","","126.5","","1537986.33"
"2025-02-03","2025-02-01","SF FuneralF830203       250201","","126.5","","1538112.83"
"2025-02-03","2025-02-01","SF FuneralF1129416      250201","","126.5","","1538239.33"
"2025-02-03","2025-01-30","SF FuneralFDC00000003L0S250130","","220","","1538459.33"
"2025-02-03","2025-01-30","SF FuneralFDC00000003L0T250130","","220","","1538679.33"
"2025-02-03","2025-02-01","SF FuneralF1034024      250201","","126.5","","1538805.83"
"2025-02-03","2025-01-22","Rev SF FuneralFDC00000006323250122","","-126.5","","1538679.33"
"2025-02-03","2025-01-28","SF FuneralFDC00000007FZ5250128","","126.5","","1538805.83"
"2025-02-03","2025-01-31","SF FuneralF988375       250201","","126.5","","1538932.33"
"2025-02-03","2025-02-01","SF FuneralFDC00000005LZ0250201","","126.5","","1539058.83"
"2025-02-03","2025-02-01","SF FuneralFDC00000005LZC250201","","126.5","","1539185.33"
"2025-02-03","2025-02-01","SF FuneralFDC000000077TK250201","","126.5","","1539311.83"
"2025-02-03","2025-02-01","SF FuneralFDC00000007HBC250201","","126.5","","1539438.33"
"2025-02-03","2025-02-01","SF FuneralFDC0000000857G250201","","126.5","","1539564.83"
"2025-02-03","2025-02-01","SF FuneralFDC000000088R5250201","","126.5","","1539691.33"
"2025-02-03","2025-02-01","SF FuneralF820498       250201","","126.5","","1539817.83"
"2025-02-03","2025-02-01","SF FuneralF822293       250201","","126.5","","1539944.33"
"2025-02-03","2025-02-01","SF FuneralF1111974      250201","","126.5","","1540070.83"
"2025-02-03","2025-02-01","SF FuneralF1113234      250201","","126.5","","1540197.33"
"2025-02-03","2025-02-01","SF FuneralF1121943      250201","","126.5","","1540323.83"
"2025-02-03","2025-02-01","SF FuneralF1129127      250201","","126.5","","1540450.33"
"2025-02-03","2025-02-03","SF FuneralFDC00000005LZD250202","","126.5","","1540576.83"
"2025-02-03","2025-02-03","SF FuneralFDC0000000BDNZ250203","","126.5","","1540703.33"
"2025-02-03","2025-01-31","SF FuneralF847452       250131","","31.63","","1540734.96"
"2025-02-03","2025-01-31","SF FuneralF900608       250131","","31.63","","1540766.59"
"2025-02-03","2025-02-03","SF FuneralFDC0000000NL09250203","","31.63","","1540798.22"
"2025-02-03","2025-01-31","Rev SF FuneralFDC0000000KLCD250131","","-31.63","","1540766.59"
"2025-02-03","2025-02-03","Rev SF FuneralFDC0000000KYZ5250203","","-31.63","","1540734.96"
"2025-02-03","2025-01-31","Rev SF FuneralFDC0000000NNGY250131","","-31.63","","1540703.33"
"2025-02-03","2025-01-31","Rev SF FuneralFDC000000069RZ250131","","-31.63","","1540671.7"
"2025-02-03","2025-01-31","Rev SF FuneralFDC0000000B37Y250131","","-31.63","","1540640.07"
"2025-02-03","2025-01-29","Rev SF FuneralFDC00000007DMT250129","","-31.63","","1540608.44"
"2025-02-03","2025-01-31","Rev SF FuneralFDC0000000JFC4250131","","-31.63","","1540576.81"
"2025-02-03","2025-01-31","Rev SF FuneralFDC00000007WBL250131","","-31.63","","1540545.18"
"2025-02-03","2025-01-24","Rev SF FuneralF987910       250127","","-126.5","","1540418.68"
"2025-02-03","2024-12-02","Rev SF FuneralFDC00000007ZCG241201","","-126.5","","1540292.18"
"2025-02-03","2025-01-24","Rev SF FuneralFDC00000006R8B250128","","-126.5","","1540165.68"
"2025-02-03","2025-01-24","Rev SF FuneralFDC000000069J2250127","","-126.5","","1540039.18"
"2025-02-03","2025-01-24","Rev SF FuneralFDC000000069ZD250127","","-126.5","","1539912.68"
"2025-02-03","2025-01-24","Rev SF FuneralFDC0000000JFXT250126","","-126.5","","1539786.18"
"2025-02-03","2025-01-24","Rev SF FuneralFDC0000000LDRG250127","","-126.5","","1539659.68"
"2025-02-03","2025-02-03","Rev SF FuneralFDC00000008JTK250203","","-63.25","","1539596.43"
"2025-02-03","2025-02-01","Rev SF FuneralFDC00000007DMS250201","","-126.5","","1539469.93"
"2025-02-03","2025-02-01","Rev SF FuneralFDC000000087KM250201","","-126.5","","1539343.43"
"2025-02-03","2025-01-24","Rev SF FuneralF1073391      250128","","-126.5","","1539216.93"
"2025-02-03","2024-12-11","Rev SF FuneralF811588       241222","","-126.5","","1539090.43"
"2025-02-03","2024-12-12","Rev SF FuneralFDC0000000KJYJ241212","","-126.5","","1538963.93"
"2025-02-03","2025-01-24","Rev SF FuneralFDC00000007NTY250125","","-126.5","","1538837.43"
"2025-02-03","2025-01-24","Rev SF FuneralF832925       250128","","-126.5","","1538710.93"
"2025-02-03","2025-02-03","Rev SF FuneralFDC00000008JXH250203","","-63.25","","1538647.68"
"2025-02-03","2025-02-03","Rev SF FuneralFDC00000008JYZ250203","","-63.25","","1538584.43"
"2025-02-03","2025-02-03","Rev SF FuneralFDC00000008JTG250203","","-63.25","","1538521.18"
"2025-02-03","2025-01-02","Rev SF FuneralFDC00000007ZCG250101","","-126.5","","1538394.68"
"2025-02-03","2025-01-24","Rev SF FuneralF1084353      250128","","-126.5","","1538268.18"
"2025-02-03","2025-01-02","Rev SF FuneralFDC000000087KM250101","","-126.5","","1538141.68"
"2025-02-03","2025-01-24","Rev SF FuneralFDC0000000P5GR250126","","-126.5","","1538015.18"
"2025-02-03","2025-01-31","SF FuneralF1079321      250131","","63.25","","1538078.43"
"2025-02-03","2025-01-29","SF FuneralF1022070      250129","","126.5","","1538204.93"
"2025-02-03","2025-02-01","SF FuneralF815328       250201","","126.5","","1538331.43"
"2025-02-03","2025-02-03","SF FuneralFDC00000002YP8250203","","55","","1538386.43"
"2025-02-03","2025-02-01","SF FuneralF1130021      250201","","126.5","","1538512.93"
"2025-02-03","2025-01-24","Rev SF FuneralF1055126      250127","","-126.5","","1538386.43"
"2025-02-04","2025-01-28","SF FuneralFDC00000007T5V250128","","126.5","","1538512.93"
"2025-02-04","2025-01-29","SF FuneralFDC000000067PW250129","","126.5","","1538639.43"
"2025-02-04","2025-01-29","SF FuneralFDC000000067YD250129","","126.5","","1538765.93"
"2025-02-04","2025-01-29","SF FuneralFDC00000006HWT250129","","126.5","","1538892.43"
"2025-02-04","2025-01-29","SF FuneralFDC000000073PX250129","","126.5","","1539018.93"
"2025-02-04","2025-01-29","SF FuneralF841583       250129","","126.5","","1539145.43"
"2025-02-04","2025-01-30","SF FuneralFDC00000002TNJ250130","","220","","1539365.43"
"2025-02-04","2025-01-30","SF FuneralFDC000000033F8250130","","220","","1539585.43"
"2025-02-04","2025-01-30","SF FuneralFDC000000078DS250130","","126.5","","1539711.93"
"2025-02-04","2025-01-30","SF FuneralFDC00000007BD0250130","","126.5","","1539838.43"
"2025-02-04","2025-01-30","SF FuneralFDC00000007F9C250130","","126.5","","1539964.93"
"2025-02-04","2025-01-30","SF FuneralFDC0000000HSN2250130","","126.5","","1540091.43"
"2025-02-04","2025-01-30","SF FuneralF1068183      250130","","126.5","","1540217.93"
"2025-02-04","2025-01-30","SF FuneralF1113236      250130","","126.5","","1540344.43"
"2025-02-04","2025-01-30","SF FuneralF1121983      250130","","126.5","","1540470.93"
"2025-02-04","2025-02-01","SF FuneralFDC00000002YTV250201","","220","","1540690.93"
"2025-02-04","2025-02-01","SF FuneralFDC0000000347V250201","","220","","1540910.93"
"2025-02-04","2025-02-01","SF FuneralFDC000000034YS250201","","220","","1541130.93"
"2025-02-04","2025-02-01","SF FuneralFDC00000003L1W250201","","220","","1541350.93"
"2025-02-04","2025-02-01","SF FuneralFDC00000003P3N250201","","220","","1541570.93"
"2025-02-04","2025-02-01","SF FuneralFDC0000000416Z250201","","220","","1541790.93"
"2025-02-04","2025-02-01","SF FuneralFDC00000004MF7250201","","220","","1542010.93"
"2025-02-04","2025-02-01","SF FuneralFDC000000058FQ250201","","126.5","","1542137.43"
"2025-02-04","2025-02-01","SF FuneralFDC000000058T0250201","","220","","1542357.43"
"2025-02-04","2025-02-01","SF FuneralFDC00000005HPT250201","","126.5","","1542483.93"
"2025-02-04","2025-02-01","SF FuneralFDC00000005MKT250201","","126.5","","1542610.43"
"2025-02-04","2025-02-01","SF FuneralFDC00000005QFJ250201","","126.5","","1542736.93"
"2025-02-04","2025-02-01","SF FuneralFDC00000005XZS250201","","126.5","","1542863.43"
"2025-02-04","2025-02-01","SF FuneralFDC000000067M8250201","","126.5","","1542989.93"
"2025-02-04","2025-02-01","SF FuneralFDC000000067X1250201","","126.5","","1543116.43"
"2025-02-04","2025-02-01","SF FuneralFDC0000000689P250201","","126.5","","1543242.93"
"2025-02-04","2025-02-01","SF FuneralFDC000000068D9250201","","126.5","","1543369.43"
"2025-02-04","2025-02-01","SF FuneralFDC00000006974250201","","126.5","","1543495.93"
"2025-02-04","2025-02-01","SF FuneralFDC0000000698C250201","","126.5","","1543622.43"
"2025-02-04","2025-02-01","SF FuneralFDC000000069D1250201","","126.5","","1543748.93"
"2025-02-04","2025-02-01","SF FuneralFDC000000069R5250201","","126.5","","1543875.43"
"2025-02-04","2025-02-01","SF FuneralFDC000000069X4250201","","126.5","","1544001.93"
"2025-02-04","2025-02-01","SF FuneralFDC00000006BBW250201","","126.5","","1544128.43"
"2025-02-04","2025-02-01","SF FuneralFDC00000006BDG250201","","126.5","","1544254.93"
"2025-02-04","2025-02-01","SF FuneralFDC00000006CQ0250201","","126.5","","1544381.43"
"2025-02-04","2025-02-01","SF FuneralFDC00000006D0W250201","","126.5","","1544507.93"
"2025-02-04","2025-02-01","SF FuneralFDC00000006DV6250201","","126.5","","1544634.43"
"2025-02-04","2025-02-01","SF FuneralFDC00000006DZY250201","","126.5","","1544760.93"
"2025-02-04","2025-02-01","SF FuneralFDC00000006GJH250201","","126.5","","1544887.43"
"2025-02-04","2025-02-01","SF FuneralFDC00000006GVG250201","","126.5","","1545013.93"
"2025-02-04","2025-02-01","SF FuneralFDC00000006HSP250201","","126.5","","1545140.43"
"2025-02-04","2025-02-01","SF FuneralFDC00000006L00250201","","126.5","","1545266.93"
"2025-02-04","2025-02-01","SF FuneralFDC00000006L4D250201","","126.5","","1545393.43"
"2025-02-04","2025-02-01","SF FuneralFDC00000006L98250201","","126.5","","1545519.93"
"2025-02-04","2025-02-01","SF FuneralFDC00000006S7B250201","","126.5","","1545646.43"
"2025-02-04","2025-02-01","SF FuneralFDC00000006VCL250201","","126.5","","1545772.93"
"2025-02-04","2025-02-01","SF FuneralFDC00000006WQ9250201","","126.5","","1545899.43"
"2025-02-04","2025-02-01","SF FuneralFDC00000006YGW250201","","126.5","","1546025.93"
"2025-02-04","2025-02-01","SF FuneralFDC00000007181250201","","126.5","","1546152.43"
"2025-02-04","2025-02-01","SF FuneralFDC000000073G2250201","","126.5","","1546278.93"
"2025-02-04","2025-02-01","SF FuneralFDC000000073L2250201","","126.5","","1546405.43"
"2025-02-04","2025-02-01","SF FuneralFDC00000007443250201","","126.5","","1546531.93"
"2025-02-04","2025-02-01","SF FuneralFDC0000000744M250201","","126.5","","1546658.43"
"2025-02-04","2025-02-01","SF FuneralFDC000000074F6250201","","220","","1546878.43"
"2025-02-04","2025-02-01","SF FuneralFDC000000074FC250201","","126.5","","1547004.93"
"2025-02-04","2025-02-01","SF FuneralFDC000000074MY250201","","126.5","","1547131.43"
"2025-02-04","2025-02-01","SF FuneralFDC000000074NS250201","","126.5","","1547257.93"
"2025-02-04","2025-02-01","SF FuneralFDC000000074SJ250201","","126.5","","1547384.43"
"2025-02-04","2025-02-01","SF FuneralFDC000000074T1250201","","126.5","","1547510.93"
"2025-02-04","2025-02-01","SF FuneralFDC000000074TG250201","","126.5","","1547637.43"
"2025-02-04","2025-02-01","SF FuneralFDC000000075C5250201","","126.5","","1547763.93"
"2025-02-04","2025-02-01","SF FuneralFDC000000075G0250201","","126.5","","1547890.43"
"2025-02-04","2025-02-01","SF FuneralFDC00000005SQ8250201","","126.5","","1548016.93"
"2025-02-04","2025-02-01","SF FuneralFDC00000006FWR250201","","126.5","","1548143.43"
"2025-02-04","2025-02-01","SF FuneralFDC000000073TX250201","","126.5","","1548269.93"
"2025-02-04","2025-02-01","SF FuneralFDC000000067SD250201","","126.5","","1548396.43"
"2025-02-04","2025-02-01","SF FuneralFDC00000006GQG250201","","126.5","","1548522.93"
"2025-02-04","2025-02-01","SF FuneralFDC000000075B4250201","","126.5","","1548649.43"
"2025-02-04","2025-02-01","SF FuneralFDC000000075VN250201","","126.5","","1548775.93"
"2025-02-04","2025-02-01","SF FuneralFDC000000076RY250201","","126.5","","1548902.43"
"2025-02-04","2025-02-01","SF FuneralFDC000000078CR250201","","126.5","","1549028.93"
"2025-02-04","2025-02-01","SF FuneralFDC000000079M1250201","","126.5","","1549155.43"
"2025-02-04","2025-02-01","SF FuneralFDC00000007CB9250201","","126.5","","1549281.93"
"2025-02-04","2025-02-01","SF FuneralFDC00000007CND250201","","126.5","","1549408.43"
"2025-02-04","2025-02-01","SF FuneralFDC00000007CSC250201","","126.5","","1549534.93"
"2025-02-04","2025-02-01","SF FuneralFDC00000007KX6250201","","126.5","","1549661.43"
"2025-02-04","2025-02-01","SF FuneralFDC00000007P17250201","","126.5","","1549787.93"
"2025-02-04","2025-02-01","SF FuneralFDC00000007P9K250201","","126.5","","1549914.43"
"2025-02-04","2025-02-01","SF FuneralFDC00000007PL3250201","","126.5","","1550040.93"
"2025-02-04","2025-02-01","SF FuneralFDC00000007PLP250201","","126.5","","1550167.43"
"2025-02-04","2025-02-01","SF FuneralFDC00000007Q7X250201","","126.5","","1550293.93"
"2025-02-04","2025-02-01","SF FuneralFDC00000007QD4250201","","126.5","","1550420.43"
"2025-02-04","2025-02-01","SF FuneralFDC00000007QL4250201","","126.5","","1550546.93"
"2025-02-04","2025-02-01","SF FuneralFDC00000007QTS250201","","126.5","","1550673.43"
"2025-02-04","2025-02-01","SF FuneralFDC00000007R55250201","","126.5","","1550799.93"
"2025-02-04","2025-02-01","SF FuneralF794309       250201","","126.5","","1550926.43"
"2025-02-04","2025-02-01","SF FuneralFDC00000007RXL250201","","126.5","","1551052.93"
"2025-02-04","2025-02-01","SF FuneralFDC00000007SBP250201","","126.5","","1551179.43"
"2025-02-04","2025-02-01","SF FuneralFDC00000007SVN250201","","126.5","","1551305.93"
"2025-02-04","2025-02-01","SF FuneralFDC00000007SYC250201","","126.5","","1551432.43"
"2025-02-04","2025-02-01","SF FuneralF794826       250201","","126.5","","1551558.93"
"2025-02-04","2025-02-01","SF FuneralFDC00000007W7P250201","","126.5","","1551685.43"
"2025-02-04","2025-02-01","SF FuneralFDC00000007WGL250201","","126.5","","1551811.93"
"2025-02-04","2025-02-01","SF FuneralFDC00000007WSX250201","","126.5","","1551938.43"
"2025-02-04","2025-02-01","SF FuneralFDC00000007YYN250201","","126.5","","1552064.93"
"2025-02-04","2025-02-01","SF FuneralFDC00000007Z9K250201","","126.5","","1552191.43"
"2025-02-04","2025-02-01","SF FuneralFDC000000083GT250201","","126.5","","1552317.93"
"2025-02-04","2025-02-01","SF FuneralFDC000000083N8250201","","126.5","","1552444.43"
"2025-02-04","2025-02-01","SF FuneralFDC000000084LK250201","","126.5","","1552570.93"
"2025-02-04","2025-02-01","SF FuneralF798328       250201","","126.5","","1552697.43"
"2025-02-04","2025-02-01","SF FuneralFDC000000085GJ250201","","126.5","","1552823.93"
"2025-02-04","2025-02-01","SF FuneralF798985       250201","","126.5","","1552950.43"
"2025-02-04","2025-02-01","SF FuneralFDC000000086QX250201","","126.5","","1553076.93"
"2025-02-04","2025-02-01","SF FuneralFDC000000089S9250201","","126.5","","1553203.43"
"2025-02-04","2025-02-01","SF FuneralF800965       250201","","126.5","","1553329.93"
"2025-02-04","2025-02-01","SF FuneralF802487       250201","","126.5","","1553456.43"
"2025-02-04","2025-02-01","SF FuneralFDC00000008KTB250201","","126.5","","1553582.93"
"2025-02-04","2025-02-01","SF FuneralFDC00000007QHR250201","","126.5","","1553709.43"
"2025-02-04","2025-02-01","SF FuneralF802669       250201","","126.5","","1553835.93"
"2025-02-04","2025-02-01","SF FuneralF802832       250201","","126.5","","1553962.43"
"2025-02-04","2025-02-01","SF FuneralF802880       250201","","126.5","","1554088.93"
"2025-02-04","2025-02-01","SF FuneralFDC00000008MDC250201","","126.5","","1554215.43"
"2025-02-04","2025-02-01","SF FuneralFDC00000008MJL250201","","126.5","","1554341.93"
"2025-02-04","2025-02-01","SF FuneralFDC00000008MVL250201","","126.5","","1554468.43"
"2025-02-04","2025-02-01","SF FuneralF803623       250201","","126.5","","1554594.93"
"2025-02-04","2025-02-01","SF FuneralFDC00000008NKB250201","","126.5","","1554721.43"
"2025-02-04","2025-02-01","SF FuneralF803900       250201","","126.5","","1554847.93"
"2025-02-04","2025-02-01","SF FuneralFDC00000008RKY250201","","126.5","","1554974.43"
"2025-02-04","2025-02-01","SF FuneralF804964       250201","","126.5","","1555100.93"
"2025-02-04","2025-02-01","SF FuneralF805055       250201","","126.5","","1555227.43"
"2025-02-04","2025-02-01","SF FuneralF808424       250201","","126.5","","1555353.93"
"2025-02-04","2025-02-01","SF FuneralF808459       250201","","126.5","","1555480.43"
"2025-02-04","2025-02-01","SF FuneralF808615       250201","","126.5","","1555606.93"
"2025-02-04","2025-02-01","SF FuneralF808645       250201","","126.5","","1555733.43"
"2025-02-04","2025-02-01","SF FuneralF809629       250201","","126.5","","1555859.93"
"2025-02-04","2025-02-01","SF FuneralF810101       250201","","126.5","","1555986.43"
"2025-02-04","2025-02-01","SF FuneralF810146       250201","","126.5","","1556112.93"
"2025-02-04","2025-02-01","SF FuneralF810226       250201","","126.5","","1556239.43"
"2025-02-04","2025-02-01","SF FuneralF810303       250201","","126.5","","1556365.93"
"2025-02-04","2025-02-01","SF FuneralF812175       250201","","126.5","","1556492.43"
"2025-02-04","2025-02-01","SF FuneralF812447       250201","","126.5","","1556618.93"
"2025-02-04","2025-02-01","SF FuneralF812524       250201","","126.5","","1556745.43"
"2025-02-04","2025-02-01","SF FuneralF812728       250201","","126.5","","1556871.93"
"2025-02-04","2025-02-01","SF FuneralF813553       250201","","126.5","","1556998.43"
"2025-02-04","2025-02-01","SF FuneralF814524       250201","","126.5","","1557124.93"
"2025-02-04","2025-02-01","SF FuneralF814641       250201","","126.5","","1557251.43"
"2025-02-04","2025-02-01","SF FuneralF815355       250201","","126.5","","1557377.93"
"2025-02-04","2025-02-01","SF FuneralF816618       250201","","126.5","","1557504.43"
"2025-02-04","2025-02-01","SF FuneralF816749       250201","","126.5","","1557630.93"
"2025-02-04","2025-02-01","SF FuneralF816757       250201","","126.5","","1557757.43"
"2025-02-04","2025-02-01","SF FuneralF816756       250201","","126.5","","1557883.93"
"2025-02-04","2025-02-01","SF FuneralF816804       250201","","126.5","","1558010.43"
"2025-02-04","2025-02-01","SF FuneralF816966       250201","","126.5","","1558136.93"
"2025-02-04","2025-02-01","SF FuneralF817279       250201","","126.5","","1558263.43"
"2025-02-04","2025-02-01","SF FuneralF817395       250201","","126.5","","1558389.93"
"2025-02-04","2025-02-01","SF FuneralF819834       250201","","126.5","","1558516.43"
"2025-02-04","2025-02-01","SF FuneralF820402       250201","","126.5","","1558642.93"
"2025-02-04","2025-02-01","SF FuneralF821541       250201","","126.5","","1558769.43"
"2025-02-04","2025-02-01","SF FuneralF821597       250201","","126.5","","1558895.93"
"2025-02-04","2025-02-01","SF FuneralF822176       250201","","126.5","","1559022.43"
"2025-02-04","2025-02-01","SF FuneralF822800       250201","","126.5","","1559148.93"
"2025-02-04","2025-02-01","SF FuneralF823058       250201","","126.5","","1559275.43"
"2025-02-04","2025-02-01","SF FuneralF828118       250201","","126.5","","1559401.93"
"2025-02-04","2025-02-01","SF FuneralF828163       250201","","126.5","","1559528.43"
"2025-02-04","2025-02-01","SF FuneralF828171       250201","","126.5","","1559654.93"
"2025-02-04","2025-02-01","SF FuneralF828291       250201","","126.5","","1559781.43"
"2025-02-04","2025-02-01","SF FuneralF828338       250201","","126.5","","1559907.93"
"2025-02-04","2025-02-01","SF FuneralF828776       250201","","126.5","","1560034.43"
"2025-02-04","2025-02-01","SF FuneralF828828       250201","","126.5","","1560160.93"
"2025-02-04","2025-02-01","SF FuneralF828889       250201","","126.5","","1560287.43"
"2025-02-04","2025-02-01","SF FuneralF829115       250201","","126.5","","1560413.93"
"2025-02-04","2025-02-01","SF FuneralFDC0000000BRBR250201","","126.5","","1560540.43"
"2025-02-04","2025-02-01","SF FuneralF829747       250201","","126.5","","1560666.93"
"2025-02-04","2025-02-01","SF FuneralF830935       250201","","126.5","","1560793.43"
"2025-02-04","2025-02-01","SF FuneralF830988       250201","","126.5","","1560919.93"
"2025-02-04","2025-02-01","SF FuneralF831077       250201","","126.5","","1561046.43"
"2025-02-04","2025-02-01","SF FuneralF832034       250201","","126.5","","1561172.93"
"2025-02-04","2025-02-01","SF FuneralFDC0000000CHRP250201","","126.5","","1561299.43"
"2025-02-04","2025-02-01","SF FuneralF832189       250201","","126.5","","1561425.93"
"2025-02-04","2025-02-01","SF FuneralF832249       250201","","126.5","","1561552.43"
"2025-02-04","2025-02-01","SF FuneralF832363       250201","","126.5","","1561678.93"
"2025-02-04","2025-02-01","SF FuneralF832928       250201","","126.5","","1561805.43"
"2025-02-04","2025-02-01","SF FuneralF833105       250201","","126.5","","1561931.93"
"2025-02-04","2025-02-01","SF FuneralFDC0000000CR2C250201","","126.5","","1562058.43"
"2025-02-04","2025-02-01","SF FuneralF833465       250201","","126.5","","1562184.93"
"2025-02-04","2025-02-01","SF FuneralF834877       250201","","126.5","","1562311.43"
"2025-02-04","2025-02-01","SF FuneralF841456       250201","","126.5","","1562437.93"
"2025-02-04","2025-02-01","SF FuneralF841493       250201","","126.5","","1562564.43"
"2025-02-04","2025-02-01","SF FuneralF841549       250201","","126.5","","1562690.93"
"2025-02-04","2025-02-01","SF FuneralF842012       250201","","126.5","","1562817.43"
"2025-02-04","2025-02-01","SF FuneralF842342       250201","","126.5","","1562943.93"
"2025-02-04","2025-02-01","SF FuneralF842371       250201","","126.5","","1563070.43"
"2025-02-04","2025-02-01","SF FuneralF842749       250201","","126.5","","1563196.93"
"2025-02-04","2025-02-01","SF FuneralF992953       250201","","126.5","","1563323.43"
"2025-02-04","2025-02-01","SF FuneralFDC0000000JBJD250201","","126.5","","1563449.93"
"2025-02-04","2025-02-01","SF FuneralF993214       250201","","126.5","","1563576.43"
"2025-02-04","2025-02-01","SF FuneralF993790       250201","","126.5","","1563702.93"
"2025-02-04","2025-02-01","SF FuneralF993901       250201","","126.5","","1563829.43"
"2025-02-04","2025-02-01","SF FuneralF1017466      250201","","126.5","","1563955.93"
"2025-02-04","2025-02-01","SF FuneralF1016909      250201","","126.5","","1564082.43"
"2025-02-04","2025-02-01","SF FuneralFDC0000000JVXT250201","","126.5","","1564208.93"
"2025-02-04","2025-02-01","SF FuneralF1021521      250201","","126.5","","1564335.43"
"2025-02-04","2025-02-01","SF FuneralF1033550      250202","","126.5","","1564461.93"
"2025-02-04","2025-02-01","SF FuneralFDC0000000K8YR250201","","126.5","","1564588.43"
"2025-02-04","2025-02-01","SF FuneralF1059852      250201","","126.5","","1564714.93"
"2025-02-04","2025-02-01","SF FuneralF1060127      250201","","126.5","","1564841.43"
"2025-02-04","2025-02-01","SF FuneralF1066676      250201","","126.5","","1564967.93"
"2025-02-04","2025-02-01","SF FuneralFDC0000000KYPH250201","","126.5","","1565094.43"
"2025-02-04","2025-02-01","SF FuneralFDC0000000KYZH250201","","126.5","","1565220.93"
"2025-02-04","2025-02-01","SF FuneralF1072717      250201","","126.5","","1565347.43"
"2025-02-04","2025-02-01","SF FuneralF1072814      250201","","126.5","","1565473.93"
"2025-02-04","2025-02-01","SF FuneralF1073817      250201","","126.5","","1565600.43"
"2025-02-04","2025-02-01","SF FuneralF1074980      250201","","126.5","","1565726.93"
"2025-02-04","2025-02-01","SF FuneralF1075151      250201","","126.5","","1565853.43"
"2025-02-04","2025-02-01","SF FuneralF1078071      250201","","126.5","","1565979.93"
"2025-02-04","2025-02-01","SF FuneralF1078320      250201","","126.5","","1566106.43"
"2025-02-04","2025-02-01","SF FuneralF1078329      250201","","126.5","","1566232.93"
"2025-02-04","2025-02-01","SF FuneralF1078538      250201","","126.5","","1566359.43"
"2025-02-04","2025-02-01","SF FuneralF1078642      250201","","126.5","","1566485.93"
"2025-02-04","2025-02-01","SF FuneralFDC0000000LHDF250201","","126.5","","1566612.43"
"2025-02-04","2025-02-01","SF FuneralF1078897      250201","","126.5","","1566738.93"
"2025-02-04","2025-02-01","SF FuneralFDC0000000LHYW250201","","126.5","","1566865.43"
"2025-02-04","2025-02-01","SF FuneralFDC0000000LHZ2250201","","126.5","","1566991.93"
"2025-02-04","2025-02-01","SF FuneralF1079811      250201","","126.5","","1567118.43"
"2025-02-04","2025-02-01","SF FuneralF1080348      250201","","126.5","","1567244.93"
"2025-02-04","2025-02-01","SF FuneralF1080359      250201","","126.5","","1567371.43"
"2025-02-04","2025-02-01","SF FuneralF1084005      250201","","126.5","","1567497.93"
"2025-02-04","2025-02-01","SF FuneralFDC0000000LVS2250201","","126.5","","1567624.43"
"2025-02-04","2025-02-01","SF FuneralF1084557      250201","","126.5","","1567750.93"
"2025-02-04","2025-02-01","SF FuneralF1084617      250201","","126.5","","1567877.43"
"2025-02-04","2025-02-01","SF FuneralF1085078      250201","","126.5","","1568003.93"
"2025-02-04","2025-02-01","SF FuneralF1085197      250201","","126.5","","1568130.43"
"2025-02-04","2025-02-01","SF FuneralF1103773      250201","","126.5","","1568256.93"
"2025-02-04","2025-02-01","SF FuneralF1104084      250201","","126.5","","1568383.43"
"2025-02-04","2025-02-01","SF FuneralF1104097      250201","","126.5","","1568509.93"
"2025-02-04","2025-02-01","SF FuneralF1108756      250201","","126.5","","1568636.43"
"2025-02-04","2025-02-01","SF FuneralF1108769      250201","","126.5","","1568762.93"
"2025-02-04","2025-02-01","SF FuneralF1108776      250201","","126.5","","1568889.43"
"2025-02-04","2025-02-01","SF FuneralF1108836      250201","","126.5","","1569015.93"
"2025-02-04","2025-02-01","SF FuneralF1108901      250201","","126.5","","1569142.43"
"2025-02-04","2025-02-01","SF FuneralF1108917      250201","","126.5","","1569268.93"
"2025-02-04","2025-02-01","SF FuneralF1108962      250201","","126.5","","1569395.43"
"2025-02-04","2025-02-01","SF FuneralF1109016      250201","","126.5","","1569521.93"
"2025-02-04","2025-02-01","SF FuneralF1109047      250201","","126.5","","1569648.43"
"2025-02-04","2025-02-01","SF FuneralF1109619      250201","","126.5","","1569774.93"
"2025-02-04","2025-02-01","SF FuneralF1110383      250201","","126.5","","1569901.43"
"2025-02-04","2025-02-01","SF FuneralFDC0000000MN6J250201","","126.5","","1570027.93"
"2025-02-04","2025-02-01","SF FuneralF1110416      250201","","126.5","","1570154.43"
"2025-02-04","2025-02-01","SF FuneralF1110422      250201","","126.5","","1570280.93"
"2025-02-04","2025-02-01","SF FuneralF1110715      250201","","126.5","","1570407.43"
"2025-02-04","2025-02-01","SF FuneralF1111340      250201","","126.5","","1570533.93"
"2025-02-04","2025-02-01","SF FuneralF1111497      250201","","126.5","","1570660.43"
"2025-02-04","2025-02-01","SF FuneralF1021271      250201","","126.5","","1570786.93"
"2025-02-04","2025-02-01","SF FuneralF1113154      250201","","126.5","","1570913.43"
"2025-02-04","2025-02-01","SF FuneralF1113218      250201","","126.5","","1571039.93"
"2025-02-04","2025-02-01","SF FuneralF1113846      250201","","126.5","","1571166.43"
"2025-02-04","2025-02-01","SF FuneralF1114230      250201","","126.5","","1571292.93"
"2025-02-04","2025-02-01","SF FuneralF1114428      250201","","126.5","","1571419.43"
"2025-02-04","2025-02-01","SF FuneralFDC0000000N97F250201","","191.5","","1571610.93"
"2025-02-04","2025-02-01","SF FuneralF1116987      250201","","126.5","","1571737.43"
"2025-02-04","2025-02-01","SF FuneralF1117129      250201","","126.5","","1571863.93"
"2025-02-04","2025-02-01","SF FuneralF1117867      250202","","126.5","","1571990.43"
"2025-02-04","2025-02-01","SF FuneralF1117926      250201","","126.5","","1572116.93"
"2025-02-04","2025-02-01","SF FuneralF1118045      250201","","126.5","","1572243.43"
"2025-02-04","2025-02-01","SF FuneralF1118360      250201","","126.5","","1572369.93"
"2025-02-04","2025-02-01","SF FuneralF1119882      250201","","126.5","","1572496.43"
"2025-02-04","2025-02-01","SF FuneralF1120806      250201","","126.5","","1572622.93"
"2025-02-04","2025-02-01","SF FuneralF1121975      250201","","126.5","","1572749.43"
"2025-02-04","2025-02-01","SF FuneralF1122666      250201","","126.5","","1572875.93"
"2025-02-04","2025-02-01","SF FuneralFDC0000000P1KP250201","","126.5","","1573002.43"
"2025-02-04","2025-02-01","SF FuneralF1122949      250201","","126.5","","1573128.93"
"2025-02-04","2025-02-01","SF FuneralF1122956      250201","","126.5","","1573255.43"
"2025-02-04","2025-02-01","SF FuneralF1122960      250201","","126.5","","1573381.93"
"2025-02-04","2025-02-01","SF FuneralFDC0000000P38T250201","","126.5","","1573508.43"
"2025-02-04","2025-02-01","SF FuneralFDC0000000P38Z250201","","126.5","","1573634.93"
"2025-02-04","2025-02-01","SF FuneralFDC0000000P658250201","","126.5","","1573761.43"
"2025-02-04","2025-02-01","SF FuneralFDC0000000P6LN250201","","126.5","","1573887.93"
"2025-02-04","2025-02-01","SF FuneralF1124370      250201","","126.5","","1574014.43"
"2025-02-04","2025-02-01","SF FuneralFDC0000000PBRD250201","","126.5","","1574140.93"
"2025-02-04","2025-02-01","SF FuneralF1125277      250201","","126.5","","1574267.43"
"2025-02-04","2025-02-01","SF FuneralFDC0000000PJR5250201","","126.5","","1574393.93"
"2025-02-04","2025-02-01","SF FuneralF1125985      250201","","126.5","","1574520.43"
"2025-02-04","2025-02-01","SF FuneralF1126112      250201","","126.5","","1574646.93"
"2025-02-04","2025-02-01","SF FuneralF1126124      250201","","126.5","","1574773.43"
"2025-02-04","2025-02-01","SF FuneralF1126228      250201","","126.5","","1574899.93"
"2025-02-04","2025-02-01","SF FuneralF1126917      250201","","126.5","","1575026.43"
"2025-02-04","2025-02-01","SF FuneralF1127908      250201","","126.5","","1575152.93"
"2025-02-04","2025-02-01","SF FuneralF1127927      250201","","126.5","","1575279.43"
"2025-02-04","2025-02-01","SF FuneralFDC0000000PTD1250201","","126.5","","1575405.93"
"2025-02-04","2025-02-01","SF FuneralFDC0000000PTFK250201","","126.5","","1575532.43"
"2025-02-04","2025-02-01","SF FuneralF1125773      250201","","191.5","","1575723.93"
"2025-02-04","2025-02-01","SF FuneralF1128800      250201","","126.5","","1575850.43"
"2025-02-04","2025-02-01","SF FuneralF1128928      250201","","126.5","","1575976.93"
"2025-02-04","2025-02-01","SF FuneralF1129059      250201","","126.5","","1576103.43"
"2025-02-04","2025-02-01","SF FuneralF1129211      250201","","126.5","","1576229.93"
"2025-02-04","2025-01-27","SF FuneralFDC00000007PLM250127","","126.5","","1576356.43"
"2025-02-04","2025-01-31","SF FuneralFDC00000005VPZ250131","","31.63","","1576388.06"
"2025-02-04","2025-01-31","SF FuneralFDC00000006B65250131","","126.5","","1576514.56"
"2025-02-04","2025-01-31","SF FuneralFDC00000007494250131","","126.5","","1576641.06"
"2025-02-04","2025-01-31","SF FuneralFDC00000007WM7250131","","126.5","","1576767.56"
"2025-02-04","2025-01-31","SF FuneralF901407       250201","","126.5","","1576894.06"
"2025-02-04","2025-01-31","SF FuneralF981295       250201","","126.5","","1577020.56"
"2025-02-04","2025-01-31","SF FuneralFDC0000000HCT7250201","","126.5","","1577147.06"
"2025-02-04","2025-01-31","SF FuneralF981643       250201","","126.5","","1577273.56"
"2025-02-04","2025-01-31","SF FuneralF981813       250201","","126.5","","1577400.06"
"2025-02-04","2025-01-31","SF FuneralF987112       250201","","126.5","","1577526.56"
"2025-02-04","2025-01-31","SF FuneralF987553       250201","","126.5","","1577653.06"
"2025-02-04","2025-01-31","SF FuneralFDC0000000HTZW250201","","126.5","","1577779.56"
"2025-02-04","2025-01-31","SF FuneralFDC0000000HX7W250131","","31.63","","1577811.19"
"2025-02-04","2025-01-31","SF FuneralF988772       250201","","126.5","","1577937.69"
"2025-02-04","2025-01-31","SF FuneralF988960       250201","","126.5","","1578064.19"
"2025-02-04","2025-01-31","SF FuneralF989475       250201","","126.5","","1578190.69"
"2025-02-04","2025-01-31","SF FuneralF989578       250201","","126.5","","1578317.19"
"2025-02-04","2025-01-31","SF FuneralFDC0000000J0YB250201","","126.5","","1578443.69"
"2025-02-04","2025-01-31","SF FuneralF990670       250201","","126.5","","1578570.19"
"2025-02-04","2025-01-31","SF FuneralF1108953      250131","","126.5","","1578696.69"
"2025-02-04","2025-01-31","SF FuneralF1125492      250131","","31.63","","1578728.32"
"2025-02-04","2025-02-03","SF FuneralFDC00000005Z06250203","","31.63","","1578759.95"
"2025-02-04","2025-02-03","SF FuneralFDC00000005Z12250203","","31.63","","1578791.58"
"2025-02-04","2025-02-03","SF FuneralFDC00000005Z25250203","","31.63","","1578823.21"
"2025-02-04","2025-02-03","SF FuneralFDC000000075VG250202","","126.5","","1578949.71"
"2025-02-04","2025-02-03","SF FuneralFDC00000008KVS250202","","126.5","","1579076.21"
"2025-02-04","2025-02-03","SF FuneralFDC00000008KX0250203","","31.63","","1579107.84"
"2025-02-04","2025-02-03","SF FuneralF808790       250203","","126.5","","1579234.34"
"2025-02-04","2025-02-03","SF FuneralFDC00000009DX3250202","","31.63","","1579265.97"
"2025-02-04","2025-02-03","SF FuneralF812437       250202","","126.5","","1579392.47"
"2025-02-04","2025-02-03","SF FuneralF814011       250202","","126.5","","1579518.97"
"2025-02-04","2025-02-03","SF FuneralF814445       250203","","126.5","","1579645.47"
"2025-02-04","2025-02-03","SF FuneralF843748       250201","","126.5","","1579771.97"
"2025-02-04","2025-02-03","SF FuneralFDC0000000FQ1L250201","","126.5","","1579898.47"
"2025-02-04","2025-02-03","SF FuneralF993010       250203","","126.5","","1580024.97"
"2025-02-04","2025-02-03","SF FuneralF1124382      250203","","126.5","","1580151.47"
"2025-02-04","2025-02-03","SF FuneralF1126036      250203","","126.5","","1580277.97"
"2025-02-04","2025-01-29","SF FuneralF1118596      250129","","126.5","","1580404.47"
"2025-02-04","2025-01-30","SF FuneralF1021113      250130","","126.5","","1580530.97"
"2025-02-04","2025-01-30","SF FuneralF1061063      250130","","191.5","","1580722.47"
"2025-02-04","2025-01-30","SF FuneralFDC0000000L27Z250130","","191.5","","1580913.97"
"2025-02-04","2025-01-31","SF FuneralF819116       250131","","63.25","","1580977.22"
"2025-02-04","2025-01-31","SF FuneralF980818       250201","","126.5","","1581103.72"
"2025-02-04","2025-01-31","SF FuneralF988528       250201","","126.5","","1581230.22"
"2025-02-04","2025-01-31","SF FuneralFDC0000000PKNL250131","","126.5","","1581356.72"
"2025-02-04","2025-01-31","SF FuneralF1126195      250131","","126.5","","1581483.22"
"2025-02-04","2025-02-01","SF FuneralFDC000000069Z1250201","","126.5","","1581609.72"
"2025-02-04","2025-02-01","SF FuneralFDC00000006JN0250201","","126.5","","1581736.22"
"2025-02-04","2025-02-01","SF FuneralFDC00000006LTK250201","","63.25","","1581799.47"
"2025-02-04","2025-02-01","SF FuneralFDC000000073TJ250201","","126.5","","1581925.97"
"2025-02-04","2025-02-01","SF FuneralF802585       250201","","126.5","","1582052.47"
"2025-02-04","2025-02-01","SF FuneralF813588       250201","","126.5","","1582178.97"
"2025-02-04","2025-02-01","SF FuneralF992293       250201","","126.5","","1582305.47"
"2025-02-04","2025-02-03","SF FuneralF900821       250201","","126.5","","1582431.97"
"2025-02-04","2025-02-03","SF FuneralF1102870      250203","","63.25","","1582495.22"
"2025-02-04","2025-02-03","SF FuneralFDC0000000NQ7P250203","","126.5","","1582621.72"
"2025-02-04","2025-01-31","SF FuneralF1054780      250131","","31.63","","1582653.35"
"2025-02-04","2025-02-01","SF FuneralF1054925      250202","","31.63","","1582684.98"
"2025-02-04","2025-02-01","SF FuneralFDC0000000LVKL250201","","126.5","","1582811.48"
"2025-02-04","2025-02-03","SF FuneralFDC00000005RZQ250203","","31.63","","1582843.11"
"2025-02-04","2025-02-03","SF FuneralF815135       250203","","31.63","","1582874.74"
"2025-02-04","2025-02-03","SF FuneralF1103857      250203","","31.63","","1582906.37"
"2025-02-04","2025-02-01","SF FuneralF802647       250201","","126.5","","1583032.87"
"2025-02-04","2025-02-01","SF FuneralF812722       250201","","126.5","","1583159.37"
"2025-02-04","2025-02-01","SF FuneralF1021991      250201","","126.5","","1583285.87"
"2025-02-04","2025-02-01","SF FuneralF1124112      250201","","126.5","","1583412.37"
"2025-02-04","2025-02-03","SF FuneralFDC00000006VB5250202","","126.5","","1583538.87"
"2025-02-04","2025-01-29","SF FuneralF980918       250129","","126.5","","1583665.37"
"2025-02-04","2025-01-30","SF FuneralF803166       250130","","126.5","","1583791.87"
"2025-02-04","2025-01-30","SF FuneralF1078703      250130","","126.5","","1583918.37"
"2025-02-04","2025-01-30","SF FuneralFDC0000000N59F250130","","126.5","","1584044.87"
"2025-02-04","2025-02-03","SF FuneralFDC0000000F7T2250203","","31.63","","1584076.5"
"2025-02-04","2025-01-28","SF FuneralF1016839      250128","","31.63","","1584108.13"
"2025-02-04","2025-02-01","SF FuneralFDC0000000PLYK250201","","126.5","","1584234.63"
"2025-02-04","2025-02-01","SF FuneralFDC0000000PLYM250201","","126.5","","1584361.13"
"2025-02-04","2025-01-27","SF FuneralFDC00000007PP4250127","","126.5","","1584487.63"
"2025-02-04","2025-01-27","SF FuneralFDC00000007PSB250127","","126.5","","1584614.13"
"2025-02-04","2025-01-27","SF FuneralFDC00000007PZH250127","","126.5","","1584740.63"
"2025-02-04","2025-01-27","SF FuneralFDC00000007QL3250127","","126.5","","1584867.13"
"2025-02-04","2025-01-27","SF FuneralFDC00000007R6C250127","","126.5","","1584993.63"
"2025-02-04","2025-01-27","SF FuneralFDC00000007RT2250127","","126.5","","1585120.13"
"2025-02-04","2025-01-27","SF FuneralF1084581      250127","","126.5","","1585246.63"
"2025-02-04","2025-01-28","SF FuneralFDC00000002W68250128","","220","","1585466.63"
"2025-02-04","2025-01-28","SF FuneralFDC000000032W4250128","","220","","1585686.63"
"2025-02-04","2025-01-28","SF FuneralFDC00000003K14250128","","220","","1585906.63"
"2025-02-04","2025-01-28","SF FuneralFDC0000000589Y250128","","126.5","","1586033.13"
"2025-02-04","2025-01-28","SF FuneralFDC00000005HZM250128","","126.5","","1586159.63"
"2025-02-04","2025-01-28","SF FuneralFDC00000005KLV250128","","126.5","","1586286.13"
"2025-02-04","2025-01-28","SF FuneralFDC00000005N42250128","","126.5","","1586412.63"
"2025-02-04","2025-01-28","SF FuneralFDC00000005NWF250128","","126.5","","1586539.13"
"2025-02-04","2025-01-28","SF FuneralFDC00000005NXS250128","","126.5","","1586665.63"
"2025-02-04","2025-01-28","SF FuneralFDC00000005S1V250128","","126.5","","1586792.13"
"2025-02-04","2025-01-28","SF FuneralFDC00000005SXC250128","","126.5","","1586918.63"
"2025-02-04","2025-01-28","SF FuneralFDC00000005VYD250128","","126.5","","1587045.13"
"2025-02-04","2025-01-28","SF FuneralFDC00000005VZK250128","","126.5","","1587171.63"
"2025-02-04","2025-01-28","SF FuneralFDC00000005VZM250128","","126.5","","1587298.13"
"2025-02-04","2025-01-28","SF FuneralFDC00000005WVZ250128","","220","","1587518.13"
"2025-02-04","2025-01-28","SF FuneralFDC00000005X6X250128","","220","","1587738.13"
"2025-02-04","2025-01-28","SF FuneralFDC00000006Y5W250128","","126.5","","1587864.63"
"2025-02-04","2025-01-28","SF FuneralFDC00000007C4H250128","","126.5","","1587991.13"
"2025-02-04","2025-01-28","SF FuneralFDC00000007P1L250128","","126.5","","1588117.63"
"2025-02-04","2025-01-28","SF FuneralFDC00000007PTG250128","","126.5","","1588244.13"
"2025-02-04","2025-01-28","SF FuneralF1118832      250128","","126.5","","1588370.63"
"2025-02-04","2025-01-29","SF FuneralFDC00000002VVZ250129","","220","","1588590.63"
"2025-02-04","2025-01-29","SF FuneralFDC00000002VW3250129","","220","","1588810.63"
"2025-02-04","2025-01-29","SF FuneralFDC000000030LY250129","","220","","1589030.63"
"2025-02-04","2025-01-29","SF FuneralFDC000000033W4250129","","220","","1589250.63"
"2025-02-04","2025-01-29","SF FuneralFDC000000040N9250129","","220","","1589470.63"
"2025-02-04","2025-01-29","SF FuneralFDC0000000418B250129","","220","","1589690.63"
"2025-02-04","2025-01-29","SF FuneralFDC0000000419R250129","","220","","1589910.63"
"2025-02-04","2025-01-29","SF FuneralFDC000000043KR250129","","220","","1590130.63"
"2025-02-04","2025-01-29","SF FuneralFDC000000043L7250129","","220","","1590350.63"
"2025-02-04","2025-01-29","SF FuneralFDC000000043LG250129","","220","","1590570.63"
"2025-02-04","2025-01-29","SF FuneralFDC000000043LL250129","","220","","1590790.63"
"2025-02-04","2025-01-29","SF FuneralFDC0000000493M250129","","220","","1591010.63"
"2025-02-04","2025-01-29","SF FuneralFDC000000049DM250129","","220","","1591230.63"
"2025-02-04","2025-01-29","SF FuneralFDC00000004GQD250129","","220","","1591450.63"
"2025-02-04","2025-01-29","SF FuneralFDC00000004ZXF250129","","126.5","","1591577.13"
"2025-02-04","2025-01-29","SF FuneralFDC000000056Q3250129","","126.5","","1591703.63"
"2025-02-04","2025-01-29","SF FuneralFDC00000005N0R250129","","126.5","","1591830.13"
"2025-02-04","2025-01-29","SF FuneralFDC00000006853250129","","126.5","","1591956.63"
"2025-02-04","2025-01-29","SF FuneralFDC000000068GY250129","","126.5","","1592083.13"
"2025-02-04","2025-01-29","SF FuneralFDC000000069HJ250129","","126.5","","1592209.63"
"2025-02-04","2025-01-29","SF FuneralFDC000000069Q2250129","","126.5","","1592336.13"
"2025-02-04","2025-01-29","SF FuneralFDC00000006DW7250129","","126.5","","1592462.63"
"2025-02-04","2025-01-29","SF FuneralFDC00000006GLP250129","","126.5","","1592589.13"
"2025-02-04","2025-01-29","SF FuneralFDC00000006GMR250129","","126.5","","1592715.63"
"2025-02-04","2025-01-29","SF FuneralFDC00000006K7P250129","","126.5","","1592842.13"
"2025-02-04","2025-01-29","SF FuneralFDC00000006PKB250129","","126.5","","1592968.63"
"2025-02-04","2025-01-29","SF FuneralFDC00000006QY3250129","","126.5","","1593095.13"
"2025-02-04","2025-01-29","SF FuneralFDC0000000754C250129","","126.5","","1593221.63"
"2025-02-04","2025-01-29","SF FuneralFDC000000075VC250129","","126.5","","1593348.13"
"2025-02-04","2025-01-29","SF FuneralFDC000000078XR250129","","220","","1593568.13"
"2025-02-04","2025-01-29","SF FuneralFDC00000007B0G250129","","126.5","","1593694.63"
"2025-02-04","2025-01-29","SF FuneralFDC00000007FDL250129","","126.5","","1593821.13"
"2025-02-04","2025-01-29","SF FuneralFDC000000083JP250129","","126.5","","1593947.63"
"2025-02-04","2025-01-29","SF FuneralF1052293      250129","","126.5","","1594074.13"
"2025-02-04","2025-01-30","SF FuneralFDC000000032T3250130","","220","","1594294.13"
"2025-02-04","2025-01-30","SF FuneralFDC000000033F1250130","","220","","1594514.13"
"2025-02-04","2025-01-30","SF FuneralFDC000000033X5250130","","220","","1594734.13"
"2025-02-04","2025-01-30","SF FuneralFDC000000034B7250130","","220","","1594954.13"
"2025-02-04","2025-01-30","SF FuneralFDC000000034B8250130","","220","","1595174.13"
"2025-02-04","2025-01-30","SF FuneralFDC000000034BB250130","","220","","1595394.13"
"2025-02-04","2025-01-30","SF FuneralFDC000000035SY250130","","220","","1595614.13"
"2025-02-04","2025-01-30","SF FuneralFDC00000003VPK250130","","220","","1595834.13"
"2025-02-04","2025-01-30","SF FuneralFDC00000003VQ7250130","","220","","1596054.13"
"2025-02-04","2025-01-30","SF FuneralFDC000000042C3250130","","220","","1596274.13"
"2025-02-04","2025-01-30","SF FuneralFDC000000063BY250130","","126.5","","1596400.63"
"2025-02-04","2025-01-30","SF FuneralFDC000000069HV250130","","126.5","","1596527.13"
"2025-02-04","2025-01-30","SF FuneralFDC00000006DQX250130","","126.5","","1596653.63"
"2025-02-04","2025-01-30","SF FuneralFDC00000006XT5250130","","220","","1596873.63"
"2025-02-04","2025-01-30","SF FuneralFDC00000009K4V250130","","126.5","","1597000.13"
"2025-02-04","2025-01-30","SF FuneralFDC0000000H8TQ250130","","126.5","","1597126.63"
"2025-02-04","2025-01-31","SF FuneralFDC000000034C1250131","","220","","1597346.63"
"2025-02-04","2025-01-31","SF FuneralFDC00000003B9R250131","","220","","1597566.63"
"2025-02-04","2025-01-31","SF FuneralFDC00000003CYL250131","","220","","1597786.63"
"2025-02-04","2025-01-31","SF FuneralFDC00000004YL3250131","","220","","1598006.63"
"2025-02-04","2025-01-31","SF FuneralFDC00000004YL6250131","","220","","1598226.63"
"2025-02-04","2025-01-31","SF FuneralFDC00000005Z53250131","","126.5","","1598353.13"
"2025-02-04","2025-01-31","SF FuneralFDC000000068T2250131","","126.5","","1598479.63"
"2025-02-04","2025-01-31","SF FuneralFDC00000006F07250131","","126.5","","1598606.13"
"2025-02-04","2025-01-31","SF FuneralFDC0000000736Z250131","","126.5","","1598732.63"
"2025-02-04","2025-01-31","SF FuneralFDC000000073JC250131","","126.5","","1598859.13"
"2025-02-04","2025-01-31","SF FuneralFDC000000073L4250131","","126.5","","1598985.63"
"2025-02-04","2025-01-31","SF FuneralFDC000000075MQ250131","","126.5","","1599112.13"
"2025-02-04","2025-01-31","SF FuneralFDC000000075XF250131","","220","","1599332.13"
"2025-02-04","2025-01-31","SF FuneralFDC00000008YNH250131","","213.31","","1599545.44"
"2025-02-04","2025-01-31","SF FuneralF781147       250131","","126.5","","1599671.94"
"2025-02-04","2025-01-31","SF FuneralFDC000000092TS250131","","126.5","","1599798.44"
"2025-02-04","2025-01-31","SF FuneralFDC0000000CH05250131","","126.5","","1599924.94"
"2025-02-04","2025-01-31","SF FuneralFDC0000000HKGV250201","","126.5","","1600051.44"
"2025-02-04","2025-01-31","SF FuneralF986769       250201","","126.5","","1600177.94"
"2025-02-04","2025-01-31","SF FuneralF987237       250201","","126.5","","1600304.44"
"2025-02-04","2025-01-31","SF FuneralF987560       250201","","126.5","","1600430.94"
"2025-02-04","2025-01-31","SF FuneralF987678       250201","","126.5","","1600557.44"
"2025-02-04","2025-01-31","SF FuneralF987844       250201","","126.5","","1600683.94"
"2025-02-04","2025-01-31","SF FuneralFDC0000000HVF5250201","","126.5","","1600810.44"
"2025-02-04","2025-01-31","SF FuneralF988158       250201","","126.5","","1600936.94"
"2025-02-04","2025-01-31","SF FuneralF988571       250201","","126.5","","1601063.44"
"2025-02-04","2025-01-31","SF FuneralF988920       250201","","126.5","","1601189.94"
"2025-02-04","2025-01-31","SF FuneralFDC0000000KS8Y250131","","126.5","","1601316.44"
"2025-02-04","2025-01-31","SF FuneralF1084367      250131","","126.5","","1601442.94"
"2025-02-04","2025-01-31","SF FuneralF1108757      250131","","126.5","","1601569.44"
"2025-02-04","2025-01-31","SF FuneralF1127898      250131","","126.5","","1601695.94"
"2025-02-04","2025-02-01","SF FuneralFDC00000002MBX250201","","220","","1601915.94"
"2025-02-04","2025-02-01","SF FuneralFDC00000002PXQ250201","","220","","1602135.94"
"2025-02-04","2025-02-01","SF FuneralFDC00000002QYZ250201","","220","","1602355.94"
"2025-02-04","2025-02-01","SF FuneralFDC00000002R7Y250201","","220","","1602575.94"
"2025-02-04","2025-02-01","SF FuneralFDC00000002RNB250201","","220","","1602795.94"
"2025-02-04","2025-02-01","SF FuneralFDC00000002SMF250201","","220","","1603015.94"
"2025-02-04","2025-02-01","SF FuneralFDC00000002SMG250201","","220","","1603235.94"
"2025-02-04","2025-02-01","SF FuneralFDC00000002TC5250201","","220","","1603455.94"
"2025-02-04","2025-02-01","SF FuneralFDC00000002TN6250201","","220","","1603675.94"
"2025-02-04","2025-02-01","SF FuneralFDC00000002TP2250201","","220.2","","1603896.14"
"2025-02-04","2025-02-01","SF FuneralFDC00000002TPH250201","","220","","1604116.14"
"2025-02-04","2025-02-01","SF FuneralFDC00000002TPK250201","","220","","1604336.14"
"2025-02-04","2025-02-01","SF FuneralFDC00000002TQ2250201","","220","","1604556.14"
"2025-02-04","2025-02-01","SF FuneralFDC00000002TR6250201","","220","","1604776.14"
"2025-02-04","2025-02-01","SF FuneralFDC00000002TVC250201","","220","","1604996.14"
"2025-02-04","2025-02-01","SF FuneralFDC00000002TW3250201","","220","","1605216.14"
"2025-02-04","2025-02-01","SF FuneralFDC00000002V0T250201","","220","","1605436.14"
"2025-02-04","2025-02-01","SF FuneralFDC00000002V19250201","","220","","1605656.14"
"2025-02-04","2025-02-01","SF FuneralFDC00000002V57250201","","220","","1605876.14"
"2025-02-04","2025-02-01","SF FuneralFDC00000002V5L250201","","220","","1606096.14"
"2025-02-04","2025-02-01","SF FuneralFDC00000002VR9250201","","220","","1606316.14"
"2025-02-04","2025-02-01","SF FuneralFDC00000002VWT250201","","220","","1606536.14"
"2025-02-04","2025-02-01","SF FuneralFDC00000002VWV250201","","220","","1606756.14"
"2025-02-04","2025-02-01","SF FuneralFDC00000002VWW250201","","220","","1606976.14"
"2025-02-04","2025-02-01","SF FuneralFDC00000002VZV250201","","220","","1607196.14"
"2025-02-04","2025-02-01","SF FuneralFDC00000002XBC250201","","220","","1607416.14"
"2025-02-04","2025-02-01","SF FuneralFDC00000002XMK250201","","220","","1607636.14"
"2025-02-04","2025-02-01","SF FuneralFDC00000002XNJ250201","","220","","1607856.14"
"2025-02-04","2025-02-01","SF FuneralFDC00000002XVQ250201","","220","","1608076.14"
"2025-02-04","2025-02-01","SF FuneralFDC00000002XY5250201","","220","","1608296.14"
"2025-02-04","2025-02-01","SF FuneralFDC00000002YHV250201","","220","","1608516.14"
"2025-02-04","2025-02-01","SF FuneralFDC00000002YP4250201","","220","","1608736.14"
"2025-02-04","2025-02-01","SF FuneralFDC00000002YQL250201","","220","","1608956.14"
"2025-02-04","2025-02-01","SF FuneralFDC00000002YVB250201","","220","","1609176.14"
"2025-02-04","2025-02-01","SF FuneralFDC00000002YYK250201","","220","","1609396.14"
"2025-02-04","2025-02-01","SF FuneralFDC00000002YZP250201","","220","","1609616.14"
"2025-02-04","2025-02-01","SF FuneralFDC00000002Z64250201","","220","","1609836.14"
"2025-02-04","2025-02-01","SF FuneralFDC00000002ZLK250201","","220","","1610056.14"
"2025-02-04","2025-02-01","SF FuneralFDC00000003099250201","","220","","1610276.14"
"2025-02-04","2025-02-01","SF FuneralFDC000000030GX250201","","220","","1610496.14"
"2025-02-04","2025-02-01","SF FuneralFDC000000032WZ250201","","220","","1610716.14"
"2025-02-04","2025-02-01","SF FuneralFDC000000032X1250201","","220","","1610936.14"
"2025-02-04","2025-02-01","SF FuneralFDC000000032XP250201","","220","","1611156.14"
"2025-02-04","2025-02-01","SF FuneralFDC000000032YZ250201","","220","","1611376.14"
"2025-02-04","2025-02-01","SF FuneralFDC0000000330H250201","","220","","1611596.14"
"2025-02-04","2025-02-01","SF FuneralFDC00000003315250201","","220","","1611816.14"
"2025-02-04","2025-02-01","SF FuneralFDC0000000335M250201","","220","","1612036.14"
"2025-02-04","2025-02-01","SF FuneralFDC0000000335P250201","","220","","1612256.14"
"2025-02-04","2025-02-01","SF FuneralFDC000000033P8250201","","220","","1612476.14"
"2025-02-04","2025-02-01","SF FuneralFDC000000033YY250201","","220","","1612696.14"
"2025-02-04","2025-02-01","SF FuneralFDC000000033ZH250201","","220","","1612916.14"
"2025-02-04","2025-02-01","SF FuneralFDC00000003452250201","","220","","1613136.14"
"2025-02-04","2025-02-01","SF FuneralFDC0000000347Q250201","","220","","1613356.14"
"2025-02-04","2025-02-01","SF FuneralFDC000000034B1250201","","220","","1613576.14"
"2025-02-04","2025-02-01","SF FuneralFDC000000034FV250201","","220","","1613796.14"
"2025-02-04","2025-02-01","SF FuneralFDC000000034GB250201","","220","","1614016.14"
"2025-02-04","2025-02-01","SF FuneralFDC000000034PZ250201","","220","","1614236.14"
"2025-02-04","2025-02-01","SF FuneralFDC000000034VV250201","","220","","1614456.14"
"2025-02-04","2025-02-01","SF FuneralFDC0000000356J250201","","220","","1614676.14"
"2025-02-04","2025-02-01","SF FuneralFDC000000035JR250201","","220","","1614896.14"
"2025-02-04","2025-02-01","SF FuneralFDC000000036CC250201","","220","","1615116.14"
"2025-02-04","2025-02-01","SF FuneralFDC000000036CJ250201","","220","","1615336.14"
"2025-02-04","2025-02-01","SF FuneralFDC00000003808250201","","220","","1615556.14"
"2025-02-04","2025-02-01","SF FuneralFDC0000000380T250201","","220","","1615776.14"
"2025-02-04","2025-02-01","SF FuneralFDC000000039CY250201","","220","","1615996.14"
"2025-02-04","2025-02-01","SF FuneralFDC000000039V7250201","","220","","1616216.14"
"2025-02-04","2025-02-01","SF FuneralFDC000000039XK250201","","220","","1616436.14"
"2025-02-04","2025-02-01","SF FuneralFDC00000003B0L250201","","220","","1616656.14"
"2025-02-04","2025-02-01","SF FuneralFDC00000003BWG250201","","220","","1616876.14"
"2025-02-04","2025-02-01","SF FuneralFDC00000003BYC250201","","220","","1617096.14"
"2025-02-04","2025-02-01","SF FuneralFDC00000003BYD250201","","220","","1617316.14"
"2025-02-04","2025-02-01","SF FuneralFDC00000003C1G250201","","220","","1617536.14"
"2025-02-04","2025-02-01","SF FuneralFDC00000003C2Y250201","","220","","1617756.14"
"2025-02-04","2025-02-01","SF FuneralFDC00000003CJ7250201","","220","","1617976.14"
"2025-02-04","2025-02-01","SF FuneralFDC00000003CR0250201","","220","","1618196.14"
"2025-02-04","2025-02-01","SF FuneralFDC00000003CSQ250201","","220","","1618416.14"
"2025-02-04","2025-02-01","SF FuneralFDC00000003CX3250201","","220","","1618636.14"
"2025-02-04","2025-02-01","SF FuneralFDC00000003FCK250201","","220","","1618856.14"
"2025-02-04","2025-02-01","SF FuneralFDC00000003FQF250201","","220","","1619076.14"
"2025-02-04","2025-02-01","SF FuneralFDC00000003K0R250201","","220","","1619296.14"
"2025-02-04","2025-02-01","SF FuneralFDC00000003K1K250201","","220","","1619516.14"
"2025-02-04","2025-02-01","SF FuneralFDC00000003KBS250201","","220","","1619736.14"
"2025-02-04","2025-02-01","SF FuneralFDC00000003KTD250201","","220","","1619956.14"
"2025-02-04","2025-02-01","SF FuneralFDC00000003KVB250201","","220","","1620176.14"
"2025-02-04","2025-02-01","SF FuneralFDC00000003LDD250201","","220","","1620396.14"
"2025-02-04","2025-02-01","SF FuneralFDC00000003MBT250201","","220","","1620616.14"
"2025-02-04","2025-02-01","SF FuneralFDC00000003MFR250201","","220","","1620836.14"
"2025-02-04","2025-02-01","SF FuneralFDC00000003MFT250201","","220","","1621056.14"
"2025-02-04","2025-02-01","SF FuneralFDC00000003NQK250201","","220","","1621276.14"
"2025-02-04","2025-02-01","SF FuneralFDC00000003SJ7250201","","220","","1621496.14"
"2025-02-04","2025-02-01","SF FuneralFDC00000003V1X250201","","220","","1621716.14"
"2025-02-04","2025-02-01","SF FuneralFDC00000003VK9250201","","220","","1621936.14"
"2025-02-04","2025-02-01","SF FuneralFDC00000003X18250201","","220","","1622156.14"
"2025-02-04","2025-02-01","SF FuneralFDC00000003XFN250201","","220","","1622376.14"
"2025-02-04","2025-02-01","SF FuneralFDC00000003YGW250201","","220","","1622596.14"
"2025-02-04","2025-02-01","SF FuneralFDC000000040F0250201","","220","","1622816.14"
"2025-02-04","2025-02-01","SF FuneralFDC000000040G2250201","","220","","1623036.14"
"2025-02-04","2025-02-01","SF FuneralFDC000000040SF250201","","220","","1623256.14"
"2025-02-04","2025-02-01","SF FuneralFDC000000043B6250201","","220","","1623476.14"
"2025-02-04","2025-02-01","SF FuneralFDC000000043CR250201","","220","","1623696.14"
"2025-02-04","2025-02-01","SF FuneralFDC000000043YG250201","","220","","1623916.14"
"2025-02-04","2025-02-01","SF FuneralFDC000000044S6250201","","220","","1624136.14"
"2025-02-04","2025-02-01","SF FuneralFDC000000046YP250201","","220","","1624356.14"
"2025-02-04","2025-02-01","SF FuneralFDC000000046ZK250201","","220","","1624576.14"
"2025-02-04","2025-02-01","SF FuneralFDC000000047BC250201","","220","","1624796.14"
"2025-02-04","2025-02-01","SF FuneralFDC00000004HJN250201","","220","","1625016.14"
"2025-02-04","2025-02-01","SF FuneralFDC00000004KSP250201","","220","","1625236.14"
"2025-02-04","2025-02-01","SF FuneralFDC00000004KSV250201","","220","","1625456.14"
"2025-02-04","2025-02-01","SF FuneralFDC00000004L1B250201","","220","","1625676.14"
"2025-02-04","2025-02-01","SF FuneralFDC00000004MPW250201","","220","","1625896.14"
"2025-02-04","2025-02-01","SF FuneralFDC00000004MQL250201","","220","","1626116.14"
"2025-02-04","2025-02-01","SF FuneralFDC00000004MRZ250201","","220","","1626336.14"
"2025-02-04","2025-02-01","SF FuneralFDC00000004MVB250201","","220","","1626556.14"
"2025-02-04","2025-02-01","SF FuneralFDC00000004TQK250201","","220","","1626776.14"
"2025-02-04","2025-02-01","SF FuneralFDC000000050KP250201","","126.5","","1626902.64"
"2025-02-04","2025-02-01","SF FuneralFDC000000052HZ250201","","220","","1627122.64"
"2025-02-04","2025-02-01","SF FuneralFDC00000005754250201","","220","","1627342.64"
"2025-02-04","2025-02-01","SF FuneralFDC0000000577C250201","","126.5","","1627469.14"
"2025-02-04","2025-02-01","SF FuneralFDC000000058DM250201","","126.5","","1627595.64"
"2025-02-04","2025-02-01","SF FuneralFDC000000058P2250201","","220","","1627815.64"
"2025-02-04","2025-02-01","SF FuneralFDC000000058V5250201","","126.5","","1627942.14"
"2025-02-04","2025-02-01","SF FuneralFDC00000005BRP250201","","220","","1628162.14"
"2025-02-04","2025-02-01","SF FuneralFDC00000005BRT250201","","220","","1628382.14"
"2025-02-04","2025-02-01","SF FuneralFDC00000005BVW250201","","126.5","","1628508.64"
"2025-02-04","2025-02-01","SF FuneralFDC00000005CST250201","","126.5","","1628635.14"
"2025-02-04","2025-02-01","SF FuneralFDC00000005DG2250201","","126.5","","1628761.64"
"2025-02-04","2025-02-01","SF FuneralFDC00000005GFT250201","","126.5","","1628888.14"
"2025-02-04","2025-02-01","SF FuneralFDC00000005GWF250201","","126.5","","1629014.64"
"2025-02-04","2025-02-01","SF FuneralFDC00000005H0F250201","","126.5","","1629141.14"
"2025-02-04","2025-02-01","SF FuneralFDC00000005H3Y250201","","126.5","","1629267.64"
"2025-02-04","2025-02-01","SF FuneralFDC00000005H4K250201","","126.5","","1629394.14"
"2025-02-04","2025-02-01","SF FuneralFDC00000005H4Z250201","","126.5","","1629520.64"
"2025-02-04","2025-02-01","SF FuneralFDC00000005H92250201","","126.5","","1629647.14"
"2025-02-04","2025-02-01","SF FuneralFDC00000005J15250201","","220","","1629867.14"
"2025-02-04","2025-02-01","SF FuneralFDC00000005J7S250201","","126.5","","1629993.64"
"2025-02-04","2025-02-01","SF FuneralFDC00000005JC8250201","","126.5","","1630120.14"
"2025-02-04","2025-02-01","SF FuneralFDC00000005JDP250201","","126.5","","1630246.64"
"2025-02-04","2025-02-01","SF FuneralFDC00000005KDS250201","","220","","1630466.64"
"2025-02-04","2025-02-01","SF FuneralFDC00000005L39250201","","126.5","","1630593.14"
"2025-02-04","2025-02-01","SF FuneralFDC00000005LJY250201","","126.5","","1630719.64"
"2025-02-04","2025-02-01","SF FuneralFDC00000005LZV250201","","220","","1630939.64"
"2025-02-04","2025-02-01","SF FuneralFDC00000005M13250201","","126.5","","1631066.14"
"2025-02-04","2025-02-01","SF FuneralFDC00000005M6T250201","","220","","1631286.14"
"2025-02-04","2025-02-01","SF FuneralFDC00000005M7K250201","","220","","1631506.14"
"2025-02-04","2025-02-01","SF FuneralFDC00000005MGP250201","","126.5","","1631632.64"
"2025-02-04","2025-02-01","SF FuneralFDC00000005MMT250201","","126.5","","1631759.14"
"2025-02-04","2025-02-01","SF FuneralFDC00000005MNB250201","","220","","1631979.14"
"2025-02-04","2025-02-01","SF FuneralFDC00000005MPT250201","","126.5","","1632105.64"
"2025-02-04","2025-02-01","SF FuneralFDC00000005MRG250201","","220","","1632325.64"
"2025-02-04","2025-02-01","SF FuneralFDC00000005MXY250201","","126.5","","1632452.14"
"2025-02-04","2025-02-01","SF FuneralFDC00000005N9D250201","","126.5","","1632578.64"
"2025-02-04","2025-02-01","SF FuneralFDC00000005Q0L250201","","126.5","","1632705.14"
"2025-02-04","2025-02-01","SF FuneralFDC00000005Q3K250201","","126.5","","1632831.64"
"2025-02-04","2025-02-01","SF FuneralFDC00000005QF5250201","","126.5","","1632958.14"
"2025-02-04","2025-02-01","SF FuneralFDC00000005RJC250201","","126.5","","1633084.64"
"2025-02-04","2025-02-01","SF FuneralFDC00000005RV7250201","","220","","1633304.64"
"2025-02-04","2025-02-01","SF FuneralFDC00000005RVB250201","","220","","1633524.64"
"2025-02-04","2025-02-01","SF FuneralFDC00000005RVV250201","","220","","1633744.64"
"2025-02-04","2025-02-01","SF FuneralFDC00000005RZ0250201","","126.5","","1633871.14"
"2025-02-04","2025-02-01","SF FuneralFDC00000005S1G250201","","256.5","","1634127.64"
"2025-02-04","2025-02-01","SF FuneralFDC00000005S4Z250201","","220","","1634347.64"
"2025-02-04","2025-02-01","SF FuneralFDC00000005SNM250201","","126.5","","1634474.14"
"2025-02-04","2025-02-01","SF FuneralFDC00000005TWK250201","","126.5","","1634600.64"
"2025-02-04","2025-02-01","SF FuneralFDC00000005TZQ250201","","220","","1634820.64"
"2025-02-04","2025-02-01","SF FuneralFDC00000005TZR250201","","220","","1635040.64"
"2025-02-04","2025-02-01","SF FuneralFDC00000005V04250201","","126.5","","1635167.14"
"2025-02-04","2025-02-01","SF FuneralFDC00000005V0F250201","","126.5","","1635293.64"
"2025-02-04","2025-02-01","SF FuneralFDC00000005V73250201","","126.5","","1635420.14"
"2025-02-04","2025-02-01","SF FuneralFDC00000005VNB250201","","126.5","","1635546.64"
"2025-02-04","2025-02-01","SF FuneralFDC00000005VW3250201","","126.5","","1635673.14"
"2025-02-04","2025-02-01","SF FuneralFDC00000005VZQ250201","","126.5","","1635799.64"
"2025-02-04","2025-02-01","SF FuneralFDC00000005WMN250201","","126.5","","1635926.14"
"2025-02-04","2025-02-01","SF FuneralFDC00000005WXX250201","","220","","1636146.14"
"2025-02-04","2025-02-01","SF FuneralFDC00000005X6Y250201","","126.5","","1636272.64"
"2025-02-04","2025-02-01","SF FuneralFDC000000060QD250201","","126.5","","1636399.14"
"2025-02-04","2025-02-01","SF FuneralFDC0000000641N250201","","126.5","","1636525.64"
"2025-02-04","2025-02-01","SF FuneralFDC0000000643Q250201","","126.5","","1636652.14"
"2025-02-04","2025-02-01","SF FuneralFDC0000000643R250201","","220","","1636872.14"
"2025-02-04","2025-02-01","SF FuneralFDC0000000675Q250201","","126.5","","1636998.64"
"2025-02-04","2025-02-01","SF FuneralFDC000000067F4250201","","126.5","","1637125.14"
"2025-02-04","2025-02-01","SF FuneralFDC000000067KP250201","","126.5","","1637251.64"
"2025-02-04","2025-02-01","SF FuneralFDC000000067LS250201","","126.5","","1637378.14"
"2025-02-04","2025-02-01","SF FuneralFDC000000067N1250201","","126.5","","1637504.64"
"2025-02-04","2025-02-01","SF FuneralFDC000000067R0250201","","126.5","","1637631.14"
"2025-02-04","2025-02-01","SF FuneralFDC000000067T7250201","","126.5","","1637757.64"
"2025-02-04","2025-02-01","SF FuneralFDC000000067VP250201","","126.5","","1637884.14"
"2025-02-04","2025-02-01","SF FuneralFDC0000000684H250201","","126.5","","1638010.64"
"2025-02-04","2025-02-01","SF FuneralFDC0000000687N250201","","126.5","","1638137.14"
"2025-02-04","2025-02-01","SF FuneralFDC000000068FL250201","","126.5","","1638263.64"
"2025-02-04","2025-02-01","SF FuneralFDC000000068HR250201","","126.5","","1638390.14"
"2025-02-04","2025-02-01","SF FuneralFDC000000068M8250201","","126.5","","1638516.64"
"2025-02-04","2025-02-01","SF FuneralFDC000000068NQ250201","","126.5","","1638643.14"
"2025-02-04","2025-02-01","SF FuneralFDC000000068Q5250201","","126.5","","1638769.64"
"2025-02-04","2025-02-01","SF FuneralFDC00000006916250201","","126.5","","1638896.14"
"2025-02-04","2025-02-01","SF FuneralFDC0000000697L250201","","126.5","","1639022.64"
"2025-02-04","2025-02-01","SF FuneralFDC0000000699P250201","","126.5","","1639149.14"
"2025-02-04","2025-02-01","SF FuneralFDC000000069CC250201","","126.5","","1639275.64"
"2025-02-04","2025-02-01","SF FuneralFDC000000069HS250201","","126.5","","1639402.14"
"2025-02-04","2025-02-01","SF FuneralFDC000000069MX250201","","126.5","","1639528.64"
"2025-02-04","2025-02-01","SF FuneralFDC000000069TZ250201","","220","","1639748.64"
"2025-02-04","2025-02-01","SF FuneralFDC00000006B07250201","","126.5","","1639875.14"
"2025-02-04","2025-02-01","SF FuneralFDC00000006B9C250201","","126.5","","1640001.64"
"2025-02-04","2025-02-01","SF FuneralFDC00000006BGY250201","","126.5","","1640128.14"
"2025-02-04","2025-02-01","SF FuneralFDC00000006BJ8250201","","126.5","","1640254.64"
"2025-02-04","2025-02-01","SF FuneralFDC00000006BLW250201","","126.5","","1640381.14"
"2025-02-04","2025-02-01","SF FuneralFDC00000006CNT250201","","126.5","","1640507.64"
"2025-02-04","2025-02-01","SF FuneralFDC00000006CQ8250201","","126.5","","1640634.14"
"2025-02-04","2025-02-01","SF FuneralFDC00000006CV3250201","","126.5","","1640760.64"
"2025-02-04","2025-02-01","SF FuneralFDC00000006CXR250201","","126.5","","1640887.14"
"2025-02-04","2025-02-01","SF FuneralFDC00000006D3P250201","","126.5","","1641013.64"
"2025-02-04","2025-02-01","SF FuneralFDC00000006D6P250201","","126.5","","1641140.14"
"2025-02-04","2025-02-01","SF FuneralFDC00000006D7Y250201","","126.5","","1641266.64"
"2025-02-04","2025-02-01","SF FuneralFDC00000006D92250201","","126.5","","1641393.14"
"2025-02-04","2025-02-01","SF FuneralFDC00000006DGP250201","","126.5","","1641519.64"
"2025-02-04","2025-02-01","SF FuneralFDC00000006DKT250201","","126.5","","1641646.14"
"2025-02-04","2025-02-01","SF FuneralFDC00000006DLB250201","","126.5","","1641772.64"
"2025-02-04","2025-02-01","SF FuneralFDC00000006DSF250201","","126.5","","1641899.14"
"2025-02-04","2025-02-01","SF FuneralFDC00000006DWS250201","","126.5","","1642025.64"
"2025-02-04","2025-02-01","SF FuneralFDC00000006DX9250201","","126.5","","1642152.14"
"2025-02-04","2025-02-01","SF FuneralFDC00000006DXC250201","","126.5","","1642278.64"
"2025-02-04","2025-02-01","SF FuneralFDC00000006DYF250201","","126.5","","1642405.14"
"2025-02-04","2025-02-01","SF FuneralFDC00000006DYK250201","","126.5","","1642531.64"
"2025-02-04","2025-02-01","SF FuneralFDC00000006F1X250201","","126.5","","1642658.14"
"2025-02-04","2025-02-01","SF FuneralFDC00000006F6D250201","","126.5","","1642784.64"
"2025-02-04","2025-02-01","SF FuneralFDC00000006F9Y250201","","126.5","","1642911.14"
"2025-02-04","2025-02-01","SF FuneralFDC00000006FB9250201","","126.5","","1643037.64"
"2025-02-04","2025-02-01","SF FuneralFDC00000006FTQ250201","","126.5","","1643164.14"
"2025-02-04","2025-02-01","SF FuneralFDC00000006G1G250201","","126.5","","1643290.64"
"2025-02-04","2025-02-01","SF FuneralFDC00000006G38250201","","126.5","","1643417.14"
"2025-02-04","2025-02-01","SF FuneralFDC00000006G6F250201","","126.5","","1643543.64"
"2025-02-04","2025-02-01","SF FuneralFDC00000006GJS250201","","126.5","","1643670.14"
"2025-02-04","2025-02-01","SF FuneralFDC00000006GJX250201","","126.5","","1643796.64"
"2025-02-04","2025-02-01","SF FuneralFDC00000006GKJ250201","","126.5","","1643923.14"
"2025-02-04","2025-02-01","SF FuneralFDC00000006GQ2250201","","126.5","","1644049.64"
"2025-02-04","2025-02-01","SF FuneralFDC00000006GT3250201","","126.5","","1644176.14"
"2025-02-04","2025-02-01","SF FuneralFDC00000006H0R250201","","126.5","","1644302.64"
"2025-02-04","2025-02-01","SF FuneralFDC00000006H42250201","","126.5","","1644429.14"
"2025-02-04","2025-02-01","SF FuneralFDC00000006H6T250201","","126.5","","1644555.64"
"2025-02-04","2025-02-01","SF FuneralFDC00000006HK1250201","","126.5","","1644682.14"
"2025-02-04","2025-02-01","SF FuneralFDC00000006HS2250201","","126.5","","1644808.64"
"2025-02-04","2025-02-01","SF FuneralFDC00000006J0X250201","","126.5","","1644935.14"
"2025-02-04","2025-02-01","SF FuneralFDC00000006J3J250201","","126.5","","1645061.64"
"2025-02-04","2025-02-01","SF FuneralFDC00000006JFT250201","","126.5","","1645188.14"
"2025-02-04","2025-02-01","SF FuneralFDC00000006JG1250201","","126.5","","1645314.64"
"2025-02-04","2025-02-01","SF FuneralFDC00000006JG9250201","","126.5","","1645441.14"
"2025-02-04","2025-02-01","SF FuneralFDC00000006JJD250201","","126.5","","1645567.64"
"2025-02-04","2025-02-01","SF FuneralFDC00000006JJP250201","","126.5","","1645694.14"
"2025-02-04","2025-02-01","SF FuneralFDC00000006KHG250201","","126.5","","1645820.64"
"2025-02-04","2025-02-01","SF FuneralFDC00000006KPF250201","","126.5","","1645947.14"
"2025-02-04","2025-02-01","SF FuneralFDC00000006KT5250201","","126.5","","1646073.64"
"2025-02-04","2025-02-01","SF FuneralFDC00000006KVC250201","","126.5","","1646200.14"
"2025-02-04","2025-02-01","SF FuneralFDC00000006L06250201","","126.5","","1646326.64"
"2025-02-04","2025-02-01","SF FuneralFDC00000006L7C250201","","126.5","","1646453.14"
"2025-02-04","2025-02-01","SF FuneralFDC00000006L7S250201","","126.5","","1646579.64"
"2025-02-04","2025-02-01","SF FuneralFDC00000006L8L250201","","126.5","","1646706.14"
"2025-02-04","2025-02-01","SF FuneralFDC00000006LB4250201","","126.5","","1646832.64"
"2025-02-04","2025-02-01","SF FuneralFDC00000006LB8250201","","126.5","","1646959.14"
"2025-02-04","2025-02-01","SF FuneralFDC00000006LC0250201","","126.5","","1647085.64"
"2025-02-04","2025-02-01","SF FuneralFDC00000006LC8250201","","126.5","","1647212.14"
"2025-02-04","2025-02-01","SF FuneralFDC00000006LGJ250201","","126.5","","1647338.64"
"2025-02-04","2025-02-01","SF FuneralFDC00000006LM6250201","","126.5","","1647465.14"
"2025-02-04","2025-02-01","SF FuneralFDC00000006LPB250201","","126.5","","1647591.64"
"2025-02-04","2025-02-01","SF FuneralFDC00000006LQ0250201","","126.5","","1647718.14"
"2025-02-04","2025-02-01","SF FuneralFDC00000006LZ2250201","","126.5","","1647844.64"
"2025-02-04","2025-02-01","SF FuneralFDC00000006M1R250201","","126.5","","1647971.14"
"2025-02-04","2025-02-01","SF FuneralFDC00000006M1W250201","","126.5","","1648097.64"
"2025-02-04","2025-02-01","SF FuneralFDC00000006MLL250201","","126.5","","1648224.14"
"2025-02-04","2025-02-01","SF FuneralFDC00000006MMH250201","","126.5","","1648350.64"
"2025-02-04","2025-02-01","SF FuneralFDC00000006MMN250201","","126.5","","1648477.14"
"2025-02-04","2025-02-01","SF FuneralFDC00000006N1W250201","","126.5","","1648603.64"
"2025-02-04","2025-02-01","SF FuneralFDC00000006NNY250201","","126.5","","1648730.14"
"2025-02-04","2025-02-01","SF FuneralFDC00000006NPB250201","","126.5","","1648856.64"
"2025-02-04","2025-02-01","SF FuneralFDC00000006P5D250201","","126.5","","1648983.14"
"2025-02-04","2025-02-01","SF FuneralFDC00000006Q52250201","","126.5","","1649109.64"
"2025-02-04","2025-02-01","SF FuneralFDC00000006Q70250201","","126.5","","1649236.14"
"2025-02-04","2025-02-01","SF FuneralFDC00000006Q73250201","","126.5","","1649362.64"
"2025-02-04","2025-02-01","SF FuneralFDC00000006Q93250201","","126.5","","1649489.14"
"2025-02-04","2025-02-01","SF FuneralFDC00000006QH0250201","","126.5","","1649615.64"
"2025-02-04","2025-02-01","SF FuneralFDC00000006QH6250201","","126.5","","1649742.14"
"2025-02-04","2025-02-01","SF FuneralFDC00000006QKY250201","","126.5","","1649868.64"
"2025-02-04","2025-02-01","SF FuneralFDC00000006R3K250201","","126.5","","1649995.14"
"2025-02-04","2025-02-01","SF FuneralFDC00000006R6H250201","","126.5","","1650121.64"
"2025-02-04","2025-02-01","SF FuneralFDC00000006RVQ250201","","126.5","","1650248.14"
"2025-02-04","2025-02-01","SF FuneralFDC00000006TH0250201","","126.5","","1650374.64"
"2025-02-04","2025-02-01","SF FuneralFDC00000006VDF250201","","126.5","","1650501.14"
"2025-02-04","2025-02-01","SF FuneralFDC00000006VZZ250201","","126.5","","1650627.64"
"2025-02-04","2025-02-01","SF FuneralFDC00000006W4Q250201","","126.5","","1650754.14"
"2025-02-04","2025-02-01","SF FuneralFDC00000006WRF250201","","126.5","","1650880.64"
"2025-02-04","2025-02-01","SF FuneralFDC00000006WW9250201","","126.5","","1651007.14"
"2025-02-04","2025-02-01","SF FuneralFDC00000006X5T250201","","126.5","","1651133.64"
"2025-02-04","2025-02-01","SF FuneralFDC00000006XMT250201","","126.5","","1651260.14"
"2025-02-04","2025-02-01","SF FuneralFDC00000006XN4250201","","126.5","","1651386.64"
"2025-02-04","2025-02-01","SF FuneralFDC00000006XP7250201","","191.5","","1651578.14"
"2025-02-04","2025-02-01","SF FuneralFDC00000006XSL250201","","126.5","","1651704.64"
"2025-02-04","2025-02-01","SF FuneralFDC0000000709J250201","","126.5","","1651831.14"
"2025-02-04","2025-02-01","SF FuneralFDC000000070ZF250201","","126.5","","1651957.64"
"2025-02-04","2025-02-01","SF FuneralFDC0000000736W250201","","126.5","","1652084.14"
"2025-02-04","2025-02-01","SF FuneralFDC0000000737J250201","","126.5","","1652210.64"
"2025-02-04","2025-02-01","SF FuneralFDC0000000738D250201","","126.5","","1652337.14"
"2025-02-04","2025-02-01","SF FuneralFDC0000000738L250201","","126.5","","1652463.64"
"2025-02-04","2025-02-01","SF FuneralFDC00000007391250201","","126.5","","1652590.14"
"2025-02-04","2025-02-01","SF FuneralFDC000000073BS250201","","126.5","","1652716.64"
"2025-02-04","2025-02-01","SF FuneralFDC000000073CC250201","","126.5","","1652843.14"
"2025-02-04","2025-02-01","SF FuneralFDC000000073HC250201","","126.5","","1652969.64"
"2025-02-04","2025-02-01","SF FuneralFDC000000073M1250201","","126.5","","1653096.14"
"2025-02-04","2025-02-01","SF FuneralFDC000000073NJ250201","","126.5","","1653222.64"
"2025-02-04","2025-02-01","SF FuneralFDC000000073S4250201","","126.5","","1653349.14"
"2025-02-04","2025-02-01","SF FuneralFDC000000073XR250201","","126.5","","1653475.64"
"2025-02-04","2025-02-01","SF FuneralFDC000000073Y8250201","","126.5","","1653602.14"
"2025-02-04","2025-02-01","SF FuneralFDC000000073ZY250201","","126.5","","1653728.64"
"2025-02-04","2025-02-01","SF FuneralFDC0000000742T250201","","126.5","","1653855.14"
"2025-02-04","2025-02-01","SF FuneralFDC0000000743B250201","","126.5","","1653981.64"
"2025-02-04","2025-02-01","SF FuneralFDC0000000744H250201","","126.5","","1654108.14"
"2025-02-04","2025-02-01","SF FuneralFDC0000000749J250201","","126.5","","1654234.64"
"2025-02-04","2025-02-01","SF FuneralFDC000000074DX250201","","126.5","","1654361.14"
"2025-02-04","2025-02-01","SF FuneralFDC000000074FS250201","","126.5","","1654487.64"
"2025-02-04","2025-02-01","SF FuneralFDC000000074J2250201","","126.5","","1654614.14"
"2025-02-04","2025-02-01","SF FuneralFDC000000074NQ250201","","126.5","","1654740.64"
"2025-02-04","2025-02-01","SF FuneralFDC000000074SX250201","","126.5","","1654867.14"
"2025-02-04","2025-02-01","SF FuneralFDC000000074TC250201","","126.5","","1654993.64"
"2025-02-04","2025-02-01","SF FuneralFDC000000074TJ250201","","126.5","","1655120.14"
"2025-02-04","2025-02-01","SF FuneralFDC0000000755Z250201","","126.5","","1655246.64"
"2025-02-04","2025-02-01","SF FuneralFDC00000007585250201","","126.5","","1655373.14"
"2025-02-04","2025-02-01","SF FuneralFDC000000075QQ250201","","126.5","","1655499.64"
"2025-02-04","2025-02-01","SF FuneralFDC000000075X3250201","","126.5","","1655626.14"
"2025-02-04","2025-02-01","SF FuneralFDC000000075YC250201","","126.5","","1655752.64"
"2025-02-04","2025-02-01","SF FuneralFDC0000000760Z250201","","126.5","","1655879.14"
"2025-02-04","2025-02-01","SF FuneralFDC0000000764W250201","","126.5","","1656005.64"
"2025-02-04","2025-02-01","SF FuneralFDC000000076B0250201","","126.5","","1656132.14"
"2025-02-04","2025-02-01","SF FuneralFDC000000076HZ250201","","126.5","","1656258.64"
"2025-02-04","2025-02-01","SF FuneralFDC000000076MP250201","","126.5","","1656385.14"
"2025-02-04","2025-02-01","SF FuneralFDC000000076QH250201","","126.5","","1656511.64"
"2025-02-04","2025-02-01","SF FuneralFDC0000000772C250201","","126.5","","1656638.14"
"2025-02-04","2025-02-01","SF FuneralFDC000000077XB250201","","126.5","","1656764.64"
"2025-02-04","2025-02-01","SF FuneralFDC0000000780B250201","","126.5","","1656891.14"
"2025-02-04","2025-02-01","SF FuneralFDC0000000784Y250201","","126.5","","1657017.64"
"2025-02-04","2025-02-01","SF FuneralFDC00000007856250201","","126.5","","1657144.14"
"2025-02-04","2025-02-01","SF FuneralFDC000000078NR250201","","126.5","","1657270.64"
"2025-02-04","2025-02-01","SF FuneralFDC000000078Q5250201","","126.5","","1657397.14"
"2025-02-04","2025-02-01","SF FuneralFDC000000078T5250201","","126.5","","1657523.64"
"2025-02-04","2025-02-01","SF FuneralFDC000000079V2250201","","126.5","","1657650.14"
"2025-02-04","2025-02-01","SF FuneralFDC00000007B42250201","","126.5","","1657776.64"
"2025-02-04","2025-02-01","SF FuneralFDC00000007B48250201","","126.5","","1657903.14"
"2025-02-04","2025-02-01","SF FuneralFDC00000007BCJ250201","","126.5","","1658029.64"
"2025-02-04","2025-02-01","SF FuneralFDC00000007BF2250201","","126.5","","1658156.14"
"2025-02-04","2025-02-01","SF FuneralFDC00000007BQP250201","","126.5","","1658282.64"
"2025-02-04","2025-02-01","SF FuneralFDC00000007C0Q250201","","126.5","","1658409.14"
"2025-02-04","2025-02-01","SF FuneralFDC00000007CNN250201","","126.5","","1658535.64"
"2025-02-04","2025-02-01","SF FuneralFDC00000007DYV250201","","126.5","","1658662.14"
"2025-02-04","2025-02-01","SF FuneralFDC00000007F7W250201","","126.5","","1658788.64"
"2025-02-04","2025-02-01","SF FuneralFDC00000007FVG250201","","126.5","","1658915.14"
"2025-02-04","2025-02-01","SF FuneralFDC00000007FWT250201","","126.5","","1659041.64"
"2025-02-04","2025-02-01","SF FuneralFDC00000007H5F250201","","126.5","","1659168.14"
"2025-02-04","2025-02-01","SF FuneralFDC00000007J1Z250201","","126.5","","1659294.64"
"2025-02-04","2025-02-01","SF FuneralFDC00000007JHQ250201","","126.5","","1659421.14"
"2025-02-04","2025-02-01","SF FuneralFDC00000007JPF250201","","126.5","","1659547.64"
"2025-02-04","2025-02-01","SF FuneralFDC00000007K29250201","","126.5","","1659674.14"
"2025-02-04","2025-02-01","SF FuneralFDC00000007KR7250201","","126.5","","1659800.64"
"2025-02-04","2025-02-01","SF FuneralFDC00000007P1J250201","","126.5","","1659927.14"
"2025-02-04","2025-02-01","SF FuneralFDC00000007P2M250201","","126.5","","1660053.64"
"2025-02-04","2025-02-01","SF FuneralFDC00000007P8K250201","","126.5","","1660180.14"
"2025-02-04","2025-02-01","SF FuneralFDC00000007PKF250201","","126.5","","1660306.64"
"2025-02-04","2025-02-01","SF FuneralFDC00000007PL9250201","","126.5","","1660433.14"
"2025-02-04","2025-02-01","SF FuneralFDC00000007PMH250201","","126.5","","1660559.64"
"2025-02-04","2025-02-01","SF FuneralFDC00000007PR7250201","","126.5","","1660686.14"
"2025-02-04","2025-02-01","SF FuneralFDC00000007PZK250201","","126.5","","1660812.64"
"2025-02-04","2025-02-01","SF FuneralFDC00000007Q01250201","","126.5","","1660939.14"
"2025-02-04","2025-02-01","SF FuneralFDC00000007Q49250201","","126.5","","1661065.64"
"2025-02-04","2025-02-01","SF FuneralFDC00000007Q52250201","","126.5","","1661192.14"
"2025-02-04","2025-02-01","SF FuneralFDC00000007Q5C250201","","126.5","","1661318.64"
"2025-02-04","2025-02-01","SF FuneralFDC00000007Q6N250201","","126.5","","1661445.14"
"2025-02-04","2025-02-01","SF FuneralFDC00000007Q7Y250201","","126.5","","1661571.64"
"2025-02-04","2025-02-01","SF FuneralFDC00000007QC4250201","","126.5","","1661698.14"
"2025-02-04","2025-02-01","SF FuneralFDC00000007QG5250201","","126.5","","1661824.64"
"2025-02-04","2025-02-01","SF FuneralFDC00000007QGQ250201","","126.5","","1661951.14"
"2025-02-04","2025-02-01","SF FuneralF793894       250201","","126.5","","1662077.64"
"2025-02-04","2025-02-01","SF FuneralFDC00000007QM0250201","","126.5","","1662204.14"
"2025-02-04","2025-02-01","SF FuneralFDC00000007QVN250201","","126.5","","1662330.64"
"2025-02-04","2025-02-01","SF FuneralFDC00000007QWG250201","","126.5","","1662457.14"
"2025-02-04","2025-02-01","SF FuneralFDC00000007R0S250201","","126.5","","1662583.64"
"2025-02-04","2025-02-01","SF FuneralFDC00000007R1F250201","","126.5","","1662710.14"
"2025-02-04","2025-02-01","SF FuneralFDC00000007R30250201","","126.5","","1662836.64"
"2025-02-04","2025-02-01","SF FuneralFDC00000007R38250201","","126.5","","1662963.14"
"2025-02-04","2025-02-01","SF FuneralFDC00000007R5X250201","","126.5","","1663089.64"
"2025-02-04","2025-02-01","SF FuneralFDC00000007R9B250201","","126.5","","1663216.14"
"2025-02-04","2025-02-01","SF FuneralFDC00000007RBR250201","","126.5","","1663342.64"
"2025-02-04","2025-02-01","SF FuneralFDC00000007RCQ250201","","126.5","","1663469.14"
"2025-02-04","2025-02-01","SF FuneralF794244       250201","","126.5","","1663595.64"
"2025-02-04","2025-02-01","SF FuneralFDC00000007RKT250201","","126.5","","1663722.14"
"2025-02-04","2025-02-01","SF FuneralFDC00000007RSQ250201","","220","","1663942.14"
"2025-02-04","2025-02-01","SF FuneralFDC00000007RX0250201","","220","","1664162.14"
"2025-02-04","2025-02-01","SF FuneralFDC00000007RYD250201","","126.5","","1664288.64"
"2025-02-04","2025-02-01","SF FuneralFDC00000007S45250201","","126.5","","1664415.14"
"2025-02-04","2025-02-01","SF FuneralFDC00000007SGP250201","","126.5","","1664541.64"
"2025-02-04","2025-02-01","SF FuneralFDC00000007SHM250201","","126.5","","1664668.14"
"2025-02-04","2025-02-01","SF FuneralFDC00000007SRS250201","","126.5","","1664794.64"
"2025-02-04","2025-02-01","SF FuneralFDC00000007SX9250201","","126.5","","1664921.14"
"2025-02-04","2025-02-01","SF FuneralFDC00000007TBG250201","","126.5","","1665047.64"
"2025-02-04","2025-02-01","SF FuneralFDC00000007TJN250201","","126.5","","1665174.14"
"2025-02-04","2025-02-01","SF FuneralFDC00000007TWP250201","","126.5","","1665300.64"
"2025-02-04","2025-02-01","SF FuneralFDC00000007VRH250201","","126.5","","1665427.14"
"2025-02-04","2025-02-01","SF FuneralFDC00000007VTV250201","","126.5","","1665553.64"
"2025-02-04","2025-02-01","SF FuneralFDC00000007W0G250201","","126.5","","1665680.14"
"2025-02-04","2025-02-01","SF FuneralFDC00000007W38250201","","126.5","","1665806.64"
"2025-02-04","2025-02-01","SF FuneralFDC00000007W9X250201","","126.5","","1665933.14"
"2025-02-04","2025-02-01","SF FuneralFDC00000007WDP250201","","126.5","","1666059.64"
"2025-02-04","2025-02-01","SF FuneralFDC00000007X6R250201","","126.5","","1666186.14"
"2025-02-04","2025-02-01","SF FuneralF795949       250201","","126.5","","1666312.64"
"2025-02-04","2025-02-01","SF FuneralF795982       250201","","126.5","","1666439.14"
"2025-02-04","2025-02-01","SF FuneralF796095       250201","","126.5","","1666565.64"
"2025-02-04","2025-02-01","SF FuneralFDC00000007XR9250201","","126.5","","1666692.14"
"2025-02-04","2025-02-01","SF FuneralFDC00000007XW0250201","","126.5","","1666818.64"
"2025-02-04","2025-02-01","SF FuneralFDC00000007YNM250201","","126.5","","1666945.14"
"2025-02-04","2025-02-01","SF FuneralFDC00000007Z7B250201","","126.5","","1667071.64"
"2025-02-04","2025-02-01","SF FuneralFDC00000007ZDP250201","","126.5","","1667198.14"
"2025-02-04","2025-02-01","SF FuneralFDC00000007ZM4250201","","126.5","","1667324.64"
"2025-02-04","2025-02-01","SF FuneralFDC0000000835Y250201","","126.5","","1667451.14"
"2025-02-04","2025-02-01","SF FuneralFDC000000083DK250201","","126.5","","1667577.64"
"2025-02-04","2025-02-01","SF FuneralFDC000000083K7250201","","126.5","","1667704.14"
"2025-02-04","2025-02-01","SF FuneralFDC000000083M4250201","","126.5","","1667830.64"
"2025-02-04","2025-02-01","SF FuneralFDC000000084LY250201","","126.5","","1667957.14"
"2025-02-04","2025-02-01","SF FuneralF798346       250201","","126.5","","1668083.64"
"2025-02-04","2025-02-01","SF FuneralFDC000000084Q6250201","","126.5","","1668210.14"
"2025-02-04","2025-02-01","SF FuneralFDC000000084R6250201","","126.5","","1668336.64"
"2025-02-04","2025-02-01","SF FuneralFDC0000000858M250201","","126.5","","1668463.14"
"2025-02-04","2025-02-01","SF FuneralFDC000000085BW250201","","126.5","","1668589.64"
"2025-02-04","2025-02-01","SF FuneralFDC000000085PG250201","","126.5","","1668716.14"
"2025-02-04","2025-02-01","SF FuneralFDC0000000860K250201","","126.5","","1668842.64"
"2025-02-04","2025-02-01","SF FuneralFDC00000008692250201","","126.5","","1668969.14"
"2025-02-04","2025-02-01","SF FuneralFDC0000000869T250201","","126.5","","1669095.64"
"2025-02-04","2025-02-01","SF FuneralFDC000000086QY250201","","126.5","","1669222.14"
"2025-02-04","2025-02-01","SF FuneralFDC000000086T2250201","","126.5","","1669348.64"
"2025-02-04","2025-02-01","SF FuneralFDC000000086TV250201","","126.5","","1669475.14"
"2025-02-04","2025-02-01","SF FuneralFDC000000087B5250201","","126.5","","1669601.64"
"2025-02-04","2025-02-01","SF FuneralFDC000000087D2250201","","126.5","","1669728.14"
"2025-02-04","2025-02-01","SF FuneralF799602       250201","","126.5","","1669854.64"
"2025-02-04","2025-02-01","SF FuneralFDC000000088HS250201","","126.5","","1669981.14"
"2025-02-04","2025-02-01","SF FuneralFDC00000008918250201","","126.5","","1670107.64"
"2025-02-04","2025-02-01","SF FuneralFDC000000089Q0250201","","126.5","","1670234.14"
"2025-02-04","2025-02-01","SF FuneralFDC000000089XC250201","","126.5","","1670360.64"
"2025-02-04","2025-02-01","SF FuneralF800735       250201","","126.5","","1670487.14"
"2025-02-04","2025-02-01","SF FuneralFDC00000008CGP250201","","126.5","","1670613.64"
"2025-02-04","2025-02-01","SF FuneralFDC00000008FHM250201","","126.5","","1670740.14"
"2025-02-04","2025-02-01","SF FuneralFDC00000008JCY250201","","126.5","","1670866.64"
"2025-02-04","2025-02-01","SF FuneralF802155       250201","","126.5","","1670993.14"
"2025-02-04","2025-02-01","SF FuneralFDC00000008KCB250201","","126.5","","1671119.64"
"2025-02-04","2025-02-01","SF FuneralFDC00000008KXG250201","","126.5","","1671246.14"
"2025-02-04","2025-02-01","SF FuneralF802644       250201","","126.5","","1671372.64"
"2025-02-04","2025-02-01","SF FuneralF802694       250201","","126.5","","1671499.14"
"2025-02-04","2025-02-01","SF FuneralF802796       250201","","126.5","","1671625.64"
"2025-02-04","2025-02-01","SF FuneralFDC00000008LGJ250201","","126.5","","1671752.14"
"2025-02-04","2025-02-01","SF FuneralFDC00000008LMN250201","","126.5","","1671878.64"
"2025-02-04","2025-02-01","SF FuneralF802999       250201","","126.5","","1672005.14"
"2025-02-04","2025-02-01","SF FuneralFDC00000008LQZ250201","","126.5","","1672131.64"
"2025-02-04","2025-02-01","SF FuneralF803064       250201","","126.5","","1672258.14"
"2025-02-04","2025-02-01","SF FuneralFDC00000008LXP250201","","126.5","","1672384.64"
"2025-02-04","2025-02-01","SF FuneralF803338       250201","","126.5","","1672511.14"
"2025-02-04","2025-02-01","SF FuneralFDC00000008MS5250201","","126.5","","1672637.64"
"2025-02-04","2025-02-01","SF FuneralF803641       250201","","126.5","","1672764.14"
"2025-02-04","2025-02-01","SF FuneralF803661       250201","","126.5","","1672890.64"
"2025-02-04","2025-02-01","SF FuneralF803677       250201","","126.5","","1673017.14"
"2025-02-04","2025-02-01","SF FuneralFDC00000008NRC250201","","126.5","","1673143.64"
"2025-02-04","2025-02-01","SF FuneralF803809       250201","","126.5","","1673270.14"
"2025-02-04","2025-02-01","SF FuneralF804010       250201","","126.5","","1673396.64"
"2025-02-04","2025-02-01","SF FuneralFDC00000008RJ7250201","","126.5","","1673523.14"
"2025-02-04","2025-02-01","SF FuneralFDC00000008S5B250201","","126.5","","1673649.64"
"2025-02-04","2025-02-01","SF FuneralF804960       250201","","126.5","","1673776.14"
"2025-02-04","2025-02-01","SF FuneralF805032       250201","","126.5","","1673902.64"
"2025-02-04","2025-02-01","SF FuneralFDC00000008SZQ250201","","191.5","","1674094.14"
"2025-02-04","2025-02-01","SF FuneralF808426       250201","","126.5","","1674220.64"
"2025-02-04","2025-02-01","SF FuneralF808437       250201","","126.5","","1674347.14"
"2025-02-04","2025-02-01","SF FuneralF808448       250201","","126.5","","1674473.64"
"2025-02-04","2025-02-01","SF FuneralF808453       250201","","126.5","","1674600.14"
"2025-02-04","2025-02-01","SF FuneralF808495       250201","","126.5","","1674726.64"
"2025-02-04","2025-02-01","SF FuneralF808516       250201","","126.5","","1674853.14"
"2025-02-04","2025-02-01","SF FuneralF808529       250201","","126.5","","1674979.64"
"2025-02-04","2025-02-01","SF FuneralF808644       250201","","126.5","","1675106.14"
"2025-02-04","2025-02-01","SF FuneralF808806       250201","","126.5","","1675232.64"
"2025-02-04","2025-02-01","SF FuneralF808862       250201","","126.5","","1675359.14"
"2025-02-04","2025-02-01","SF FuneralF809011       250201","","126.5","","1675485.64"
"2025-02-04","2025-02-01","SF FuneralF809173       250201","","126.5","","1675612.14"
"2025-02-04","2025-02-01","SF FuneralF809232       250201","","126.5","","1675738.64"
"2025-02-04","2025-02-01","SF FuneralF803048       250201","","126.5","","1675865.14"
"2025-02-04","2025-02-01","SF FuneralF809276       250201","","126.5","","1675991.64"
"2025-02-04","2025-02-01","SF FuneralFDC0000000930J250201","","126.5","","1676118.14"
"2025-02-04","2025-02-01","SF FuneralF809788       250201","","126.5","","1676244.64"
"2025-02-04","2025-02-01","SF FuneralF788700       250201","","191.5","","1676436.14"
"2025-02-04","2025-02-01","SF FuneralFDC0000000955R250201","","126.5","","1676562.64"
"2025-02-04","2025-02-01","SF FuneralF810261       250201","","126.5","","1676689.14"
"2025-02-04","2025-02-01","SF FuneralF810660       250201","","126.5","","1676815.64"
"2025-02-04","2025-02-01","SF FuneralF810877       250201","","126.5","","1676942.14"
"2025-02-04","2025-02-01","SF FuneralF810901       250201","","126.5","","1677068.64"
"2025-02-04","2025-02-01","SF FuneralFDC000000098J6250201","","126.5","","1677195.14"
"2025-02-04","2025-02-01","SF FuneralFDC000000098MQ250201","","126.5","","1677321.64"
"2025-02-04","2025-02-01","SF FuneralF812111       250201","","126.5","","1677448.14"
"2025-02-04","2025-02-01","SF FuneralF812132       250201","","126.5","","1677574.64"
"2025-02-04","2025-02-01","SF FuneralF812145       250201","","126.5","","1677701.14"
"2025-02-04","2025-02-01","SF FuneralF812264       250201","","126.5","","1677827.64"
"2025-02-04","2025-02-01","SF FuneralF812284       250201","","126.5","","1677954.14"
"2025-02-04","2025-02-01","SF FuneralF812320       250201","","126.5","","1678080.64"
"2025-02-04","2025-02-01","SF FuneralF812343       250201","","126.5","","1678207.14"
"2025-02-04","2025-02-01","SF FuneralF812445       250201","","126.5","","1678333.64"
"2025-02-04","2025-02-01","SF FuneralF812510       250201","","126.5","","1678460.14"
"2025-02-04","2025-02-01","SF FuneralF812557       250201","","126.5","","1678586.64"
"2025-02-04","2025-02-01","SF FuneralF809994       250201","","126.5","","1678713.14"
"2025-02-04","2025-02-01","SF FuneralF812726       250201","","126.5","","1678839.64"
"2025-02-04","2025-02-01","SF FuneralF812960       250201","","126.5","","1678966.14"
"2025-02-04","2025-02-01","SF FuneralF813295       250201","","126.5","","1679092.64"
"2025-02-04","2025-02-01","SF FuneralFDC00000009H3H250201","","191.5","","1679284.14"
"2025-02-04","2025-02-01","SF FuneralF813473       250201","","126.5","","1679410.64"
"2025-02-04","2025-02-01","SF FuneralF813499       250201","","126.5","","1679537.14"
"2025-02-04","2025-02-01","SF FuneralF813837       250201","","126.5","","1679663.64"
"2025-02-04","2025-02-01","SF FuneralF736177       250201","","126.5","","1679790.14"
"2025-02-04","2025-02-01","SF FuneralF816390       250201","","126.5","","1679916.64"
"2025-02-04","2025-02-01","SF FuneralF816391       250201","","126.5","","1680043.14"
"2025-02-04","2025-02-01","SF FuneralF816408       250201","","126.5","","1680169.64"
"2025-02-04","2025-02-01","SF FuneralF816416       250201","","126.5","","1680296.14"
"2025-02-04","2025-02-01","SF FuneralF816423       250201","","126.5","","1680422.64"
"2025-02-04","2025-02-01","SF FuneralF816481       250201","","126.5","","1680549.14"
"2025-02-04","2025-02-01","SF FuneralF816688       250201","","126.5","","1680675.64"
"2025-02-04","2025-02-01","SF FuneralF816695       250201","","126.5","","1680802.14"
"2025-02-04","2025-02-01","SF FuneralF812143       250201","","126.5","","1680928.64"
"2025-02-04","2025-02-01","SF FuneralF816924       250201","","191.5","","1681120.14"
"2025-02-04","2025-02-01","SF FuneralF817045       250201","","126.5","","1681246.64"
"2025-02-04","2025-02-01","SF FuneralF817048       250201","","126.5","","1681373.14"
"2025-02-04","2025-02-01","SF FuneralF817121       250201","","126.5","","1681499.64"
"2025-02-04","2025-02-01","SF FuneralF817162       250201","","126.5","","1681626.14"
"2025-02-04","2025-02-01","SF FuneralF817235       250201","","126.5","","1681752.64"
"2025-02-04","2025-02-01","SF FuneralF817265       250201","","126.5","","1681879.14"
"2025-02-04","2025-02-01","SF FuneralF817339       250201","","126.5","","1682005.64"
"2025-02-04","2025-02-01","SF FuneralFDC00000009Y01250201","","126.5","","1682132.14"
"2025-02-04","2025-02-01","SF FuneralF818299       250201","","126.5","","1682258.64"
"2025-02-04","2025-02-01","SF FuneralF818471       250201","","126.5","","1682385.14"
"2025-02-04","2025-02-01","SF FuneralF818760       250201","","126.5","","1682511.64"
"2025-02-04","2025-02-01","SF FuneralF819185       250201","","126.5","","1682638.14"
"2025-02-04","2025-02-01","SF FuneralFDC0000000B3GF250201","","191.5","","1682829.64"
"2025-02-04","2025-02-01","SF FuneralFDC0000000B538250201","","191.5","","1683021.14"
"2025-02-04","2025-02-01","SF FuneralF820295       250201","","126.5","","1683147.64"
"2025-02-04","2025-02-01","SF FuneralF820545       250201","","126.5","","1683274.14"
"2025-02-04","2025-02-01","SF FuneralFDC0000000B874250201","","126.5","","1683400.64"
"2025-02-04","2025-02-01","SF FuneralFDC0000000B878250201","","126.5","","1683527.14"
"2025-02-04","2025-02-01","SF FuneralF820666       250201","","126.5","","1683653.64"
"2025-02-04","2025-02-01","SF FuneralFDC0000000B8KH250201","","126.5","","1683780.14"
"2025-02-04","2025-02-01","SF FuneralF780987       250201","","191.5","","1683971.64"
"2025-02-04","2025-02-01","SF FuneralF821275       250201","","126.5","","1684098.14"
"2025-02-04","2025-02-01","SF FuneralF821508       250201","","126.5","","1684224.64"
"2025-02-04","2025-02-01","SF FuneralF821849       250201","","126.5","","1684351.14"
"2025-02-04","2025-02-01","SF FuneralF821896       250201","","126.5","","1684477.64"
"2025-02-04","2025-02-01","SF FuneralFDC0000000BDFG250201","","126.5","","1684604.14"
"2025-02-04","2025-02-01","SF FuneralF752451       250201","","126.5","","1684730.64"
"2025-02-04","2025-02-01","SF FuneralFDC0000000BGCH250201","","126.5","","1684857.14"
"2025-02-04","2025-02-01","SF FuneralF823119       250201","","126.5","","1684983.64"
"2025-02-04","2025-02-01","SF FuneralFDC0000000BNQG250201","","126.5","","1685110.14"
"2025-02-04","2025-02-01","SF FuneralF780930       250201","","191.5","","1685301.64"
"2025-02-04","2025-02-01","SF FuneralF828032       250201","","126.5","","1685428.14"
"2025-02-04","2025-02-01","SF FuneralF788452       250201","","126.5","","1685554.64"
"2025-02-04","2025-02-01","SF FuneralF828077       250201","","126.5","","1685681.14"
"2025-02-04","2025-02-01","SF FuneralF828087       250201","","126.5","","1685807.64"
"2025-02-04","2025-02-01","SF FuneralF828138       250201","","126.5","","1685934.14"
"2025-02-04","2025-02-01","SF FuneralF828241       250201","","126.5","","1686060.64"
"2025-02-04","2025-02-01","SF FuneralF828317       250201","","126.5","","1686187.14"
"2025-02-04","2025-02-01","SF FuneralFDC0000000BPKJ250201","","191.5","","1686378.64"
"2025-02-04","2025-02-01","SF FuneralF830007       250201","","126.5","","1686505.14"
"2025-02-04","2025-02-01","SF FuneralF830513       250201","","126.5","","1686631.64"
"2025-02-04","2025-02-01","SF FuneralF740930       250201","","126.5","","1686758.14"
"2025-02-04","2025-02-01","SF FuneralF832117       250201","","126.5","","1686884.64"
"2025-02-04","2025-02-01","SF FuneralF832118       250201","","126.5","","1687011.14"
"2025-02-04","2025-02-01","SF FuneralF832224       250201","","126.5","","1687137.64"
"2025-02-04","2025-02-01","SF FuneralFDC0000000CJVL250201","","126.5","","1687264.14"
"2025-02-04","2025-02-01","SF FuneralF832359       250201","","126.5","","1687390.64"
"2025-02-04","2025-02-01","SF FuneralFDC0000000CN2Y250201","","126.5","","1687517.14"
"2025-02-04","2025-02-01","SF FuneralF832847       250201","","126.5","","1687643.64"
"2025-02-04","2025-02-01","SF FuneralF832870       250201","","126.5","","1687770.14"
"2025-02-04","2025-02-01","SF FuneralF833015       250201","","126.5","","1687896.64"
"2025-02-04","2025-02-01","SF FuneralF833848       250201","","126.5","","1688023.14"
"2025-02-04","2025-02-01","SF FuneralF833920       250201","","126.5","","1688149.64"
"2025-02-04","2025-02-01","SF FuneralFDC0000000CWZF250201","","191.5","","1688341.14"
"2025-02-04","2025-02-01","SF FuneralF834248       250201","","126.5","","1688467.64"
"2025-02-04","2025-02-01","SF FuneralFDC0000000D2YW250201","","126.5","","1688594.14"
"2025-02-04","2025-02-01","SF FuneralFDC0000000DZ16250201","","126.5","","1688720.64"
"2025-02-04","2025-02-01","SF FuneralF841814       250201","","126.5","","1688847.14"
"2025-02-04","2025-02-01","SF FuneralF841856       250201","","126.5","","1688973.64"
"2025-02-04","2025-02-01","SF FuneralF842218       250201","","126.5","","1689100.14"
"2025-02-04","2025-02-01","SF FuneralF842777       250201","","126.5","","1689226.64"
"2025-02-04","2025-02-01","SF FuneralF992191       250201","","126.5","","1689353.14"
"2025-02-04","2025-02-01","SF FuneralF992195       250201","","126.5","","1689479.64"
"2025-02-04","2025-02-01","SF FuneralF992932       250201","","126.5","","1689606.14"
"2025-02-04","2025-02-01","SF FuneralFDC0000000JBX7250201","","126.5","","1689732.64"
"2025-02-04","2025-02-01","SF FuneralF993234       250201","","126.5","","1689859.14"
"2025-02-04","2025-02-01","SF FuneralF993503       250201","","126.5","","1689985.64"
"2025-02-04","2025-02-01","SF FuneralF796542       250201","","126.5","","1690112.14"
"2025-02-04","2025-02-01","SF FuneralF1017042      250201","","126.5","","1690238.64"
"2025-02-04","2025-02-01","SF FuneralF828064       250201","","126.5","","1690365.14"
"2025-02-04","2025-02-01","SF FuneralFDC0000000JV5C250201","","191.5","","1690556.64"
"2025-02-04","2025-02-01","SF FuneralFDC0000000JVRY250201","","126.5","","1690683.14"
"2025-02-04","2025-02-01","SF FuneralF1021460      250201","","126.5","","1690809.64"
"2025-02-04","2025-02-01","SF FuneralF1021476      250201","","126.5","","1690936.14"
"2025-02-04","2025-02-01","SF FuneralF1021932      250201","","126.5","","1691062.64"
"2025-02-04","2025-02-01","SF FuneralFDC0000000JZ3N250201","","126.5","","1691189.14"
"2025-02-04","2025-02-01","SF FuneralF1055179      250201","","126.5","","1691315.64"
"2025-02-04","2025-02-01","SF FuneralF1055215      250201","","126.5","","1691442.14"
"2025-02-04","2025-02-01","SF FuneralF1058758      250201","","126.5","","1691568.64"
"2025-02-04","2025-02-01","SF FuneralF1058806      250201","","126.5","","1691695.14"
"2025-02-04","2025-02-01","SF FuneralF1058807      250201","","126.5","","1691821.64"
"2025-02-04","2025-02-01","SF FuneralF1059433      250201","","126.5","","1691948.14"
"2025-02-04","2025-02-01","SF FuneralF1059866      250201","","126.5","","1692074.64"
"2025-02-04","2025-02-01","SF FuneralF1060059      250201","","126.5","","1692201.14"
"2025-02-04","2025-02-01","SF FuneralF1060808      250201","","126.5","","1692327.64"
"2025-02-04","2025-02-01","SF FuneralF1060894      250201","","126.5","","1692454.14"
"2025-02-04","2025-02-01","SF FuneralF1060917      250201","","126.5","","1692580.64"
"2025-02-04","2025-02-01","SF FuneralFDC0000000KKYW250201","","126.5","","1692707.14"
"2025-02-04","2025-02-01","SF FuneralF1066578      250201","","386.5","","1693093.64"
"2025-02-04","2025-02-01","SF FuneralF990615       250201","","126.5","","1693220.14"
"2025-02-04","2025-02-01","SF FuneralF1073295      250201","","126.5","","1693346.64"
"2025-02-04","2025-02-01","SF FuneralF1073681      250201","","126.5","","1693473.14"
"2025-02-04","2025-02-01","SF FuneralFDC0000000LBJ3250201","","191.5","","1693664.64"
"2025-02-04","2025-02-01","SF FuneralF1075142      250202","","126.5","","1693791.14"
"2025-02-04","2025-02-01","SF FuneralFDC0000000LDMM250201","","126.5","","1693917.64"
"2025-02-04","2025-02-01","SF FuneralFDC0000000LF86250201","","126.5","","1694044.14"
"2025-02-04","2025-02-01","SF FuneralF1079159      250201","","126.5","","1694170.64"
"2025-02-04","2025-02-01","SF FuneralF1084305      250201","","126.5","","1694297.14"
"2025-02-04","2025-02-01","SF FuneralFDC0000000LY13250202","","126.5","","1694423.64"
"2025-02-04","2025-02-01","SF FuneralF1084888      250201","","126.5","","1694550.14"
"2025-02-04","2025-02-01","SF FuneralF1085324      250201","","126.5","","1694676.64"
"2025-02-04","2025-02-01","SF FuneralFDC0000000M1TB250201","","126.5","","1694803.14"
"2025-02-04","2025-02-01","SF FuneralF1093787      250201","","126.5","","1694929.64"
"2025-02-04","2025-02-01","SF FuneralF1108818      250201","","126.5","","1695056.14"
"2025-02-04","2025-02-01","SF FuneralF1109036      250201","","126.5","","1695182.64"
"2025-02-04","2025-02-01","SF FuneralFDC0000000MKPT250201","","126.5","","1695309.14"
"2025-02-04","2025-02-01","SF FuneralFDC0000000MLRQ250201","","126.5","","1695435.64"
"2025-02-04","2025-02-01","SF FuneralFDC0000000MMVR250201","","126.5","","1695562.14"
"2025-02-04","2025-02-01","SF FuneralF789174       250201","","256.5","","1695818.64"
"2025-02-04","2025-02-01","SF FuneralF1110617      250201","","126.5","","1695945.14"
"2025-02-04","2025-02-01","SF FuneralF1112283      250201","","126.5","","1696071.64"
"2025-02-04","2025-02-01","SF FuneralF1113978      250201","","126.5","","1696198.14"
"2025-02-04","2025-02-01","SF FuneralFDC0000000N7NH250201","","126.5","","1696324.64"
"2025-02-04","2025-02-01","SF FuneralFDC0000000N7W0250201","","126.5","","1696451.14"
"2025-02-04","2025-02-01","SF FuneralFDC0000000N9JB250201","","126.5","","1696577.64"
"2025-02-04","2025-02-01","SF FuneralFDC0000000N9JS250201","","126.5","","1696704.14"
"2025-02-04","2025-02-01","SF FuneralFDC0000000NLPW250201","","126.5","","1696830.64"
"2025-02-04","2025-02-01","SF FuneralF1117987      250201","","126.5","","1696957.14"
"2025-02-04","2025-02-01","SF FuneralF1118261      250201","","126.5","","1697083.64"
"2025-02-04","2025-02-01","SF FuneralFDC0000000NXT7250201","","220","","1697303.64"
"2025-02-04","2025-02-01","SF FuneralF765108       250201","","220","","1697523.64"
"2025-02-04","2025-02-01","SF FuneralF1122011      250201","","126.5","","1697650.14"
"2025-02-04","2025-02-01","SF FuneralFDC00000002W5P250201","","220","","1697870.14"
"2025-02-04","2025-02-01","SF FuneralF1129058      250201","","126.5","","1697996.64"
"2025-02-04","2025-02-03","SF FuneralFDC00000006PQZ250203","","126.5","","1698123.14"
"2025-02-04","2025-02-01","SF FuneralF1122242      250201","","126.5","","1698249.64"
"2025-02-04","2025-02-01","SF FuneralF1122261      250201","","126.5","","1698376.14"
"2025-02-04","2025-02-01","SF FuneralF1122267      250201","","126.5","","1698502.64"
"2025-02-04","2025-02-01","SF FuneralFDC0000000P0WJ250201","","126.5","","1698629.14"
"2025-02-04","2025-02-01","SF FuneralF1122669      250201","","126.5","","1698755.64"
"2025-02-04","2025-02-01","SF FuneralF1122903      250201","","126.5","","1698882.14"
"2025-02-04","2025-02-01","SF FuneralF1123285      250201","","126.5","","1699008.64"
"2025-02-04","2025-02-01","SF FuneralFDC0000000PYBJ250201","","126.5","","1699135.14"
"2025-02-04","2025-02-01","SF FuneralF1129326      250201","","126.5","","1699261.64"
"2025-02-04","2025-02-01","SF FuneralFDC0000000PYXM250201","","220","","1699481.64"
"2025-02-04","2025-02-03","SF FuneralFDC00000003G42250202","","220","","1699701.64"
"2025-02-04","2025-02-03","SF FuneralFDC000000041TN250202","","220","","1699921.64"
"2025-02-04","2025-02-03","SF FuneralFDC00000004509250202","","220","","1700141.64"
"2025-02-04","2025-02-03","SF FuneralFDC00000006G5M250202","","126.5","","1700268.14"
"2025-02-04","2025-02-03","SF FuneralFDC000000075FC250202","","126.5","","1700394.64"
"2025-02-04","2025-02-03","SF FuneralFDC000000075G7250202","","126.5","","1700521.14"
"2025-02-04","2025-02-03","SF FuneralFDC0000000866L250203","","126.5","","1700647.64"
"2025-02-04","2025-02-03","SF FuneralF802925       250202","","126.5","","1700774.14"
"2025-02-04","2025-02-03","SF FuneralF812171       250203","","126.5","","1700900.64"
"2025-02-04","2025-02-03","SF FuneralF816698       250202","","126.5","","1701027.14"
"2025-02-04","2025-02-03","SF FuneralF842967       250201","","191.5","","1701218.64"
"2025-02-04","2025-02-03","SF FuneralF843641       250201","","126.5","","1701345.14"
"2025-02-04","2025-02-03","SF FuneralF843653       250201","","126.5","","1701471.64"
"2025-02-04","2025-02-03","SF FuneralF781975       250201","","126.5","","1701598.14"
"2025-02-04","2025-02-04","SF FuneralFDC00000005MNV250204","","126.5","","1701724.64"
"2025-02-04","2025-02-04","SF FuneralFDC00000005MP0250204","","126.5","","1701851.14"
"2025-02-04","2025-02-04","SF FuneralFDC00000006R1Q250204","","126.5","","1701977.64"
"2025-02-04","2025-02-04","SF FuneralFDC00000007G81250204","","63.25","","1702040.89"
"2025-02-04","2025-02-04","SF FuneralF801331       250204","","31.63","","1702072.52"
"2025-02-04","2025-02-04","SF FuneralF1022184      250204","","31.63","","1702104.15"
"2025-02-04","2025-02-04","SF FuneralFDC0000000KCRX250204","","126.5","","1702230.65"
"2025-02-04","2025-02-04","SF FuneralF1125777      250204","","31.63","","1702262.28"
"2025-02-04","2025-02-02","SF FuneralFDC0000000BQXN250202","","126.5","","1702388.78"
"2025-02-04","2025-02-02","SF FuneralF832765       250202","","126.5","","1702515.28"
"2025-02-04","2025-01-27","SF FuneralFDC0000000HXW8250127","","126.5","","1702641.78"
"2025-02-04","2025-01-30","SF FuneralFDC00000006GP9250130","","126.5","","1702768.28"
"2025-02-04","2025-01-30","SF FuneralF812228       250130","","126.5","","1702894.78"
"2025-02-04","2025-01-30","SF FuneralF1084366      250130","","126.5","","1703021.28"
"2025-02-04","2025-01-30","SF FuneralF1113744      250130","","126.5","","1703147.78"
"2025-02-04","2025-01-30","SF FuneralF1121996      250130","","126.5","","1703274.28"
"2025-02-04","2025-01-28","SF FuneralF798312       250128","","126.5","","1703400.78"
"2025-02-04","2025-01-28","SF FuneralF1094335      250128","","126.5","","1703527.28"
"2025-02-04","2025-01-28","SF FuneralF1122600      250128","","126.5","","1703653.78"
"2025-02-04","2025-01-29","SF FuneralFDC000000067LX250129","","126.5","","1703780.28"
"2025-02-04","2025-01-29","SF FuneralFDC00000006MZH250129","","126.5","","1703906.78"
"2025-02-04","2025-01-29","SF FuneralFDC000000076N2250129","","126.5","","1704033.28"
"2025-02-04","2025-01-29","SF FuneralF834993       250129","","126.5","","1704159.78"
"2025-02-04","2025-01-29","SF FuneralF992486       250129","","126.5","","1704286.28"
"2025-02-04","2025-01-29","SF FuneralF993446       250129","","126.5","","1704412.78"
"2025-02-04","2025-01-29","SF FuneralF1074886      250129","","126.5","","1704539.28"
"2025-02-04","2025-01-31","SF FuneralFDC0000000736K250131","","126.5","","1704665.78"
"2025-02-04","2025-01-31","SF FuneralFDC000000077SY250131","","126.5","","1704792.28"
"2025-02-04","2025-01-31","SF FuneralF901095       250201","","126.5","","1704918.78"
"2025-02-04","2025-01-31","SF FuneralF901189       250201","","126.5","","1705045.28"
"2025-02-04","2025-01-31","SF FuneralF901400       250201","","126.5","","1705171.78"
"2025-02-04","2025-01-31","SF FuneralF980932       250201","","126.5","","1705298.28"
"2025-02-04","2025-01-31","SF FuneralF980943       250201","","126.5","","1705424.78"
"2025-02-04","2025-01-31","SF FuneralF980942       250201","","126.5","","1705551.28"
"2025-02-04","2025-01-31","SF FuneralFDC0000000H9WB250201","","126.5","","1705677.78"
"2025-02-04","2025-01-31","SF FuneralF986701       250201","","126.5","","1705804.28"
"2025-02-04","2025-01-31","SF FuneralFDC0000000HLPG250201","","126.5","","1705930.78"
"2025-02-04","2025-01-31","SF FuneralF987598       250131","","126.5","","1706057.28"
"2025-02-04","2025-01-31","SF FuneralF987615       250201","","126.5","","1706183.78"
"2025-02-04","2025-01-31","SF FuneralF988095       250201","","126.5","","1706310.28"
"2025-02-04","2025-01-31","SF FuneralF988105       250201","","126.5","","1706436.78"
"2025-02-04","2025-01-31","SF FuneralF988161       250201","","126.5","","1706563.28"
"2025-02-04","2025-01-31","SF FuneralFDC0000000HVTY250201","","126.5","","1706689.78"
"2025-02-04","2025-01-31","SF FuneralF841564       250201","","126.5","","1706816.28"
"2025-02-04","2025-01-31","SF FuneralF812243       250201","","126.5","","1706942.78"
"2025-02-04","2025-01-31","SF FuneralF988558       250201","","126.5","","1707069.28"
"2025-02-04","2025-01-31","SF FuneralF989195       250201","","126.5","","1707195.78"
"2025-02-04","2025-01-31","SF FuneralF989241       250201","","126.5","","1707322.28"
"2025-02-04","2025-01-31","SF FuneralF989454       250201","","126.5","","1707448.78"
"2025-02-04","2025-01-31","SF FuneralF989461       250201","","126.5","","1707575.28"
"2025-02-04","2025-01-31","SF FuneralF990632       250201","","126.5","","1707701.78"
"2025-02-04","2025-01-31","SF FuneralF1125148      250131","","126.5","","1707828.28"
"2025-02-04","2025-02-01","SF FuneralFDC00000002VCM250201","","220","","1708048.28"
"2025-02-04","2025-02-01","SF FuneralFDC00000002VKC250201","","220","","1708268.28"
"2025-02-04","2025-02-01","SF FuneralFDC00000002VYW250201","","220","","1708488.28"
"2025-02-04","2025-02-01","SF FuneralFDC000000033SY250201","","220","","1708708.28"
"2025-02-04","2025-02-01","SF FuneralFDC00000004G93250201","","220","","1708928.28"
"2025-02-04","2025-02-01","SF FuneralFDC000000058N7250201","","126.5","","1709054.78"
"2025-02-04","2025-02-01","SF FuneralFDC00000005F2D250201","","126.5","","1709181.28"
"2025-02-04","2025-02-01","SF FuneralFDC00000005HYC250201","","220","","1709401.28"
"2025-02-04","2025-02-01","SF FuneralFDC00000005LYP250201","","220","","1709621.28"
"2025-02-04","2025-02-01","SF FuneralFDC00000005Z94250201","","126.5","","1709747.78"
"2025-02-04","2025-02-01","SF FuneralFDC000000063NT250201","","126.5","","1709874.28"
"2025-02-04","2025-02-01","SF FuneralFDC0000000680H250201","","126.5","","1710000.78"
"2025-02-04","2025-02-01","SF FuneralFDC0000000683X250201","","126.5","","1710127.28"
"2025-02-04","2025-02-01","SF FuneralFDC0000000688X250201","","126.5","","1710253.78"
"2025-02-04","2025-02-01","SF FuneralFDC0000000697M250201","","126.5","","1710380.28"
"2025-02-04","2025-02-01","SF FuneralFDC000000069Y7250201","","126.5","","1710506.78"
"2025-02-04","2025-02-01","SF FuneralFDC00000006BFB250201","","126.5","","1710633.28"
"2025-02-04","2025-02-01","SF FuneralFDC00000006BNH250201","","126.5","","1710759.78"
"2025-02-04","2025-02-01","SF FuneralFDC00000006BQX250201","","126.5","","1710886.28"
"2025-02-04","2025-02-01","SF FuneralFDC00000006CFT250201","","126.5","","1711012.78"
"2025-02-04","2025-02-01","SF FuneralFDC00000006DRL250201","","126.5","","1711139.28"
"2025-02-04","2025-02-01","SF FuneralFDC00000006F5R250201","","126.5","","1711265.78"
"2025-02-04","2025-02-01","SF FuneralFDC00000006FVH250201","","126.5","","1711392.28"
"2025-02-04","2025-02-01","SF FuneralFDC00000006FXN250201","","126.5","","1711518.78"
"2025-02-04","2025-02-01","SF FuneralFDC00000006GPH250201","","126.5","","1711645.28"
"2025-02-04","2025-02-01","SF FuneralFDC00000006GVN250201","","126.5","","1711771.78"
"2025-02-04","2025-02-01","SF FuneralFDC00000006H70250201","","126.5","","1711898.28"
"2025-02-04","2025-02-01","SF FuneralFDC00000006KH0250201","","126.5","","1712024.78"
"2025-02-04","2025-02-01","SF FuneralFDC00000006LYX250201","","126.5","","1712151.28"
"2025-02-04","2025-02-01","SF FuneralFDC00000006NVV250201","","126.5","","1712277.78"
"2025-02-04","2025-02-01","SF FuneralFDC00000006RYM250201","","126.5","","1712404.28"
"2025-02-04","2025-02-01","SF FuneralFDC00000006S94250201","","126.5","","1712530.78"
"2025-02-04","2025-02-01","SF FuneralFDC00000006ZYP250201","","126.5","","1712657.28"
"2025-02-04","2025-02-01","SF FuneralFDC0000000712R250201","","126.5","","1712783.78"
"2025-02-04","2025-02-01","SF FuneralFDC000000073Q5250201","","126.5","","1712910.28"
"2025-02-04","2025-02-01","SF FuneralFDC0000000746Z250201","","126.5","","1713036.78"
"2025-02-04","2025-02-01","SF FuneralFDC000000074ZK250201","","126.5","","1713163.28"
"2025-02-04","2025-02-01","SF FuneralFDC00000007578250201","","126.5","","1713289.78"
"2025-02-04","2025-02-01","SF FuneralFDC000000075FJ250201","","126.5","","1713416.28"
"2025-02-04","2025-02-01","SF FuneralFDC000000076MN250201","","126.5","","1713542.78"
"2025-02-04","2025-02-01","SF FuneralFDC0000000798G250201","","126.5","","1713669.28"
"2025-02-04","2025-02-01","SF FuneralFDC00000007B6S250201","","126.5","","1713795.78"
"2025-02-04","2025-02-01","SF FuneralFDC00000007CG3250201","","126.5","","1713922.28"
"2025-02-04","2025-02-01","SF FuneralFDC00000007DMX250201","","220","","1714142.28"
"2025-02-04","2025-02-01","SF FuneralFDC00000007DRC250201","","126.5","","1714268.78"
"2025-02-04","2025-02-01","SF FuneralFDC00000007F7V250201","","126.5","","1714395.28"
"2025-02-04","2025-02-01","SF FuneralFDC00000007FR6250201","","126.5","","1714521.78"
"2025-02-04","2025-02-01","SF FuneralFDC00000007P25250201","","126.5","","1714648.28"
"2025-02-04","2025-02-01","SF FuneralFDC00000007P2H250201","","126.5","","1714774.78"
"2025-02-04","2025-02-01","SF FuneralFDC00000007PW2250201","","126.5","","1714901.28"
"2025-02-04","2025-02-01","SF FuneralFDC00000007QG6250201","","126.5","","1715027.78"
"2025-02-04","2025-02-01","SF FuneralF793932       250201","","126.5","","1715154.28"
"2025-02-04","2025-02-01","SF FuneralFDC00000007QMY250201","","126.5","","1715280.78"
"2025-02-04","2025-02-01","SF FuneralFDC00000007RG9250201","","126.5","","1715407.28"
"2025-02-04","2025-02-01","SF FuneralFDC00000007S2G250201","","126.5","","1715533.78"
"2025-02-04","2025-02-01","SF FuneralF794675       250201","","126.5","","1715660.28"
"2025-02-04","2025-02-01","SF FuneralFDC00000007SXX250201","","126.5","","1715786.78"
"2025-02-04","2025-02-01","SF FuneralF794882       250201","","126.5","","1715913.28"
"2025-02-04","2025-02-01","SF FuneralFDC00000007TKR250201","","126.5","","1716039.78"
"2025-02-04","2025-02-01","SF FuneralFDC00000007WYG250201","","126.5","","1716166.28"
"2025-02-04","2025-02-01","SF FuneralFDC00000007ZD0250201","","126.5","","1716292.78"
"2025-02-04","2025-02-01","SF FuneralFDC000000083H6250201","","126.5","","1716419.28"
"2025-02-04","2025-02-01","SF FuneralF798031       250201","","126.5","","1716545.78"
"2025-02-04","2025-02-01","SF FuneralF798034       250201","","126.5","","1716672.28"
"2025-02-04","2025-02-01","SF FuneralF798189       250201","","126.5","","1716798.78"
"2025-02-04","2025-02-01","SF FuneralF798267       250201","","126.5","","1716925.28"
"2025-02-04","2025-02-01","SF FuneralFDC000000084X4250201","","126.5","","1717051.78"
"2025-02-04","2025-02-01","SF FuneralF799195       250201","","126.5","","1717178.28"
"2025-02-04","2025-02-01","SF FuneralFDC000000086YL250201","","256.5","","1717434.78"
"2025-02-04","2025-02-01","SF FuneralF799361       250201","","126.5","","1717561.28"
"2025-02-04","2025-02-01","SF FuneralF799379       250201","","126.5","","1717687.78"
"2025-02-04","2025-02-01","SF FuneralFDC000000087D8250201","","126.5","","1717814.28"
"2025-02-04","2025-02-01","SF FuneralFDC000000089VT250201","","126.5","","1717940.78"
"2025-02-04","2025-02-01","SF FuneralF802198       250201","","126.5","","1718067.28"
"2025-02-04","2025-02-01","SF FuneralF789710       250201","","126.5","","1718193.78"
"2025-02-04","2025-02-01","SF FuneralF802589       250201","","126.5","","1718320.28"
"2025-02-04","2025-02-01","SF FuneralF802610       250201","","126.5","","1718446.78"
"2025-02-04","2025-02-01","SF FuneralF802826       250201","","126.5","","1718573.28"
"2025-02-04","2025-02-01","SF FuneralF802844       250201","","126.5","","1718699.78"
"2025-02-04","2025-02-01","SF FuneralF784219       250201","","126.5","","1718826.28"
"2025-02-04","2025-02-01","SF FuneralF804039       250201","","126.5","","1718952.78"
"2025-02-04","2025-02-01","SF FuneralF804113       250201","","126.5","","1719079.28"
"2025-02-04","2025-02-01","SF FuneralF804537       250201","","126.5","","1719205.78"
"2025-02-04","2025-02-01","SF FuneralF786912       250201","","126.5","","1719332.28"
"2025-02-04","2025-02-01","SF FuneralFDC00000008T61250201","","126.5","","1719458.78"
"2025-02-04","2025-02-01","SF FuneralF805817       250201","","126.5","","1719585.28"
"2025-02-04","2025-02-01","SF FuneralFDC00000008ZBR250201","","191.5","","1719776.78"
"2025-02-04","2025-02-01","SF FuneralFDC00000008ZPZ250201","","126.5","","1719903.28"
"2025-02-04","2025-02-01","SF FuneralF808855       250201","","126.5","","1720029.78"
"2025-02-04","2025-02-01","SF FuneralF809022       250201","","126.5","","1720156.28"
"2025-02-04","2025-02-01","SF FuneralF809160       250201","","126.5","","1720282.78"
"2025-02-04","2025-02-01","SF FuneralF810288       250201","","126.5","","1720409.28"
"2025-02-04","2025-02-01","SF FuneralF810793       250201","","126.5","","1720535.78"
"2025-02-04","2025-02-01","SF FuneralF812102       250201","","126.5","","1720662.28"
"2025-02-04","2025-02-01","SF FuneralF812177       250201","","126.5","","1720788.78"
"2025-02-04","2025-02-01","SF FuneralF813009       250201","","126.5","","1720915.28"
"2025-02-04","2025-02-01","SF FuneralF813058       250201","","126.5","","1721041.78"
"2025-02-04","2025-02-01","SF FuneralFDC00000009GML250201","","126.5","","1721168.28"
"2025-02-04","2025-02-01","SF FuneralF813085       250201","","126.5","","1721294.78"
"2025-02-04","2025-02-01","SF FuneralF813252       250201","","126.5","","1721421.28"
"2025-02-04","2025-02-01","SF FuneralFDC00000009JFJ250201","","126.5","","1721547.78"
"2025-02-04","2025-02-01","SF FuneralFDC00000009KM3250201","","126.5","","1721674.28"
"2025-02-04","2025-02-01","SF FuneralF814343       250201","","126.5","","1721800.78"
"2025-02-04","2025-02-01","SF FuneralFDC00000009MJN250201","","126.5","","1721927.28"
"2025-02-04","2025-02-01","SF FuneralF816679       250201","","126.5","","1722053.78"
"2025-02-04","2025-02-01","SF FuneralFDC00000009WXB250201","","126.5","","1722180.28"
"2025-02-04","2025-02-01","SF FuneralF816912       250201","","126.5","","1722306.78"
"2025-02-04","2025-02-01","SF FuneralF816956       250201","","126.5","","1722433.28"
"2025-02-04","2025-02-01","SF FuneralF817195       250201","","126.5","","1722559.78"
"2025-02-04","2025-02-01","SF FuneralF817220       250201","","126.5","","1722686.28"
"2025-02-04","2025-02-01","SF FuneralF817255       250201","","126.5","","1722812.78"
"2025-02-04","2025-02-01","SF FuneralF817431       250201","","126.5","","1722939.28"
"2025-02-04","2025-02-01","SF FuneralF817523       250201","","126.5","","1723065.78"
"2025-02-04","2025-02-01","SF FuneralF817762       250201","","126.5","","1723192.28"
"2025-02-04","2025-02-01","SF FuneralF818082       250201","","126.5","","1723318.78"
"2025-02-04","2025-02-01","SF FuneralF820352       250201","","126.5","","1723445.28"
"2025-02-04","2025-02-01","SF FuneralF820369       250201","","126.5","","1723571.78"
"2025-02-04","2025-02-01","SF FuneralF812538       250201","","126.5","","1723698.28"
"2025-02-04","2025-02-01","SF FuneralF820579       250201","","126.5","","1723824.78"
"2025-02-04","2025-02-01","SF FuneralF820639       250201","","126.5","","1723951.28"
"2025-02-04","2025-02-01","SF FuneralF820758       250201","","126.5","","1724077.78"
"2025-02-04","2025-02-01","SF FuneralF821192       250201","","126.5","","1724204.28"
"2025-02-04","2025-02-01","SF FuneralF821523       250201","","126.5","","1724330.78"
"2025-02-04","2025-02-01","SF FuneralF821558       250201","","126.5","","1724457.28"
"2025-02-04","2025-02-01","SF FuneralF796028       250201","","126.5","","1724583.78"
"2025-02-04","2025-02-01","SF FuneralF822681       250201","","126.5","","1724710.28"
"2025-02-04","2025-02-01","SF FuneralF823985       250201","","126.5","","1724836.78"
"2025-02-04","2025-02-01","SF FuneralFDC0000000BM1F250201","","126.5","","1724963.28"
"2025-02-04","2025-02-01","SF FuneralF827926       250201","","126.5","","1725089.78"
"2025-02-04","2025-02-01","SF FuneralF828015       250201","","126.5","","1725216.28"
"2025-02-04","2025-02-01","SF FuneralF828030       250201","","126.5","","1725342.78"
"2025-02-04","2025-02-01","SF FuneralFDC0000000BNVM250201","","126.5","","1725469.28"
"2025-02-04","2025-02-01","SF FuneralF828133       250201","","126.5","","1725595.78"
"2025-02-04","2025-02-01","SF FuneralF788407       250201","","126.5","","1725722.28"
"2025-02-04","2025-02-01","SF FuneralF828343       250201","","126.5","","1725848.78"
"2025-02-04","2025-02-01","SF FuneralF828345       250201","","126.5","","1725975.28"
"2025-02-04","2025-02-01","SF FuneralF828369       250201","","126.5","","1726101.78"
"2025-02-04","2025-02-01","SF FuneralFDC0000000BPJF250201","","126.5","","1726228.28"
"2025-02-04","2025-02-01","SF FuneralF828375       250201","","126.5","","1726354.78"
"2025-02-04","2025-02-01","SF FuneralF828389       250201","","126.5","","1726481.28"
"2025-02-04","2025-02-01","SF FuneralF815209       250201","","126.5","","1726607.78"
"2025-02-04","2025-02-01","SF FuneralF828705       250201","","126.5","","1726734.28"
"2025-02-04","2025-02-01","SF FuneralF828734       250201","","126.5","","1726860.78"
"2025-02-04","2025-02-01","SF FuneralF828744       250201","","126.5","","1726987.28"
"2025-02-04","2025-02-01","SF FuneralF828783       250201","","126.5","","1727113.78"
"2025-02-04","2025-02-01","SF FuneralF829073       250201","","126.5","","1727240.28"
"2025-02-04","2025-02-01","SF FuneralF829572       250201","","126.5","","1727366.78"
"2025-02-04","2025-02-01","SF FuneralF829662       250201","","126.5","","1727493.28"
"2025-02-04","2025-02-01","SF FuneralF829669       250201","","126.5","","1727619.78"
"2025-02-04","2025-02-01","SF FuneralF830032       250201","","126.5","","1727746.28"
"2025-02-04","2025-02-01","SF FuneralF830399       250201","","126.5","","1727872.78"
"2025-02-04","2025-02-01","SF FuneralF830559       250201","","126.5","","1727999.28"
"2025-02-04","2025-02-01","SF FuneralF830681       250201","","126.5","","1728125.78"
"2025-02-04","2025-02-01","SF FuneralF830686       250201","","126.5","","1728252.28"
"2025-02-04","2025-02-01","SF FuneralF831863       250201","","126.5","","1728378.78"
"2025-02-04","2025-02-01","SF FuneralF832016       250201","","126.5","","1728505.28"
"2025-02-04","2025-02-01","SF FuneralF832448       250201","","126.5","","1728631.78"
"2025-02-04","2025-02-01","SF FuneralF832510       250201","","126.5","","1728758.28"
"2025-02-04","2025-02-01","SF FuneralF832536       250201","","126.5","","1728884.78"
"2025-02-04","2025-02-01","SF FuneralF832664       250201","","126.5","","1729011.28"
"2025-02-04","2025-02-01","SF FuneralF833260       250201","","126.5","","1729137.78"
"2025-02-04","2025-02-01","SF FuneralF834605       250201","","126.5","","1729264.28"
"2025-02-04","2025-02-01","SF FuneralF834657       250201","","126.5","","1729390.78"
"2025-02-04","2025-02-01","SF FuneralF841402       250201","","126.5","","1729517.28"
"2025-02-04","2025-02-01","SF FuneralF841428       250201","","126.5","","1729643.78"
"2025-02-04","2025-02-01","SF FuneralF841433       250201","","126.5","","1729770.28"
"2025-02-04","2025-02-01","SF FuneralF841624       250201","","126.5","","1729896.78"
"2025-02-04","2025-02-01","SF FuneralF841824       250201","","126.5","","1730023.28"
"2025-02-04","2025-02-01","SF FuneralF842015       250201","","126.5","","1730149.78"
"2025-02-04","2025-02-01","SF FuneralF842120       250201","","126.5","","1730276.28"
"2025-02-04","2025-02-01","SF FuneralF842175       250201","","126.5","","1730402.78"
"2025-02-04","2025-02-01","SF FuneralF842271       250201","","126.5","","1730529.28"
"2025-02-04","2025-02-01","SF FuneralF842268       250201","","126.5","","1730655.78"
"2025-02-04","2025-02-01","SF FuneralF842292       250201","","126.5","","1730782.28"
"2025-02-04","2025-02-01","SF FuneralF842325       250201","","126.5","","1730908.78"
"2025-02-04","2025-02-01","SF FuneralF842673       250201","","126.5","","1731035.28"
"2025-02-04","2025-02-01","SF FuneralF842738       250201","","126.5","","1731161.78"
"2025-02-04","2025-02-01","SF FuneralF992276       250201","","126.5","","1731288.28"
"2025-02-04","2025-02-01","SF FuneralF992343       250201","","126.5","","1731414.78"
"2025-02-04","2025-02-01","SF FuneralF992349       250201","","126.5","","1731541.28"
"2025-02-04","2025-02-01","SF FuneralF992373       250201","","126.5","","1731667.78"
"2025-02-04","2025-02-01","SF FuneralF992455       250201","","126.5","","1731794.28"
"2025-02-04","2025-02-01","SF FuneralF992754       250201","","126.5","","1731920.78"
"2025-02-04","2025-02-01","SF FuneralF993306       250201","","126.5","","1732047.28"
"2025-02-04","2025-02-01","SF FuneralF993375       250201","","126.5","","1732173.78"
"2025-02-04","2025-02-01","SF FuneralF993432       250201","","126.5","","1732300.28"
"2025-02-04","2025-02-01","SF FuneralFDC0000000JD0W250201","","126.5","","1732426.78"
"2025-02-04","2025-02-01","SF FuneralF994043       250201","","126.5","","1732553.28"
"2025-02-04","2025-02-01","SF FuneralF793647       250201","","191.5","","1732744.78"
"2025-02-04","2025-02-01","SF FuneralF1017067      250201","","126.5","","1732871.28"
"2025-02-04","2025-02-01","SF FuneralF1021314      250201","","126.5","","1732997.78"
"2025-02-04","2025-02-01","SF FuneralF1021515      250201","","126.5","","1733124.28"
"2025-02-04","2025-02-01","SF FuneralF1021556      250201","","126.5","","1733250.78"
"2025-02-04","2025-02-01","SF FuneralFDC0000000JW3W250201","","126.5","","1733377.28"
"2025-02-04","2025-02-01","SF FuneralF1021621      250201","","126.5","","1733503.78"
"2025-02-04","2025-02-01","SF FuneralF1021712      250201","","126.5","","1733630.28"
"2025-02-04","2025-02-01","SF FuneralF1021805      250201","","126.5","","1733756.78"
"2025-02-04","2025-02-01","SF FuneralF1022202      250201","","126.5","","1733883.28"
"2025-02-04","2025-02-01","SF FuneralF1033553      250201","","126.5","","1734009.78"
"2025-02-04","2025-02-01","SF FuneralF1033710      250201","","126.5","","1734136.28"
"2025-02-04","2025-02-01","SF FuneralF1050857      250201","","126.5","","1734262.78"
"2025-02-04","2025-02-01","SF FuneralF1052434      250201","","126.5","","1734389.28"
"2025-02-04","2025-02-01","SF FuneralF1054961      250201","","126.5","","1734515.78"
"2025-02-04","2025-02-01","SF FuneralF1054996      250201","","126.5","","1734642.28"
"2025-02-04","2025-02-01","SF FuneralF1055101      250201","","126.5","","1734768.78"
"2025-02-04","2025-02-01","SF FuneralF1055252      250201","","126.5","","1734895.28"
"2025-02-04","2025-02-01","SF FuneralF1058690      250201","","126.5","","1735021.78"
"2025-02-04","2025-02-01","SF FuneralF1058731      250201","","126.5","","1735148.28"
"2025-02-04","2025-02-01","SF FuneralFDC0000000K9KF250201","","126.5","","1735274.78"
"2025-02-04","2025-02-01","SF FuneralF1058816      250201","","126.5","","1735401.28"
"2025-02-04","2025-02-01","SF FuneralF1059495      250201","","126.5","","1735527.78"
"2025-02-04","2025-02-01","SF FuneralF1060074      250201","","126.5","","1735654.28"
"2025-02-04","2025-02-01","SF FuneralF1060699      250201","","126.5","","1735780.78"
"2025-02-04","2025-02-01","SF FuneralF1060801      250201","","126.5","","1735907.28"
"2025-02-04","2025-02-01","SF FuneralF1061011      250201","","126.5","","1736033.78"
"2025-02-04","2025-02-01","SF FuneralF1065983      250201","","126.5","","1736160.28"
"2025-02-04","2025-02-01","SF FuneralF1066221      250201","","126.5","","1736286.78"
"2025-02-04","2025-02-01","SF FuneralF1066593      250201","","126.5","","1736413.28"
"2025-02-04","2025-02-01","SF FuneralF1066650      250201","","126.5","","1736539.78"
"2025-02-04","2025-02-01","SF FuneralF1066788      250201","","126.5","","1736666.28"
"2025-02-04","2025-02-01","SF FuneralF1072941      250201","","126.5","","1736792.78"
"2025-02-04","2025-02-01","SF FuneralF1073786      250201","","126.5","","1736919.28"
"2025-02-04","2025-02-01","SF FuneralF1075268      250202","","126.5","","1737045.78"
"2025-02-04","2025-02-01","SF FuneralF1075280      250201","","126.5","","1737172.28"
"2025-02-04","2025-02-01","SF FuneralF1078095      250201","","126.5","","1737298.78"
"2025-02-04","2025-02-01","SF FuneralF1078338      250201","","126.5","","1737425.28"
"2025-02-04","2025-02-01","SF FuneralF1078368      250201","","126.5","","1737551.78"
"2025-02-04","2025-02-01","SF FuneralF788384       250201","","126.5","","1737678.28"
"2025-02-04","2025-02-01","SF FuneralF1078680      250201","","126.5","","1737804.78"
"2025-02-04","2025-02-01","SF FuneralFDC0000000LJPF250201","","126.5","","1737931.28"
"2025-02-04","2025-02-01","SF FuneralF1079822      250201","","126.5","","1738057.78"
"2025-02-04","2025-02-01","SF FuneralF1084017      250202","","126.5","","1738184.28"
"2025-02-04","2025-02-01","SF FuneralF1084443      250201","","126.5","","1738310.78"
"2025-02-04","2025-02-01","SF FuneralF1084684      250201","","126.5","","1738437.28"
"2025-02-04","2025-02-01","SF FuneralF1085087      250201","","126.5","","1738563.78"
"2025-02-04","2025-02-01","SF FuneralF1085204      250201","","126.5","","1738690.28"
"2025-02-04","2025-02-01","SF FuneralF1085346      250201","","126.5","","1738816.78"
"2025-02-04","2025-02-01","SF FuneralF1102799      250202","","126.5","","1738943.28"
"2025-02-04","2025-02-01","SF FuneralF1103019      250201","","126.5","","1739069.78"
"2025-02-04","2025-02-01","SF FuneralF1108827      250201","","126.5","","1739196.28"
"2025-02-04","2025-02-01","SF FuneralF1108852      250201","","126.5","","1739322.78"
"2025-02-04","2025-02-01","SF FuneralF1109060      250201","","126.5","","1739449.28"
"2025-02-04","2025-02-01","SF FuneralF1109126      250202","","126.5","","1739575.78"
"2025-02-04","2025-02-01","SF FuneralF1109687      250201","","126.5","","1739702.28"
"2025-02-04","2025-02-01","SF FuneralF793753       250201","","191.5","","1739893.78"
"2025-02-04","2025-02-01","SF FuneralF1110042      250201","","126.5","","1740020.28"
"2025-02-04","2025-02-01","SF FuneralFDC0000000ML98250201","","126.5","","1740146.78"
"2025-02-04","2025-02-01","SF FuneralFDC0000000ML9H250201","","126.5","","1740273.28"
"2025-02-04","2025-02-01","SF FuneralFDC0000000MN56250201","","126.5","","1740399.78"
"2025-02-04","2025-02-01","SF FuneralFDC0000000MN5D250201","","126.5","","1740526.28"
"2025-02-04","2025-02-01","SF FuneralF1110522      250201","","126.5","","1740652.78"
"2025-02-04","2025-02-01","SF FuneralF1110795      250201","","126.5","","1740779.28"
"2025-02-04","2025-02-01","SF FuneralF1111359      250201","","126.5","","1740905.78"
"2025-02-04","2025-02-01","SF FuneralF804557       250201","","126.5","","1741032.28"
"2025-02-04","2025-02-01","SF FuneralF1111645      250201","","126.5","","1741158.78"
"2025-02-04","2025-02-01","SF FuneralF1112039      250201","","126.5","","1741285.28"
"2025-02-04","2025-02-01","SF FuneralF1112487      250201","","126.5","","1741411.78"
"2025-02-04","2025-02-01","SF FuneralF1113175      250202","","126.5","","1741538.28"
"2025-02-04","2025-02-01","SF FuneralF1113244      250201","","126.5","","1741664.78"
"2025-02-04","2025-02-01","SF FuneralF1113733      250201","","126.5","","1741791.28"
"2025-02-04","2025-02-01","SF FuneralF1113864      250201","","126.5","","1741917.78"
"2025-02-04","2025-02-01","SF FuneralFDC0000000N5V7250201","","126.5","","1742044.28"
"2025-02-04","2025-02-01","SF FuneralF1113959      250201","","126.5","","1742170.78"
"2025-02-04","2025-02-01","SF FuneralF1114496      250201","","126.5","","1742297.28"
"2025-02-04","2025-02-01","SF FuneralFDC0000000N963250201","","126.5","","1742423.78"
"2025-02-04","2025-02-01","SF FuneralFDC0000000N99D250201","","126.5","","1742550.28"
"2025-02-04","2025-02-01","SF FuneralF1114845      250201","","126.5","","1742676.78"
"2025-02-04","2025-02-01","SF FuneralF1114868      250201","","126.5","","1742803.28"
"2025-02-04","2025-02-01","SF FuneralF1115155      250201","","126.5","","1742929.78"
"2025-02-04","2025-02-01","SF FuneralF1115857      250201","","126.5","","1743056.28"
"2025-02-04","2025-02-01","SF FuneralF1116902      250202","","126.5","","1743182.78"
"2025-02-04","2025-02-01","SF FuneralF1116907      250201","","126.5","","1743309.28"
"2025-02-04","2025-02-01","SF FuneralF1116951      250201","","126.5","","1743435.78"
"2025-02-04","2025-02-01","SF FuneralF1117049      250201","","126.5","","1743562.28"
"2025-02-04","2025-02-01","SF FuneralF1117147      250201","","126.5","","1743688.78"
"2025-02-04","2025-02-01","SF FuneralF1117263      250201","","126.5","","1743815.28"
"2025-02-04","2025-02-01","SF FuneralF1117366      250201","","126.5","","1743941.78"
"2025-02-04","2025-02-01","SF FuneralF1117870      250201","","126.5","","1744068.28"
"2025-02-04","2025-02-01","SF FuneralF1118124      250201","","126.5","","1744194.78"
"2025-02-04","2025-02-01","SF FuneralF1118278      250201","","126.5","","1744321.28"
"2025-02-04","2025-02-01","SF FuneralF1118353      250201","","126.5","","1744447.78"
"2025-02-04","2025-02-01","SF FuneralF1118550      250201","","126.5","","1744574.28"
"2025-02-04","2025-02-01","SF FuneralF1118772      250201","","126.5","","1744700.78"
"2025-02-04","2025-02-01","SF FuneralF1118806      250201","","126.5","","1744827.28"
"2025-02-04","2025-02-01","SF FuneralF1118838      250201","","126.5","","1744953.78"
"2025-02-04","2025-02-01","SF FuneralF1119078      250201","","126.5","","1745080.28"
"2025-02-04","2025-02-01","SF FuneralF1120222      250201","","126.5","","1745206.78"
"2025-02-04","2025-02-01","SF FuneralF1121914      250201","","126.5","","1745333.28"
"2025-02-04","2025-02-01","SF FuneralF1122065      250201","","126.5","","1745459.78"
"2025-02-04","2025-02-01","SF FuneralF1122740      250201","","126.5","","1745586.28"
"2025-02-04","2025-02-01","SF FuneralF1122823      250201","","126.5","","1745712.78"
"2025-02-04","2025-02-01","SF FuneralF1122955      250201","","126.5","","1745839.28"
"2025-02-04","2025-02-01","SF FuneralF1123059      250201","","126.5","","1745965.78"
"2025-02-04","2025-02-01","SF FuneralFDC0000000P3JW250201","","126.5","","1746092.28"
"2025-02-04","2025-02-01","SF FuneralF1123252      250201","","126.5","","1746218.78"
"2025-02-04","2025-02-01","SF FuneralF1123978      250201","","126.5","","1746345.28"
"2025-02-04","2025-02-01","SF FuneralF1124158      250201","","126.5","","1746471.78"
"2025-02-04","2025-02-01","SF FuneralF1124539      250201","","126.5","","1746598.28"
"2025-02-04","2025-02-01","SF FuneralFDC0000000PGJD250201","","126.5","","1746724.78"
"2025-02-04","2025-02-01","SF FuneralF900641       250201","","126.5","","1746851.28"
"2025-02-04","2025-02-01","SF FuneralF1125449      250201","","126.5","","1746977.78"
"2025-02-04","2025-02-01","SF FuneralFDC0000000PHKN250201","","126.5","","1747104.28"
"2025-02-04","2025-02-01","SF FuneralF1125729      250201","","126.5","","1747230.78"
"2025-02-04","2025-02-01","SF FuneralFDC0000000PJVJ250201","","126.5","","1747357.28"
"2025-02-04","2025-02-01","SF FuneralF1126017      250201","","126.5","","1747483.78"
"2025-02-04","2025-02-01","SF FuneralF1126173      250201","","126.5","","1747610.28"
"2025-02-04","2025-02-01","SF FuneralFDC0000000PL08250201","","126.5","","1747736.78"
"2025-02-04","2025-02-01","SF FuneralF1126306      250201","","126.5","","1747863.28"
"2025-02-04","2025-02-01","SF FuneralF1127433      250201","","126.5","","1747989.78"
"2025-02-04","2025-02-01","SF FuneralF1127581      250201","","126.5","","1748116.28"
"2025-02-04","2025-02-01","SF FuneralF1127635      250201","","126.5","","1748242.78"
"2025-02-04","2025-02-01","SF FuneralF1128034      250201","","126.5","","1748369.28"
"2025-02-04","2025-02-01","SF FuneralF1128061      250201","","126.5","","1748495.78"
"2025-02-04","2025-02-01","SF FuneralF1128120      250201","","126.5","","1748622.28"
"2025-02-04","2025-02-01","SF FuneralF1128154      250201","","126.5","","1748748.78"
"2025-02-04","2025-02-01","SF FuneralF1108313      250201","","126.5","","1748875.28"
"2025-02-04","2025-02-01","SF FuneralF1128373      250201","","126.5","","1749001.78"
"2025-02-04","2025-02-01","SF FuneralF1128866      250201","","126.5","","1749128.28"
"2025-02-04","2025-02-01","SF FuneralF1128944      250201","","126.5","","1749254.78"
"2025-02-04","2025-02-01","SF FuneralF1129109      250201","","126.5","","1749381.28"
"2025-02-04","2025-02-01","SF FuneralF1129253      250201","","126.5","","1749507.78"
"2025-02-04","2025-02-01","SF FuneralF1129314      250201","","126.5","","1749634.28"
"2025-02-04","2025-02-01","SF FuneralF1129352      250201","","126.5","","1749760.78"
"2025-02-04","2025-02-01","SF FuneralF1129892      250201","","126.5","","1749887.28"
"2025-02-04","2025-02-03","SF FuneralFDC000000057W9250202","","126.5","","1750013.78"
"2025-02-04","2025-02-03","SF FuneralFDC000000057WN250202","","126.5","","1750140.28"
"2025-02-04","2025-02-03","SF FuneralF808792       250203","","126.5","","1750266.78"
"2025-02-04","2025-02-03","SF FuneralF843025       250201","","126.5","","1750393.28"
"2025-02-04","2025-02-03","SF FuneralF843093       250201","","126.5","","1750519.78"
"2025-02-04","2025-02-03","SF FuneralF843393       250201","","126.5","","1750646.28"
"2025-02-04","2025-02-03","SF FuneralF843519       250201","","126.5","","1750772.78"
"2025-02-04","2025-02-03","SF FuneralF786500       250201","","126.5","","1750899.28"
"2025-02-04","2025-02-03","SF FuneralF789277       250201","","256.5","","1751155.78"
"2025-02-04","2025-02-03","SF FuneralFDC0000000GW5V250201","","126.5","","1751282.28"
"2025-02-04","2025-02-03","SF FuneralF900711       250201","","126.5","","1751408.78"
"2025-02-04","2025-02-03","SF FuneralF900780       250201","","126.5","","1751535.28"
"2025-02-04","2025-02-03","SF FuneralF1059350      250203","","126.5","","1751661.78"
"2025-02-04","2025-02-03","SF FuneralF1113217      250203","","126.5","","1751788.28"
"2025-02-04","2025-02-03","SF FuneralF1119770      250203","","126.5","","1751914.78"
"2025-02-04","2025-02-03","SF FuneralF1124565      250203","","126.5","","1752041.28"
"2025-02-04","2025-02-04","SF FuneralFDC0000000892D250204","","31.63","","1752072.91"
"2025-02-04","2025-02-04","SF FuneralF811733       250204","","31.63","","1752104.54"
"2025-02-04","2025-02-04","SF FuneralFDC0000000LFBD250204","","126.5","","1752231.04"
"2025-02-04","2025-02-04","SF FuneralF1078389      250204","","126.5","","1752357.54"
"2025-02-04","2025-01-28","SF FuneralFDC0000000801P250128","","126.5","","1752484.04"
"2025-02-04","2025-01-31","SF FuneralFDC0000000HCQR250201","","126.5","","1752610.54"
"2025-02-04","2025-01-31","SF FuneralF981564       250201","","126.5","","1752737.04"
"2025-02-04","2025-02-01","SF FuneralFDC00000002VHN250201","","220","","1752957.04"
"2025-02-04","2025-02-01","SF FuneralFDC00000006F04250201","","126.5","","1753083.54"
"2025-02-04","2025-02-01","SF FuneralF832238       250201","","126.5","","1753210.04"
"2025-02-04","2025-02-01","SF FuneralF1060101      250201","","126.5","","1753336.54"
"2025-02-04","2025-02-01","SF FuneralF993483       250201","","126.5","","1753463.04"
"2025-02-04","2025-02-01","SF FuneralFDC0000000MM95250201","","191.5","","1753654.54"
"2025-02-04","2025-02-01","SF FuneralF1117349      250201","","126.5","","1753781.04"
"2025-02-04","2025-02-01","SF FuneralF1128860      250201","","126.5","","1753907.54"
"2025-02-04","2025-02-03","SF FuneralF1072867      250203","","126.5","","1754034.04"
"2025-02-04","2025-02-03","SF FuneralF1110647      250203","","126.5","","1754160.54"
"2025-02-04","2025-02-03","SF FuneralF1124342      250203","","126.5","","1754287.04"
"2025-02-04","2025-02-04","SF FuneralFDC00000006L9F250204","","31.63","","1754318.67"
"2025-02-04","2025-02-01","SF FuneralFDC0000000P0W3250202","","31.63","","1754350.3"
"2025-02-04","2025-02-01","SF FuneralF1122269      250202","","31.63","","1754381.93"
"2025-02-04","2025-02-04","SF FuneralF981838       250204","","31.63","","1754413.56"
"2025-02-04","2025-02-04","SF FuneralF986691       250204","","31.63","","1754445.19"
"2025-02-04","2025-02-04","SF FuneralF987244       250204","","31.63","","1754476.82"
"2025-02-04","2025-02-04","SF FuneralF1068212      250204","","31.63","","1754508.45"
"2025-02-04","2025-02-04","SF FuneralFDC0000000L0TM250204","","31.63","","1754540.08"
"2025-02-04","2025-02-04","SF FuneralF1112035      250204","","31.63","","1754571.71"
"2025-02-04","2025-01-29","SF FuneralFDC00000003FS6250129","","55","","1754626.71"
"2025-02-04","2025-02-04","SF FuneralFDC00000008365250204","","31.63","","1754658.34"
"2025-02-04","2025-02-04","SF FuneralF834203       250204","","31.63","","1754689.97"
"2025-02-04","2025-02-04","SF FuneralF1016839      250204","","31.63","","1754721.6"
"2025-02-04","2025-02-04","SF FuneralF1021235      250204","","31.63","","1754753.23"
"2025-02-04","2025-02-04","SF FuneralF1068027      250204","","31.63","","1754784.86"
"2025-02-04","2025-02-04","SF FuneralF1110117      250204","","31.63","","1754816.49"
"2025-02-04","2025-02-01","SF FuneralF1122059      250202","","31.63","","1754848.12"
"2025-02-04","2025-02-04","SF FuneralF817293       250204","","31.63","","1754879.75"
"2025-02-04","2025-02-04","SF FuneralF833072       250204","","31.63","","1754911.38"
"2025-02-04","2025-02-04","SF FuneralF1130870      250204","","31.63","","1754943.01"
"2025-02-04","2025-02-01","SF FuneralF1122035      250202","","31.63","","1754974.64"
"2025-02-04","2025-02-01","SF FuneralF1122066      250202","","31.63","","1755006.27"
"2025-02-04","2025-02-01","SF FuneralFDC0000000P0VX250202","","31.63","","1755037.9"
"2025-02-04","2025-02-01","SF FuneralF1122642      250202","","31.63","","1755069.53"
"2025-02-04","2025-02-01","SF FuneralF1122847      250202","","31.63","","1755101.16"
"2025-02-04","2025-02-04","SF FuneralF1073801      250204","","31.63","","1755132.79"
"2025-02-04","2025-02-04","SF FuneralF1080246      250204","","31.63","","1755164.42"
"2025-02-04","2025-02-04","SF FuneralF1110079      250204","","31.63","","1755196.05"
"2025-02-04","2025-02-04","SF FuneralF1129356      250204","","31.63","","1755227.68"
"2025-02-04","2025-02-01","SF FuneralFDC00000005KXR250201","","31.63","","1755259.31"
"2025-02-04","2025-02-01","SF FuneralFDC0000000P0VY250202","","31.63","","1755290.94"
"2025-02-04","2025-02-03","SF FuneralF820012       250203","","31.63","","1755322.57"
"2025-02-04","2025-02-04","SF FuneralFDC00000006WX3250204","","31.63","","1755354.2"
"2025-02-04","2025-02-04","SF FuneralFDC00000007X31250204","","31.63","","1755385.83"
"2025-02-04","2025-02-04","SF FuneralFDC00000007YH4250204","","31.63","","1755417.46"
"2025-02-04","2025-02-04","SF FuneralFDC00000007YZB250204","","31.63","","1755449.09"
"2025-02-04","2025-02-04","SF FuneralFDC00000007ZD3250204","","31.63","","1755480.72"
"2025-02-04","2025-02-04","SF FuneralFDC00000008H47250204","","31.63","","1755512.35"
"2025-02-04","2025-02-04","SF FuneralF900687       250204","","31.63","","1755543.98"
"2025-02-04","2025-02-04","SF FuneralF1060838      250204","","31.63","","1755575.61"
"2025-02-04","2025-02-04","SF FuneralF1102938      250204","","31.63","","1755607.24"
"2025-02-04","2025-02-04","SF FuneralF1102942      250204","","31.63","","1755638.87"
"2025-02-04","2025-02-04","SF FuneralF1113741      250204","","31.63","","1755670.5"
"2025-02-04","2025-02-01","SF FuneralF1121892      250202","","31.63","","1755702.13"
"2025-02-04","2025-02-04","SF FuneralF1117422      250204","","31.63","","1755733.76"
"2025-02-04","2025-02-04","SF FuneralFDC00000007X30250204","","31.63","","1755765.39"
"2025-02-04","2025-02-03","SF FuneralF1124411      250203","","31.63","","1755797.02"
"2025-02-04","2025-02-04","SF FuneralFDC00000006Q68250204","","31.63","","1755828.65"
"2025-02-04","2025-02-04","SF FuneralFDC000000073P4250204","","31.63","","1755860.28"
"2025-02-04","2025-02-04","SF FuneralF1120226      250204","","31.63","","1755891.91"
"2025-02-04","2025-01-27","SF FuneralFDC000000086FV250127","","126.5","","1756018.41"
"2025-02-04","2025-01-28","SF FuneralFDC0000000578B250128","","126.5","","1756144.91"
"2025-02-04","2025-01-28","SF FuneralFDC00000006N69250128","","126.5","","1756271.41"
"2025-02-04","2025-01-29","SF FuneralFDC0000000675G250129","","126.5","","1756397.91"
"2025-02-04","2025-01-29","SF FuneralFDC000000067G5250129","","126.5","","1756524.41"
"2025-02-04","2025-01-29","SF FuneralFDC0000000H0TM250129","","126.5","","1756650.91"
"2025-02-04","2025-01-30","SF FuneralF1108800      250130","","126.5","","1756777.41"
"2025-02-04","2025-01-30","SF FuneralF1124126      250130","","126.5","","1756903.91"
"2025-02-04","2025-01-31","SF FuneralFDC000000073KZ250131","","126.5","","1757030.41"
"2025-02-04","2025-01-31","SF FuneralFDC000000077Q4250131","","126.5","","1757156.91"
"2025-02-04","2025-01-31","SF FuneralFDC000000078ZL250131","","126.5","","1757283.41"
"2025-02-04","2025-01-31","SF FuneralF981337       250201","","126.5","","1757409.91"
"2025-02-04","2025-01-31","SF FuneralF981610       250201","","126.5","","1757536.41"
"2025-02-04","2025-01-31","SF FuneralF981607       250201","","126.5","","1757662.91"
"2025-02-04","2025-01-31","SF FuneralF981742       250201","","126.5","","1757789.41"
"2025-02-04","2025-01-31","SF FuneralF986843       250201","","126.5","","1757915.91"
"2025-02-04","2025-01-31","SF FuneralF987213       250201","","126.5","","1758042.41"
"2025-02-04","2025-01-31","SF FuneralF987606       250201","","126.5","","1758168.91"
"2025-02-04","2025-01-31","SF FuneralF989839       250201","","126.5","","1758295.41"
"2025-02-04","2025-01-31","SF FuneralF989934       250201","","126.5","","1758421.91"
"2025-02-04","2025-01-31","SF FuneralF1072952      250131","","126.5","","1758548.41"
"2025-02-04","2025-01-31","SF FuneralF1084727      250131","","126.5","","1758674.91"
"2025-02-04","2025-02-01","SF FuneralFDC00000002V4G250201","","220","","1758894.91"
"2025-02-04","2025-02-01","SF FuneralFDC00000002V81250201","","220","","1759114.91"
"2025-02-04","2025-02-01","SF FuneralFDC00000002VGH250201","","220","","1759334.91"
"2025-02-04","2025-02-01","SF FuneralFDC00000002WT8250201","","220","","1759554.91"
"2025-02-04","2025-02-01","SF FuneralFDC00000004G9L250201","","220","","1759774.91"
"2025-02-04","2025-02-01","SF FuneralFDC00000004GC6250201","","220","","1759994.91"
"2025-02-04","2025-02-01","SF FuneralFDC000000057FM250201","","126.5","","1760121.41"
"2025-02-04","2025-02-01","SF FuneralFDC000000058Q4250201","","126.5","","1760247.91"
"2025-02-04","2025-02-01","SF FuneralFDC00000005QQD250201","","126.5","","1760374.41"
"2025-02-04","2025-02-01","SF FuneralFDC00000005TXX250201","","126.5","","1760500.91"
"2025-02-04","2025-02-01","SF FuneralFDC00000006G08250201","","126.5","","1760627.41"
"2025-02-04","2025-02-01","SF FuneralFDC00000006HPW250201","","126.5","","1760753.91"
"2025-02-04","2025-02-01","SF FuneralFDC00000006HSF250201","","126.5","","1760880.41"
"2025-02-04","2025-02-01","SF FuneralFDC00000006NQW250201","","126.5","","1761006.91"
"2025-02-04","2025-02-01","SF FuneralFDC00000006NVG250201","","126.5","","1761133.41"
"2025-02-04","2025-02-01","SF FuneralFDC00000006W32250201","","126.5","","1761259.91"
"2025-02-04","2025-02-01","SF FuneralFDC000000073DN250201","","126.5","","1761386.41"
"2025-02-04","2025-02-01","SF FuneralFDC0000000759C250201","","126.5","","1761512.91"
"2025-02-04","2025-02-01","SF FuneralFDC000000075B0250201","","126.5","","1761639.41"
"2025-02-04","2025-02-01","SF FuneralFDC000000075C1250201","","126.5","","1761765.91"
"2025-02-04","2025-02-01","SF FuneralFDC000000075CD250201","","126.5","","1761892.41"
"2025-02-04","2025-02-01","SF FuneralFDC00000007BSL250201","","126.5","","1762018.91"
"2025-02-04","2025-02-01","SF FuneralFDC00000007D65250201","","220","","1762238.91"
"2025-02-04","2025-02-01","SF FuneralFDC00000007QLQ250201","","126.5","","1762365.41"
"2025-02-04","2025-02-01","SF FuneralFDC00000007TMF250201","","126.5","","1762491.91"
"2025-02-04","2025-02-01","SF FuneralFDC00000007WG1250201","","126.5","","1762618.41"
"2025-02-04","2025-02-01","SF FuneralFDC00000007ZDG250201","","126.5","","1762744.91"
"2025-02-04","2025-02-01","SF FuneralF797097       250201","","126.5","","1762871.41"
"2025-02-04","2025-02-01","SF FuneralF801425       250201","","126.5","","1762997.91"
"2025-02-04","2025-02-01","SF FuneralFDC00000008L1Y250201","","126.5","","1763124.41"
"2025-02-04","2025-02-01","SF FuneralF802692       250201","","126.5","","1763250.91"
"2025-02-04","2025-02-01","SF FuneralF808547       250201","","126.5","","1763377.41"
"2025-02-04","2025-02-01","SF FuneralFDC00000009038250201","","126.5","","1763503.91"
"2025-02-04","2025-02-01","SF FuneralF810459       250201","","126.5","","1763630.41"
"2025-02-04","2025-02-01","SF FuneralF812789       250201","","126.5","","1763756.91"
"2025-02-04","2025-02-01","SF FuneralF813893       250201","","126.5","","1763883.41"
"2025-02-04","2025-02-01","SF FuneralF813911       250201","","126.5","","1764009.91"
"2025-02-04","2025-02-01","SF FuneralF833589       250201","","126.5","","1764136.41"
"2025-02-04","2025-02-01","SF FuneralF833571       250201","","126.5","","1764262.91"
"2025-02-04","2025-02-01","SF FuneralF993301       250201","","126.5","","1764389.41"
"2025-02-04","2025-02-01","SF FuneralF993342       250201","","126.5","","1764515.91"
"2025-02-04","2025-02-01","SF FuneralF1021003      250201","","126.5","","1764642.41"
"2025-02-04","2025-02-01","SF FuneralF1021794      250202","","126.5","","1764768.91"
"2025-02-04","2025-02-01","SF FuneralF1047421      250201","","126.5","","1764895.41"
"2025-02-04","2025-02-01","SF FuneralF1047419      250201","","126.5","","1765021.91"
"2025-02-04","2025-02-01","SF FuneralF1061030      250201","","126.5","","1765148.41"
"2025-02-04","2025-02-01","SF FuneralFDC0000000KKWS250201","","126.5","","1765274.91"
"2025-02-04","2025-02-01","SF FuneralF1078634      250201","","126.5","","1765401.41"
"2025-02-04","2025-02-01","SF FuneralF1108826      250201","","126.5","","1765527.91"
"2025-02-04","2025-02-01","SF FuneralF1109081      250201","","126.5","","1765654.41"
"2025-02-04","2025-02-01","SF FuneralF1113561      250201","","126.5","","1765780.91"
"2025-02-04","2025-02-01","SF FuneralF1117191      250201","","126.5","","1765907.41"
"2025-02-04","2025-02-01","SF FuneralF1117223      250201","","126.5","","1766033.91"
"2025-02-04","2025-02-01","SF FuneralFDC0000000NJYP250201","","126.5","","1766160.41"
"2025-02-04","2025-02-01","SF FuneralF1117339      250201","","126.5","","1766286.91"
"2025-02-04","2025-02-01","SF FuneralF1120183      250201","","126.5","","1766413.41"
"2025-02-04","2025-02-01","SF FuneralF1120186      250201","","126.5","","1766539.91"
"2025-02-04","2025-02-01","SF FuneralF1075158      250201","","126.5","","1766666.41"
"2025-02-04","2025-02-01","SF FuneralF1121989      250201","","126.5","","1766792.91"
"2025-02-04","2025-02-01","SF FuneralF1123250      250201","","126.5","","1766919.41"
"2025-02-04","2025-02-01","SF FuneralF1124023      250201","","126.5","","1767045.91"
"2025-02-04","2025-02-01","SF FuneralF797990       250201","","126.5","","1767172.41"
"2025-02-04","2025-02-01","SF FuneralF1125394      250201","","126.5","","1767298.91"
"2025-02-04","2025-02-01","SF FuneralF1127486      250201","","126.5","","1767425.41"
"2025-02-04","2025-02-01","SF FuneralF1127558      250201","","126.5","","1767551.91"
"2025-02-04","2025-02-01","SF FuneralF1127964      250201","","126.5","","1767678.41"
"2025-02-04","2025-02-01","SF FuneralF1128659      250201","","126.5","","1767804.91"
"2025-02-04","2025-02-01","SF FuneralF1128952      250201","","126.5","","1767931.41"
"2025-02-04","2025-02-03","SF FuneralF843427       250201","","126.5","","1768057.91"
"2025-02-04","2025-02-03","SF FuneralF843473       250201","","126.5","","1768184.41"
"2025-02-04","2025-02-03","SF FuneralF843528       250201","","126.5","","1768310.91"
"2025-02-04","2025-02-03","SF FuneralF843749       250201","","126.5","","1768437.41"
"2025-02-04","2025-02-03","SF FuneralF843819       250201","","126.5","","1768563.91"
"2025-02-04","2025-02-03","SF FuneralFDC0000000GRSX250201","","126.5","","1768690.41"
"2025-02-04","2025-02-03","SF FuneralF1058742      250203","","126.5","","1768816.91"
"2025-02-04","2025-02-04","SF FuneralFDC00000006S4K250204","","126.5","","1768943.41"
"2025-02-04","2025-02-04","SF FuneralF820389       250204","","126.5","","1769069.91"
"2025-02-04","2025-02-04","SF FuneralF990305       250204","","126.5","","1769196.41"
"2025-02-04","2025-02-04","SF FuneralF992943       250204","","63.25","","1769259.66"
"2025-02-04","2025-02-04","SF FuneralF1129049      250204","","126.5","","1769386.16"
"2025-02-04","2025-02-01","SF FuneralF1113849      250201","","126.5","","1769512.66"
"2025-02-04","2025-02-01","SF FuneralF1115770      250201","","126.5","","1769639.16"
"2025-02-04","2025-02-01","SF FuneralF1109751      250201","","126.5","","1769765.66"
"2025-02-04","2025-02-01","SF FuneralF1117229      250201","","126.5","","1769892.16"
"2025-02-04","2025-02-01","SF FuneralF1117341      250201","","126.5","","1770018.66"
"2025-02-04","2025-02-01","SF FuneralF1117392      250201","","126.5","","1770145.16"
"2025-02-04","2025-02-01","SF FuneralF1118037      250201","","126.5","","1770271.66"
"2025-02-04","2025-02-01","SF FuneralF1118145      250201","","126.5","","1770398.16"
"2025-02-04","2025-02-01","SF FuneralF1121774      250201","","126.5","","1770524.66"
"2025-02-04","2025-02-01","SF FuneralF1066220      250201","","126.5","","1770651.16"
"2025-02-04","2025-02-01","SF FuneralF1122014      250201","","126.5","","1770777.66"
"2025-02-04","2025-02-01","SF FuneralF1122276      250201","","126.5","","1770904.16"
"2025-02-04","2025-02-01","SF FuneralF1122721      250201","","126.5","","1771030.66"
"2025-02-04","2025-02-01","SF FuneralF1123950      250201","","126.5","","1771157.16"
"2025-02-04","2025-02-01","SF FuneralF1124092      250201","","126.5","","1771283.66"
"2025-02-04","2025-02-01","SF FuneralF1125781      250201","","126.5","","1771410.16"
"2025-02-04","2025-02-01","SF FuneralF1125849      250201","","126.5","","1771536.66"
"2025-02-04","2025-02-01","SF FuneralF1126266      250201","","126.5","","1771663.16"
"2025-02-04","2025-02-01","SF FuneralF1126272      250201","","126.5","","1771789.66"
"2025-02-04","2025-02-01","SF FuneralF1126833      250201","","126.5","","1771916.16"
"2025-02-04","2025-02-01","SF FuneralF1127994      250201","","126.5","","1772042.66"
"2025-02-04","2025-02-01","SF FuneralF1128790      250201","","126.5","","1772169.16"
"2025-02-04","2025-02-01","SF FuneralF1128808      250201","","126.5","","1772295.66"
"2025-02-04","2025-02-01","SF FuneralF1128945      250201","","126.5","","1772422.16"
"2025-02-04","2025-02-01","SF FuneralF1128962      250201","","126.5","","1772548.66"
"2025-02-04","2025-02-01","SF FuneralF1129077      250201","","126.5","","1772675.16"
"2025-02-04","2025-02-01","SF FuneralF1129081      250201","","126.5","","1772801.66"
"2025-02-04","2025-02-01","SF FuneralF1129131      250201","","126.5","","1772928.16"
"2025-02-04","2025-02-01","SF FuneralF1129388      250201","","126.5","","1773054.66"
"2025-02-04","2025-02-01","SF FuneralF1129420      250201","","126.5","","1773181.16"
"2025-02-04","2025-02-01","SF FuneralF1129999      250201","","126.5","","1773307.66"
"2025-02-04","2025-02-01","SF FuneralF1130264      250201","","126.5","","1773434.16"
"2025-02-04","2025-02-01","SF FuneralF1130411      250201","","126.5","","1773560.66"
"2025-02-04","2025-02-03","SF FuneralF813312       250202","","126.5","","1773687.16"
"2025-02-04","2025-02-03","SF FuneralF816981       250203","","126.5","","1773813.66"
"2025-02-04","2025-02-03","SF FuneralF828266       250203","","126.5","","1773940.16"
"2025-02-04","2025-02-03","SF FuneralFDC0000000CL5K250202","","126.5","","1774066.66"
"2025-02-04","2025-02-03","SF FuneralF843363       250201","","126.5","","1774193.16"
"2025-02-04","2025-02-03","SF FuneralF843905       250201","","126.5","","1774319.66"
"2025-02-04","2025-02-03","SF FuneralF1110065      250203","","126.5","","1774446.16"
"2025-02-04","2025-02-04","SF FuneralFDC00000008JV9250204","","63.25","","1774509.41"
"2025-02-04","2025-02-04","SF FuneralFDC00000008JVC250204","","63.25","","1774572.66"
"2025-02-04","2025-02-04","SF FuneralF808898       250204","","63.25","","1774635.91"
"2025-02-04","2025-02-04","SF FuneralF1066577      250204","","126.5","","1774762.41"
"2025-02-04","2025-01-27","SF FuneralFDC00000007QX5250127","","126.5","","1774888.91"
"2025-02-04","2025-01-27","SF FuneralF794145       250126","","126.5","","1775015.41"
"2025-02-04","2025-01-28","SF FuneralF1122289      250128","","126.5","","1775141.91"
"2025-02-04","2025-01-29","SF FuneralF841301       250129","","126.5","","1775268.41"
"2025-02-04","2025-01-29","SF FuneralF900534       250129","","126.5","","1775394.91"
"2025-02-04","2025-01-29","SF FuneralF1055274      250129","","126.5","","1775521.41"
"2025-02-04","2025-01-29","SF FuneralF1121927      250129","","126.5","","1775647.91"
"2025-02-04","2025-01-30","SF FuneralFDC00000006MCM250130","","126.5","","1775774.41"
"2025-02-04","2025-01-30","SF FuneralFDC00000006VYW250130","","126.5","","1775900.91"
"2025-02-04","2025-01-30","SF FuneralF832125       250130","","126.5","","1776027.41"
"2025-02-04","2025-01-30","SF FuneralF841429       250130","","126.5","","1776153.91"
"2025-02-04","2025-01-30","SF FuneralF1052773      250130","","126.5","","1776280.41"
"2025-02-04","2025-01-30","SF FuneralF1055200      250130","","126.5","","1776406.91"
"2025-02-04","2025-01-30","SF FuneralF900551       250130","","126.5","","1776533.41"
"2025-02-04","2025-01-30","SF FuneralF1055234      250130","","126.5","","1776659.91"
"2025-02-04","2025-01-30","SF FuneralF1121889      250130","","126.5","","1776786.41"
"2025-02-04","2025-01-31","SF FuneralF987586       250131","","126.5","","1776912.91"
"2025-02-04","2025-01-31","SF FuneralF987599       250201","","126.5","","1777039.41"
"2025-02-04","2025-01-31","SF FuneralF987605       250201","","126.5","","1777165.91"
"2025-02-04","2025-02-01","SF FuneralFDC00000002QK7250201","","220","","1777385.91"
"2025-02-04","2025-02-01","SF FuneralFDC00000002W18250201","","220","","1777605.91"
"2025-02-04","2025-02-01","SF FuneralFDC00000002W89250201","","220","","1777825.91"
"2025-02-04","2025-02-01","SF FuneralFDC000000033J5250201","","220","","1778045.91"
"2025-02-04","2025-02-01","SF FuneralFDC00000005C21250201","","126.5","","1778172.41"
"2025-02-04","2025-02-01","SF FuneralFDC00000005RY1250201","","126.5","","1778298.91"
"2025-02-04","2025-02-01","SF FuneralFDC0000000697Z250201","","126.5","","1778425.41"
"2025-02-04","2025-02-01","SF FuneralFDC00000006B33250201","","126.5","","1778551.91"
"2025-02-04","2025-02-01","SF FuneralFDC00000006DLX250201","","126.5","","1778678.41"
"2025-02-04","2025-02-01","SF FuneralFDC00000006FMT250201","","126.5","","1778804.91"
"2025-02-04","2025-02-01","SF FuneralFDC00000006FN4250201","","126.5","","1778931.41"
"2025-02-04","2025-02-01","SF FuneralFDC00000006G12250201","","126.5","","1779057.91"
"2025-02-04","2025-02-01","SF FuneralFDC00000006JT7250201","","126.5","","1779184.41"
"2025-02-04","2025-02-01","SF FuneralFDC00000006LT4250201","","126.5","","1779310.91"
"2025-02-04","2025-02-01","SF FuneralFDC00000006LVM250201","","126.5","","1779437.41"
"2025-02-04","2025-02-01","SF FuneralFDC00000006MMT250201","","126.5","","1779563.91"
"2025-02-04","2025-02-01","SF FuneralFDC00000006N1H250201","","126.5","","1779690.41"
"2025-02-04","2025-02-01","SF FuneralFDC00000006N1L250201","","126.5","","1779816.91"
"2025-02-04","2025-02-01","SF FuneralFDC00000006QZ1250201","","126.5","","1779943.41"
"2025-02-04","2025-02-01","SF FuneralFDC00000006RFR250201","","126.5","","1780069.91"
"2025-02-04","2025-02-01","SF FuneralFDC00000006RMR250201","","126.5","","1780196.41"
"2025-02-04","2025-02-01","SF FuneralFDC00000006RNH250201","","126.5","","1780322.91"
"2025-02-04","2025-02-01","SF FuneralFDC00000006SDN250201","","126.5","","1780449.41"
"2025-02-04","2025-02-01","SF FuneralFDC000000073J2250201","","126.5","","1780575.91"
"2025-02-04","2025-02-01","SF FuneralFDC000000073SP250201","","126.5","","1780702.41"
"2025-02-04","2025-02-01","SF FuneralFDC000000074F3250201","","126.5","","1780828.91"
"2025-02-04","2025-02-01","SF FuneralFDC000000074FR250201","","126.5","","1780955.41"
"2025-02-04","2025-02-01","SF FuneralFDC000000075B2250201","","126.5","","1781081.91"
"2025-02-04","2025-02-01","SF FuneralFDC00000007638250201","","126.5","","1781208.41"
"2025-02-04","2025-02-01","SF FuneralFDC0000000763J250201","","126.5","","1781334.91"
"2025-02-04","2025-02-01","SF FuneralFDC000000079PT250201","","220","","1781554.91"
"2025-02-04","2025-02-01","SF FuneralFDC00000007CCT250201","","126.5","","1781681.41"
"2025-02-04","2025-02-01","SF FuneralF793687       250201","","126.5","","1781807.91"
"2025-02-04","2025-02-01","SF FuneralF793696       250201","","126.5","","1781934.41"
"2025-02-04","2025-02-01","SF FuneralFDC00000007RZR250201","","126.5","","1782060.91"
"2025-02-04","2025-02-01","SF FuneralFDC00000007RZX250201","","126.5","","1782187.41"
"2025-02-04","2025-02-01","SF FuneralFDC00000007S05250201","","126.5","","1782313.91"
"2025-02-04","2025-02-01","SF FuneralFDC00000007S0P250201","","126.5","","1782440.41"
"2025-02-04","2025-02-01","SF FuneralF794644       250201","","126.5","","1782566.91"
"2025-02-04","2025-02-01","SF FuneralFDC00000007V6L250201","","126.5","","1782693.41"
"2025-02-04","2025-02-01","SF FuneralFDC00000007V6Y250201","","126.5","","1782819.91"
"2025-02-04","2025-02-01","SF FuneralFDC00000007VRJ250201","","126.5","","1782946.41"
"2025-02-04","2025-02-01","SF FuneralFDC000000083H0250201","","126.5","","1783072.91"
"2025-02-04","2025-02-01","SF FuneralF798342       250201","","126.5","","1783199.41"
"2025-02-04","2025-02-01","SF FuneralF798397       250201","","126.5","","1783325.91"
"2025-02-04","2025-02-01","SF FuneralF798408       250201","","126.5","","1783452.41"
"2025-02-04","2025-02-01","SF FuneralFDC000000084TC250201","","126.5","","1783578.91"
"2025-02-04","2025-02-01","SF FuneralF799892       250201","","126.5","","1783705.41"
"2025-02-04","2025-02-01","SF FuneralF802574       250201","","126.5","","1783831.91"
"2025-02-04","2025-02-01","SF FuneralF802583       250201","","126.5","","1783958.41"
"2025-02-04","2025-02-01","SF FuneralF802599       250201","","126.5","","1784084.91"
"2025-02-04","2025-02-01","SF FuneralF804192       250201","","126.5","","1784211.41"
"2025-02-04","2025-02-01","SF FuneralF810782       250201","","126.5","","1784337.91"
"2025-02-04","2025-02-01","SF FuneralF812100       250201","","126.5","","1784464.41"
"2025-02-04","2025-02-01","SF FuneralF812189       250201","","126.5","","1784590.91"
"2025-02-04","2025-02-01","SF FuneralF816797       250201","","126.5","","1784717.41"
"2025-02-04","2025-02-01","SF FuneralF816806       250201","","126.5","","1784843.91"
"2025-02-04","2025-02-01","SF FuneralF820487       250201","","126.5","","1784970.41"
"2025-02-04","2025-02-01","SF FuneralF820515       250201","","126.5","","1785096.91"
"2025-02-04","2025-02-01","SF FuneralF808620       250201","","126.5","","1785223.41"
"2025-02-04","2025-02-01","SF FuneralF820568       250201","","126.5","","1785349.91"
"2025-02-04","2025-02-01","SF FuneralF820591       250201","","126.5","","1785476.41"
"2025-02-04","2025-02-01","SF FuneralF820665       250201","","126.5","","1785602.91"
"2025-02-04","2025-02-01","SF FuneralF821437       250201","","126.5","","1785729.41"
"2025-02-04","2025-02-01","SF FuneralF816467       250201","","126.5","","1785855.91"
"2025-02-04","2025-02-01","SF FuneralF828108       250201","","126.5","","1785982.41"
"2025-02-04","2025-02-01","SF FuneralF828127       250201","","126.5","","1786108.91"
"2025-02-04","2025-02-01","SF FuneralF828487       250201","","126.5","","1786235.41"
"2025-02-04","2025-02-01","SF FuneralF828514       250201","","126.5","","1786361.91"
"2025-02-04","2025-02-01","SF FuneralF828527       250201","","126.5","","1786488.41"
"2025-02-04","2025-02-01","SF FuneralF828428       250201","","126.5","","1786614.91"
"2025-02-04","2025-02-01","SF FuneralF828577       250201","","126.5","","1786741.41"
"2025-02-04","2025-02-01","SF FuneralFDC0000000BPX3250201","","126.5","","1786867.91"
"2025-02-04","2025-02-01","SF FuneralF784083       250201","","126.5","","1786994.41"
"2025-02-04","2025-02-01","SF FuneralF828698       250201","","126.5","","1787120.91"
"2025-02-04","2025-02-01","SF FuneralF829835       250201","","126.5","","1787247.41"
"2025-02-04","2025-02-01","SF FuneralF832366       250201","","126.5","","1787373.91"
"2025-02-04","2025-02-01","SF FuneralF832542       250201","","126.5","","1787500.41"
"2025-02-04","2025-02-01","SF FuneralF834431       250201","","126.5","","1787626.91"
"2025-02-04","2025-02-01","SF FuneralF841336       250201","","191.5","","1787818.41"
"2025-02-04","2025-02-01","SF FuneralF841684       250201","","126.5","","1787944.91"
"2025-02-04","2025-02-01","SF FuneralFDC0000000F7DT250201","","126.5","","1788071.41"
"2025-02-04","2025-02-01","SF FuneralF842538       250201","","126.5","","1788197.91"
"2025-02-04","2025-02-01","SF FuneralF992326       250201","","126.5","","1788324.41"
"2025-02-04","2025-02-01","SF FuneralF992334       250201","","126.5","","1788450.91"
"2025-02-04","2025-02-01","SF FuneralF1017290      250201","","126.5","","1788577.41"
"2025-02-04","2025-02-01","SF FuneralF992633       250201","","126.5","","1788703.91"
"2025-02-04","2025-02-01","SF FuneralF1050749      250201","","126.5","","1788830.41"
"2025-02-04","2025-02-01","SF FuneralF1050852      250201","","126.5","","1788956.91"
"2025-02-04","2025-02-01","SF FuneralF1052445      250201","","126.5","","1789083.41"
"2025-02-04","2025-02-01","SF FuneralF1058615      250201","","126.5","","1789209.91"
"2025-02-04","2025-02-01","SF FuneralF1058765      250201","","126.5","","1789336.41"
"2025-02-04","2025-02-01","SF FuneralF1058794      250201","","126.5","","1789462.91"
"2025-02-04","2025-02-01","SF FuneralF1058810      250201","","126.5","","1789589.41"
"2025-02-04","2025-02-01","SF FuneralF1058824      250201","","126.5","","1789715.91"
"2025-02-04","2025-02-01","SF FuneralF1061563      250201","","126.5","","1789842.41"
"2025-02-04","2025-02-01","SF FuneralFDC0000000KPQ0250201","","191.5","","1790033.91"
"2025-02-04","2025-02-01","SF FuneralF1062722      250201","","126.5","","1790160.41"
"2025-02-04","2025-02-01","SF FuneralF1065812      250201","","126.5","","1790286.91"
"2025-02-04","2025-02-01","SF FuneralF1066631      250201","","126.5","","1790413.41"
"2025-02-04","2025-02-01","SF FuneralF1078089      250201","","126.5","","1790539.91"
"2025-02-04","2025-02-01","SF FuneralFDC0000000LFBG250201","","126.5","","1790666.41"
"2025-02-04","2025-02-01","SF FuneralF1078868      250201","","126.5","","1790792.91"
"2025-02-04","2025-02-01","SF FuneralFDC0000000LK8N250201","","126.5","","1790919.41"
"2025-02-04","2025-02-01","SF FuneralF1084440      250201","","126.5","","1791045.91"
"2025-02-04","2025-02-01","SF FuneralF1084454      250201","","126.5","","1791172.41"
"2025-02-04","2025-02-01","SF FuneralF1084585      250201","","126.5","","1791298.91"
"2025-02-04","2025-02-01","SF FuneralF1084670      250201","","126.5","","1791425.41"
"2025-02-04","2025-02-01","SF FuneralF1084757      250201","","126.5","","1791551.91"
"2025-02-04","2025-02-01","SF FuneralF1103010      250201","","126.5","","1791678.41"
"2025-02-04","2025-02-01","SF FuneralF1108031      250201","","126.5","","1791804.91"
"2025-02-04","2025-02-01","SF FuneralF1109549      250201","","126.5","","1791931.41"
"2025-02-04","2025-02-01","SF FuneralF1109560      250201","","126.5","","1792057.91"
"2025-02-04","2025-02-01","SF FuneralF1113340      250201","","126.5","","1792184.41"
"2025-02-04","2025-02-01","SF FuneralF1113341      250201","","126.5","","1792310.91"
"2025-02-04","2025-02-01","SF FuneralF1116909      250202","","126.5","","1792437.41"
"2025-02-04","2025-02-01","SF FuneralF1117666      250201","","126.5","","1792563.91"
"2025-02-04","2025-02-01","SF FuneralF1117681      250201","","126.5","","1792690.41"
"2025-02-04","2025-02-01","SF FuneralF1117717      250201","","126.5","","1792816.91"
"2025-02-04","2025-02-01","SF FuneralF1118270      250201","","126.5","","1792943.41"
"2025-02-04","2025-02-01","SF FuneralF1120529      250201","","126.5","","1793069.91"
"2025-02-04","2025-02-01","SF FuneralF1122161      250201","","126.5","","1793196.41"
"2025-02-04","2025-02-01","SF FuneralF1123053      250201","","126.5","","1793322.91"
"2025-02-04","2025-02-01","SF FuneralF1123325      250201","","126.5","","1793449.41"
"2025-02-04","2025-02-01","SF FuneralF1125401      250201","","126.5","","1793575.91"
"2025-02-04","2025-02-01","SF FuneralF1125856      250201","","126.5","","1793702.41"
"2025-02-04","2025-02-01","SF FuneralFDC0000000PJ60250201","","126.5","","1793828.91"
"2025-02-04","2025-02-01","SF FuneralF1126957      250201","","126.5","","1793955.41"
"2025-02-04","2025-02-01","SF FuneralF1127911      250201","","126.5","","1794081.91"
"2025-02-04","2025-02-01","SF FuneralF1127935      250201","","126.5","","1794208.41"
"2025-02-04","2025-02-01","SF FuneralF1128212      250201","","126.5","","1794334.91"
"2025-02-04","2025-02-01","SF FuneralF1130741      250201","","126.5","","1794461.41"
"2025-02-04","2025-02-03","SF FuneralF808841       250203","","126.5","","1794587.91"
"2025-02-04","2025-02-03","SF FuneralFDC0000000FQV3250201","","126.5","","1794714.41"
"2025-02-04","2025-01-29","SF FuneralF1113555      250129","","126.5","","1794840.91"
"2025-02-04","2025-01-29","SF FuneralF1114122      250129","","126.5","","1794967.41"
"2025-02-04","2025-01-31","SF FuneralFDC0000000507S250131","","220","","1795187.41"
"2025-02-04","2025-01-31","SF FuneralFDC00000005VQ5250131","","126.5","","1795313.91"
"2025-02-04","2025-01-31","SF FuneralFDC000000073PN250131","","126.5","","1795440.41"
"2025-02-04","2025-01-31","SF FuneralFDC000000073QT250131","","126.5","","1795566.91"
"2025-02-04","2025-01-31","SF FuneralFDC0000000752K250131","","126.5","","1795693.41"
"2025-02-04","2025-01-31","SF FuneralFDC00000008BHF250131","","126.5","","1795819.91"
"2025-02-04","2025-01-31","SF FuneralF901034       250201","","126.5","","1795946.41"
"2025-02-04","2025-01-31","SF FuneralF980442       250201","","126.5","","1796072.91"
"2025-02-04","2025-01-31","SF FuneralF981376       250201","","126.5","","1796199.41"
"2025-02-04","2025-01-31","SF FuneralF981614       250201","","126.5","","1796325.91"
"2025-02-04","2025-01-31","SF FuneralF981660       250201","","126.5","","1796452.41"
"2025-02-04","2025-01-31","SF FuneralF987567       250201","","126.5","","1796578.91"
"2025-02-04","2025-01-31","SF FuneralFDC0000000HSKW250201","","126.5","","1796705.41"
"2025-02-04","2025-01-31","SF FuneralF987575       250201","","126.5","","1796831.91"
"2025-02-04","2025-01-31","SF FuneralF987654       250201","","126.5","","1796958.41"
"2025-02-04","2025-01-31","SF FuneralF987675       250201","","126.5","","1797084.91"
"2025-02-04","2025-01-31","SF FuneralF987681       250201","","126.5","","1797211.41"
"2025-02-04","2025-01-31","SF FuneralF988336       250201","","126.5","","1797337.91"
"2025-02-04","2025-01-31","SF FuneralF988401       250201","","126.5","","1797464.41"
"2025-02-04","2025-01-31","SF FuneralF988475       250201","","126.5","","1797590.91"
"2025-02-04","2025-01-31","SF FuneralF989469       250201","","126.5","","1797717.41"
"2025-02-04","2025-01-31","SF FuneralF989476       250201","","126.5","","1797843.91"
"2025-02-04","2025-01-31","SF FuneralF989546       250201","","126.5","","1797970.41"
"2025-02-04","2025-01-31","SF FuneralF990004       250201","","126.5","","1798096.91"
"2025-02-04","2025-01-31","SF FuneralF990435       250201","","126.5","","1798223.41"
"2025-02-04","2025-01-31","SF FuneralF1125396      250131","","126.5","","1798349.91"
"2025-02-04","2025-02-01","SF FuneralFDC000000058B6250201","","126.5","","1798476.41"
"2025-02-04","2025-02-01","SF FuneralFDC00000005H8B250201","","126.5","","1798602.91"
"2025-02-04","2025-02-01","SF FuneralFDC00000005MGK250201","","126.5","","1798729.41"
"2025-02-04","2025-02-01","SF FuneralFDC00000005RKH250201","","126.5","","1798855.91"
"2025-02-04","2025-02-01","SF FuneralFDC00000005SVX250201","","126.5","","1798982.41"
"2025-02-04","2025-02-01","SF FuneralFDC0000000685H250201","","126.5","","1799108.91"
"2025-02-04","2025-02-01","SF FuneralFDC0000000688D250201","","126.5","","1799235.41"
"2025-02-04","2025-02-01","SF FuneralFDC000000069ZK250201","","126.5","","1799361.91"
"2025-02-04","2025-02-01","SF FuneralFDC00000006FH1250201","","126.5","","1799488.41"
"2025-02-04","2025-02-01","SF FuneralFDC00000006GSM250201","","126.5","","1799614.91"
"2025-02-04","2025-02-01","SF FuneralFDC00000006H0G250201","","220","","1799834.91"
"2025-02-04","2025-02-01","SF FuneralFDC00000006MHN250201","","126.5","","1799961.41"
"2025-02-04","2025-02-01","SF FuneralFDC00000006NG8250201","","126.5","","1800087.91"
"2025-02-04","2025-02-01","SF FuneralFDC00000006RXG250201","","126.5","","1800214.41"
"2025-02-04","2025-02-01","SF FuneralFDC00000006S71250201","","126.5","","1800340.91"
"2025-02-04","2025-02-01","SF FuneralFDC00000006SG5250201","","220","","1800560.91"
"2025-02-04","2025-02-01","SF FuneralFDC00000006SJT250201","","126.5","","1800687.41"
"2025-02-04","2025-02-01","SF FuneralFDC00000006STT250201","","126.5","","1800813.91"
"2025-02-04","2025-02-01","SF FuneralFDC000000071JR250201","","126.5","","1800940.41"
"2025-02-04","2025-02-01","SF FuneralFDC000000075B6250201","","126.5","","1801066.91"
"2025-02-04","2025-02-01","SF FuneralFDC000000075RS250201","","126.5","","1801193.41"
"2025-02-04","2025-02-01","SF FuneralFDC000000076NL250201","","126.5","","1801319.91"
"2025-02-04","2025-02-01","SF FuneralFDC000000078VP250201","","126.5","","1801446.41"
"2025-02-04","2025-02-01","SF FuneralFDC000000078VV250201","","126.5","","1801572.91"
"2025-02-04","2025-02-01","SF FuneralFDC0000000792V250201","","126.5","","1801699.41"
"2025-02-04","2025-02-01","SF FuneralFDC00000007BKD250201","","126.5","","1801825.91"
"2025-02-04","2025-02-01","SF FuneralFDC00000007BN1250201","","126.5","","1801952.41"
"2025-02-04","2025-02-01","SF FuneralFDC00000007D3S250201","","126.5","","1802078.91"
"2025-02-04","2025-02-01","SF FuneralFDC00000007D8Q250201","","126.5","","1802205.41"
"2025-02-04","2025-02-01","SF FuneralFDC00000007DLS250201","","126.5","","1802331.91"
"2025-02-04","2025-02-01","SF FuneralFDC00000007R9N250201","","126.5","","1802458.41"
"2025-02-04","2025-02-01","SF FuneralF794186       250201","","126.5","","1802584.91"
"2025-02-04","2025-02-01","SF FuneralF794279       250201","","126.5","","1802711.41"
"2025-02-04","2025-02-01","SF FuneralF795220       250201","","126.5","","1802837.91"
"2025-02-04","2025-02-01","SF FuneralFDC000000086HM250201","","213.31","","1803051.22"
"2025-02-04","2025-02-01","SF FuneralF799473       250201","","126.5","","1803177.72"
"2025-02-04","2025-02-01","SF FuneralF799541       250201","","126.5","","1803304.22"
"2025-02-04","2025-02-01","SF FuneralF799877       250201","","126.5","","1803430.72"
"2025-02-04","2025-02-01","SF FuneralFDC00000008LCW250201","","126.5","","1803557.22"
"2025-02-04","2025-02-01","SF FuneralF783433       250201","","126.5","","1803683.72"
"2025-02-04","2025-02-01","SF FuneralFDC00000008M52250201","","126.5","","1803810.22"
"2025-02-04","2025-02-01","SF FuneralFDC00000008MHV250201","","126.5","","1803936.72"
"2025-02-04","2025-02-01","SF FuneralFDC00000009035250201","","126.5","","1804063.22"
"2025-02-04","2025-02-01","SF FuneralF809040       250201","","126.5","","1804189.72"
"2025-02-04","2025-02-01","SF FuneralF781009       250201","","126.5","","1804316.22"
"2025-02-04","2025-02-01","SF FuneralF811708       250201","","126.5","","1804442.72"
"2025-02-04","2025-02-01","SF FuneralF811970       250201","","126.5","","1804569.22"
"2025-02-04","2025-02-01","SF FuneralF812323       250201","","126.5","","1804695.72"
"2025-02-04","2025-02-01","SF FuneralF812332       250201","","126.5","","1804822.22"
"2025-02-04","2025-02-01","SF FuneralF812514       250201","","126.5","","1804948.72"
"2025-02-04","2025-02-01","SF FuneralF813439       250201","","126.5","","1805075.22"
"2025-02-04","2025-02-01","SF FuneralF815023       250201","","126.5","","1805201.72"
"2025-02-04","2025-02-01","SF FuneralF816406       250201","","126.5","","1805328.22"
"2025-02-04","2025-02-01","SF FuneralF816447       250201","","126.5","","1805454.72"
"2025-02-04","2025-02-01","SF FuneralF816459       250201","","126.5","","1805581.22"
"2025-02-04","2025-02-01","SF FuneralF816461       250201","","126.5","","1805707.72"
"2025-02-04","2025-02-01","SF FuneralF816465       250201","","126.5","","1805834.22"
"2025-02-04","2025-02-01","SF FuneralF809249       250201","","191.5","","1806025.72"
"2025-02-04","2025-02-01","SF FuneralF816686       250201","","126.5","","1806152.22"
"2025-02-04","2025-02-01","SF FuneralF816703       250201","","126.5","","1806278.72"
"2025-02-04","2025-02-01","SF FuneralF816737       250201","","126.5","","1806405.22"
"2025-02-04","2025-02-01","SF FuneralF816828       250201","","126.5","","1806531.72"
"2025-02-04","2025-02-01","SF FuneralF817237       250201","","126.5","","1806658.22"
"2025-02-04","2025-02-01","SF FuneralF817253       250201","","126.5","","1806784.72"
"2025-02-04","2025-02-01","SF FuneralF820879       250201","","126.5","","1806911.22"
"2025-02-04","2025-02-01","SF FuneralF821319       250201","","126.5","","1807037.72"
"2025-02-04","2025-02-01","SF FuneralF821351       250201","","126.5","","1807164.22"
"2025-02-04","2025-02-01","SF FuneralFDC0000000BB5Z250201","","126.5","","1807290.72"
"2025-02-04","2025-02-01","SF FuneralF821448       250201","","126.5","","1807417.22"
"2025-02-04","2025-02-01","SF FuneralFDC0000000BB6L250201","","126.5","","1807543.72"
"2025-02-04","2025-02-01","SF FuneralF821841       250201","","126.5","","1807670.22"
"2025-02-04","2025-02-01","SF FuneralF827586       250201","","126.5","","1807796.72"
"2025-02-04","2025-02-01","SF FuneralF829967       250201","","126.5","","1807923.22"
"2025-02-04","2025-02-01","SF FuneralF830570       250201","","126.5","","1808049.72"
"2025-02-04","2025-02-01","SF FuneralF830812       250201","","126.5","","1808176.22"
"2025-02-04","2025-02-01","SF FuneralF841005       250201","","126.5","","1808302.72"
"2025-02-04","2025-02-01","SF FuneralF841419       250201","","126.5","","1808429.22"
"2025-02-04","2025-02-01","SF FuneralF841453       250201","","126.5","","1808555.72"
"2025-02-04","2025-02-01","SF FuneralF841450       250201","","126.5","","1808682.22"
"2025-02-04","2025-02-01","SF FuneralF842651       250201","","126.5","","1808808.72"
"2025-02-04","2025-02-01","SF FuneralF992795       250201","","126.5","","1808935.22"
"2025-02-04","2025-02-01","SF FuneralF992906       250201","","126.5","","1809061.72"
"2025-02-04","2025-02-01","SF FuneralF993548       250201","","126.5","","1809188.22"
"2025-02-04","2025-02-01","SF FuneralF994003       250201","","126.5","","1809314.72"
"2025-02-04","2025-02-01","SF FuneralFDC0000000JG30250201","","126.5","","1809441.22"
"2025-02-04","2025-02-01","SF FuneralF1016685      250201","","126.5","","1809567.72"
"2025-02-04","2025-02-01","SF FuneralFDC0000000JK0C250201","","126.5","","1809694.22"
"2025-02-04","2025-02-01","SF FuneralF1021585      250201","","126.5","","1809820.72"
"2025-02-04","2025-02-01","SF FuneralF1021614      250201","","126.5","","1809947.22"
"2025-02-04","2025-02-01","SF FuneralF1021952      250201","","126.5","","1810073.72"
"2025-02-04","2025-02-01","SF FuneralF1022038      250201","","126.5","","1810200.22"
"2025-02-04","2025-02-01","SF FuneralF1054545      250201","","126.5","","1810326.72"
"2025-02-04","2025-02-01","SF FuneralF1054563      250201","","126.5","","1810453.22"
"2025-02-04","2025-02-01","SF FuneralFDC0000000K42S250201","","126.5","","1810579.72"
"2025-02-04","2025-02-01","SF FuneralFDC0000000K4ZC250201","","126.5","","1810706.22"
"2025-02-04","2025-02-01","SF FuneralF1055167      250201","","126.5","","1810832.72"
"2025-02-04","2025-02-01","SF FuneralF740921       250201","","126.5","","1810959.22"
"2025-02-04","2025-02-01","SF FuneralF1055191      250201","","126.5","","1811085.72"
"2025-02-04","2025-02-01","SF FuneralF1055201      250201","","126.5","","1811212.22"
"2025-02-04","2025-02-01","SF FuneralF1059411      250201","","126.5","","1811338.72"
"2025-02-04","2025-02-01","SF FuneralF1059419      250201","","126.5","","1811465.22"
"2025-02-04","2025-02-01","SF FuneralFDC0000000KFH0250201","","126.5","","1811591.72"
"2025-02-04","2025-02-01","SF FuneralF1061760      250201","","126.5","","1811718.22"
"2025-02-04","2025-02-01","SF FuneralFDC0000000KNBG250201","","126.5","","1811844.72"
"2025-02-04","2025-02-01","SF FuneralF1066316      250201","","126.5","","1811971.22"
"2025-02-04","2025-02-01","SF FuneralF1066544      250201","","126.5","","1812097.72"
"2025-02-04","2025-02-01","SF FuneralF1066556      250201","","126.5","","1812224.22"
"2025-02-04","2025-02-01","SF FuneralF1073699      250201","","126.5","","1812350.72"
"2025-02-04","2025-02-01","SF FuneralF1074984      250201","","126.5","","1812477.22"
"2025-02-04","2025-02-01","SF FuneralF1078322      250201","","126.5","","1812603.72"
"2025-02-04","2025-02-01","SF FuneralF1078330      250201","","126.5","","1812730.22"
"2025-02-04","2025-02-01","SF FuneralF1078975      250201","","126.5","","1812856.72"
"2025-02-04","2025-02-01","SF FuneralF1079009      250201","","126.5","","1812983.22"
"2025-02-04","2025-02-01","SF FuneralF1079059      250201","","126.5","","1813109.72"
"2025-02-04","2025-02-01","SF FuneralF1079492      250201","","126.5","","1813236.22"
"2025-02-04","2025-02-01","SF FuneralF1079495      250201","","126.5","","1813362.72"
"2025-02-04","2025-02-01","SF FuneralF1079533      250201","","126.5","","1813489.22"
"2025-02-04","2025-02-01","SF FuneralF987824       250201","","126.5","","1813615.72"
"2025-02-04","2025-02-01","SF FuneralF1079702      250201","","126.5","","1813742.22"
"2025-02-04","2025-02-01","SF FuneralF1080150      250201","","126.5","","1813868.72"
"2025-02-04","2025-02-01","SF FuneralF1080365      250201","","126.5","","1813995.22"
"2025-02-04","2025-02-01","SF FuneralF988426       250201","","126.5","","1814121.72"
"2025-02-04","2025-02-01","SF FuneralF1084006      250201","","126.5","","1814248.22"
"2025-02-04","2025-02-01","SF FuneralF1085298      250202","","126.5","","1814374.72"
"2025-02-04","2025-02-01","SF FuneralF1103624      250201","","126.5","","1814501.22"
"2025-02-04","2025-02-01","SF FuneralF1104049      250201","","126.5","","1814627.72"
"2025-02-04","2025-02-01","SF FuneralF1108562      250201","","126.5","","1814754.22"
"2025-02-04","2025-02-01","SF FuneralF1060357      250202","","126.5","","1814880.72"
"2025-02-04","2025-02-01","SF FuneralF1108766      250201","","126.5","","1815007.22"
"2025-02-04","2025-02-01","SF FuneralF1108815      250201","","126.5","","1815133.72"
"2025-02-04","2025-02-01","SF FuneralF1109642      250201","","126.5","","1815260.22"
"2025-02-04","2025-02-01","SF FuneralF1111560      250201","","126.5","","1815386.72"
"2025-02-04","2025-02-01","SF FuneralF1113274      250201","","126.5","","1815513.22"
"2025-02-04","2025-02-01","SF FuneralF1114215      250201","","126.5","","1815639.72"
"2025-02-04","2025-02-01","SF FuneralF1115807      250201","","126.5","","1815766.22"
"2025-02-04","2025-02-01","SF FuneralF1117003      250201","","126.5","","1815892.72"
"2025-02-04","2025-02-01","SF FuneralF1117162      250201","","126.5","","1816019.22"
"2025-02-04","2025-02-01","SF FuneralF1117201      250201","","126.5","","1816145.72"
"2025-02-04","2025-02-01","SF FuneralF1117228      250201","","126.5","","1816272.22"
"2025-02-04","2025-02-01","SF FuneralFDC0000000NJRN250201","","126.5","","1816398.72"
"2025-02-04","2025-02-01","SF FuneralF1117275      250201","","126.5","","1816525.22"
"2025-02-04","2025-02-01","SF FuneralF1118506      250201","","126.5","","1816651.72"
"2025-02-04","2025-02-01","SF FuneralF1118834      250201","","126.5","","1816778.22"
"2025-02-04","2025-02-01","SF FuneralF1119718      250201","","126.5","","1816904.72"
"2025-02-04","2025-02-01","SF FuneralF1120178      250201","","126.5","","1817031.22"
"2025-02-04","2025-02-01","SF FuneralF1120409      250201","","126.5","","1817157.72"
"2025-02-04","2025-02-01","SF FuneralF1122007      250201","","126.5","","1817284.22"
"2025-02-04","2025-02-01","SF FuneralF1122063      250201","","126.5","","1817410.72"
"2025-02-04","2025-02-01","SF FuneralF1122228      250201","","126.5","","1817537.22"
"2025-02-04","2025-02-01","SF FuneralF1122285      250201","","126.5","","1817663.72"
"2025-02-04","2025-02-01","SF FuneralF1117411      250201","","191.5","","1817855.22"
"2025-02-04","2025-02-01","SF FuneralF1122670      250201","","126.5","","1817981.72"
"2025-02-04","2025-02-01","SF FuneralF1122962      250201","","126.5","","1818108.22"
"2025-02-04","2025-02-01","SF FuneralFDC0000000P2ZP250201","","126.5","","1818234.72"
"2025-02-04","2025-02-01","SF FuneralF1122994      250201","","126.5","","1818361.22"
"2025-02-04","2025-02-01","SF FuneralF1123152      250201","","126.5","","1818487.72"
"2025-02-04","2025-02-01","SF FuneralF1123160      250201","","126.5","","1818614.22"
"2025-02-04","2025-02-01","SF FuneralF1125906      250201","","126.5","","1818740.72"
"2025-02-04","2025-02-01","SF FuneralFDC0000000PJVX250201","","126.5","","1818867.22"
"2025-02-04","2025-02-01","SF FuneralF1126163      250201","","126.5","","1818993.72"
"2025-02-04","2025-02-01","SF FuneralF1126820      250201","","126.5","","1819120.22"
"2025-02-04","2025-02-01","SF FuneralF1127525      250201","","126.5","","1819246.72"
"2025-02-04","2025-02-01","SF FuneralF1127560      250201","","126.5","","1819373.22"
"2025-02-04","2025-02-01","SF FuneralF1127901      250201","","126.5","","1819499.72"
"2025-02-04","2025-02-01","SF FuneralF1127915      250201","","126.5","","1819626.22"
"2025-02-04","2025-02-01","SF FuneralF1129309      250201","","126.5","","1819752.72"
"2025-02-04","2025-02-01","SF FuneralF1129442      250201","","126.5","","1819879.22"
"2025-02-04","2025-02-01","SF FuneralF775153       250201","","126.5","","1820005.72"
"2025-02-04","2025-02-03","SF FuneralF844719       250201","","126.5","","1820132.22"
"2025-02-04","2025-02-04","SF FuneralF1114001      250204","","126.5","","1820258.72"
"2025-02-04","2025-02-04","SF FuneralF1125077      250204","","63.25","","1820321.97"
"2025-02-04","2025-02-04","SF FuneralF1129149      250204","","63.25","","1820385.22"
"2025-02-04","2025-01-28","SF FuneralFDC00000007QKJ250128","","126.5","","1820511.72"
"2025-02-04","2025-01-28","SF FuneralFDC00000007QV6250128","","126.5","","1820638.22"
"2025-02-04","2025-01-29","SF FuneralF987917       250129","","126.5","","1820764.72"
"2025-02-04","2025-01-30","SF FuneralF812141       250130","","126.5","","1820891.22"
"2025-02-04","2025-01-31","SF FuneralFDC000000078LH250131","","126.5","","1821017.72"
"2025-02-04","2025-01-31","SF FuneralFDC00000007QKG250131","","126.5","","1821144.22"
"2025-02-04","2025-01-31","SF FuneralF813832       250131","","126.5","","1821270.72"
"2025-02-04","2025-01-31","SF FuneralF840850       250131","","126.5","","1821397.22"
"2025-02-04","2025-01-31","SF FuneralF901055       250201","","126.5","","1821523.72"
"2025-02-04","2025-01-31","SF FuneralF901298       250201","","126.5","","1821650.22"
"2025-02-04","2025-01-31","SF FuneralF980271       250201","","126.5","","1821776.72"
"2025-02-04","2025-01-31","SF FuneralF987947       250201","","126.5","","1821903.22"
"2025-02-04","2025-01-31","SF FuneralF988017       250201","","126.5","","1822029.72"
"2025-02-04","2025-01-31","SF FuneralF988374       250201","","126.5","","1822156.22"
"2025-02-04","2025-01-31","SF FuneralF988947       250201","","126.5","","1822282.72"
"2025-02-04","2025-01-31","SF FuneralF989188       250201","","126.5","","1822409.22"
"2025-02-04","2025-01-31","SF FuneralF989292       250201","","126.5","","1822535.72"
"2025-02-04","2025-01-31","SF FuneralF989407       250201","","126.5","","1822662.22"
"2025-02-04","2025-01-31","SF FuneralFDC0000000HZ66250201","","126.5","","1822788.72"
"2025-02-04","2025-01-31","SF FuneralF989422       250201","","126.5","","1822915.22"
"2025-02-04","2025-01-31","SF FuneralF989427       250201","","126.5","","1823041.72"
"2025-02-04","2025-01-31","SF FuneralF991424       250201","","126.5","","1823168.22"
"2025-02-04","2025-01-31","SF FuneralF994091       250131","","126.5","","1823294.72"
"2025-02-04","2025-02-01","SF FuneralFDC00000002X6Y250201","","220","","1823514.72"
"2025-02-04","2025-02-01","SF FuneralFDC000000069CX250201","","126.5","","1823641.22"
"2025-02-04","2025-02-01","SF FuneralFDC00000006CLJ250201","","126.5","","1823767.72"
"2025-02-04","2025-02-01","SF FuneralFDC00000006M79250201","","126.5","","1823894.22"
"2025-02-04","2025-02-01","SF FuneralFDC00000006M99250201","","126.5","","1824020.72"
"2025-02-04","2025-02-01","SF FuneralFDC00000006W3M250201","","126.5","","1824147.22"
"2025-02-04","2025-02-01","SF FuneralFDC00000006XLM250201","","126.5","","1824273.72"
"2025-02-04","2025-02-01","SF FuneralFDC000000073LH250201","","126.5","","1824400.22"
"2025-02-04","2025-02-01","SF FuneralFDC000000073P0250201","","126.5","","1824526.72"
"2025-02-04","2025-02-01","SF FuneralFDC0000000751M250201","","126.5","","1824653.22"
"2025-02-04","2025-02-01","SF FuneralFDC0000000751P250201","","126.5","","1824779.72"
"2025-02-04","2025-02-01","SF FuneralFDC000000076HM250201","","126.5","","1824906.22"
"2025-02-04","2025-02-01","SF FuneralFDC000000076QT250201","","126.5","","1825032.72"
"2025-02-04","2025-02-01","SF FuneralFDC000000076XR250201","","126.5","","1825159.22"
"2025-02-04","2025-02-01","SF FuneralFDC00000007C1B250201","","220","","1825379.22"
"2025-02-04","2025-02-01","SF FuneralFDC00000007FFP250201","","126.5","","1825505.72"
"2025-02-04","2025-02-01","SF FuneralFDC00000007FGW250201","","126.5","","1825632.22"
"2025-02-04","2025-02-01","SF FuneralFDC00000007FSJ250201","","220","","1825852.22"
"2025-02-04","2025-02-01","SF FuneralF794057       250201","","126.5","","1825978.72"
"2025-02-04","2025-02-01","SF FuneralFDC00000007QZ1250201","","126.5","","1826105.22"
"2025-02-04","2025-02-01","SF FuneralF794079       250201","","126.5","","1826231.72"
"2025-02-04","2025-02-01","SF FuneralFDC00000007T11250201","","126.5","","1826358.22"
"2025-02-04","2025-02-01","SF FuneralFDC000000083KP250201","","126.5","","1826484.72"
"2025-02-04","2025-02-01","SF FuneralFDC000000083M2250201","","126.5","","1826611.22"
"2025-02-04","2025-02-01","SF FuneralF798270       250201","","126.5","","1826737.72"
"2025-02-04","2025-02-01","SF FuneralF798283       250201","","126.5","","1826864.22"
"2025-02-04","2025-02-01","SF FuneralFDC000000084J9250201","","191.5","","1827055.72"
"2025-02-04","2025-02-01","SF FuneralF799134       250201","","126.5","","1827182.22"
"2025-02-04","2025-02-01","SF FuneralFDC000000087CT250201","","191.5","","1827373.72"
"2025-02-04","2025-02-01","SF FuneralF799995       250201","","126.5","","1827500.22"
"2025-02-04","2025-02-01","SF FuneralF800341       250201","","126.5","","1827626.72"
"2025-02-04","2025-02-01","SF FuneralFDC00000008HQG250201","","126.5","","1827753.22"
"2025-02-04","2025-02-01","SF FuneralF801917       250201","","126.5","","1827879.72"
"2025-02-04","2025-02-01","SF FuneralFDC00000008NR9250201","","256.5","","1828136.22"
"2025-02-04","2025-02-01","SF FuneralF803813       250201","","126.5","","1828262.72"
"2025-02-04","2025-02-01","SF FuneralF803834       250201","","126.5","","1828389.22"
"2025-02-04","2025-02-01","SF FuneralF804347       250201","","126.5","","1828515.72"
"2025-02-04","2025-02-01","SF FuneralF804363       250201","","126.5","","1828642.22"
"2025-02-04","2025-02-01","SF FuneralF808534       250201","","126.5","","1828768.72"
"2025-02-04","2025-02-01","SF FuneralF808551       250201","","126.5","","1828895.22"
"2025-02-04","2025-02-01","SF FuneralF808569       250201","","126.5","","1829021.72"
"2025-02-04","2025-02-01","SF FuneralF808672       250201","","126.5","","1829148.22"
"2025-02-04","2025-02-01","SF FuneralF809426       250201","","126.5","","1829274.72"
"2025-02-04","2025-02-01","SF FuneralFDC000000093B2250201","","126.5","","1829401.22"
"2025-02-04","2025-02-01","SF FuneralF809752       250201","","126.5","","1829527.72"
"2025-02-04","2025-02-01","SF FuneralFDC000000094MH250201","","126.5","","1829654.22"
"2025-02-04","2025-02-01","SF FuneralF812513       250201","","126.5","","1829780.72"
"2025-02-04","2025-02-01","SF FuneralF812563       250201","","126.5","","1829907.22"
"2025-02-04","2025-02-01","SF FuneralF812566       250201","","126.5","","1830033.72"
"2025-02-04","2025-02-01","SF FuneralF812875       250201","","126.5","","1830160.22"
"2025-02-04","2025-02-01","SF FuneralF812972       250201","","126.5","","1830286.72"
"2025-02-04","2025-02-01","SF FuneralF817111       250201","","126.5","","1830413.22"
"2025-02-04","2025-02-01","SF FuneralF817415       250201","","126.5","","1830539.72"
"2025-02-04","2025-02-01","SF FuneralF817503       250201","","126.5","","1830666.22"
"2025-02-04","2025-02-01","SF FuneralF817504       250201","","126.5","","1830792.72"
"2025-02-04","2025-02-01","SF FuneralF817950       250201","","126.5","","1830919.22"
"2025-02-04","2025-02-01","SF FuneralF821531       250201","","126.5","","1831045.72"
"2025-02-04","2025-02-01","SF FuneralF822506       250201","","126.5","","1831172.22"
"2025-02-04","2025-02-01","SF FuneralF822766       250201","","126.5","","1831298.72"
"2025-02-04","2025-02-01","SF FuneralF822773       250201","","126.5","","1831425.22"
"2025-02-04","2025-02-01","SF FuneralF829476       250201","","126.5","","1831551.72"
"2025-02-04","2025-02-01","SF FuneralF829515       250201","","126.5","","1831678.22"
"2025-02-04","2025-02-01","SF FuneralFDC0000000D0HF250201","","126.5","","1831804.72"
"2025-02-04","2025-02-01","SF FuneralF992465       250201","","126.5","","1831931.22"
"2025-02-04","2025-02-01","SF FuneralF992477       250201","","126.5","","1832057.72"
"2025-02-04","2025-02-01","SF FuneralF992651       250201","","126.5","","1832184.22"
"2025-02-04","2025-02-01","SF FuneralF992954       250201","","126.5","","1832310.72"
"2025-02-04","2025-02-01","SF FuneralF993045       250201","","126.5","","1832437.22"
"2025-02-04","2025-02-01","SF FuneralF1021294      250201","","126.5","","1832563.72"
"2025-02-04","2025-02-01","SF FuneralF1021493      250201","","126.5","","1832690.22"
"2025-02-04","2025-02-01","SF FuneralF1021905      250201","","126.5","","1832816.72"
"2025-02-04","2025-02-01","SF FuneralF1050820      250201","","126.5","","1832943.22"
"2025-02-04","2025-02-01","SF FuneralF981022       250201","","126.5","","1833069.72"
"2025-02-04","2025-02-01","SF FuneralF1055278      250201","","126.5","","1833196.22"
"2025-02-04","2025-02-01","SF FuneralF1058593      250201","","126.5","","1833322.72"
"2025-02-04","2025-02-01","SF FuneralF1059468      250201","","126.5","","1833449.22"
"2025-02-04","2025-02-01","SF FuneralF1059485      250201","","126.5","","1833575.72"
"2025-02-04","2025-02-01","SF FuneralF1060091      250201","","126.5","","1833702.22"
"2025-02-04","2025-02-01","SF FuneralFDC0000000KCT8250202","","126.5","","1833828.72"
"2025-02-04","2025-02-01","SF FuneralF1066175      250201","","126.5","","1833955.22"
"2025-02-04","2025-02-01","SF FuneralF1066385      250201","","126.5","","1834081.72"
"2025-02-04","2025-02-01","SF FuneralF1066402      250201","","191.5","","1834273.22"
"2025-02-04","2025-02-01","SF FuneralF1066539      250201","","126.5","","1834399.72"
"2025-02-04","2025-02-01","SF FuneralF816893       250201","","126.5","","1834526.22"
"2025-02-04","2025-02-01","SF FuneralF1068229      250201","","126.5","","1834652.72"
"2025-02-04","2025-02-01","SF FuneralF1068337      250201","","126.5","","1834779.22"
"2025-02-04","2025-02-01","SF FuneralF1073829      250201","","126.5","","1834905.72"
"2025-02-04","2025-02-01","SF FuneralF1075081      250201","","126.5","","1835032.22"
"2025-02-04","2025-02-01","SF FuneralF1075082      250201","","126.5","","1835158.72"
"2025-02-04","2025-02-01","SF FuneralF1075087      250201","","126.5","","1835285.22"
"2025-02-04","2025-02-01","SF FuneralF1078374      250201","","126.5","","1835411.72"
"2025-02-04","2025-02-01","SF FuneralF1094330      250201","","126.5","","1835538.22"
"2025-02-04","2025-02-01","SF FuneralF1108793      250201","","126.5","","1835664.72"
"2025-02-04","2025-02-01","SF FuneralF1110240      250201","","126.5","","1835791.22"
"2025-02-04","2025-02-01","SF FuneralF1110469      250201","","126.5","","1835917.72"
"2025-02-04","2025-02-01","SF FuneralF1113882      250201","","126.5","","1836044.22"
"2025-02-04","2025-02-01","SF FuneralF1114668      250201","","126.5","","1836170.72"
"2025-02-04","2025-02-01","SF FuneralF1116073      250201","","126.5","","1836297.22"
"2025-02-04","2025-02-01","SF FuneralF1116091      250201","","126.5","","1836423.72"
"2025-02-04","2025-02-01","SF FuneralF1116949      250201","","126.5","","1836550.22"
"2025-02-04","2025-02-01","SF FuneralFDC0000000NJV4250201","","126.5","","1836676.72"
"2025-02-04","2025-02-01","SF FuneralF1117331      250201","","126.5","","1836803.22"
"2025-02-04","2025-02-01","SF FuneralF1117409      250201","","126.5","","1836929.72"
"2025-02-04","2025-02-01","SF FuneralFDC0000000NLLQ250201","","126.5","","1837056.22"
"2025-02-04","2025-02-01","SF FuneralF1122566      250201","","126.5","","1837182.72"
"2025-02-04","2025-02-01","SF FuneralF1126288      250201","","126.5","","1837309.22"
"2025-02-04","2025-02-01","SF FuneralF1126916      250201","","126.5","","1837435.72"
"2025-02-04","2025-02-01","SF FuneralF1127101      250202","","126.5","","1837562.22"
"2025-02-04","2025-02-01","SF FuneralF1127848      250201","","126.5","","1837688.72"
"2025-02-04","2025-02-01","SF FuneralFDC0000000PSQ8250201","","191.5","","1837880.22"
"2025-02-04","2025-02-01","SF FuneralF1129480      250201","","126.5","","1838006.72"
"2025-02-04","2025-02-01","SF FuneralFDC0000000PZLM250201","","126.5","","1838133.22"
"2025-02-04","2025-02-03","SF FuneralF818067       250203","","126.5","","1838259.72"
"2025-02-04","2025-02-03","SF FuneralF832917       250203","","126.5","","1838386.22"
"2025-02-04","2025-02-03","SF FuneralFDC0000000F9MW250201","","126.5","","1838512.72"
"2025-02-04","2025-02-03","SF FuneralF842942       250201","","126.5","","1838639.22"
"2025-02-04","2025-02-03","SF FuneralF842959       250201","","126.5","","1838765.72"
"2025-02-04","2025-02-03","SF FuneralF1058809      250203","","126.5","","1838892.22"
"2025-02-04","2025-02-04","SF FuneralFDC00000007J6D250204","","63.25","","1838955.47"
"2025-02-04","2025-02-01","SF FuneralF1121775      250202","","47.88","","1839003.35"
"2025-02-04","2025-02-03","SF FuneralF1118181      250203","","31.63","","1839034.98"
"2025-02-04","2025-02-04","SF FuneralF805200       250204","","31.63","","1839066.61"
"2025-02-04","2025-02-04","SF FuneralFDC0000000HK7D250204","","31.63","","1839098.24"
"2025-02-04","2025-02-04","SF FuneralFDC0000000HN9N250204","","31.63","","1839129.87"
"2025-02-04","2025-02-04","SF FuneralF1050833      250204","","31.63","","1839161.5"
"2025-02-04","2025-01-29","SF FuneralFDC000000057WC250129","","126.5","","1839288"
"2025-02-04","2025-01-29","SF FuneralF809474       250129","","126.5","","1839414.5"
"2025-02-04","2025-01-29","SF FuneralF809599       250129","","126.5","","1839541"
"2025-02-04","2025-01-29","SF FuneralF900486       250129","","126.5","","1839667.5"
"2025-02-04","2025-01-30","SF FuneralFDC00000005S90250130","","126.5","","1839794"
"2025-02-04","2025-01-30","SF FuneralFDC00000005X08250130","","191.5","","1839985.5"
"2025-02-04","2025-01-30","SF FuneralFDC000000067XG250130","","126.5","","1840112"
"2025-02-04","2025-01-30","SF FuneralFDC00000007629250130","","126.5","","1840238.5"
"2025-02-04","2025-01-30","SF FuneralF1084621      250130","","126.5","","1840365"
"2025-02-04","2025-01-30","SF FuneralF1121876      250130","","126.5","","1840491.5"
"2025-02-04","2025-01-30","SF FuneralF1121897      250130","","126.5","","1840618"
"2025-02-04","2025-01-31","SF FuneralFDC000000067VY250131","","126.5","","1840744.5"
"2025-02-04","2025-01-31","SF FuneralF828408       250201","","126.5","","1840871"
"2025-02-04","2025-01-31","SF FuneralF900961       250201","","126.5","","1840997.5"
"2025-02-04","2025-01-31","SF FuneralF796457       250201","","256.5","","1841254"
"2025-02-04","2025-01-31","SF FuneralF981694       250201","","126.5","","1841380.5"
"2025-02-04","2025-01-31","SF FuneralFDC0000000HLPD250201","","126.5","","1841507"
"2025-02-04","2025-01-31","SF FuneralF788755       250201","","126.5","","1841633.5"
"2025-02-04","2025-01-31","SF FuneralF988391       250201","","126.5","","1841760"
"2025-02-04","2025-01-31","SF FuneralF988500       250201","","126.5","","1841886.5"
"2025-02-04","2025-01-31","SF FuneralF988504       250201","","126.5","","1842013"
"2025-02-04","2025-01-31","SF FuneralF988519       250201","","126.5","","1842139.5"
"2025-02-04","2025-01-31","SF FuneralF802810       250201","","126.5","","1842266"
"2025-02-04","2025-01-31","SF FuneralF989220       250201","","126.5","","1842392.5"
"2025-02-04","2025-01-31","SF FuneralFDC0000000HYRW250201","","126.5","","1842519"
"2025-02-04","2025-01-31","SF FuneralF990466       250201","","126.5","","1842645.5"
"2025-02-04","2025-01-31","SF FuneralF991084       250201","","126.5","","1842772"
"2025-02-04","2025-02-01","SF FuneralFDC00000003LNL250201","","220","","1842992"
"2025-02-04","2025-02-01","SF FuneralFDC00000005F07250201","","126.5","","1843118.5"
"2025-02-04","2025-02-01","SF FuneralFDC00000005F1Y250201","","126.5","","1843245"
"2025-02-04","2025-02-01","SF FuneralFDC00000005FWS250201","","126.5","","1843371.5"
"2025-02-04","2025-02-01","SF FuneralFDC00000005K5Y250201","","126.5","","1843498"
"2025-02-04","2025-02-01","SF FuneralFDC00000005RZ6250201","","126.5","","1843624.5"
"2025-02-04","2025-02-01","SF FuneralFDC000000067GS250201","","126.5","","1843751"
"2025-02-04","2025-02-01","SF FuneralFDC000000067K1250201","","126.5","","1843877.5"
"2025-02-04","2025-02-01","SF FuneralFDC000000067R1250201","","126.5","","1844004"
"2025-02-04","2025-02-01","SF FuneralFDC00000006821250201","","126.5","","1844130.5"
"2025-02-04","2025-02-01","SF FuneralFDC000000068C4250201","","126.5","","1844257"
"2025-02-04","2025-02-01","SF FuneralFDC000000068P8250201","","126.5","","1844383.5"
"2025-02-04","2025-02-01","SF FuneralFDC00000006CB7250201","","126.5","","1844510"
"2025-02-04","2025-02-01","SF FuneralFDC00000006CD0250201","","126.5","","1844636.5"
"2025-02-04","2025-02-01","SF FuneralFDC00000006CXQ250201","","126.5","","1844763"
"2025-02-04","2025-02-01","SF FuneralFDC00000006D0B250201","","126.5","","1844889.5"
"2025-02-04","2025-02-01","SF FuneralFDC00000006GLR250201","","126.5","","1845016"
"2025-02-04","2025-02-01","SF FuneralFDC00000006HZT250201","","126.5","","1845142.5"
"2025-02-04","2025-02-01","SF FuneralFDC00000006KKY250201","","126.5","","1845269"
"2025-02-04","2025-02-01","SF FuneralFDC00000006STY250201","","126.5","","1845395.5"
"2025-02-04","2025-02-01","SF FuneralFDC00000006W0Y250201","","126.5","","1845522"
"2025-02-04","2025-02-01","SF FuneralFDC00000006YXW250201","","126.5","","1845648.5"
"2025-02-04","2025-02-01","SF FuneralFDC0000000745C250201","","126.5","","1845775"
"2025-02-04","2025-02-01","SF FuneralFDC0000000745J250201","","126.5","","1845901.5"
"2025-02-04","2025-02-01","SF FuneralFDC0000000747P250201","","126.5","","1846028"
"2025-02-04","2025-02-01","SF FuneralFDC000000074NG250201","","126.5","","1846154.5"
"2025-02-04","2025-02-01","SF FuneralFDC000000075K0250201","","126.5","","1846281"
"2025-02-04","2025-02-01","SF FuneralFDC000000075NM250201","","126.5","","1846407.5"
"2025-02-04","2025-02-01","SF FuneralFDC0000000779Z250201","","126.5","","1846534"
"2025-02-04","2025-02-01","SF FuneralFDC000000077TG250201","","126.5","","1846660.5"
"2025-02-04","2025-02-01","SF FuneralFDC000000079KX250201","","126.5","","1846787"
"2025-02-04","2025-02-01","SF FuneralFDC00000007FC9250201","","126.5","","1846913.5"
"2025-02-04","2025-02-01","SF FuneralFDC00000007RJT250201","","126.5","","1847040"
"2025-02-04","2025-02-01","SF FuneralFDC00000007SJP250201","","126.5","","1847166.5"
"2025-02-04","2025-02-01","SF FuneralFDC00000007SK3250201","","126.5","","1847293"
"2025-02-04","2025-02-01","SF FuneralFDC00000007TRN250201","","126.5","","1847419.5"
"2025-02-04","2025-02-01","SF FuneralFDC00000007TRQ250201","","126.5","","1847546"
"2025-02-04","2025-02-01","SF FuneralFDC00000007TWH250201","","126.5","","1847672.5"
"2025-02-04","2025-02-01","SF FuneralFDC00000007YVX250201","","126.5","","1847799"
"2025-02-04","2025-02-01","SF FuneralFDC000000083DD250201","","126.5","","1847925.5"
"2025-02-04","2025-02-01","SF FuneralF797988       250201","","126.5","","1848052"
"2025-02-04","2025-02-01","SF FuneralF798296       250201","","126.5","","1848178.5"
"2025-02-04","2025-02-01","SF FuneralFDC000000084J1250201","","126.5","","1848305"
"2025-02-04","2025-02-01","SF FuneralF798376       250201","","126.5","","1848431.5"
"2025-02-04","2025-02-01","SF FuneralF798677       250201","","126.5","","1848558"
"2025-02-04","2025-02-01","SF FuneralFDC000000085XW250201","","126.5","","1848684.5"
"2025-02-04","2025-02-01","SF FuneralF798869       250201","","126.5","","1848811"
"2025-02-04","2025-02-01","SF FuneralFDC000000089HY250201","","126.5","","1848937.5"
"2025-02-04","2025-02-01","SF FuneralF802788       250201","","126.5","","1849064"
"2025-02-04","2025-02-01","SF FuneralF803332       250201","","126.5","","1849190.5"
"2025-02-04","2025-02-01","SF FuneralF803536       250201","","126.5","","1849317"
"2025-02-04","2025-02-01","SF FuneralF803720       250201","","126.5","","1849443.5"
"2025-02-04","2025-02-01","SF FuneralF808477       250201","","126.5","","1849570"
"2025-02-04","2025-02-01","SF FuneralF808482       250201","","126.5","","1849696.5"
"2025-02-04","2025-02-01","SF FuneralF808743       250201","","126.5","","1849823"
"2025-02-04","2025-02-01","SF FuneralF808883       250201","","126.5","","1849949.5"
"2025-02-04","2025-02-01","SF FuneralF809238       250201","","126.5","","1850076"
"2025-02-04","2025-02-01","SF FuneralFDC000000096CF250201","","126.5","","1850202.5"
"2025-02-04","2025-02-01","SF FuneralF812400       250201","","126.5","","1850329"
"2025-02-04","2025-02-01","SF FuneralF812405       250201","","126.5","","1850455.5"
"2025-02-04","2025-02-01","SF FuneralF812440       250201","","126.5","","1850582"
"2025-02-04","2025-02-01","SF FuneralF812442       250201","","126.5","","1850708.5"
"2025-02-04","2025-02-01","SF FuneralF812918       250201","","126.5","","1850835"
"2025-02-04","2025-02-01","SF FuneralF812925       250201","","126.5","","1850961.5"
"2025-02-04","2025-02-01","SF FuneralF813080       250201","","126.5","","1851088"
"2025-02-04","2025-02-01","SF FuneralF815527       250201","","126.5","","1851214.5"
"2025-02-04","2025-02-01","SF FuneralF815637       250201","","126.5","","1851341"
"2025-02-04","2025-02-01","SF FuneralF816497       250201","","126.5","","1851467.5"
"2025-02-04","2025-02-01","SF FuneralF816508       250201","","126.5","","1851594"
"2025-02-04","2025-02-01","SF FuneralF816525       250201","","126.5","","1851720.5"
"2025-02-04","2025-02-01","SF FuneralF816534       250201","","126.5","","1851847"
"2025-02-04","2025-02-01","SF FuneralF816751       250201","","126.5","","1851973.5"
"2025-02-04","2025-02-01","SF FuneralF816867       250201","","126.5","","1852100"
"2025-02-04","2025-02-01","SF FuneralF816932       250201","","126.5","","1852226.5"
"2025-02-04","2025-02-01","SF FuneralF816976       250201","","126.5","","1852353"
"2025-02-04","2025-02-01","SF FuneralF818126       250201","","126.5","","1852479.5"
"2025-02-04","2025-02-01","SF FuneralF818129       250201","","126.5","","1852606"
"2025-02-04","2025-02-01","SF FuneralF818316       250201","","126.5","","1852732.5"
"2025-02-04","2025-02-01","SF FuneralF802683       250201","","256.5","","1852989"
"2025-02-04","2025-02-01","SF FuneralF820555       250201","","126.5","","1853115.5"
"2025-02-04","2025-02-01","SF FuneralF820556       250201","","126.5","","1853242"
"2025-02-04","2025-02-01","SF FuneralF820799       250201","","126.5","","1853368.5"
"2025-02-04","2025-02-01","SF FuneralF828242       250201","","126.5","","1853495"
"2025-02-04","2025-02-01","SF FuneralF828245       250201","","126.5","","1853621.5"
"2025-02-04","2025-02-01","SF FuneralF828287       250201","","126.5","","1853748"
"2025-02-04","2025-02-01","SF FuneralF828286       250201","","126.5","","1853874.5"
"2025-02-04","2025-02-01","SF FuneralF828478       250201","","126.5","","1854001"
"2025-02-04","2025-02-01","SF FuneralF828662       250201","","126.5","","1854127.5"
"2025-02-04","2025-02-01","SF FuneralF828967       250201","","126.5","","1854254"
"2025-02-04","2025-02-01","SF FuneralF828981       250201","","126.5","","1854380.5"
"2025-02-04","2025-02-01","SF FuneralF828986       250201","","126.5","","1854507"
"2025-02-04","2025-02-01","SF FuneralF829545       250201","","126.5","","1854633.5"
"2025-02-04","2025-02-01","SF FuneralF829553       250201","","126.5","","1854760"
"2025-02-04","2025-02-01","SF FuneralF781024       250201","","126.5","","1854886.5"
"2025-02-04","2025-02-01","SF FuneralF830742       250201","","126.5","","1855013"
"2025-02-04","2025-02-01","SF FuneralF832041       250201","","126.5","","1855139.5"
"2025-02-04","2025-02-01","SF FuneralF832079       250201","","126.5","","1855266"
"2025-02-04","2025-02-01","SF FuneralFDC0000000CJ2S250201","","126.5","","1855392.5"
"2025-02-04","2025-02-01","SF FuneralF832258       250201","","126.5","","1855519"
"2025-02-04","2025-02-01","SF FuneralF832263       250201","","126.5","","1855645.5"
"2025-02-04","2025-02-01","SF FuneralF833299       250201","","126.5","","1855772"
"2025-02-04","2025-02-01","SF FuneralF841468       250201","","126.5","","1855898.5"
"2025-02-04","2025-02-01","SF FuneralF841687       250201","","126.5","","1856025"
"2025-02-04","2025-02-01","SF FuneralF841912       250201","","126.5","","1856151.5"
"2025-02-04","2025-02-01","SF FuneralF842144       250201","","126.5","","1856278"
"2025-02-04","2025-02-01","SF FuneralF842246       250201","","126.5","","1856404.5"
"2025-02-04","2025-02-01","SF FuneralF992744       250201","","126.5","","1856531"
"2025-02-04","2025-02-01","SF FuneralF993122       250201","","126.5","","1856657.5"
"2025-02-04","2025-02-01","SF FuneralF993124       250201","","126.5","","1856784"
"2025-02-04","2025-02-01","SF FuneralF993244       250201","","126.5","","1856910.5"
"2025-02-04","2025-02-01","SF FuneralF993470       250201","","126.5","","1857037"
"2025-02-04","2025-02-01","SF FuneralF1017198      250201","","126.5","","1857163.5"
"2025-02-04","2025-02-01","SF FuneralF1017492      250201","","126.5","","1857290"
"2025-02-04","2025-02-01","SF FuneralF1021209      250201","","126.5","","1857416.5"
"2025-02-04","2025-02-01","SF FuneralF1021489      250201","","126.5","","1857543"
"2025-02-04","2025-02-01","SF FuneralF1021508      250202","","126.5","","1857669.5"
"2025-02-04","2025-02-01","SF FuneralF1021604      250201","","126.5","","1857796"
"2025-02-04","2025-02-01","SF FuneralFDC0000000JWZ2250201","","126.5","","1857922.5"
"2025-02-04","2025-02-01","SF FuneralF1022196      250201","","126.5","","1858049"
"2025-02-04","2025-02-01","SF FuneralF1033684      250201","","126.5","","1858175.5"
"2025-02-04","2025-02-01","SF FuneralF1033695      250201","","126.5","","1858302"
"2025-02-04","2025-02-01","SF FuneralF1033728      250201","","126.5","","1858428.5"
"2025-02-04","2025-02-01","SF FuneralF1052264      250201","","126.5","","1858555"
"2025-02-04","2025-02-01","SF FuneralF1052517      250201","","126.5","","1858681.5"
"2025-02-04","2025-02-01","SF FuneralF1055226      250201","","126.5","","1858808"
"2025-02-04","2025-02-01","SF FuneralF1055227      250201","","126.5","","1858934.5"
"2025-02-04","2025-02-01","SF FuneralF1055231      250201","","126.5","","1859061"
"2025-02-04","2025-02-01","SF FuneralF1058673      250201","","126.5","","1859187.5"
"2025-02-04","2025-02-01","SF FuneralF1058679      250201","","126.5","","1859314"
"2025-02-04","2025-02-01","SF FuneralF1058683      250201","","126.5","","1859440.5"
"2025-02-04","2025-02-01","SF FuneralF1058732      250201","","126.5","","1859567"
"2025-02-04","2025-02-01","SF FuneralF1059042      250201","","126.5","","1859693.5"
"2025-02-04","2025-02-01","SF FuneralFDC0000000KB1G250201","","126.5","","1859820"
"2025-02-04","2025-02-01","SF FuneralF1060606      250201","","126.5","","1859946.5"
"2025-02-04","2025-02-01","SF FuneralF1060629      250201","","126.5","","1860073"
"2025-02-04","2025-02-01","SF FuneralF1066405      250201","","126.5","","1860199.5"
"2025-02-04","2025-02-01","SF FuneralF1066674      250201","","126.5","","1860326"
"2025-02-04","2025-02-01","SF FuneralF1068194      250201","","126.5","","1860452.5"
"2025-02-04","2025-02-01","SF FuneralFDC0000000L177250201","","126.5","","1860579"
"2025-02-04","2025-02-01","SF FuneralF1073600      250201","","126.5","","1860705.5"
"2025-02-04","2025-02-01","SF FuneralFDC0000000L46S250201","","126.5","","1860832"
"2025-02-04","2025-02-01","SF FuneralF1075194      250201","","126.5","","1860958.5"
"2025-02-04","2025-02-01","SF FuneralF1075206      250201","","126.5","","1861085"
"2025-02-04","2025-02-01","SF FuneralF1078201      250201","","126.5","","1861211.5"
"2025-02-04","2025-02-01","SF FuneralF1078695      250201","","126.5","","1861338"
"2025-02-04","2025-02-01","SF FuneralF1080383      250201","","126.5","","1861464.5"
"2025-02-04","2025-02-01","SF FuneralF1084324      250201","","126.5","","1861591"
"2025-02-04","2025-02-01","SF FuneralF1084439      250201","","126.5","","1861717.5"
"2025-02-04","2025-02-01","SF FuneralF1084561      250201","","126.5","","1861844"
"2025-02-04","2025-02-01","SF FuneralF1084562      250201","","126.5","","1861970.5"
"2025-02-04","2025-02-01","SF FuneralF1085230      250201","","126.5","","1862097"
"2025-02-04","2025-02-01","SF FuneralF1085334      250201","","126.5","","1862223.5"
"2025-02-04","2025-02-01","SF FuneralF1096652      250201","","126.5","","1862350"
"2025-02-04","2025-02-01","SF FuneralF1101597      250201","","126.5","","1862476.5"
"2025-02-04","2025-02-01","SF FuneralF1102906      250201","","126.5","","1862603"
"2025-02-04","2025-02-01","SF FuneralF1108796      250201","","126.5","","1862729.5"
"2025-02-04","2025-02-01","SF FuneralF1108987      250201","","126.5","","1862856"
"2025-02-04","2025-02-01","SF FuneralF1108997      250201","","126.5","","1862982.5"
"2025-02-04","2025-02-01","SF FuneralF1109053      250201","","126.5","","1863109"
"2025-02-04","2025-02-01","SF FuneralF1109132      250201","","126.5","","1863235.5"
"2025-02-04","2025-02-01","SF FuneralF1110013      250201","","126.5","","1863362"
"2025-02-04","2025-02-01","SF FuneralF1110177      250201","","126.5","","1863488.5"
"2025-02-04","2025-02-01","SF FuneralF1110657      250201","","126.5","","1863615"
"2025-02-04","2025-02-01","SF FuneralF1110670      250201","","126.5","","1863741.5"
"2025-02-04","2025-02-01","SF FuneralF1111435      250201","","126.5","","1863868"
"2025-02-04","2025-02-01","SF FuneralF1113117      250201","","126.5","","1863994.5"
"2025-02-04","2025-02-01","SF FuneralF1113134      250201","","126.5","","1864121"
"2025-02-04","2025-02-01","SF FuneralF1113135      250201","","126.5","","1864247.5"
"2025-02-04","2025-02-01","SF FuneralF1113144      250201","","126.5","","1864374"
"2025-02-04","2025-02-01","SF FuneralF1113257      250201","","126.5","","1864500.5"
"2025-02-04","2025-02-01","SF FuneralFDC0000000N52Y250201","","191.5","","1864692"
"2025-02-04","2025-02-01","SF FuneralF1114339      250201","","126.5","","1864818.5"
"2025-02-04","2025-02-01","SF FuneralF1114599      250201","","126.5","","1864945"
"2025-02-04","2025-02-01","SF FuneralF1114711      250201","","126.5","","1865071.5"
"2025-02-04","2025-02-01","SF FuneralF1116071      250201","","126.5","","1865198"
"2025-02-04","2025-02-01","SF FuneralF1116920      250201","","126.5","","1865324.5"
"2025-02-04","2025-02-01","SF FuneralF1116952      250201","","126.5","","1865451"
"2025-02-04","2025-02-01","SF FuneralFDC0000000NJ43250201","","126.5","","1865577.5"
"2025-02-04","2025-02-01","SF FuneralF1117130      250201","","126.5","","1865704"
"2025-02-04","2025-02-01","SF FuneralF1117140      250201","","126.5","","1865830.5"
"2025-02-04","2025-02-01","SF FuneralF1117362      250201","","126.5","","1865957"
"2025-02-04","2025-02-01","SF FuneralF1117643      250201","","126.5","","1866083.5"
"2025-02-04","2025-02-01","SF FuneralF1117734      250201","","126.5","","1866210"
"2025-02-04","2025-02-01","SF FuneralF1117765      250201","","126.5","","1866336.5"
"2025-02-04","2025-02-01","SF FuneralF784270       250201","","126.5","","1866463"
"2025-02-04","2025-02-01","SF FuneralF1118279      250201","","126.5","","1866589.5"
"2025-02-04","2025-02-01","SF FuneralF1118309      250201","","126.5","","1866716"
"2025-02-04","2025-02-01","SF FuneralFDC0000000NPWH250201","","126.5","","1866842.5"
"2025-02-04","2025-02-01","SF FuneralF1118916      250201","","126.5","","1866969"
"2025-02-04","2025-02-01","SF FuneralF1120167      250201","","126.5","","1867095.5"
"2025-02-04","2025-02-01","SF FuneralF1121776      250201","","126.5","","1867222"
"2025-02-04","2025-02-01","SF FuneralF1121777      250201","","126.5","","1867348.5"
"2025-02-04","2025-02-01","SF FuneralF1121878      250201","","126.5","","1867475"
"2025-02-04","2025-02-01","SF FuneralF1121974      250201","","126.5","","1867601.5"
"2025-02-04","2025-02-01","SF FuneralF1121977      250201","","126.5","","1867728"
"2025-02-04","2025-02-01","SF FuneralF1121986      250201","","126.5","","1867854.5"
"2025-02-04","2025-02-01","SF FuneralF1121987      250201","","126.5","","1867981"
"2025-02-04","2025-02-01","SF FuneralF1122271      250201","","126.5","","1868107.5"
"2025-02-04","2025-02-01","SF FuneralF1122810      250201","","126.5","","1868234"
"2025-02-04","2025-02-01","SF FuneralF783420       250201","","191.5","","1868425.5"
"2025-02-04","2025-02-01","SF FuneralF1122863      250201","","126.5","","1868552"
"2025-02-04","2025-02-01","SF FuneralF1123047      250201","","126.5","","1868678.5"
"2025-02-04","2025-02-01","SF FuneralF1123215      250201","","126.5","","1868805"
"2025-02-04","2025-02-01","SF FuneralF1123491      250201","","126.5","","1868931.5"
"2025-02-04","2025-02-01","SF FuneralF1124076      250201","","126.5","","1869058"
"2025-02-04","2025-02-01","SF FuneralF1125695      250201","","126.5","","1869184.5"
"2025-02-04","2025-02-01","SF FuneralF1126127      250201","","126.5","","1869311"
"2025-02-04","2025-02-01","SF FuneralFDC0000000PNDG250201","","126.5","","1869437.5"
"2025-02-04","2025-02-01","SF FuneralFDC0000000PNWN250201","","126.5","","1869564"
"2025-02-04","2025-02-01","SF FuneralF1127443      250201","","126.5","","1869690.5"
"2025-02-04","2025-02-01","SF FuneralFDC0000000PSQ4250201","","191.5","","1869882"
"2025-02-04","2025-02-01","SF FuneralF1128026      250201","","126.5","","1870008.5"
"2025-02-04","2025-02-01","SF FuneralF1128173      250201","","126.5","","1870135"
"2025-02-04","2025-02-01","SF FuneralFDC0000000PVH6250201","","126.5","","1870261.5"
"2025-02-04","2025-02-01","SF FuneralF1128215      250201","","126.5","","1870388"
"2025-02-04","2025-02-01","SF FuneralF1128220      250201","","126.5","","1870514.5"
"2025-02-04","2025-02-01","SF FuneralF1128690      250201","","126.5","","1870641"
"2025-02-04","2025-02-01","SF FuneralF1128750      250201","","126.5","","1870767.5"
"2025-02-04","2025-02-01","SF FuneralF1129066      250201","","126.5","","1870894"
"2025-02-04","2025-02-03","SF FuneralF809350       250202","","126.5","","1871020.5"
"2025-02-04","2025-02-03","SF FuneralF816772       250202","","126.5","","1871147"
"2025-02-04","2025-02-03","SF FuneralF828553       250203","","126.5","","1871273.5"
"2025-02-04","2025-02-03","SF FuneralF900523       250201","","126.5","","1871400"
"2025-02-04","2025-02-03","SF FuneralF900631       250201","","126.5","","1871526.5"
"2025-02-04","2025-01-27","SF FuneralF793906       250126","","126.5","","1871653"
"2025-02-04","2025-01-27","SF FuneralF793930       250126","","126.5","","1871779.5"
"2025-02-04","2025-01-27","SF FuneralF795804       250126","","126.5","","1871906"
"2025-02-04","2025-01-28","SF FuneralFDC0000000N8NW250128","","63.25","","1871969.25"
"2025-02-04","2025-01-29","SF FuneralF1075029      250129","","126.5","","1872095.75"
"2025-02-04","2025-01-29","SF FuneralF1118760      250129","","126.5","","1872222.25"
"2025-02-04","2025-01-30","SF FuneralFDC0000000N3YP250130","","126.5","","1872348.75"
"2025-02-04","2025-01-31","SF FuneralF901030       250201","","126.5","","1872475.25"
"2025-02-04","2025-01-31","SF FuneralF980330       250201","","126.5","","1872601.75"
"2025-02-04","2025-01-31","SF FuneralF980421       250201","","126.5","","1872728.25"
"2025-02-04","2025-01-31","SF FuneralF980431       250201","","126.5","","1872854.75"
"2025-02-04","2025-01-31","SF FuneralFDC0000000HY0G250201","","126.5","","1872981.25"
"2025-02-04","2025-02-01","SF FuneralFDC00000002VV2250201","","220","","1873201.25"
"2025-02-04","2025-02-01","SF FuneralFDC000000032G7250201","","220","","1873421.25"
"2025-02-04","2025-02-01","SF FuneralFDC000000033YD250201","","220","","1873641.25"
"2025-02-04","2025-02-01","SF FuneralFDC000000035ZH250201","","220","","1873861.25"
"2025-02-04","2025-02-01","SF FuneralFDC00000003SY9250201","","220","","1874081.25"
"2025-02-04","2025-02-01","SF FuneralFDC000000057QF250201","","126.5","","1874207.75"
"2025-02-04","2025-02-01","SF FuneralFDC000000058MX250201","","126.5","","1874334.25"
"2025-02-04","2025-02-01","SF FuneralFDC000000059MJ250201","","126.5","","1874460.75"
"2025-02-04","2025-02-01","SF FuneralFDC00000005DFV250201","","126.5","","1874587.25"
"2025-02-04","2025-02-01","SF FuneralFDC00000005GBW250201","","126.5","","1874713.75"
"2025-02-04","2025-02-01","SF FuneralFDC00000005GHR250201","","126.5","","1874840.25"
"2025-02-04","2025-02-01","SF FuneralFDC00000005GLT250201","","126.5","","1874966.75"
"2025-02-04","2025-02-01","SF FuneralFDC00000005LW5250201","","126.5","","1875093.25"
"2025-02-04","2025-02-01","SF FuneralFDC00000005X5Q250201","","126.5","","1875219.75"
"2025-02-04","2025-02-01","SF FuneralFDC00000005XJ3250201","","126.5","","1875346.25"
"2025-02-04","2025-02-01","SF FuneralFDC00000005Y87250201","","126.5","","1875472.75"
"2025-02-04","2025-02-01","SF FuneralFDC000000065RK250201","","126.5","","1875599.25"
"2025-02-04","2025-02-01","SF FuneralFDC000000068DX250201","","126.5","","1875725.75"
"2025-02-04","2025-02-01","SF FuneralFDC000000068F7250201","","126.5","","1875852.25"
"2025-02-04","2025-02-01","SF FuneralFDC000000068KY250201","","126.5","","1875978.75"
"2025-02-04","2025-02-01","SF FuneralFDC000000069JR250201","","126.5","","1876105.25"
"2025-02-04","2025-02-01","SF FuneralFDC00000006BRY250201","","126.5","","1876231.75"
"2025-02-04","2025-02-01","SF FuneralFDC00000006BW2250201","","126.5","","1876358.25"
"2025-02-04","2025-02-01","SF FuneralFDC00000006DGV250201","","126.5","","1876484.75"
"2025-02-04","2025-02-01","SF FuneralFDC00000006DWF250201","","126.5","","1876611.25"
"2025-02-04","2025-02-01","SF FuneralFDC00000006G5B250201","","126.5","","1876737.75"
"2025-02-04","2025-02-01","SF FuneralFDC00000006GC5250201","","126.5","","1876864.25"
"2025-02-04","2025-02-01","SF FuneralFDC00000006GWG250201","","126.5","","1876990.75"
"2025-02-04","2025-02-01","SF FuneralFDC00000006HHS250201","","126.5","","1877117.25"
"2025-02-04","2025-02-01","SF FuneralFDC00000006JBR250201","","126.5","","1877243.75"
"2025-02-04","2025-02-01","SF FuneralFDC00000006JCQ250201","","126.5","","1877370.25"
"2025-02-04","2025-02-01","SF FuneralFDC00000006K95250201","","126.5","","1877496.75"
"2025-02-04","2025-02-01","SF FuneralFDC00000006KHX250201","","126.5","","1877623.25"
"2025-02-04","2025-02-01","SF FuneralFDC00000006KV7250201","","126.5","","1877749.75"
"2025-02-04","2025-02-01","SF FuneralFDC00000006LNL250201","","126.5","","1877876.25"
"2025-02-04","2025-02-01","SF FuneralFDC00000006LR1250201","","126.5","","1878002.75"
"2025-02-04","2025-02-01","SF FuneralFDC00000006LW6250201","","126.5","","1878129.25"
"2025-02-04","2025-02-01","SF FuneralFDC00000006LX2250201","","126.5","","1878255.75"
"2025-02-04","2025-02-01","SF FuneralFDC00000006Q10250201","","126.5","","1878382.25"
"2025-02-04","2025-02-01","SF FuneralFDC00000006Q7L250201","","126.5","","1878508.75"
"2025-02-04","2025-02-01","SF FuneralFDC00000006Q81250201","","126.5","","1878635.25"
"2025-02-04","2025-02-01","SF FuneralFDC000000070V2250201","","126.5","","1878761.75"
"2025-02-04","2025-02-01","SF FuneralFDC000000073CX250201","","126.5","","1878888.25"
"2025-02-04","2025-02-01","SF FuneralFDC000000073DC250201","","126.5","","1879014.75"
"2025-02-04","2025-02-01","SF FuneralFDC000000073V0250201","","126.5","","1879141.25"
"2025-02-04","2025-02-01","SF FuneralFDC000000075VX250201","","126.5","","1879267.75"
"2025-02-04","2025-02-01","SF FuneralFDC0000000787D250201","","126.5","","1879394.25"
"2025-02-04","2025-02-01","SF FuneralFDC000000078S5250201","","126.5","","1879520.75"
"2025-02-04","2025-02-01","SF FuneralFDC00000007DG1250201","","126.5","","1879647.25"
"2025-02-04","2025-02-01","SF FuneralFDC00000007GKV250201","","126.5","","1879773.75"
"2025-02-04","2025-02-01","SF FuneralFDC00000007P33250201","","126.5","","1879900.25"
"2025-02-04","2025-02-01","SF FuneralFDC00000007PR0250201","","126.5","","1880026.75"
"2025-02-04","2025-02-01","SF FuneralFDC00000007PSF250201","","220","","1880246.75"
"2025-02-04","2025-02-01","SF FuneralFDC00000007Q02250201","","126.5","","1880373.25"
"2025-02-04","2025-02-01","SF FuneralFDC00000007Q62250201","","126.5","","1880499.75"
"2025-02-04","2025-02-01","SF FuneralFDC00000007VL1250201","","126.5","","1880626.25"
"2025-02-04","2025-02-01","SF FuneralFDC00000007W1G250201","","126.5","","1880752.75"
"2025-02-04","2025-02-01","SF FuneralF795594       250201","","126.5","","1880879.25"
"2025-02-04","2025-02-01","SF FuneralF795726       250201","","126.5","","1881005.75"
"2025-02-04","2025-02-01","SF FuneralF795984       250201","","126.5","","1881132.25"
"2025-02-04","2025-02-01","SF FuneralFDC000000085NZ250201","","126.5","","1881258.75"
"2025-02-04","2025-02-01","SF FuneralF799293       250201","","126.5","","1881385.25"
"2025-02-04","2025-02-01","SF FuneralF799577       250201","","126.5","","1881511.75"
"2025-02-04","2025-02-01","SF FuneralFDC000000088K3250201","","220","","1881731.75"
"2025-02-04","2025-02-01","SF FuneralFDC000000088K6250201","","126.5","","1881858.25"
"2025-02-04","2025-02-01","SF FuneralFDC00000008KPH250201","","126.5","","1881984.75"
"2025-02-04","2025-02-01","SF FuneralFDC00000008KXM250201","","126.5","","1882111.25"
"2025-02-04","2025-02-01","SF FuneralFDC00000008LJ6250201","","126.5","","1882237.75"
"2025-02-04","2025-02-01","SF FuneralF803205       250201","","126.5","","1882364.25"
"2025-02-04","2025-02-01","SF FuneralF803244       250201","","126.5","","1882490.75"
"2025-02-04","2025-02-01","SF FuneralF803247       250201","","126.5","","1882617.25"
"2025-02-04","2025-02-01","SF FuneralFDC00000008M9Q250201","","126.5","","1882743.75"
"2025-02-04","2025-02-01","SF FuneralF803927       250201","","126.5","","1882870.25"
"2025-02-04","2025-02-01","SF FuneralFDC00000008PH6250201","","126.5","","1882996.75"
"2025-02-04","2025-02-01","SF FuneralF805064       250201","","126.5","","1883123.25"
"2025-02-04","2025-02-01","SF FuneralFDC00000008VDP250201","","126.5","","1883249.75"
"2025-02-04","2025-02-01","SF FuneralF808830       250201","","126.5","","1883376.25"
"2025-02-04","2025-02-01","SF FuneralF808966       250201","","126.5","","1883502.75"
"2025-02-04","2025-02-01","SF FuneralF809138       250201","","126.5","","1883629.25"
"2025-02-04","2025-02-01","SF FuneralF809139       250201","","126.5","","1883755.75"
"2025-02-04","2025-02-01","SF FuneralF809157       250201","","126.5","","1883882.25"
"2025-02-04","2025-02-01","SF FuneralF812134       250201","","126.5","","1884008.75"
"2025-02-04","2025-02-01","SF FuneralF812158       250201","","126.5","","1884135.25"
"2025-02-04","2025-02-01","SF FuneralF812172       250201","","126.5","","1884261.75"
"2025-02-04","2025-02-01","SF FuneralF812466       250201","","126.5","","1884388.25"
"2025-02-04","2025-02-01","SF FuneralF812491       250201","","126.5","","1884514.75"
"2025-02-04","2025-02-01","SF FuneralF812843       250201","","126.5","","1884641.25"
"2025-02-04","2025-02-01","SF FuneralF813164       250201","","126.5","","1884767.75"
"2025-02-04","2025-02-01","SF FuneralF813181       250201","","126.5","","1884894.25"
"2025-02-04","2025-02-01","SF FuneralF813341       250201","","126.5","","1885020.75"
"2025-02-04","2025-02-01","SF FuneralF813373       250201","","126.5","","1885147.25"
"2025-02-04","2025-02-01","SF FuneralF815160       250201","","126.5","","1885273.75"
"2025-02-04","2025-02-01","SF FuneralF815486       250201","","126.5","","1885400.25"
"2025-02-04","2025-02-01","SF FuneralF816550       250201","","126.5","","1885526.75"
"2025-02-04","2025-02-01","SF FuneralF816558       250201","","126.5","","1885653.25"
"2025-02-04","2025-02-01","SF FuneralF816673       250201","","126.5","","1885779.75"
"2025-02-04","2025-02-01","SF FuneralF816963       250201","","126.5","","1885906.25"
"2025-02-04","2025-02-01","SF FuneralF817074       250201","","126.5","","1886032.75"
"2025-02-04","2025-02-01","SF FuneralF817337       250201","","126.5","","1886159.25"
"2025-02-04","2025-02-01","SF FuneralF817648       250201","","126.5","","1886285.75"
"2025-02-04","2025-02-01","SF FuneralF818336       250201","","126.5","","1886412.25"
"2025-02-04","2025-02-01","SF FuneralFDC0000000B16T250201","","126.5","","1886538.75"
"2025-02-04","2025-02-01","SF FuneralF818466       250201","","126.5","","1886665.25"
"2025-02-04","2025-02-01","SF FuneralF819181       250201","","126.5","","1886791.75"
"2025-02-04","2025-02-01","SF FuneralF819203       250201","","126.5","","1886918.25"
"2025-02-04","2025-02-01","SF FuneralF819863       250201","","126.5","","1887044.75"
"2025-02-04","2025-02-01","SF FuneralF819976       250201","","126.5","","1887171.25"
"2025-02-04","2025-02-01","SF FuneralFDC0000000B7GC250201","","126.5","","1887297.75"
"2025-02-04","2025-02-01","SF FuneralF820759       250201","","126.5","","1887424.25"
"2025-02-04","2025-02-01","SF FuneralF821676       250201","","126.5","","1887550.75"
"2025-02-04","2025-02-01","SF FuneralF822178       250201","","126.5","","1887677.25"
"2025-02-04","2025-02-01","SF FuneralF828045       250201","","126.5","","1887803.75"
"2025-02-04","2025-02-01","SF FuneralF828252       250201","","126.5","","1887930.25"
"2025-02-04","2025-02-01","SF FuneralF828433       250201","","126.5","","1888056.75"
"2025-02-04","2025-02-01","SF FuneralFDC0000000BPPL250201","","126.5","","1888183.25"
"2025-02-04","2025-02-01","SF FuneralF830239       250201","","126.5","","1888309.75"
"2025-02-04","2025-02-01","SF FuneralF832272       250201","","126.5","","1888436.25"
"2025-02-04","2025-02-01","SF FuneralF832387       250201","","126.5","","1888562.75"
"2025-02-04","2025-02-01","SF FuneralFDC0000000CK5L250201","","126.5","","1888689.25"
"2025-02-04","2025-02-01","SF FuneralF832607       250201","","126.5","","1888815.75"
"2025-02-04","2025-02-01","SF FuneralF832633       250201","","126.5","","1888942.25"
"2025-02-04","2025-02-01","SF FuneralF832764       250201","","126.5","","1889068.75"
"2025-02-04","2025-02-01","SF FuneralF832767       250201","","126.5","","1889195.25"
"2025-02-04","2025-02-01","SF FuneralF832845       250201","","126.5","","1889321.75"
"2025-02-04","2025-02-01","SF FuneralF833124       250201","","126.5","","1889448.25"
"2025-02-04","2025-02-01","SF FuneralF833333       250201","","126.5","","1889574.75"
"2025-02-04","2025-02-01","SF FuneralF833642       250201","","126.5","","1889701.25"
"2025-02-04","2025-02-01","SF FuneralF833751       250201","","126.5","","1889827.75"
"2025-02-04","2025-02-01","SF FuneralF833766       250201","","126.5","","1889954.25"
"2025-02-04","2025-02-01","SF FuneralF834011       250201","","126.5","","1890080.75"
"2025-02-04","2025-02-01","SF FuneralF834053       250201","","126.5","","1890207.25"
"2025-02-04","2025-02-01","SF FuneralF834713       250201","","126.5","","1890333.75"
"2025-02-04","2025-02-01","SF FuneralF834999       250201","","126.5","","1890460.25"
"2025-02-04","2025-02-01","SF FuneralF838784       250201","","126.5","","1890586.75"
"2025-02-04","2025-02-01","SF FuneralF841410       250201","","126.5","","1890713.25"
"2025-02-04","2025-02-01","SF FuneralF841413       250201","","126.5","","1890839.75"
"2025-02-04","2025-02-01","SF FuneralF841444       250201","","126.5","","1890966.25"
"2025-02-04","2025-02-01","SF FuneralF841508       250201","","126.5","","1891092.75"
"2025-02-04","2025-02-01","SF FuneralF841612       250201","","126.5","","1891219.25"
"2025-02-04","2025-02-01","SF FuneralF841657       250201","","126.5","","1891345.75"
"2025-02-04","2025-02-01","SF FuneralF841975       250201","","126.5","","1891472.25"
"2025-02-04","2025-02-01","SF FuneralF842119       250201","","126.5","","1891598.75"
"2025-02-04","2025-02-01","SF FuneralF842435       250201","","126.5","","1891725.25"
"2025-02-04","2025-02-01","SF FuneralF842805       250201","","126.5","","1891851.75"
"2025-02-04","2025-02-01","SF FuneralF814243       250201","","126.5","","1891978.25"
"2025-02-04","2025-02-01","SF FuneralF992213       250201","","126.5","","1892104.75"
"2025-02-04","2025-02-01","SF FuneralF992237       250201","","126.5","","1892231.25"
"2025-02-04","2025-02-01","SF FuneralF992246       250201","","126.5","","1892357.75"
"2025-02-04","2025-02-01","SF FuneralF992261       250201","","126.5","","1892484.25"
"2025-02-04","2025-02-01","SF FuneralF992283       250201","","126.5","","1892610.75"
"2025-02-04","2025-02-01","SF FuneralF992282       250201","","126.5","","1892737.25"
"2025-02-04","2025-02-01","SF FuneralF992454       250201","","126.5","","1892863.75"
"2025-02-04","2025-02-01","SF FuneralFDC0000000J9KL250201","","126.5","","1892990.25"
"2025-02-04","2025-02-01","SF FuneralF993346       250201","","126.5","","1893116.75"
"2025-02-04","2025-02-01","SF FuneralF993427       250201","","126.5","","1893243.25"
"2025-02-04","2025-02-01","SF FuneralF1021313      250201","","126.5","","1893369.75"
"2025-02-04","2025-02-01","SF FuneralF1021318      250201","","126.5","","1893496.25"
"2025-02-04","2025-02-01","SF FuneralF1021441      250201","","126.5","","1893622.75"
"2025-02-04","2025-02-01","SF FuneralF1021439      250201","","126.5","","1893749.25"
"2025-02-04","2025-02-01","SF FuneralFDC0000000JVRB250201","","126.5","","1893875.75"
"2025-02-04","2025-02-01","SF FuneralF1021546      250201","","126.5","","1894002.25"
"2025-02-04","2025-02-01","SF FuneralF1022271      250201","","126.5","","1894128.75"
"2025-02-04","2025-02-01","SF FuneralF1022274      250201","","126.5","","1894255.25"
"2025-02-04","2025-02-01","SF FuneralF1022276      250201","","126.5","","1894381.75"
"2025-02-04","2025-02-01","SF FuneralF1033527      250201","","126.5","","1894508.25"
"2025-02-04","2025-02-01","SF FuneralF1033642      250201","","126.5","","1894634.75"
"2025-02-04","2025-02-01","SF FuneralFDC0000000JZF2250201","","126.5","","1894761.25"
"2025-02-04","2025-02-01","SF FuneralF1050790      250201","","126.5","","1894887.75"
"2025-02-04","2025-02-01","SF FuneralF1052366      250201","","126.5","","1895014.25"
"2025-02-04","2025-02-01","SF FuneralF1055240      250201","","126.5","","1895140.75"
"2025-02-04","2025-02-01","SF FuneralF1055272      250201","","126.5","","1895267.25"
"2025-02-04","2025-02-01","SF FuneralFDC0000000K8KW250201","","126.5","","1895393.75"
"2025-02-04","2025-02-01","SF FuneralFDC0000000KFV9250201","","126.5","","1895520.25"
"2025-02-04","2025-02-01","SF FuneralF1066378      250201","","126.5","","1895646.75"
"2025-02-04","2025-02-01","SF FuneralF1066638      250201","","126.5","","1895773.25"
"2025-02-04","2025-02-01","SF FuneralF1066704      250201","","126.5","","1895899.75"
"2025-02-04","2025-02-01","SF FuneralF1066721      250201","","126.5","","1896026.25"
"2025-02-04","2025-02-01","SF FuneralF1067958      250201","","126.5","","1896152.75"
"2025-02-04","2025-02-01","SF FuneralF1068155      250201","","126.5","","1896279.25"
"2025-02-04","2025-02-01","SF FuneralF1072972      250201","","126.5","","1896405.75"
"2025-02-04","2025-02-01","SF FuneralF1073126      250201","","126.5","","1896532.25"
"2025-02-04","2025-02-01","SF FuneralF1075241      250201","","126.5","","1896658.75"
"2025-02-04","2025-02-01","SF FuneralF1075283      250201","","126.5","","1896785.25"
"2025-02-04","2025-02-01","SF FuneralF1075303      250201","","126.5","","1896911.75"
"2025-02-04","2025-02-01","SF FuneralF1078286      250201","","126.5","","1897038.25"
"2025-02-04","2025-02-01","SF FuneralF1078397      250201","","126.5","","1897164.75"
"2025-02-04","2025-02-01","SF FuneralF1078990      250201","","126.5","","1897291.25"
"2025-02-04","2025-02-01","SF FuneralF1084385      250201","","126.5","","1897417.75"
"2025-02-04","2025-02-01","SF FuneralF1084396      250201","","126.5","","1897544.25"
"2025-02-04","2025-02-01","SF FuneralF1084468      250201","","126.5","","1897670.75"
"2025-02-04","2025-02-01","SF FuneralF1084495      250201","","126.5","","1897797.25"
"2025-02-04","2025-02-01","SF FuneralF1084535      250201","","126.5","","1897923.75"
"2025-02-04","2025-02-01","SF FuneralF1084725      250201","","126.5","","1898050.25"
"2025-02-04","2025-02-01","SF FuneralF812346       250201","","126.5","","1898176.75"
"2025-02-04","2025-02-01","SF FuneralF1085006      250201","","126.5","","1898303.25"
"2025-02-04","2025-02-01","SF FuneralF1085449      250201","","126.5","","1898429.75"
"2025-02-04","2025-02-01","SF FuneralF1103735      250201","","126.5","","1898556.25"
"2025-02-04","2025-02-01","SF FuneralF1108068      250201","","126.5","","1898682.75"
"2025-02-04","2025-02-01","SF FuneralF1108795      250201","","126.5","","1898809.25"
"2025-02-04","2025-02-01","SF FuneralF1108813      250201","","126.5","","1898935.75"
"2025-02-04","2025-02-01","SF FuneralF1108851      250201","","126.5","","1899062.25"
"2025-02-04","2025-02-01","SF FuneralF1109104      250202","","126.5","","1899188.75"
"2025-02-04","2025-02-01","SF FuneralF1109613      250202","","126.5","","1899315.25"
"2025-02-04","2025-02-01","SF FuneralF1110257      250201","","126.5","","1899441.75"
"2025-02-04","2025-02-01","SF FuneralF1110272      250201","","126.5","","1899568.25"
"2025-02-04","2025-02-01","SF FuneralF1110481      250201","","126.5","","1899694.75"
"2025-02-04","2025-02-01","SF FuneralF1111599      250201","","126.5","","1899821.25"
"2025-02-04","2025-02-01","SF FuneralF1112427      250201","","126.5","","1899947.75"
"2025-02-04","2025-02-01","SF FuneralF1113096      250201","","126.5","","1900074.25"
"2025-02-04","2025-02-01","SF FuneralFDC0000000N3JN250201","","126.5","","1900200.75"
"2025-02-04","2025-02-01","SF FuneralF1113221      250201","","126.5","","1900327.25"
"2025-02-04","2025-02-01","SF FuneralF986723       250201","","126.5","","1900453.75"
"2025-02-04","2025-02-01","SF FuneralF1113235      250201","","126.5","","1900580.25"
"2025-02-04","2025-02-01","SF FuneralF1113622      250201","","126.5","","1900706.75"
"2025-02-04","2025-02-01","SF FuneralFDC0000000N5HL250201","","126.5","","1900833.25"
"2025-02-04","2025-02-01","SF FuneralF1113855      250201","","126.5","","1900959.75"
"2025-02-04","2025-02-01","SF FuneralF1114563      250201","","126.5","","1901086.25"
"2025-02-04","2025-02-01","SF FuneralF1115853      250201","","126.5","","1901212.75"
"2025-02-04","2025-02-01","SF FuneralF1115910      250202","","126.5","","1901339.25"
"2025-02-04","2025-02-01","SF FuneralFDC0000000NHPV250201","","213.31","","1901552.56"
"2025-02-04","2025-02-01","SF FuneralF774354       250201","","220","","1901772.56"
"2025-02-04","2025-02-01","SF FuneralF1117397      250201","","126.5","","1901899.06"
"2025-02-04","2025-02-01","SF FuneralF1117610      250201","","126.5","","1902025.56"
"2025-02-04","2025-02-01","SF FuneralF1117711      250201","","126.5","","1902152.06"
"2025-02-04","2025-02-01","SF FuneralF1118074      250201","","126.5","","1902278.56"
"2025-02-04","2025-02-01","SF FuneralF1118511      250201","","126.5","","1902405.06"
"2025-02-04","2025-02-01","SF FuneralF1118681      250201","","126.5","","1902531.56"
"2025-02-04","2025-02-01","SF FuneralF1120135      250201","","126.5","","1902658.06"
"2025-02-04","2025-02-01","SF FuneralF1120377      250201","","126.5","","1902784.56"
"2025-02-04","2025-02-01","SF FuneralFDC0000000NZT1250202","","126.5","","1902911.06"
"2025-02-04","2025-02-01","SF FuneralFDC0000000P01F250201","","126.5","","1903037.56"
"2025-02-04","2025-02-01","SF FuneralF1121926      250201","","126.5","","1903164.06"
"2025-02-04","2025-02-01","SF FuneralF1122005      250201","","126.5","","1903290.56"
"2025-02-04","2025-02-01","SF FuneralF1122074      250201","","126.5","","1903417.06"
"2025-02-04","2025-02-01","SF FuneralF1122169      250201","","126.5","","1903543.56"
"2025-02-04","2025-02-01","SF FuneralF1123069      250201","","126.5","","1903670.06"
"2025-02-04","2025-02-01","SF FuneralF1123283      250201","","126.5","","1903796.56"
"2025-02-04","2025-02-01","SF FuneralF1123961      250201","","126.5","","1903923.06"
"2025-02-04","2025-02-01","SF FuneralF1123969      250201","","126.5","","1904049.56"
"2025-02-04","2025-02-01","SF FuneralF1124150      250201","","126.5","","1904176.06"
"2025-02-04","2025-02-01","SF FuneralF1124160      250201","","126.5","","1904302.56"
"2025-02-04","2025-02-01","SF FuneralFDC0000000PGQD250201","","126.5","","1904429.06"
"2025-02-04","2025-02-01","SF FuneralF1125485      250201","","126.5","","1904555.56"
"2025-02-04","2025-02-01","SF FuneralF1125694      250201","","126.5","","1904682.06"
"2025-02-04","2025-02-01","SF FuneralF1125737      250201","","126.5","","1904808.56"
"2025-02-04","2025-02-01","SF FuneralFDC0000000PJ41250201","","126.5","","1904935.06"
"2025-02-04","2025-02-01","SF FuneralF1021796      250201","","126.5","","1905061.56"
"2025-02-04","2025-02-01","SF FuneralF1126002      250201","","126.5","","1905188.06"
"2025-02-04","2025-02-01","SF FuneralFDC0000000PK6F250201","","126.5","","1905314.56"
"2025-02-04","2025-02-01","SF FuneralF1126260      250201","","126.5","","1905441.06"
"2025-02-04","2025-02-01","SF FuneralFDC0000000PL7W250201","","126.5","","1905567.56"
"2025-02-04","2025-02-01","SF FuneralF1126832      250201","","126.5","","1905694.06"
"2025-02-04","2025-02-01","SF FuneralFDC0000000PL99250201","","126.5","","1905820.56"
"2025-02-04","2025-02-01","SF FuneralF1126909      250201","","126.5","","1905947.06"
"2025-02-04","2025-02-01","SF FuneralF1126952      250201","","126.5","","1906073.56"
"2025-02-04","2025-02-01","SF FuneralFDC0000000PNDM250201","","126.5","","1906200.06"
"2025-02-04","2025-02-01","SF FuneralFDC0000000PNYS250201","","126.5","","1906326.56"
"2025-02-04","2025-02-01","SF FuneralF1127751      250201","","126.5","","1906453.06"
"2025-02-04","2025-02-01","SF FuneralF1127855      250201","","126.5","","1906579.56"
"2025-02-04","2025-02-01","SF FuneralFDC0000000PSQD250201","","191.5","","1906771.06"
"2025-02-04","2025-02-01","SF FuneralF1127877      250201","","126.5","","1906897.56"
"2025-02-04","2025-02-01","SF FuneralF1127879      250201","","126.5","","1907024.06"
"2025-02-04","2025-02-01","SF FuneralF1128029      250201","","126.5","","1907150.56"
"2025-02-04","2025-02-01","SF FuneralFDC0000000PV0M250201","","126.5","","1907277.06"
"2025-02-04","2025-02-01","SF FuneralF1128050      250201","","126.5","","1907403.56"
"2025-02-04","2025-02-01","SF FuneralF1128054      250201","","126.5","","1907530.06"
"2025-02-04","2025-02-01","SF FuneralF1128149      250201","","126.5","","1907656.56"
"2025-02-04","2025-02-01","SF FuneralF1128249      250201","","126.5","","1907783.06"
"2025-02-04","2025-02-01","SF FuneralF1128662      250201","","126.5","","1907909.56"
"2025-02-04","2025-02-01","SF FuneralF1128725      250201","","126.5","","1908036.06"
"2025-02-04","2025-02-01","SF FuneralFDC0000000PW30250201","","126.5","","1908162.56"
"2025-02-04","2025-02-01","SF FuneralF1128934      250201","","126.5","","1908289.06"
"2025-02-04","2025-02-01","SF FuneralF1129407      250201","","126.5","","1908415.56"
"2025-02-04","2025-02-03","SF FuneralF832821       250203","","126.5","","1908542.06"
"2025-02-04","2025-02-03","SF FuneralF843840       250201","","126.5","","1908668.56"
"2025-02-04","2025-02-03","SF FuneralF843858       250201","","126.5","","1908795.06"
"2025-02-04","2025-02-03","SF FuneralFDC0000000G123250201","","126.5","","1908921.56"
"2025-02-04","2025-02-03","SF FuneralF859288       250201","","126.5","","1909048.06"
"2025-02-04","2025-02-03","SF FuneralF900676       250201","","126.5","","1909174.56"
"2025-02-04","2025-02-03","SF FuneralF1068295      250203","","126.5","","1909301.06"
"2025-02-04","2025-02-03","SF FuneralF1128241      250203","","126.5","","1909427.56"
"2025-02-04","2025-02-04","SF FuneralF812955       250204","","126.5","","1909554.06"
"2025-02-04","2025-02-04","SF FuneralF829052       250204","","63.25","","1909617.31"
"2025-02-04","2025-01-29","SF FuneralFDC0000000331P250129","","220","","1909837.31"
"2025-02-04","2025-01-31","SF FuneralF1108755      250131","","126.5","","1909963.81"
"2025-02-04","2025-02-01","SF FuneralFDC00000004ZGD250201","","191.05","","1910154.86"
"2025-02-04","2025-02-01","SF FuneralFDC00000005JTS250201","","126.5","","1910281.36"
"2025-02-04","2025-02-01","SF FuneralFDC000000067LL250201","","126.5","","1910407.86"
"2025-02-04","2025-02-01","SF FuneralFDC000000067VS250201","","126.5","","1910534.36"
"2025-02-04","2025-02-01","SF FuneralFDC000000069LZ250201","","126.5","","1910660.86"
"2025-02-04","2025-02-01","SF FuneralFDC00000006D27250201","","126.5","","1910787.36"
"2025-02-04","2025-02-01","SF FuneralFDC00000006D8R250201","","126.5","","1910913.86"
"2025-02-04","2025-02-01","SF FuneralFDC00000006P1R250201","","126.5","","1911040.36"
"2025-02-04","2025-02-01","SF FuneralFDC00000006TWX250201","","126.5","","1911166.86"
"2025-02-04","2025-02-01","SF FuneralFDC00000006V6H250201","","126.5","","1911293.36"
"2025-02-04","2025-02-01","SF FuneralFDC00000006YJ0250201","","126.5","","1911419.86"
"2025-02-04","2025-02-01","SF FuneralFDC0000000788X250201","","126.5","","1911546.36"
"2025-02-04","2025-02-01","SF FuneralF795454       250201","","126.5","","1911672.86"
"2025-02-04","2025-02-01","SF FuneralFDC000000083NM250201","","126.5","","1911799.36"
"2025-02-04","2025-02-01","SF FuneralFDC000000083NN250201","","126.5","","1911925.86"
"2025-02-04","2025-02-01","SF FuneralFDC000000083VT250201","","220","","1912145.86"
"2025-02-04","2025-02-01","SF FuneralF798250       250201","","126.5","","1912272.36"
"2025-02-04","2025-02-01","SF FuneralFDC000000084CJ250201","","126.5","","1912398.86"
"2025-02-04","2025-02-01","SF FuneralFDC000000084H0250201","","126.5","","1912525.36"
"2025-02-04","2025-02-01","SF FuneralF798780       250201","","126.5","","1912651.86"
"2025-02-04","2025-02-01","SF FuneralFDC00000008GXD250201","","126.5","","1912778.36"
"2025-02-04","2025-02-01","SF FuneralFDC00000008Q46250201","","191.5","","1912969.86"
"2025-02-04","2025-02-01","SF FuneralFDC00000008QKP250201","","126.5","","1913096.36"
"2025-02-04","2025-02-01","SF FuneralF804561       250201","","126.5","","1913222.86"
"2025-02-04","2025-02-01","SF FuneralF805194       250201","","126.5","","1913349.36"
"2025-02-04","2025-02-01","SF FuneralF808458       250201","","126.5","","1913475.86"
"2025-02-04","2025-02-01","SF FuneralF808462       250201","","126.5","","1913602.36"
"2025-02-04","2025-02-01","SF FuneralF810691       250201","","126.5","","1913728.86"
"2025-02-04","2025-02-01","SF FuneralF813492       250201","","126.5","","1913855.36"
"2025-02-04","2025-02-01","SF FuneralF813721       250201","","126.5","","1913981.86"
"2025-02-04","2025-02-01","SF FuneralF816573       250201","","126.5","","1914108.36"
"2025-02-04","2025-02-01","SF FuneralFDC00000009WGZ250201","","126.5","","1914234.86"
"2025-02-04","2025-02-01","SF FuneralF813008       250201","","126.5","","1914361.36"
"2025-02-04","2025-02-01","SF FuneralF819017       250201","","126.5","","1914487.86"
"2025-02-04","2025-02-01","SF FuneralF834401       250201","","126.5","","1914614.36"
"2025-02-04","2025-02-01","SF FuneralF834416       250201","","126.5","","1914740.86"
"2025-02-04","2025-02-01","SF FuneralF992526       250201","","126.5","","1914867.36"
"2025-02-04","2025-02-01","SF FuneralF993608       250201","","126.5","","1914993.86"
"2025-02-04","2025-02-01","SF FuneralF1058864      250201","","126.5","","1915120.36"
"2025-02-04","2025-02-01","SF FuneralF1058869      250201","","126.5","","1915246.86"
"2025-02-04","2025-02-01","SF FuneralF1059845      250201","","126.5","","1915373.36"
"2025-02-04","2025-02-01","SF FuneralF1059863      250201","","126.5","","1915499.86"
"2025-02-04","2025-02-01","SF FuneralF1060066      250201","","126.5","","1915626.36"
"2025-02-04","2025-02-01","SF FuneralF1066731      250201","","126.5","","1915752.86"
"2025-02-04","2025-02-01","SF FuneralF1066738      250201","","126.5","","1915879.36"
"2025-02-04","2025-02-01","SF FuneralF1073351      250201","","126.5","","1916005.86"
"2025-02-04","2025-02-01","SF FuneralF1080237      250201","","126.5","","1916132.36"
"2025-02-04","2025-02-01","SF FuneralF1104079      250201","","126.5","","1916258.86"
"2025-02-04","2025-02-01","SF FuneralF1108779      250201","","126.5","","1916385.36"
"2025-02-04","2025-02-01","SF FuneralF1108792      250201","","126.5","","1916511.86"
"2025-02-04","2025-02-01","SF FuneralF1108873      250201","","126.5","","1916638.36"
"2025-02-04","2025-02-01","SF FuneralF1110188      250201","","126.5","","1916764.86"
"2025-02-04","2025-02-01","SF FuneralFDC0000000MMWY250201","","126.5","","1916891.36"
"2025-02-04","2025-02-01","SF FuneralF1113133      250201","","126.5","","1917017.86"
"2025-02-04","2025-02-01","SF FuneralF1113161      250201","","126.5","","1917144.36"
"2025-02-04","2025-02-01","SF FuneralF1113834      250201","","126.5","","1917270.86"
"2025-02-04","2025-02-01","SF FuneralFDC0000000N9XQ250201","","126.5","","1917397.36"
"2025-02-04","2025-02-01","SF FuneralF1114878      250201","","126.5","","1917523.86"
"2025-02-04","2025-02-01","SF FuneralFDC0000000NJSK250201","","126.5","","1917650.36"
"2025-02-04","2025-02-01","SF FuneralF1118282      250201","","126.5","","1917776.86"
"2025-02-04","2025-02-01","SF FuneralF1118288      250201","","126.5","","1917903.36"
"2025-02-04","2025-02-01","SF FuneralF1121919      250201","","126.5","","1918029.86"
"2025-02-04","2025-02-01","SF FuneralF1122802      250201","","126.5","","1918156.36"
"2025-02-04","2025-02-01","SF FuneralF1123104      250201","","126.5","","1918282.86"
"2025-02-04","2025-02-01","SF FuneralF1125440      250201","","126.5","","1918409.36"
"2025-02-04","2025-02-01","SF FuneralF1125473      250201","","126.5","","1918535.86"
"2025-02-04","2025-02-01","SF FuneralF1125703      250201","","126.5","","1918662.36"
"2025-02-04","2025-02-01","SF FuneralF1127888      250201","","126.5","","1918788.86"
"2025-02-04","2025-02-01","SF FuneralF1128086      250201","","126.5","","1918915.36"
"2025-02-04","2025-02-01","SF FuneralFDC0000000Q2JW250201","","126.5","","1919041.86"
"2025-02-04","2025-02-03","SF FuneralF820869       250202","","126.5","","1919168.36"
"2025-02-04","2025-02-03","SF FuneralF843148       250201","","126.5","","1919294.86"
"2025-02-04","2025-02-03","SF FuneralF843158       250201","","126.5","","1919421.36"
"2025-02-04","2025-02-03","SF FuneralF843183       250201","","126.5","","1919547.86"
"2025-02-04","2025-02-03","SF FuneralF843322       250201","","126.5","","1919674.36"
"2025-02-04","2025-02-03","SF FuneralF843657       250201","","126.5","","1919800.86"
"2025-02-04","2025-02-04","SF FuneralFDC00000005MP2250204","","126.5","","1919927.36"
"2025-02-04","2025-02-04","SF FuneralFDC00000005X6K250204","","126.5","","1920053.86"
"2025-02-04","2025-01-28","SF FuneralF816877       250128","","63.25","","1920117.11"
"2025-02-04","2025-01-29","SF FuneralFDC00000006PHV250129","","126.5","","1920243.61"
"2025-02-04","2025-01-29","SF FuneralFDC00000006Q0Q250129","","126.5","","1920370.11"
"2025-02-04","2025-01-29","SF FuneralFDC00000007PTW250129","","63.25","","1920433.36"
"2025-02-04","2025-01-31","SF FuneralF987832       250201","","126.5","","1920559.86"
"2025-02-04","2025-01-31","SF FuneralF987927       250201","","126.5","","1920686.36"
"2025-02-04","2025-02-01","SF FuneralFDC000000033MH250201","","220","","1920906.36"
"2025-02-04","2025-02-01","SF FuneralFDC00000005BQJ250201","","126.5","","1921032.86"
"2025-02-04","2025-02-01","SF FuneralFDC00000005N7N250201","","126.5","","1921159.36"
"2025-02-04","2025-02-01","SF FuneralFDC00000005Q8H250201","","126.5","","1921285.86"
"2025-02-04","2025-02-01","SF FuneralFDC00000005QBY250201","","126.5","","1921412.36"
"2025-02-04","2025-02-01","SF FuneralFDC00000005QKR250201","","126.5","","1921538.86"
"2025-02-04","2025-02-01","SF FuneralFDC00000005Z14250201","","126.5","","1921665.36"
"2025-02-04","2025-02-01","SF FuneralFDC0000000622L250201","","126.5","","1921791.86"
"2025-02-04","2025-02-01","SF FuneralFDC000000062SY250201","","126.5","","1921918.36"
"2025-02-04","2025-02-01","SF FuneralFDC000000069TX250201","","126.5","","1922044.86"
"2025-02-04","2025-02-01","SF FuneralFDC00000006BFH250201","","126.5","","1922171.36"
"2025-02-04","2025-02-01","SF FuneralFDC00000006F8J250201","","126.5","","1922297.86"
"2025-02-04","2025-02-01","SF FuneralFDC00000006H07250201","","126.5","","1922424.36"
"2025-02-04","2025-02-01","SF FuneralFDC00000006J9Z250201","","126.5","","1922550.86"
"2025-02-04","2025-02-01","SF FuneralFDC00000006JQF250201","","126.5","","1922677.36"
"2025-02-04","2025-02-01","SF FuneralFDC00000006JWW250201","","126.5","","1922803.86"
"2025-02-04","2025-02-01","SF FuneralFDC00000006MS1250201","","126.5","","1922930.36"
"2025-02-04","2025-02-01","SF FuneralFDC00000006R2W250201","","126.5","","1923056.86"
"2025-02-04","2025-02-01","SF FuneralFDC00000006R2X250201","","126.5","","1923183.36"
"2025-02-04","2025-02-01","SF FuneralFDC0000000737N250201","","126.5","","1923309.86"
"2025-02-04","2025-02-01","SF FuneralFDC000000073GV250201","","126.5","","1923436.36"
"2025-02-04","2025-02-01","SF FuneralFDC000000077NV250201","","126.5","","1923562.86"
"2025-02-04","2025-02-01","SF FuneralFDC000000079KS250201","","126.5","","1923689.36"
"2025-02-04","2025-02-01","SF FuneralFDC00000007CJR250201","","126.5","","1923815.86"
"2025-02-04","2025-02-01","SF FuneralFDC00000007CJS250201","","126.5","","1923942.36"
"2025-02-04","2025-02-01","SF FuneralFDC00000007F6N250201","","126.5","","1924068.86"
"2025-02-04","2025-02-01","SF FuneralFDC00000007GP1250201","","126.5","","1924195.36"
"2025-02-04","2025-02-01","SF FuneralFDC00000007HFH250201","","126.5","","1924321.86"
"2025-02-04","2025-02-01","SF FuneralFDC00000007HND250201","","126.5","","1924448.36"
"2025-02-04","2025-02-01","SF FuneralFDC00000007HSV250201","","126.5","","1924574.86"
"2025-02-04","2025-02-01","SF FuneralFDC00000007RLF250201","","126.5","","1924701.36"
"2025-02-04","2025-02-01","SF FuneralFDC00000007RM8250201","","126.5","","1924827.86"
"2025-02-04","2025-02-01","SF FuneralFDC00000007RQG250201","","126.5","","1924954.36"
"2025-02-04","2025-02-01","SF FuneralFDC00000007RZB250201","","126.5","","1925080.86"
"2025-02-04","2025-02-01","SF FuneralF794483       250201","","126.5","","1925207.36"
"2025-02-04","2025-02-01","SF FuneralFDC00000007S15250201","","126.5","","1925333.86"
"2025-02-04","2025-02-01","SF FuneralF794643       250201","","126.5","","1925460.36"
"2025-02-04","2025-02-01","SF FuneralFDC00000007WGR250201","","126.5","","1925586.86"
"2025-02-04","2025-02-01","SF FuneralFDC00000007XCN250201","","126.5","","1925713.36"
"2025-02-04","2025-02-01","SF FuneralFDC00000007XFK250201","","126.5","","1925839.86"
"2025-02-04","2025-02-01","SF FuneralF798070       250201","","126.5","","1925966.36"
"2025-02-04","2025-02-01","SF FuneralF798084       250201","","126.5","","1926092.86"
"2025-02-04","2025-02-01","SF FuneralF798080       250201","","126.5","","1926219.36"
"2025-02-04","2025-02-01","SF FuneralFDC000000085GH250201","","126.5","","1926345.86"
"2025-02-04","2025-02-01","SF FuneralFDC0000000874P250201","","126.5","","1926472.36"
"2025-02-04","2025-02-01","SF FuneralF800712       250201","","126.5","","1926598.86"
"2025-02-04","2025-02-01","SF FuneralF800740       250201","","126.5","","1926725.36"
"2025-02-04","2025-02-01","SF FuneralF801206       250201","","126.5","","1926851.86"
"2025-02-04","2025-02-01","SF FuneralF809688       250201","","126.5","","1926978.36"
"2025-02-04","2025-02-01","SF FuneralF810963       250201","","126.5","","1927104.86"
"2025-02-04","2025-02-01","SF FuneralF810410       250201","","191.5","","1927296.36"
"2025-02-04","2025-02-01","SF FuneralF812113       250201","","126.5","","1927422.86"
"2025-02-04","2025-02-01","SF FuneralF812207       250201","","126.5","","1927549.36"
"2025-02-04","2025-02-01","SF FuneralF812230       250201","","126.5","","1927675.86"
"2025-02-04","2025-02-01","SF FuneralFDC00000009FDB250201","","126.5","","1927802.36"
"2025-02-04","2025-02-01","SF FuneralF812616       250201","","126.5","","1927928.86"
"2025-02-04","2025-02-01","SF FuneralF812673       250201","","126.5","","1928055.36"
"2025-02-04","2025-02-01","SF FuneralF813300       250201","","126.5","","1928181.86"
"2025-02-04","2025-02-01","SF FuneralF816742       250201","","126.5","","1928308.36"
"2025-02-04","2025-02-01","SF FuneralF817305       250201","","126.5","","1928434.86"
"2025-02-04","2025-02-01","SF FuneralF817371       250201","","126.5","","1928561.36"
"2025-02-04","2025-02-01","SF FuneralF817383       250201","","126.5","","1928687.86"
"2025-02-04","2025-02-01","SF FuneralF817952       250201","","126.5","","1928814.36"
"2025-02-04","2025-02-01","SF FuneralF821123       250201","","126.5","","1928940.86"
"2025-02-04","2025-02-01","SF FuneralF821160       250201","","126.5","","1929067.36"
"2025-02-04","2025-02-01","SF FuneralF821315       250201","","126.5","","1929193.86"
"2025-02-04","2025-02-01","SF FuneralF821470       250201","","126.5","","1929320.36"
"2025-02-04","2025-02-01","SF FuneralF821474       250201","","126.5","","1929446.86"
"2025-02-04","2025-02-01","SF FuneralF821788       250201","","126.5","","1929573.36"
"2025-02-04","2025-02-01","SF FuneralF823213       250201","","126.5","","1929699.86"
"2025-02-04","2025-02-01","SF FuneralF828119       250201","","126.5","","1929826.36"
"2025-02-04","2025-02-01","SF FuneralF828208       250201","","126.5","","1929952.86"
"2025-02-04","2025-02-01","SF FuneralF780830       250201","","126.5","","1930079.36"
"2025-02-04","2025-02-01","SF FuneralF828229       250201","","126.5","","1930205.86"
"2025-02-04","2025-02-01","SF FuneralF828823       250201","","126.5","","1930332.36"
"2025-02-04","2025-02-01","SF FuneralF830677       250201","","126.5","","1930458.86"
"2025-02-04","2025-02-01","SF FuneralF832452       250201","","126.5","","1930585.36"
"2025-02-04","2025-02-01","SF FuneralF833022       250201","","126.5","","1930711.86"
"2025-02-04","2025-02-01","SF FuneralF833456       250201","","126.5","","1930838.36"
"2025-02-04","2025-02-01","SF FuneralF834888       250201","","126.5","","1930964.86"
"2025-02-04","2025-02-01","SF FuneralF838824       250201","","126.5","","1931091.36"
"2025-02-04","2025-02-01","SF FuneralF841396       250201","","126.5","","1931217.86"
"2025-02-04","2025-02-01","SF FuneralF841401       250201","","126.5","","1931344.36"
"2025-02-04","2025-02-01","SF FuneralF841576       250201","","126.5","","1931470.86"
"2025-02-04","2025-02-01","SF FuneralF841603       250201","","126.5","","1931597.36"
"2025-02-04","2025-02-01","SF FuneralF842272       250201","","126.5","","1931723.86"
"2025-02-04","2025-02-01","SF FuneralF842304       250201","","126.5","","1931850.36"
"2025-02-04","2025-02-01","SF FuneralF842616       250201","","126.5","","1931976.86"
"2025-02-04","2025-02-01","SF FuneralF842740       250201","","126.5","","1932103.36"
"2025-02-04","2025-02-01","SF FuneralF993353       250201","","126.5","","1932229.86"
"2025-02-04","2025-02-01","SF FuneralFDC0000000JHX2250201","","126.5","","1932356.36"
"2025-02-04","2025-02-01","SF FuneralF1021280      250201","","126.5","","1932482.86"
"2025-02-04","2025-02-01","SF FuneralF1021302      250201","","126.5","","1932609.36"
"2025-02-04","2025-02-01","SF FuneralF1021346      250201","","126.5","","1932735.86"
"2025-02-04","2025-02-01","SF FuneralF1021837      250201","","126.5","","1932862.36"
"2025-02-04","2025-02-01","SF FuneralF1022135      250201","","126.5","","1932988.86"
"2025-02-04","2025-02-01","SF FuneralF1022142      250201","","126.5","","1933115.36"
"2025-02-04","2025-02-01","SF FuneralF1052936      250201","","126.5","","1933241.86"
"2025-02-04","2025-02-01","SF FuneralF1054513      250201","","126.5","","1933368.36"
"2025-02-04","2025-02-01","SF FuneralF1058649      250201","","126.5","","1933494.86"
"2025-02-04","2025-02-01","SF FuneralFDC0000000K902250201","","126.5","","1933621.36"
"2025-02-04","2025-02-01","SF FuneralF1058747      250201","","126.5","","1933747.86"
"2025-02-04","2025-02-01","SF FuneralFDC0000000K9FC250201","","126.5","","1933874.36"
"2025-02-04","2025-02-01","SF FuneralF1060096      250201","","126.5","","1934000.86"
"2025-02-04","2025-02-01","SF FuneralF1060106      250201","","126.5","","1934127.36"
"2025-02-04","2025-02-01","SF FuneralF1060501      250201","","126.5","","1934253.86"
"2025-02-04","2025-02-01","SF FuneralF1060700      250201","","126.5","","1934380.36"
"2025-02-04","2025-02-01","SF FuneralF777453       250201","","126.5","","1934506.86"
"2025-02-04","2025-02-01","SF FuneralF1073381      250201","","126.5","","1934633.36"
"2025-02-04","2025-02-01","SF FuneralF1074511      250201","","126.5","","1934759.86"
"2025-02-04","2025-02-01","SF FuneralF1074895      250201","","126.5","","1934886.36"
"2025-02-04","2025-02-01","SF FuneralF1074922      250201","","126.5","","1935012.86"
"2025-02-04","2025-02-01","SF FuneralF1075028      250201","","126.5","","1935139.36"
"2025-02-04","2025-02-01","SF FuneralF1075040      250201","","126.5","","1935265.86"
"2025-02-04","2025-02-01","SF FuneralF1075216      250201","","126.5","","1935392.36"
"2025-02-04","2025-02-01","SF FuneralF1075230      250201","","126.5","","1935518.86"
"2025-02-04","2025-02-01","SF FuneralF1078371      250201","","126.5","","1935645.36"
"2025-02-04","2025-02-01","SF FuneralF1078449      250201","","126.5","","1935771.86"
"2025-02-04","2025-02-01","SF FuneralF1078898      250201","","126.5","","1935898.36"
"2025-02-04","2025-02-01","SF FuneralF1079042      250201","","126.5","","1936024.86"
"2025-02-04","2025-02-01","SF FuneralF1079043      250201","","126.5","","1936151.36"
"2025-02-04","2025-02-01","SF FuneralF1080515      250201","","126.5","","1936277.86"
"2025-02-04","2025-02-01","SF FuneralF1083999      250201","","126.5","","1936404.36"
"2025-02-04","2025-02-01","SF FuneralF1084546      250201","","126.5","","1936530.86"
"2025-02-04","2025-02-01","SF FuneralF1084986      250201","","126.5","","1936657.36"
"2025-02-04","2025-02-01","SF FuneralF1102983      250201","","126.5","","1936783.86"
"2025-02-04","2025-02-01","SF FuneralFDC0000000M3DG250201","","213.31","","1936997.17"
"2025-02-04","2025-02-01","SF FuneralF1108904      250201","","126.5","","1937123.67"
"2025-02-04","2025-02-01","SF FuneralF1108973      250201","","126.5","","1937250.17"
"2025-02-04","2025-02-01","SF FuneralF1109084      250201","","126.5","","1937376.67"
"2025-02-04","2025-02-01","SF FuneralF1109947      250201","","126.5","","1937503.17"
"2025-02-04","2025-02-01","SF FuneralF1110352      250201","","126.5","","1937629.67"
"2025-02-04","2025-02-01","SF FuneralF1113317      250201","","126.5","","1937756.17"
"2025-02-04","2025-02-01","SF FuneralF1113563      250201","","126.5","","1937882.67"
"2025-02-04","2025-02-01","SF FuneralF1114053      250201","","126.5","","1938009.17"
"2025-02-04","2025-02-01","SF FuneralFDC0000000N6DY250201","","126.5","","1938135.67"
"2025-02-04","2025-02-01","SF FuneralF1114380      250201","","126.5","","1938262.17"
"2025-02-04","2025-02-01","SF FuneralF1116816      250201","","126.5","","1938388.67"
"2025-02-04","2025-02-01","SF FuneralF1116954      250201","","126.5","","1938515.17"
"2025-02-04","2025-02-01","SF FuneralF1107990      250201","","126.5","","1938641.67"
"2025-02-04","2025-02-01","SF FuneralF1117042      250201","","126.5","","1938768.17"
"2025-02-04","2025-02-01","SF FuneralFDC0000000NJJG250201","","126.5","","1938894.67"
"2025-02-04","2025-02-01","SF FuneralFDC0000000NQ2D250201","","126.5","","1939021.17"
"2025-02-04","2025-02-01","SF FuneralF1120300      250201","","126.5","","1939147.67"
"2025-02-04","2025-02-01","SF FuneralF1121967      250201","","126.5","","1939274.17"
"2025-02-04","2025-02-01","SF FuneralF1121990      250201","","126.5","","1939400.67"
"2025-02-04","2025-02-01","SF FuneralF1122837      250201","","126.5","","1939527.17"
"2025-02-04","2025-02-01","SF FuneralF1122909      250201","","126.5","","1939653.67"
"2025-02-04","2025-02-01","SF FuneralF1123083      250201","","126.5","","1939780.17"
"2025-02-04","2025-02-01","SF FuneralF1124152      250201","","126.5","","1939906.67"
"2025-02-04","2025-02-01","SF FuneralF1124588      250201","","126.5","","1940033.17"
"2025-02-04","2025-02-01","SF FuneralF799573       250201","","126.5","","1940159.67"
"2025-02-04","2025-02-01","SF FuneralF1125424      250201","","126.5","","1940286.17"
"2025-02-04","2025-02-01","SF FuneralF1125885      250201","","126.5","","1940412.67"
"2025-02-04","2025-02-01","SF FuneralFDC0000000PJPF250201","","126.5","","1940539.17"
"2025-02-04","2025-02-01","SF FuneralF1126160      250201","","126.5","","1940665.67"
"2025-02-04","2025-02-01","SF FuneralFDC0000000PL7T250201","","126.5","","1940792.17"
"2025-02-04","2025-02-01","SF FuneralF1126829      250201","","126.5","","1940918.67"
"2025-02-04","2025-02-01","SF FuneralF1126842      250201","","126.5","","1941045.17"
"2025-02-04","2025-02-01","SF FuneralF1127875      250201","","126.5","","1941171.67"
"2025-02-04","2025-02-01","SF FuneralF1127926      250201","","126.5","","1941298.17"
"2025-02-04","2025-02-01","SF FuneralF1128006      250201","","126.5","","1941424.67"
"2025-02-04","2025-02-01","SF FuneralF1128131      250201","","126.5","","1941551.17"
"2025-02-04","2025-02-01","SF FuneralF1128206      250201","","126.5","","1941677.67"
"2025-02-04","2025-02-01","SF FuneralF1128217      250201","","126.5","","1941804.17"
"2025-02-04","2025-02-01","SF FuneralF1128251      250201","","126.5","","1941930.67"
"2025-02-04","2025-02-01","SF FuneralF1128666      250201","","126.5","","1942057.17"
"2025-02-04","2025-02-01","SF FuneralF1128758      250201","","126.5","","1942183.67"
"2025-02-04","2025-02-01","SF FuneralF1128843      250201","","126.5","","1942310.17"
"2025-02-04","2025-02-01","SF FuneralF1129166      250201","","126.5","","1942436.67"
"2025-02-04","2025-02-01","SF FuneralF1129320      250201","","126.5","","1942563.17"
"2025-02-04","2025-02-01","SF FuneralF1129347      250201","","126.5","","1942689.67"
"2025-02-04","2025-02-01","SF FuneralFDC0000000Q18F250201","","126.5","","1942816.17"
"2025-02-04","2025-02-03","SF FuneralFDC000000075ZV250203","","126.5","","1942942.67"
"2025-02-04","2025-02-03","SF FuneralF843706       250201","","126.5","","1943069.17"
"2025-02-04","2025-02-03","SF FuneralF900766       250201","","126.5","","1943195.67"
"2025-02-04","2025-02-03","SF FuneralF900772       250201","","126.5","","1943322.17"
"2025-02-04","2025-02-03","SF FuneralF1033564      250203","","126.5","","1943448.67"
"2025-02-04","2025-02-04","SF FuneralFDC00000005V54250204","","126.5","","1943575.17"
"2025-02-04","2025-02-04","SF FuneralF1123020      250204","","126.5","","1943701.67"
"2025-02-04","2025-02-04","SF FuneralF1123179      250204","","126.5","","1943828.17"
"2025-02-04","2025-01-29","SF FuneralFDC00000006D1K250129","","126.5","","1943954.67"
"2025-02-04","2025-01-29","SF FuneralFDC000000073B9250129","","63.25","","1944017.92"
"2025-02-04","2025-01-29","SF FuneralF1124330      250129","","126.5","","1944144.42"
"2025-02-04","2025-01-30","SF FuneralF1113102      250130","","126.5","","1944270.92"
"2025-02-04","2025-01-31","SF FuneralFDC00000007BK0250131","","126.5","","1944397.42"
"2025-02-04","2025-01-31","SF FuneralF901118       250201","","126.5","","1944523.92"
"2025-02-04","2025-01-31","SF FuneralF901542       250201","","126.5","","1944650.42"
"2025-02-04","2025-01-31","SF FuneralF980994       250201","","126.5","","1944776.92"
"2025-02-04","2025-01-31","SF FuneralF981060       250201","","126.5","","1944903.42"
"2025-02-04","2025-01-31","SF FuneralF988285       250201","","126.5","","1945029.92"
"2025-02-04","2025-01-31","SF FuneralF988567       250201","","126.5","","1945156.42"
"2025-02-04","2025-01-31","SF FuneralF988584       250201","","126.5","","1945282.92"
"2025-02-04","2025-01-31","SF FuneralF988891       250201","","126.5","","1945409.42"
"2025-02-04","2025-01-31","SF FuneralF993530       250131","","126.5","","1945535.92"
"2025-02-04","2025-01-31","SF FuneralF1075068      250131","","126.5","","1945662.42"
"2025-02-04","2025-01-31","SF FuneralF1127498      250131","","126.5","","1945788.92"
"2025-02-04","2025-01-31","SF FuneralF1127852      250131","","126.5","","1945915.42"
"2025-02-04","2025-02-01","SF FuneralFDC000000032T1250201","","220","","1946135.42"
"2025-02-04","2025-02-01","SF FuneralFDC00000004TFW250201","","220","","1946355.42"
"2025-02-04","2025-02-01","SF FuneralFDC00000005M8K250201","","220","","1946575.42"
"2025-02-04","2025-02-01","SF FuneralFDC00000005M8L250201","","220","","1946795.42"
"2025-02-04","2025-02-01","SF FuneralFDC00000005MDX250201","","126.5","","1946921.92"
"2025-02-04","2025-02-01","SF FuneralFDC0000000676Z250201","","126.5","","1947048.42"
"2025-02-04","2025-02-01","SF FuneralFDC00000006772250201","","126.5","","1947174.92"
"2025-02-04","2025-02-01","SF FuneralFDC00000006793250201","","126.5","","1947301.42"
"2025-02-04","2025-02-01","SF FuneralFDC000000067NH250201","","126.5","","1947427.92"
"2025-02-04","2025-02-01","SF FuneralFDC000000067P6250201","","126.5","","1947554.42"
"2025-02-04","2025-02-01","SF FuneralFDC000000068MX250201","","126.5","","1947680.92"
"2025-02-04","2025-02-01","SF FuneralFDC00000006GHZ250201","","126.5","","1947807.42"
"2025-02-04","2025-02-01","SF FuneralFDC00000006H3W250201","","126.5","","1947933.92"
"2025-02-04","2025-02-01","SF FuneralFDC00000006J3N250201","","126.5","","1948060.42"
"2025-02-04","2025-02-01","SF FuneralFDC00000006KG3250201","","126.5","","1948186.92"
"2025-02-04","2025-02-01","SF FuneralFDC00000006WQY250201","","126.5","","1948313.42"
"2025-02-04","2025-02-01","SF FuneralFDC000000075YY250201","","126.5","","1948439.92"
"2025-02-04","2025-02-01","SF FuneralFDC0000000766W250201","","126.5","","1948566.42"
"2025-02-04","2025-02-01","SF FuneralFDC0000000768W250201","","126.5","","1948692.92"
"2025-02-04","2025-02-01","SF FuneralFDC000000077C5250201","","126.5","","1948819.42"
"2025-02-04","2025-02-01","SF FuneralFDC00000007815250201","","126.5","","1948945.92"
"2025-02-04","2025-02-01","SF FuneralFDC00000007889250201","","126.5","","1949072.42"
"2025-02-04","2025-02-01","SF FuneralFDC00000007SYS250201","","126.5","","1949198.92"
"2025-02-04","2025-02-01","SF FuneralFDC00000007V4M250201","","126.5","","1949325.42"
"2025-02-04","2025-02-01","SF FuneralF795213       250201","","126.5","","1949451.92"
"2025-02-04","2025-02-01","SF FuneralF798515       250201","","126.5","","1949578.42"
"2025-02-04","2025-02-01","SF FuneralF798748       250201","","191.5","","1949769.92"
"2025-02-04","2025-02-01","SF FuneralF800897       250201","","126.5","","1949896.42"
"2025-02-04","2025-02-01","SF FuneralFDC00000008MZ2250201","","126.5","","1950022.92"
"2025-02-04","2025-02-01","SF FuneralF808441       250201","","126.5","","1950149.42"
"2025-02-04","2025-02-01","SF FuneralF798079       250201","","126.5","","1950275.92"
"2025-02-04","2025-02-01","SF FuneralF808856       250201","","126.5","","1950402.42"
"2025-02-04","2025-02-01","SF FuneralF809104       250201","","126.5","","1950528.92"
"2025-02-04","2025-02-01","SF FuneralF809668       250201","","126.5","","1950655.42"
"2025-02-04","2025-02-01","SF FuneralF784101       250201","","126.5","","1950781.92"
"2025-02-04","2025-02-01","SF FuneralF814070       250201","","126.5","","1950908.42"
"2025-02-04","2025-02-01","SF FuneralF814080       250201","","126.5","","1951034.92"
"2025-02-04","2025-02-01","SF FuneralF816370       250201","","126.5","","1951161.42"
"2025-02-04","2025-02-01","SF FuneralFDC00000009W14250201","","126.5","","1951287.92"
"2025-02-04","2025-02-01","SF FuneralF793524       250201","","126.5","","1951414.42"
"2025-02-04","2025-02-01","SF FuneralF816411       250201","","126.5","","1951540.92"
"2025-02-04","2025-02-01","SF FuneralF816986       250201","","126.5","","1951667.42"
"2025-02-04","2025-02-01","SF FuneralF820326       250201","","126.5","","1951793.92"
"2025-02-04","2025-02-01","SF FuneralFDC0000000B7MT250201","","126.5","","1951920.42"
"2025-02-04","2025-02-01","SF FuneralF820718       250201","","126.5","","1952046.92"
"2025-02-04","2025-02-01","SF FuneralF828048       250201","","126.5","","1952173.42"
"2025-02-04","2025-02-01","SF FuneralF780970       250201","","126.5","","1952299.92"
"2025-02-04","2025-02-01","SF FuneralF828078       250201","","126.5","","1952426.42"
"2025-02-04","2025-02-01","SF FuneralF828082       250201","","126.5","","1952552.92"
"2025-02-04","2025-02-01","SF FuneralF828107       250201","","126.5","","1952679.42"
"2025-02-04","2025-02-01","SF FuneralF828335       250201","","126.5","","1952805.92"
"2025-02-04","2025-02-01","SF FuneralF829048       250201","","126.5","","1952932.42"
"2025-02-04","2025-02-01","SF FuneralF830911       250201","","126.5","","1953058.92"
"2025-02-04","2025-02-01","SF FuneralF832216       250201","","126.5","","1953185.42"
"2025-02-04","2025-02-01","SF FuneralF832283       250201","","126.5","","1953311.92"
"2025-02-04","2025-02-01","SF FuneralF832594       250201","","126.5","","1953438.42"
"2025-02-04","2025-02-01","SF FuneralF832598       250201","","126.5","","1953564.92"
"2025-02-04","2025-02-01","SF FuneralF833256       250201","","126.5","","1953691.42"
"2025-02-04","2025-02-01","SF FuneralF841673       250201","","126.5","","1953817.92"
"2025-02-04","2025-02-01","SF FuneralFDC0000000F98K250201","","126.5","","1953944.42"
"2025-02-04","2025-02-01","SF FuneralF992306       250201","","126.5","","1954070.92"
"2025-02-04","2025-02-01","SF FuneralF992675       250201","","126.5","","1954197.42"
"2025-02-04","2025-02-01","SF FuneralF992715       250201","","126.5","","1954323.92"
"2025-02-04","2025-02-01","SF FuneralF1021246      250201","","126.5","","1954450.42"
"2025-02-04","2025-02-01","SF FuneralF1021388      250201","","126.5","","1954576.92"
"2025-02-04","2025-02-01","SF FuneralF1033554      250201","","126.5","","1954703.42"
"2025-02-04","2025-02-01","SF FuneralF1033978      250201","","126.5","","1954829.92"
"2025-02-04","2025-02-01","SF FuneralF1055236      250201","","126.5","","1954956.42"
"2025-02-04","2025-02-01","SF FuneralF1058847      250201","","126.5","","1955082.92"
"2025-02-04","2025-02-01","SF FuneralF1060358      250201","","126.5","","1955209.42"
"2025-02-04","2025-02-01","SF FuneralF1060654      250201","","126.5","","1955335.92"
"2025-02-04","2025-02-01","SF FuneralF1066368      250201","","126.5","","1955462.42"
"2025-02-04","2025-02-01","SF FuneralF1075003      250201","","126.5","","1955588.92"
"2025-02-04","2025-02-01","SF FuneralFDC0000000LBVR250201","","126.5","","1955715.42"
"2025-02-04","2025-02-01","SF FuneralF1075047      250201","","126.5","","1955841.92"
"2025-02-04","2025-02-01","SF FuneralF1020657      250201","","126.5","","1955968.42"
"2025-02-04","2025-02-01","SF FuneralF1078344      250201","","126.5","","1956094.92"
"2025-02-04","2025-02-01","SF FuneralF1078628      250201","","126.5","","1956221.42"
"2025-02-04","2025-02-01","SF FuneralF1078896      250201","","126.5","","1956347.92"
"2025-02-04","2025-02-01","SF FuneralF1079459      250201","","126.5","","1956474.42"
"2025-02-04","2025-02-01","SF FuneralFDC0000000LNP3250201","","126.5","","1956600.92"
"2025-02-04","2025-02-01","SF FuneralF1083681      250201","","126.5","","1956727.42"
"2025-02-04","2025-02-01","SF FuneralF1083867      250201","","126.5","","1956853.92"
"2025-02-04","2025-02-01","SF FuneralF1085028      250201","","126.5","","1956980.42"
"2025-02-04","2025-02-01","SF FuneralF1103744      250201","","126.5","","1957106.92"
"2025-02-04","2025-02-01","SF FuneralF987556       250201","","126.5","","1957233.42"
"2025-02-04","2025-02-01","SF FuneralF1108770      250201","","126.5","","1957359.92"
"2025-02-04","2025-02-01","SF FuneralFDC0000000MJHS250201","","126.5","","1957486.42"
"2025-02-04","2025-02-01","SF FuneralF1113269      250201","","126.5","","1957612.92"
"2025-02-04","2025-02-01","SF FuneralFDC0000000N4J5250201","","126.5","","1957739.42"
"2025-02-04","2025-02-01","SF FuneralF1113773      250201","","126.5","","1957865.92"
"2025-02-04","2025-02-01","SF FuneralF1113775      250201","","126.5","","1957992.42"
"2025-02-04","2025-02-01","SF FuneralFDC0000000NBKM250201","","126.5","","1958118.92"
"2025-02-04","2025-02-01","SF FuneralF1115158      250201","","126.5","","1958245.42"
"2025-02-04","2025-02-01","SF FuneralF1115195      250201","","126.5","","1958371.92"
"2025-02-04","2025-02-01","SF FuneralF1116937      250201","","126.5","","1958498.42"
"2025-02-04","2025-02-01","SF FuneralF1117626      250201","","126.5","","1958624.92"
"2025-02-04","2025-02-01","SF FuneralF1118521      250201","","126.5","","1958751.42"
"2025-02-04","2025-02-01","SF FuneralFDC0000000P0MH250201","","126.5","","1958877.92"
"2025-02-04","2025-02-01","SF FuneralF1122259      250201","","126.5","","1959004.42"
"2025-02-04","2025-02-01","SF FuneralFDC0000000P1G2250201","","126.5","","1959130.92"
"2025-02-04","2025-02-01","SF FuneralF1122647      250201","","126.5","","1959257.42"
"2025-02-04","2025-02-01","SF FuneralF1123390      250201","","126.5","","1959383.92"
"2025-02-04","2025-02-01","SF FuneralF1125410      250201","","126.5","","1959510.42"
"2025-02-04","2025-02-01","SF FuneralF1125442      250201","","126.5","","1959636.92"
"2025-02-04","2025-02-01","SF FuneralFDC0000000PHJK250201","","126.5","","1959763.42"
"2025-02-04","2025-02-01","SF FuneralF1125771      250201","","126.5","","1959889.92"
"2025-02-04","2025-02-01","SF FuneralF782608       250201","","126.5","","1960016.42"
"2025-02-04","2025-02-01","SF FuneralF1126081      250201","","126.5","","1960142.92"
"2025-02-04","2025-02-01","SF FuneralF1127850      250201","","126.5","","1960269.42"
"2025-02-04","2025-02-01","SF FuneralF1127851      250201","","126.5","","1960395.92"
"2025-02-04","2025-02-01","SF FuneralFDC0000000PVL5250201","","126.5","","1960522.42"
"2025-02-04","2025-02-01","SF FuneralFDC0000000PVYW250201","","126.5","","1960648.92"
"2025-02-04","2025-02-01","SF FuneralF803093       250201","","126.5","","1960775.42"
"2025-02-04","2025-02-03","SF FuneralF844537       250201","","126.5","","1960901.92"
"2025-02-04","2025-02-03","SF FuneralF844546       250201","","126.5","","1961028.42"
"2025-02-04","2025-02-03","SF FuneralF900487       250201","","126.5","","1961154.92"
"2025-02-04","2025-02-03","SF FuneralF1021277      250203","","126.5","","1961281.42"
"2025-02-04","2025-02-03","SF FuneralF1021653      250203","","126.5","","1961407.92"
"2025-02-04","2025-02-04","SF FuneralFDC00000008TJ6250204","","126.5","","1961534.42"
"2025-02-04","2025-02-04","SF FuneralF1021468      250204","","63.25","","1961597.67"
"2025-02-04","2025-01-27","SF FuneralF1078942      250127","","126.5","","1961724.17"
"2025-02-04","2025-01-28","SF FuneralFDC00000005SKG250128","","220","","1961944.17"
"2025-02-04","2025-01-28","SF FuneralFDC00000005XD6250128","","220","","1962164.17"
"2025-02-04","2025-01-28","SF FuneralFDC00000007PZP250128","","126.5","","1962290.67"
"2025-02-04","2025-01-29","SF FuneralFDC00000005W0Y250129","","126.5","","1962417.17"
"2025-02-04","2025-01-30","SF FuneralFDC000000033D5250130","","220","","1962637.17"
"2025-02-04","2025-01-30","SF FuneralF828113       250130","","126.5","","1962763.67"
"2025-02-04","2025-01-30","SF FuneralFDC0000000CQJ9250130","","126.5","","1962890.17"
"2025-02-04","2025-01-30","SF FuneralF1084382      250130","","126.5","","1963016.67"
"2025-02-04","2025-01-30","SF FuneralF1114144      250130","","126.5","","1963143.17"
"2025-02-04","2025-01-30","SF FuneralF1126858      250130","","126.5","","1963269.67"
"2025-02-04","2025-01-31","SF FuneralFDC00000006LD5250131","","126.5","","1963396.17"
"2025-02-04","2025-01-31","SF FuneralFDC0000000H15Y250201","","126.5","","1963522.67"
"2025-02-04","2025-01-31","SF FuneralF900880       250201","","126.5","","1963649.17"
"2025-02-04","2025-01-31","SF FuneralF980292       250201","","126.5","","1963775.67"
"2025-02-04","2025-01-31","SF FuneralF981791       250201","","126.5","","1963902.17"
"2025-02-04","2025-01-31","SF FuneralF986826       250201","","126.5","","1964028.67"
"2025-02-04","2025-01-31","SF FuneralF986997       250201","","126.5","","1964155.17"
"2025-02-04","2025-01-31","SF FuneralF987668       250201","","126.5","","1964281.67"
"2025-02-04","2025-01-31","SF FuneralF987877       250201","","126.5","","1964408.17"
"2025-02-04","2025-01-31","SF FuneralF989638       250201","","126.5","","1964534.67"
"2025-02-04","2025-01-31","SF FuneralF989711       250201","","126.5","","1964661.17"
"2025-02-04","2025-01-31","SF FuneralFDC0000000J052250201","","126.5","","1964787.67"
"2025-02-04","2025-02-01","SF FuneralFDC000000039PJ250201","","220","","1965007.67"
"2025-02-04","2025-02-01","SF FuneralFDC00000003KBW250201","","220","","1965227.67"
"2025-02-04","2025-02-01","SF FuneralFDC00000005W4K250201","","126.5","","1965354.17"
"2025-02-04","2025-02-01","SF FuneralFDC00000005WFL250201","","126.5","","1965480.67"
"2025-02-04","2025-02-01","SF FuneralFDC000000068VB250201","","126.5","","1965607.17"
"2025-02-04","2025-02-01","SF FuneralFDC000000069XR250201","","126.5","","1965733.67"
"2025-02-04","2025-02-01","SF FuneralFDC000000069YT250201","","126.5","","1965860.17"
"2025-02-04","2025-02-01","SF FuneralFDC00000006JFM250201","","220","","1966080.17"
"2025-02-04","2025-02-01","SF FuneralFDC0000000715T250201","","126.5","","1966206.67"
"2025-02-04","2025-02-01","SF FuneralFDC000000074SQ250201","","126.5","","1966333.17"
"2025-02-04","2025-02-01","SF FuneralFDC000000074Y3250201","","126.5","","1966459.67"
"2025-02-04","2025-02-01","SF FuneralFDC000000075DQ250201","","126.5","","1966586.17"
"2025-02-04","2025-02-01","SF FuneralFDC000000077Q8250201","","126.5","","1966712.67"
"2025-02-04","2025-02-01","SF FuneralFDC000000077VD250201","","126.5","","1966839.17"
"2025-02-04","2025-02-01","SF FuneralFDC000000077VM250201","","126.5","","1966965.67"
"2025-02-04","2025-02-01","SF FuneralFDC00000007JZT250201","","126.5","","1967092.17"
"2025-02-04","2025-02-01","SF FuneralF793515       250201","","126.5","","1967218.67"
"2025-02-04","2025-02-01","SF FuneralFDC00000007P1Z250201","","256.5","","1967475.17"
"2025-02-04","2025-02-01","SF FuneralFDC00000007PKR250201","","126.5","","1967601.67"
"2025-02-04","2025-02-01","SF FuneralFDC00000007QFG250201","","126.5","","1967728.17"
"2025-02-04","2025-02-01","SF FuneralFDC00000007VC8250201","","126.5","","1967854.67"
"2025-02-04","2025-02-01","SF FuneralF795309       250201","","126.5","","1967981.17"
"2025-02-04","2025-02-01","SF FuneralFDC00000007VDG250201","","126.5","","1968107.67"
"2025-02-04","2025-02-01","SF FuneralFDC000000083SQ250201","","126.5","","1968234.17"
"2025-02-04","2025-02-01","SF FuneralFDC0000000858Q250201","","126.5","","1968360.67"
"2025-02-04","2025-02-01","SF FuneralF799181       250201","","126.5","","1968487.17"
"2025-02-04","2025-02-01","SF FuneralFDC00000008LKW250201","","191.5","","1968678.67"
"2025-02-04","2025-02-01","SF FuneralF803036       250201","","126.5","","1968805.17"
"2025-02-04","2025-02-01","SF FuneralFDC00000008LX8250201","","126.5","","1968931.67"
"2025-02-04","2025-02-01","SF FuneralF803645       250201","","126.5","","1969058.17"
"2025-02-04","2025-02-01","SF FuneralF803759       250201","","126.5","","1969184.67"
"2025-02-04","2025-02-01","SF FuneralF808094       250201","","126.5","","1969311.17"
"2025-02-04","2025-02-01","SF FuneralF809349       250201","","126.5","","1969437.67"
"2025-02-04","2025-02-01","SF FuneralF809614       250201","","126.5","","1969564.17"
"2025-02-04","2025-02-01","SF FuneralF810863       250201","","126.5","","1969690.67"
"2025-02-04","2025-02-01","SF FuneralF810875       250201","","126.5","","1969817.17"
"2025-02-04","2025-02-01","SF FuneralFDC000000097ZQ250201","","126.5","","1969943.67"
"2025-02-04","2025-02-01","SF FuneralFDC00000009G12250201","","126.5","","1970070.17"
"2025-02-04","2025-02-01","SF FuneralF814434       250201","","126.5","","1970196.67"
"2025-02-04","2025-02-01","SF FuneralFDC00000009LQN250201","","126.5","","1970323.17"
"2025-02-04","2025-02-01","SF FuneralF814478       250201","","126.5","","1970449.67"
"2025-02-04","2025-02-01","SF FuneralF814624       250201","","126.5","","1970576.17"
"2025-02-04","2025-02-01","SF FuneralF814681       250201","","126.5","","1970702.67"
"2025-02-04","2025-02-01","SF FuneralF814828       250201","","126.5","","1970829.17"
"2025-02-04","2025-02-01","SF FuneralF814836       250201","","126.5","","1970955.67"
"2025-02-04","2025-02-01","SF FuneralF816420       250201","","126.5","","1971082.17"
"2025-02-04","2025-02-01","SF FuneralF816426       250201","","126.5","","1971208.67"
"2025-02-04","2025-02-01","SF FuneralF818967       250201","","126.5","","1971335.17"
"2025-02-04","2025-02-01","SF FuneralF820655       250201","","126.5","","1971461.67"
"2025-02-04","2025-02-01","SF FuneralF820662       250201","","126.5","","1971588.17"
"2025-02-04","2025-02-01","SF FuneralF821497       250201","","126.5","","1971714.67"
"2025-02-04","2025-02-01","SF FuneralF821506       250201","","126.5","","1971841.17"
"2025-02-04","2025-02-01","SF FuneralF821592       250201","","126.5","","1971967.67"
"2025-02-04","2025-02-01","SF FuneralF821622       250201","","126.5","","1972094.17"
"2025-02-04","2025-02-01","SF FuneralF821702       250201","","126.5","","1972220.67"
"2025-02-04","2025-02-01","SF FuneralF823097       250201","","126.5","","1972347.17"
"2025-02-04","2025-02-01","SF FuneralF827686       250201","","126.5","","1972473.67"
"2025-02-04","2025-02-01","SF FuneralF828340       250201","","126.5","","1972600.17"
"2025-02-04","2025-02-01","SF FuneralF832355       250201","","126.5","","1972726.67"
"2025-02-04","2025-02-01","SF FuneralF832506       250201","","126.5","","1972853.17"
"2025-02-04","2025-02-01","SF FuneralF832805       250201","","126.5","","1972979.67"
"2025-02-04","2025-02-01","SF FuneralF832802       250201","","126.5","","1973106.17"
"2025-02-04","2025-02-01","SF FuneralF834292       250201","","126.5","","1973232.67"
"2025-02-04","2025-02-01","SF FuneralF840465       250201","","126.5","","1973359.17"
"2025-02-04","2025-02-01","SF FuneralF841426       250201","","126.5","","1973485.67"
"2025-02-04","2025-02-01","SF FuneralF991693       250201","","126.5","","1973612.17"
"2025-02-04","2025-02-01","SF FuneralF808523       250201","","126.5","","1973738.67"
"2025-02-04","2025-02-01","SF FuneralF991917       250201","","126.5","","1973865.17"
"2025-02-04","2025-02-01","SF FuneralF992443       250201","","126.5","","1973991.67"
"2025-02-04","2025-02-01","SF FuneralF992448       250201","","126.5","","1974118.17"
"2025-02-04","2025-02-01","SF FuneralF992449       250201","","126.5","","1974244.67"
"2025-02-04","2025-02-01","SF FuneralFDC0000000J9T8250201","","126.5","","1974371.17"
"2025-02-04","2025-02-01","SF FuneralF992746       250201","","126.5","","1974497.67"
"2025-02-04","2025-02-01","SF FuneralF992773       250201","","126.5","","1974624.17"
"2025-02-04","2025-02-01","SF FuneralF993863       250201","","126.5","","1974750.67"
"2025-02-04","2025-02-01","SF FuneralF1021598      250201","","126.5","","1974877.17"
"2025-02-04","2025-02-01","SF FuneralF1021771      250201","","126.5","","1975003.67"
"2025-02-04","2025-02-01","SF FuneralF1033686      250201","","126.5","","1975130.17"
"2025-02-04","2025-02-01","SF FuneralF1033864      250201","","126.5","","1975256.67"
"2025-02-04","2025-02-01","SF FuneralF1050692      250201","","126.5","","1975383.17"
"2025-02-04","2025-02-01","SF FuneralF1050706      250201","","126.5","","1975509.67"
"2025-02-04","2025-02-01","SF FuneralF1050725      250201","","126.5","","1975636.17"
"2025-02-04","2025-02-01","SF FuneralF1052815      250201","","126.5","","1975762.67"
"2025-02-04","2025-02-01","SF FuneralF1052899      250201","","126.5","","1975889.17"
"2025-02-04","2025-02-01","SF FuneralF1060093      250202","","126.5","","1976015.67"
"2025-02-04","2025-02-01","SF FuneralF1060967      250201","","126.5","","1976142.17"
"2025-02-04","2025-02-01","SF FuneralF1066154      250201","","126.5","","1976268.67"
"2025-02-04","2025-02-01","SF FuneralF1066191      250201","","126.5","","1976395.17"
"2025-02-04","2025-02-01","SF FuneralF1066245      250201","","126.5","","1976521.67"
"2025-02-04","2025-02-01","SF FuneralF1075222      250201","","126.5","","1976648.17"
"2025-02-04","2025-02-01","SF FuneralF1075311      250201","","126.5","","1976774.67"
"2025-02-04","2025-02-01","SF FuneralF1078086      250201","","126.5","","1976901.17"
"2025-02-04","2025-02-01","SF FuneralF1078379      250201","","126.5","","1977027.67"
"2025-02-04","2025-02-01","SF FuneralF1078390      250201","","126.5","","1977154.17"
"2025-02-04","2025-02-01","SF FuneralF1078473      250201","","126.5","","1977280.67"
"2025-02-04","2025-02-01","SF FuneralF1079286      250201","","126.5","","1977407.17"
"2025-02-04","2025-02-01","SF FuneralF1079560      250201","","126.5","","1977533.67"
"2025-02-04","2025-02-01","SF FuneralFDC0000000LQSC250201","","126.5","","1977660.17"
"2025-02-04","2025-02-01","SF FuneralF1084597      250201","","126.5","","1977786.67"
"2025-02-04","2025-02-01","SF FuneralF1085142      250201","","126.5","","1977913.17"
"2025-02-04","2025-02-01","SF FuneralF1108850      250201","","126.5","","1978039.67"
"2025-02-04","2025-02-01","SF FuneralF1109346      250201","","126.5","","1978166.17"
"2025-02-04","2025-02-01","SF FuneralF1110094      250201","","126.5","","1978292.67"
"2025-02-04","2025-02-01","SF FuneralF1110372      250201","","126.5","","1978419.17"
"2025-02-04","2025-02-01","SF FuneralF1110440      250201","","126.5","","1978545.67"
"2025-02-04","2025-02-01","SF FuneralF1113291      250201","","126.5","","1978672.17"
"2025-02-04","2025-02-01","SF FuneralF1113360      250201","","126.5","","1978798.67"
"2025-02-04","2025-01-28","SF FuneralFDC00000005MVX250128","","126.5","","1978925.17"
"2025-02-04","2025-01-28","SF FuneralFDC00000006JQD250128","","126.5","","1979051.67"
"2025-02-04","2025-01-28","SF FuneralFDC00000007ZPC250128","","126.5","","1979178.17"
"2025-02-04","2025-01-29","SF FuneralFDC000000067TL250129","","126.5","","1979304.67"
"2025-02-04","2025-01-29","SF FuneralFDC00000006GT4250129","","126.5","","1979431.17"
"2025-02-04","2025-01-29","SF FuneralFDC00000006TXT250129","","126.5","","1979557.67"
"2025-02-04","2025-01-29","SF FuneralF798737       250129","","126.5","","1979684.17"
"2025-02-04","2025-01-29","SF FuneralF810917       250129","","126.5","","1979810.67"
"2025-02-04","2025-01-29","SF FuneralFDC0000000BD9R250129","","126.5","","1979937.17"
"2025-02-04","2025-01-29","SF FuneralF834085       250129","","126.5","","1980063.67"
"2025-02-04","2025-01-29","SF FuneralF838802       250129","","126.5","","1980190.17"
"2025-02-04","2025-01-29","SF FuneralF1084911      250129","","126.5","","1980316.67"
"2025-02-04","2025-01-29","SF FuneralF1125947      250129","","126.5","","1980443.17"
"2025-02-04","2025-01-29","SF FuneralF1127860      250129","","126.5","","1980569.67"
"2025-02-04","2025-01-30","SF FuneralFDC00000002WQ5250130","","220","","1980789.67"
"2025-02-04","2025-01-30","SF FuneralFDC00000006BXT250130","","126.5","","1980916.17"
"2025-02-04","2025-01-30","SF FuneralFDC00000006CLY250130","","126.5","","1981042.67"
"2025-02-04","2025-01-30","SF FuneralFDC000000078RB250130","","126.5","","1981169.17"
"2025-02-04","2025-01-30","SF FuneralFDC00000007H64250130","","343.31","","1981512.48"
"2025-02-04","2025-01-30","SF FuneralFDC00000009DR6250130","","126.5","","1981638.98"
"2025-02-04","2025-01-30","SF FuneralF989553       250130","","126.5","","1981765.48"
"2025-02-04","2025-01-31","SF FuneralF828117       250131","","126.5","","1981891.98"
"2025-02-04","2025-01-31","SF FuneralF900866       250201","","126.5","","1982018.48"
"2025-02-04","2025-01-31","SF FuneralF840974       250201","","256.5","","1982274.98"
"2025-02-04","2025-01-31","SF FuneralFDC0000000HFBF250201","","126.5","","1982401.48"
"2025-02-04","2025-01-31","SF FuneralF987573       250201","","126.5","","1982527.98"
"2025-02-04","2025-01-31","SF FuneralF987579       250201","","126.5","","1982654.48"
"2025-02-04","2025-01-31","SF FuneralF988081       250201","","126.5","","1982780.98"
"2025-02-04","2025-01-31","SF FuneralF988228       250201","","126.5","","1982907.48"
"2025-02-04","2025-01-31","SF FuneralF988372       250201","","126.5","","1983033.98"
"2025-02-04","2025-01-31","SF FuneralF988514       250201","","126.5","","1983160.48"
"2025-02-04","2025-01-31","SF FuneralFDC0000000HXCP250201","","126.5","","1983286.98"
"2025-02-04","2025-01-31","SF FuneralF989263       250201","","126.5","","1983413.48"
"2025-02-04","2025-01-31","SF FuneralF989775       250201","","126.5","","1983539.98"
"2025-02-04","2025-01-31","SF FuneralF989976       250201","","126.5","","1983666.48"
"2025-02-04","2025-01-31","SF FuneralF991159       250201","","126.5","","1983792.98"
"2025-02-04","2025-01-31","SF FuneralF1125931      250131","","126.5","","1983919.48"
"2025-02-04","2025-01-31","SF FuneralFDC0000000PZ6P250131","","126.5","","1984045.98"
"2025-02-04","2025-02-01","SF FuneralFDC00000002VJX250201","","220","","1984265.98"
"2025-02-04","2025-02-01","SF FuneralFDC00000002VQ1250201","","220","","1984485.98"
"2025-02-04","2025-02-01","SF FuneralFDC00000002WGN250201","","220","","1984705.98"
"2025-02-04","2025-02-01","SF FuneralFDC000000033B9250201","","220","","1984925.98"
"2025-02-04","2025-02-01","SF FuneralFDC000000033D3250201","","220","","1985145.98"
"2025-02-04","2025-02-01","SF FuneralFDC00000003F0W250201","","220","","1985365.98"
"2025-02-04","2025-02-01","SF FuneralFDC00000003F71250201","","220","","1985585.98"
"2025-02-04","2025-02-01","SF FuneralFDC00000003KHB250201","","220","","1985805.98"
"2025-02-04","2025-02-01","SF FuneralFDC000000047DZ250201","","220","","1986025.98"
"2025-02-04","2025-02-01","SF FuneralFDC00000004XLV250201","","220","","1986245.98"
"2025-02-04","2025-02-01","SF FuneralFDC000000058HS250201","","126.5","","1986372.48"
"2025-02-04","2025-02-01","SF FuneralFDC00000005C15250201","","126.5","","1986498.98"
"2025-02-04","2025-02-01","SF FuneralFDC00000005H42250201","","126.5","","1986625.48"
"2025-02-04","2025-02-01","SF FuneralFDC00000005MDQ250201","","126.5","","1986751.98"
"2025-02-04","2025-02-01","SF FuneralFDC00000005MMV250201","","126.5","","1986878.48"
"2025-02-04","2025-02-01","SF FuneralFDC00000005NBT250201","","126.5","","1987004.98"
"2025-02-04","2025-02-01","SF FuneralFDC00000005TB4250201","","126.5","","1987131.48"
"2025-02-04","2025-02-01","SF FuneralFDC00000005TD8250201","","126.5","","1987257.98"
"2025-02-04","2025-02-01","SF FuneralFDC00000005X66250201","","220","","1987477.98"
"2025-02-04","2025-02-01","SF FuneralFDC000000067DZ250201","","126.5","","1987604.48"
"2025-02-04","2025-02-01","SF FuneralFDC000000067MD250201","","126.5","","1987730.98"
"2025-02-04","2025-02-01","SF FuneralFDC000000067QG250201","","126.5","","1987857.48"
"2025-02-04","2025-02-01","SF FuneralFDC000000067TK250201","","126.5","","1987983.98"
"2025-02-04","2025-02-01","SF FuneralFDC0000000681F250201","","126.5","","1988110.48"
"2025-02-04","2025-02-01","SF FuneralFDC0000000681L250201","","126.5","","1988236.98"
"2025-02-04","2025-02-01","SF FuneralFDC000000068D3250201","","126.5","","1988363.48"
"2025-02-04","2025-02-01","SF FuneralFDC000000069N3250201","","126.5","","1988489.98"
"2025-02-04","2025-02-01","SF FuneralFDC000000069ZF250201","","126.5","","1988616.48"
"2025-02-04","2025-02-01","SF FuneralFDC00000006BDT250201","","126.5","","1988742.98"
"2025-02-04","2025-02-01","SF FuneralFDC00000006BJ6250201","","126.5","","1988869.48"
"2025-02-04","2025-02-01","SF FuneralFDC00000006BKH250201","","126.5","","1988995.98"
"2025-02-04","2025-02-01","SF FuneralFDC00000006BKY250201","","126.5","","1989122.48"
"2025-02-04","2025-02-01","SF FuneralFDC00000006BN6250201","","126.5","","1989248.98"
"2025-02-04","2025-02-01","SF FuneralFDC00000006BRH250201","","126.5","","1989375.48"
"2025-02-04","2025-02-01","SF FuneralFDC00000006CCC250201","","126.5","","1989501.98"
"2025-02-04","2025-02-01","SF FuneralFDC00000006DM4250201","","126.5","","1989628.48"
"2025-02-04","2025-02-01","SF FuneralFDC00000006F6S250201","","126.5","","1989754.98"
"2025-02-04","2025-02-01","SF FuneralFDC00000006F9L250201","","126.5","","1989881.48"
"2025-02-04","2025-02-01","SF FuneralFDC00000006GRC250201","","126.5","","1990007.98"
"2025-02-04","2025-02-01","SF FuneralFDC00000006GSG250201","","126.5","","1990134.48"
"2025-02-04","2025-02-01","SF FuneralFDC00000006GTS250201","","126.5","","1990260.98"
"2025-02-04","2025-02-01","SF FuneralFDC00000006GTV250201","","126.5","","1990387.48"
"2025-02-04","2025-02-01","SF FuneralFDC00000006HLP250201","","126.5","","1990513.98"
"2025-02-04","2025-02-01","SF FuneralFDC00000006J30250201","","126.5","","1990640.48"
"2025-02-04","2025-02-01","SF FuneralFDC00000006J9P250201","","126.5","","1990766.98"
"2025-02-04","2025-02-01","SF FuneralFDC00000006JSY250201","","126.5","","1990893.48"
"2025-02-04","2025-02-01","SF FuneralFDC00000006KHF250201","","126.5","","1991019.98"
"2025-02-04","2025-02-01","SF FuneralFDC00000006KHK250201","","126.5","","1991146.48"
"2025-02-04","2025-02-01","SF FuneralFDC00000006KS5250201","","126.5","","1991272.98"
"2025-02-04","2025-02-01","SF FuneralFDC00000006L0V250201","","126.5","","1991399.48"
"2025-02-04","2025-02-01","SF FuneralFDC00000006MCS250201","","126.5","","1991525.98"
"2025-02-04","2025-02-01","SF FuneralFDC00000006RQR250201","","220","","1991745.98"
"2025-02-04","2025-02-01","SF FuneralFDC00000006RXD250201","","126.5","","1991872.48"
"2025-02-04","2025-02-01","SF FuneralFDC00000006TQX250201","","126.5","","1991998.98"
"2025-02-04","2025-02-01","SF FuneralFDC00000006X0Y250201","","126.5","","1992125.48"
"2025-02-04","2025-02-01","SF FuneralFDC00000006XK9250201","","126.5","","1992251.98"
"2025-02-04","2025-02-01","SF FuneralFDC00000006Y9Z250201","","126.5","","1992378.48"
"2025-02-04","2025-02-01","SF FuneralFDC00000006Z19250201","","126.5","","1992504.98"
"2025-02-04","2025-02-01","SF FuneralFDC00000007368250201","","126.5","","1992631.48"
"2025-02-04","2025-02-01","SF FuneralFDC00000007397250201","","126.5","","1992757.98"
"2025-02-04","2025-02-01","SF FuneralFDC000000073QN250201","","126.5","","1992884.48"
"2025-02-04","2025-02-01","SF FuneralFDC000000073VZ250201","","126.5","","1993010.98"
"2025-02-04","2025-02-01","SF FuneralFDC000000074G0250201","","126.5","","1993137.48"
"2025-02-04","2025-02-01","SF FuneralFDC000000074KR250201","","126.5","","1993263.98"
"2025-02-04","2025-02-01","SF FuneralFDC0000000746T250201","","126.5","","1993390.48"
"2025-02-04","2025-02-01","SF FuneralFDC000000074TB250201","","126.5","","1993516.98"
"2025-02-04","2025-02-01","SF FuneralFDC00000007590250201","","126.5","","1993643.48"
"2025-02-04","2025-02-01","SF FuneralFDC0000000759K250201","","126.5","","1993769.98"
"2025-02-04","2025-02-01","SF FuneralFDC000000076H8250201","","126.5","","1993896.48"
"2025-02-04","2025-02-01","SF FuneralFDC000000076PL250201","","126.5","","1994022.98"
"2025-02-04","2025-02-01","SF FuneralFDC000000076PN250201","","126.5","","1994149.48"
"2025-02-04","2025-02-01","SF FuneralFDC000000076QW250201","","126.5","","1994275.98"
"2025-02-04","2025-02-01","SF FuneralFDC000000077RR250201","","126.5","","1994402.48"
"2025-02-04","2025-02-01","SF FuneralFDC00000007878250201","","126.5","","1994528.98"
"2025-02-04","2025-02-01","SF FuneralFDC000000078Q6250201","","126.5","","1994655.48"
"2025-02-04","2025-02-01","SF FuneralFDC00000007960250201","","126.5","","1994781.98"
"2025-02-04","2025-02-01","SF FuneralFDC0000000799C250201","","126.5","","1994908.48"
"2025-02-04","2025-02-01","SF FuneralFDC000000079HK250201","","126.5","","1995034.98"
"2025-02-04","2025-02-01","SF FuneralFDC00000007BLJ250201","","126.5","","1995161.48"
"2025-02-04","2025-02-01","SF FuneralFDC00000007DDH250201","","126.5","","1995287.98"
"2025-02-04","2025-02-01","SF FuneralFDC00000007DR3250201","","126.5","","1995414.48"
"2025-02-04","2025-02-01","SF FuneralFDC00000007FCV250201","","126.5","","1995540.98"
"2025-02-04","2025-02-01","SF FuneralFDC00000007FQ5250201","","126.5","","1995667.48"
"2025-02-04","2025-02-01","SF FuneralFDC00000007FY3250201","","126.5","","1995793.98"
"2025-02-04","2025-02-01","SF FuneralFDC00000007NRN250201","","126.5","","1995920.48"
"2025-02-04","2025-02-01","SF FuneralF793670       250201","","126.5","","1996046.98"
"2025-02-04","2025-02-01","SF FuneralFDC00000007PVN250201","","126.5","","1996173.48"
"2025-02-04","2025-02-01","SF FuneralFDC00000007PXR250201","","126.5","","1996299.98"
"2025-02-04","2025-02-01","SF FuneralFDC00000007QJ9250201","","126.5","","1996426.48"
"2025-02-04","2025-02-01","SF FuneralFDC00000007QKC250201","","126.5","","1996552.98"
"2025-02-04","2025-02-01","SF FuneralFDC00000007QNF250201","","220","","1996772.98"
"2025-02-04","2025-02-01","SF FuneralFDC00000007R49250201","","126.5","","1996899.48"
"2025-02-04","2025-02-01","SF FuneralF794127       250201","","126.5","","1997025.98"
"2025-02-04","2025-02-01","SF FuneralFDC00000007RJJ250201","","126.5","","1997152.48"
"2025-02-04","2025-02-01","SF FuneralFDC00000007RPX250201","","126.5","","1997278.98"
"2025-02-04","2025-02-01","SF FuneralFDC00000007S1V250201","","126.5","","1997405.48"
"2025-02-04","2025-02-01","SF FuneralFDC00000007T2F250201","","126.5","","1997531.98"
"2025-02-04","2025-02-01","SF FuneralFDC00000007T7R250201","","126.5","","1997658.48"
"2025-02-04","2025-02-01","SF FuneralFDC00000007TJS250201","","220","","1997878.48"
"2025-02-04","2025-02-01","SF FuneralF795059       250201","","126.5","","1998004.98"
"2025-02-04","2025-02-01","SF FuneralF795659       250201","","126.5","","1998131.48"
"2025-02-04","2025-02-01","SF FuneralFDC00000007WP1250201","","126.5","","1998257.98"
"2025-02-04","2025-02-01","SF FuneralFDC00000007Z00250201","","126.5","","1998384.48"
"2025-02-04","2025-02-01","SF FuneralFDC00000007Z9H250201","","126.5","","1998510.98"
"2025-02-04","2025-02-01","SF FuneralF796829       250201","","126.5","","1998637.48"
"2025-02-04","2025-02-01","SF FuneralF797949       250201","","126.5","","1998763.98"
"2025-02-04","2025-02-01","SF FuneralFDC000000083FW250201","","126.5","","1998890.48"
"2025-02-04","2025-02-01","SF FuneralFDC000000083RQ250201","","126.5","","1999016.98"
"2025-02-04","2025-02-01","SF FuneralF798268       250201","","126.5","","1999143.48"
"2025-02-04","2025-02-01","SF FuneralF798673       250201","","126.5","","1999269.98"
"2025-02-04","2025-02-01","SF FuneralF798709       250201","","126.5","","1999396.48"
"2025-02-04","2025-02-01","SF FuneralF799226       250201","","126.5","","1999522.98"
"2025-02-04","2025-02-01","SF FuneralF799543       250201","","126.5","","1999649.48"
"2025-02-04","2025-02-01","SF FuneralFDC000000088D1250201","","126.5","","1999775.98"
"2025-02-04","2025-02-01","SF FuneralF800040       250201","","126.5","","1999902.48"
"2025-02-04","2025-02-01","SF FuneralF800181       250201","","126.5","","2000028.98"
"2025-02-04","2025-02-01","SF FuneralF800841       250201","","126.5","","2000155.48"
"2025-02-04","2025-02-01","SF FuneralF800898       250201","","126.5","","2000281.98"
"2025-02-04","2025-02-01","SF FuneralFDC00000008FHW250201","","126.5","","2000408.48"
"2025-02-04","2025-02-01","SF FuneralFDC00000008FJF250201","","126.5","","2000534.98"
"2025-02-04","2025-02-01","SF FuneralF801279       250201","","126.5","","2000661.48"
"2025-02-04","2025-02-01","SF FuneralF801564       250201","","126.5","","2000787.98"
"2025-02-04","2025-02-01","SF FuneralF801687       250201","","126.5","","2000914.48"
"2025-02-04","2025-02-01","SF FuneralF802408       250201","","126.5","","2001040.98"
"2025-02-04","2025-02-01","SF FuneralF804211       250201","","126.5","","2001167.48"
"2025-02-04","2025-02-01","SF FuneralF805048       250201","","126.5","","2001293.98"
"2025-02-04","2025-02-01","SF FuneralF805555       250201","","126.5","","2001420.48"
"2025-02-04","2025-02-01","SF FuneralF808473       250201","","126.5","","2001546.98"
"2025-02-04","2025-02-01","SF FuneralF808524       250201","","126.5","","2001673.48"
"2025-02-04","2025-02-01","SF FuneralF808554       250201","","126.5","","2001799.98"
"2025-02-04","2025-02-01","SF FuneralF808576       250201","","126.5","","2001926.48"
"2025-02-04","2025-02-01","SF FuneralF808750       250201","","126.5","","2002052.98"
"2025-02-04","2025-02-01","SF FuneralF808892       250201","","126.5","","2002179.48"
"2025-02-04","2025-02-01","SF FuneralF809312       250201","","126.5","","2002305.98"
"2025-02-04","2025-02-01","SF FuneralF809478       250201","","126.5","","2002432.48"
"2025-02-04","2025-02-01","SF FuneralF809677       250201","","126.5","","2002558.98"
"2025-02-04","2025-02-01","SF FuneralF809704       250201","","126.5","","2002685.48"
"2025-02-04","2025-02-01","SF FuneralF809882       250201","","126.5","","2002811.98"
"2025-02-04","2025-02-01","SF FuneralF794621       250201","","220","","2003031.98"
"2025-02-04","2025-02-01","SF FuneralF810465       250201","","126.5","","2003158.48"
"2025-02-04","2025-02-01","SF FuneralF810747       250201","","126.5","","2003284.98"
"2025-02-04","2025-02-01","SF FuneralF793750       250201","","220","","2003504.98"
"2025-02-04","2025-02-01","SF FuneralF813167       250201","","126.5","","2003631.48"
"2025-02-04","2025-02-01","SF FuneralF813622       250201","","126.5","","2003757.98"
"2025-02-04","2025-02-01","SF FuneralF813774       250201","","126.5","","2003884.48"
"2025-02-04","2025-02-01","SF FuneralF813902       250201","","126.5","","2004010.98"
"2025-02-04","2025-02-01","SF FuneralF815666       250201","","126.5","","2004137.48"
"2025-02-04","2025-02-01","SF FuneralFDC00000009W3B250201","","126.5","","2004263.98"
"2025-02-04","2025-02-01","SF FuneralF816424       250201","","126.5","","2004390.48"
"2025-02-04","2025-02-01","SF FuneralF816527       250201","","126.5","","2004516.98"
"2025-02-04","2025-02-01","SF FuneralF816814       250201","","126.5","","2004643.48"
"2025-02-04","2025-02-01","SF FuneralF816945       250201","","126.5","","2004769.98"
"2025-02-04","2025-02-01","SF FuneralF817405       250201","","126.5","","2004896.48"
"2025-02-04","2025-02-01","SF FuneralF817500       250201","","126.5","","2005022.98"
"2025-02-04","2025-02-01","SF FuneralF818317       250201","","126.5","","2005149.48"
"2025-02-04","2025-02-01","SF FuneralF818524       250201","","126.5","","2005275.98"
"2025-02-04","2025-02-01","SF FuneralF818852       250201","","126.5","","2005402.48"
"2025-02-04","2025-02-01","SF FuneralF818982       250201","","126.5","","2005528.98"
"2025-02-04","2025-02-01","SF FuneralF820384       250201","","126.5","","2005655.48"
"2025-02-04","2025-02-01","SF FuneralF820447       250201","","126.5","","2005781.98"
"2025-02-04","2025-02-01","SF FuneralF820617       250201","","126.5","","2005908.48"
"2025-02-04","2025-02-01","SF FuneralF820831       250201","","126.5","","2006034.98"
"2025-02-04","2025-02-01","SF FuneralF821100       250201","","126.5","","2006161.48"
"2025-02-04","2025-02-01","SF FuneralFDC0000000B99B250201","","126.5","","2006287.98"
"2025-02-04","2025-02-01","SF FuneralFDC0000000B9Y8250201","","126.5","","2006414.48"
"2025-02-04","2025-02-01","SF FuneralF821461       250201","","213.31","","2006627.79"
"2025-02-04","2025-02-01","SF FuneralF821613       250201","","126.5","","2006754.29"
"2025-02-04","2025-02-01","SF FuneralF827716       250201","","126.5","","2006880.79"
"2025-02-04","2025-02-01","SF FuneralF828016       250201","","126.5","","2007007.29"
"2025-02-04","2025-02-01","SF FuneralF828019       250201","","126.5","","2007133.79"
"2025-02-04","2025-02-01","SF FuneralF828071       250201","","126.5","","2007260.29"
"2025-02-04","2025-02-01","SF FuneralF828184       250201","","126.5","","2007386.79"
"2025-02-04","2025-02-01","SF FuneralF828207       250201","","126.5","","2007513.29"
"2025-02-04","2025-02-01","SF FuneralF828259       250201","","126.5","","2007639.79"
"2025-02-04","2025-02-01","SF FuneralF828893       250201","","126.5","","2007766.29"
"2025-02-04","2025-02-01","SF FuneralF829034       250201","","126.5","","2007892.79"
"2025-02-04","2025-02-01","SF FuneralF829077       250201","","126.5","","2008019.29"
"2025-02-04","2025-02-01","SF FuneralF829789       250201","","126.5","","2008145.79"
"2025-02-04","2025-02-01","SF FuneralF829886       250201","","126.5","","2008272.29"
"2025-02-04","2025-02-01","SF FuneralF830585       250201","","126.5","","2008398.79"
"2025-02-04","2025-02-01","SF FuneralF830876       250201","","126.5","","2008525.29"
"2025-02-04","2025-02-01","SF FuneralF831104       250201","","126.5","","2008651.79"
"2025-02-04","2025-02-01","SF FuneralF832052       250201","","126.5","","2008778.29"
"2025-02-04","2025-02-01","SF FuneralF832244       250201","","126.5","","2008904.79"
"2025-02-04","2025-02-01","SF FuneralF832375       250201","","126.5","","2009031.29"
"2025-02-04","2025-02-01","SF FuneralF832964       250201","","126.5","","2009157.79"
"2025-02-04","2025-02-01","SF FuneralF833096       250201","","126.5","","2009284.29"
"2025-02-04","2025-02-01","SF FuneralF833102       250201","","126.5","","2009410.79"
"2025-02-04","2025-02-01","SF FuneralF833128       250201","","126.5","","2009537.29"
"2025-02-04","2025-02-01","SF FuneralF833426       250201","","126.5","","2009663.79"
"2025-02-04","2025-02-01","SF FuneralFDC0000000CXR7250201","","126.5","","2009790.29"
"2025-02-04","2025-02-01","SF FuneralF834187       250201","","126.5","","2009916.79"
"2025-02-04","2025-02-01","SF FuneralF834745       250201","","126.5","","2010043.29"
"2025-02-04","2025-02-01","SF FuneralF834936       250201","","126.5","","2010169.79"
"2025-02-04","2025-02-01","SF FuneralF841427       250201","","126.5","","2010296.29"
"2025-02-04","2025-02-01","SF FuneralF841437       250201","","126.5","","2010422.79"
"2025-02-04","2025-02-01","SF FuneralF841489       250201","","126.5","","2010549.29"
"2025-02-04","2025-02-01","SF FuneralF841942       250201","","126.5","","2010675.79"
"2025-02-04","2025-02-01","SF FuneralF842044       250201","","126.5","","2010802.29"
"2025-02-04","2025-02-01","SF FuneralF842444       250201","","126.5","","2010928.79"
"2025-02-04","2025-02-01","SF FuneralF842519       250201","","126.5","","2011055.29"
"2025-02-04","2025-02-01","SF FuneralF842695       250201","","126.5","","2011181.79"
"2025-02-04","2025-02-01","SF FuneralF842766       250201","","126.5","","2011308.29"
"2025-02-04","2025-02-01","SF FuneralF992305       250201","","126.5","","2011434.79"
"2025-02-04","2025-02-01","SF FuneralF992362       250201","","126.5","","2011561.29"
"2025-02-04","2025-02-01","SF FuneralF992372       250201","","126.5","","2011687.79"
"2025-02-04","2025-02-01","SF FuneralF992488       250201","","126.5","","2011814.29"
"2025-02-04","2025-02-01","SF FuneralF992732       250201","","126.5","","2011940.79"
"2025-02-04","2025-02-01","SF FuneralF993035       250201","","126.5","","2012067.29"
"2025-02-04","2025-02-01","SF FuneralF993155       250201","","126.5","","2012193.79"
"2025-02-04","2025-02-01","SF FuneralF993212       250201","","126.5","","2012320.29"
"2025-02-04","2025-02-01","SF FuneralF993215       250201","","126.5","","2012446.79"
"2025-02-04","2025-02-01","SF FuneralF1021223      250201","","126.5","","2012573.29"
"2025-02-04","2025-02-01","SF FuneralF1021275      250201","","126.5","","2012699.79"
"2025-02-04","2025-02-01","SF FuneralF1021431      250201","","126.5","","2012826.29"
"2025-02-04","2025-02-01","SF FuneralF1021516      250201","","126.5","","2012952.79"
"2025-02-04","2025-02-01","SF FuneralF1021767      250201","","126.5","","2013079.29"
"2025-02-04","2025-02-01","SF FuneralF1022018      250201","","126.5","","2013205.79"
"2025-02-04","2025-02-01","SF FuneralF1022189      250201","","126.5","","2013332.29"
"2025-02-04","2025-02-01","SF FuneralF1050754      250201","","126.5","","2013458.79"
"2025-02-04","2025-02-01","SF FuneralF1052041      250201","","126.5","","2013585.29"
"2025-02-04","2025-02-01","SF FuneralFDC0000000K0YD250201","","126.5","","2013711.79"
"2025-02-04","2025-02-01","SF FuneralF1052147      250201","","126.5","","2013838.29"
"2025-02-04","2025-02-01","SF FuneralF1052508      250201","","126.5","","2013964.79"
"2025-02-04","2025-02-01","SF FuneralF1052747      250201","","126.5","","2014091.29"
"2025-02-04","2025-02-01","SF FuneralF1058669      250201","","126.5","","2014217.79"
"2025-02-04","2025-02-01","SF FuneralF1060242      250201","","126.5","","2014344.29"
"2025-02-04","2025-02-01","SF FuneralFDC0000000KLR7250201","","126.5","","2014470.79"
"2025-02-04","2025-02-01","SF FuneralF1061685      250201","","126.5","","2014597.29"
"2025-02-04","2025-02-01","SF FuneralF1061705      250201","","126.5","","2014723.79"
"2025-02-04","2025-02-01","SF FuneralF1065845      250201","","126.5","","2014850.29"
"2025-02-04","2025-02-01","SF FuneralF1066205      250201","","126.5","","2014976.79"
"2025-02-04","2025-02-01","SF FuneralF1066353      250201","","126.5","","2015103.29"
"2025-02-04","2025-02-01","SF FuneralF1066410      250201","","126.5","","2015229.79"
"2025-02-04","2025-02-01","SF FuneralF1066418      250201","","126.5","","2015356.29"
"2025-02-04","2025-02-01","SF FuneralF1066716      250201","","126.5","","2015482.79"
"2025-02-04","2025-02-01","SF FuneralF1072710      250201","","126.5","","2015609.29"
"2025-02-04","2025-02-01","SF FuneralF1072866      250201","","126.5","","2015735.79"
"2025-02-04","2025-02-01","SF FuneralF1073201      250201","","126.5","","2015862.29"
"2025-02-04","2025-02-01","SF FuneralF1074755      250201","","126.5","","2015988.79"
"2025-02-04","2025-02-01","SF FuneralF1075045      250201","","126.5","","2016115.29"
"2025-02-04","2025-02-01","SF FuneralF1075125      250201","","126.5","","2016241.79"
"2025-02-04","2025-02-01","SF FuneralF1075236      250201","","126.5","","2016368.29"
"2025-02-04","2025-02-01","SF FuneralF1078246      250201","","126.5","","2016494.79"
"2025-02-04","2025-02-01","SF FuneralF1078386      250201","","126.5","","2016621.29"
"2025-02-04","2025-02-01","SF FuneralF1078615      250201","","126.5","","2016747.79"
"2025-02-04","2025-02-01","SF FuneralF1078875      250201","","126.5","","2016874.29"
"2025-02-04","2025-02-01","SF FuneralF1078964      250201","","126.5","","2017000.79"
"2025-02-04","2025-02-01","SF FuneralFDC0000000LM0M250201","","126.5","","2017127.29"
"2025-02-04","2025-02-01","SF FuneralFDC0000000LNNV250201","","126.5","","2017253.79"
"2025-02-04","2025-02-01","SF FuneralF1021257      250201","","126.5","","2017380.29"
"2025-02-04","2025-02-01","SF FuneralF1084033      250201","","126.5","","2017506.79"
"2025-02-04","2025-02-01","SF FuneralF1084333      250201","","126.5","","2017633.29"
"2025-02-04","2025-02-01","SF FuneralF1084394      250201","","126.5","","2017759.79"
"2025-02-04","2025-02-01","SF FuneralF1084483      250201","","126.5","","2017886.29"
"2025-02-04","2025-02-01","SF FuneralF1084657      250201","","126.5","","2018012.79"
"2025-02-04","2025-02-01","SF FuneralF1084730      250201","","126.5","","2018139.29"
"2025-02-04","2025-02-01","SF FuneralF1084875      250201","","126.5","","2018265.79"
"2025-02-04","2025-02-01","SF FuneralF1103949      250201","","126.5","","2018392.29"
"2025-02-04","2025-02-01","SF FuneralF1104064      250201","","126.5","","2018518.79"
"2025-02-04","2025-02-01","SF FuneralF1104184      250201","","126.5","","2018645.29"
"2025-02-04","2025-02-01","SF FuneralF1108137      250201","","126.5","","2018771.79"
"2025-02-04","2025-02-01","SF FuneralF1108778      250201","","126.5","","2018898.29"
"2025-02-04","2025-02-01","SF FuneralFDC0000000MJFF250201","","126.5","","2019024.79"
"2025-02-04","2025-02-01","SF FuneralFDC0000000MJSQ250201","","220","","2019244.79"
"2025-02-04","2025-02-01","SF FuneralF1109831      250201","","126.5","","2019371.29"
"2025-02-04","2025-02-01","SF FuneralF1110353      250201","","126.5","","2019497.79"
"2025-02-04","2025-02-01","SF FuneralFDC0000000N388250201","","126.5","","2019624.29"
"2025-02-04","2025-02-01","SF FuneralF1113827      250201","","126.5","","2019750.79"
"2025-02-04","2025-02-01","SF FuneralF1113835      250201","","126.5","","2019877.29"
"2025-02-04","2025-02-01","SF FuneralF1114049      250201","","126.5","","2020003.79"
"2025-02-04","2025-02-01","SF FuneralF1114271      250201","","126.5","","2020130.29"
"2025-02-04","2025-02-01","SF FuneralF1114598      250201","","126.5","","2020256.79"
"2025-02-04","2025-02-01","SF FuneralF1114625      250201","","126.5","","2020383.29"
"2025-02-04","2025-02-01","SF FuneralF1116889      250201","","126.5","","2020509.79"
"2025-02-04","2025-02-01","SF FuneralF1116933      250201","","126.5","","2020636.29"
"2025-02-04","2025-02-01","SF FuneralF1116943      250202","","126.5","","2020762.79"
"2025-02-04","2025-02-01","SF FuneralF1116955      250201","","126.5","","2020889.29"
"2025-02-04","2025-02-01","SF FuneralF1117142      250201","","126.5","","2021015.79"
"2025-02-04","2025-02-01","SF FuneralF1117301      250202","","126.5","","2021142.29"
"2025-02-04","2025-02-01","SF FuneralF1117869      250201","","126.5","","2021268.79"
"2025-02-04","2025-02-01","SF FuneralF1117997      250201","","126.5","","2021395.29"
"2025-02-04","2025-02-01","SF FuneralF1118066      250201","","126.5","","2021521.79"
"2025-02-04","2025-02-01","SF FuneralF1118415      250201","","126.5","","2021648.29"
"2025-02-04","2025-02-01","SF FuneralF1118907      250201","","126.5","","2021774.79"
"2025-02-04","2025-02-01","SF FuneralF1119687      250201","","126.5","","2021901.29"
"2025-02-04","2025-02-01","SF FuneralF1119879      250201","","126.5","","2022027.79"
"2025-02-04","2025-02-01","SF FuneralF1121893      250201","","126.5","","2022154.29"
"2025-02-04","2025-02-01","SF FuneralF1121912      250201","","126.5","","2022280.79"
"2025-02-04","2025-02-01","SF FuneralF1122033      250201","","126.5","","2022407.29"
"2025-02-04","2025-02-01","SF FuneralF1122225      250201","","126.5","","2022533.79"
"2025-02-04","2025-02-01","SF FuneralF1122234      250201","","126.5","","2022660.29"
"2025-02-04","2025-02-01","SF FuneralF1122623      250201","","126.5","","2022786.79"
"2025-02-04","2025-02-01","SF FuneralF1122671      250201","","126.5","","2022913.29"
"2025-02-04","2025-02-01","SF FuneralF1122726      250201","","126.5","","2023039.79"
"2025-02-04","2025-02-01","SF FuneralF1122801      250201","","126.5","","2023166.29"
"2025-02-04","2025-02-01","SF FuneralF1122861      250201","","126.5","","2023292.79"
"2025-02-04","2025-02-01","SF FuneralF1122990      250201","","126.5","","2023419.29"
"2025-02-04","2025-02-01","SF FuneralF1123060      250201","","126.5","","2023545.79"
"2025-02-04","2025-02-01","SF FuneralF1123462      250201","","126.5","","2023672.29"
"2025-02-04","2025-02-01","SF FuneralF1124062      250201","","126.5","","2023798.79"
"2025-02-04","2025-02-01","SF FuneralF1125280      250201","","126.5","","2023925.29"
"2025-02-04","2025-02-01","SF FuneralF1125422      250201","","126.5","","2024051.79"
"2025-02-04","2025-02-01","SF FuneralF1125463      250201","","126.5","","2024178.29"
"2025-02-04","2025-02-01","SF FuneralF1125499      250201","","126.5","","2024304.79"
"2025-02-04","2025-02-01","SF FuneralFDC0000000PKGF250201","","213.31","","2024518.1"
"2025-02-04","2025-02-01","SF FuneralF1126822      250201","","126.5","","2024644.6"
"2025-02-04","2025-02-01","SF FuneralF1127398      250201","","126.5","","2024771.1"
"2025-02-04","2025-02-01","SF FuneralF1127400      250201","","126.5","","2024897.6"
"2025-02-04","2025-02-01","SF FuneralF1127645      250201","","126.5","","2025024.1"
"2025-02-04","2025-02-01","SF FuneralF1127992      250201","","126.5","","2025150.6"
"2025-02-04","2025-02-01","SF FuneralF1128004      250201","","126.5","","2025277.1"
"2025-02-04","2025-02-01","SF FuneralF1128137      250201","","126.5","","2025403.6"
"2025-02-04","2025-02-01","SF FuneralF1128186      250201","","126.5","","2025530.1"
"2025-02-04","2025-02-01","SF FuneralF1128987      250201","","126.5","","2025656.6"
"2025-02-04","2025-02-01","SF FuneralF1129162      250201","","126.5","","2025783.1"
"2025-02-04","2025-02-01","SF FuneralF1129319      250201","","126.5","","2025909.6"
"2025-02-04","2025-02-01","SF FuneralF1129350      250201","","126.5","","2026036.1"
"2025-02-04","2025-02-03","SF FuneralF802942       250202","","126.5","","2026162.6"
"2025-02-04","2025-02-02","SF FuneralF828062       250202","","126.5","","2026289.1"
"2025-02-04","2025-02-03","SF FuneralF832528       250203","","126.5","","2026415.6"
"2025-02-04","2025-02-02","SF FuneralF832557       250202","","126.5","","2026542.1"
"2025-02-04","2025-02-03","SF FuneralF843397       250201","","126.5","","2026668.6"
"2025-02-04","2025-02-03","SF FuneralF900689       250201","","126.5","","2026795.1"
"2025-02-04","2025-02-03","SF FuneralF900733       250201","","126.5","","2026921.6"
"2025-02-04","2025-02-03","SF FuneralF900740       250201","","126.5","","2027048.1"
"2025-02-04","2025-02-03","SF FuneralF993884       250203","","126.5","","2027174.6"
"2025-02-04","2025-02-03","SF FuneralF1061660      250203","","126.5","","2027301.1"
"2025-02-04","2025-02-03","SF FuneralF1125880      250203","","126.5","","2027427.6"
"2025-02-04","2025-02-03","SF FuneralF1126015      250203","","126.5","","2027554.1"
"2025-02-04","2025-02-03","SF FuneralF1126184      250203","","126.5","","2027680.6"
"2025-02-04","2025-02-04","SF FuneralFDC00000006WKK250204","","31.63","","2027712.23"
"2025-02-04","2025-02-04","SF FuneralFDC00000006X91250204","","31.63","","2027743.86"
"2025-02-04","2025-02-04","SF FuneralF802375       250204","","31.63","","2027775.49"
"2025-02-04","2025-02-04","SF FuneralFDC00000007CJF250204","","63.25","","2027838.74"
"2025-02-04","2025-02-04","SF FuneralFDC00000007BRR250204","","126.5","","2027965.24"
"2025-02-04","2025-02-04","SF FuneralF816802       250204","","31.63","","2027996.87"
"2025-02-04","2025-02-04","SF FuneralF831106       250204","","31.63","","2028028.5"
"2025-02-04","2025-02-04","SF FuneralF1020916      250204","","31.63","","2028060.13"
"2025-02-04","2025-02-04","SF FuneralF1073137      250204","","63.25","","2028123.38"
"2025-02-04","2025-02-04","SF FuneralF1078487      250204","","126.5","","2028249.88"
"2025-02-04","2025-02-04","SF FuneralF1127411      250204","","126.5","","2028376.38"
"2025-02-04","2025-02-01","SF FuneralFDC00000005BSR250201","","126.5","","2028502.88"
"2025-02-04","2025-02-04","SF FuneralFDC00000005DH3250204","","110","","2028612.88"
"2025-02-04","2025-02-04","SF FuneralFDC0000000BBZY250204","","126.5","","2028739.38"
"2025-02-04","2025-02-04","SF FuneralF840716       250204","","126.5","","2028865.88"
"2025-02-04","2025-02-04","SF FuneralF844086       250204","","63.25","","2028929.13"
"2025-02-04","2025-02-04","SF FuneralF1061069      250204","","31.63","","2028960.76"
"2025-02-04","2025-02-03","SF FuneralF808696       250202","","126.5","","2029087.26"
"2025-02-04","2025-02-03","SF FuneralF808733       250202","","126.5","","2029213.76"
"2025-02-04","2025-02-03","SF FuneralFDC0000000934R250203","","191.5","","2029405.26"
"2025-02-04","2025-02-03","SF FuneralF812500       250202","","126.5","","2029531.76"
"2025-02-04","2025-02-03","SF FuneralF812666       250203","","126.5","","2029658.26"
"2025-02-04","2025-02-03","SF FuneralF822955       250202","","126.5","","2029784.76"
"2025-02-04","2025-02-03","SF FuneralF842965       250201","","126.5","","2029911.26"
"2025-02-04","2025-02-03","SF FuneralF842984       250201","","126.5","","2030037.76"
"2025-02-04","2025-02-03","SF FuneralF900531       250201","","126.5","","2030164.26"
"2025-02-04","2025-02-03","SF FuneralF900569       250201","","126.5","","2030290.76"
"2025-02-04","2025-02-03","SF FuneralF987942       250203","","126.5","","2030417.26"
"2025-02-04","2025-02-03","SF FuneralF1066729      250203","","126.5","","2030543.76"
"2025-02-04","2025-02-03","SF FuneralF1078472      250203","","126.5","","2030670.26"
"2025-02-04","2025-02-03","SF FuneralF1078604      250203","","126.5","","2030796.76"
"2025-02-04","2025-02-03","SF FuneralF1122021      250203","","126.5","","2030923.26"
"2025-02-04","2025-02-03","SF FuneralF1125683      250203","","126.5","","2031049.76"
"2025-02-04","2025-02-03","SF FuneralF1126140      250203","","126.5","","2031176.26"
"2025-02-04","2025-01-27","SF FuneralF793899       250126","","126.5","","2031302.76"
"2025-02-04","2025-01-27","SF FuneralF830051       250127","","63.25","","2031366.01"
"2025-02-04","2025-01-29","SF FuneralFDC00000006FDH250129","","126.5","","2031492.51"
"2025-02-04","2025-01-29","SF FuneralF832974       250129","","126.5","","2031619.01"
"2025-02-04","2025-01-29","SF FuneralF841461       250129","","126.5","","2031745.51"
"2025-02-04","2025-01-30","SF FuneralFDC000000034D9250130","","220","","2031965.51"
"2025-02-04","2025-01-30","SF FuneralFDC00000006L3F250130","","126.5","","2032092.01"
"2025-02-04","2025-01-30","SF FuneralF809340       250130","","126.5","","2032218.51"
"2025-02-04","2025-01-31","SF FuneralFDC00000006XYT250131","","126.5","","2032345.01"
"2025-02-04","2025-01-31","SF FuneralF900902       250201","","126.5","","2032471.51"
"2025-02-04","2025-01-31","SF FuneralF901080       250201","","126.5","","2032598.01"
"2025-02-04","2025-01-31","SF FuneralF901085       250201","","126.5","","2032724.51"
"2025-02-04","2025-01-31","SF FuneralF901183       250201","","126.5","","2032851.01"
"2025-02-04","2025-01-31","SF FuneralF901240       250201","","126.5","","2032977.51"
"2025-02-04","2025-01-31","SF FuneralF981616       250201","","126.5","","2033104.01"
"2025-02-04","2025-01-31","SF FuneralF777476       250201","","191.5","","2033295.51"
"2025-02-04","2025-01-31","SF FuneralF987076       250201","","126.5","","2033422.01"
"2025-02-04","2025-01-31","SF FuneralF987612       250201","","126.5","","2033548.51"
"2025-02-04","2025-01-31","SF FuneralF987680       250201","","126.5","","2033675.01"
"2025-02-04","2025-01-31","SF FuneralF987688       250131","","126.5","","2033801.51"
"2025-02-04","2025-01-31","SF FuneralF987735       250201","","126.5","","2033928.01"
"2025-02-04","2025-01-31","SF FuneralF987837       250201","","126.5","","2034054.51"
"2025-02-04","2025-01-31","SF FuneralF987944       250201","","126.5","","2034181.01"
"2025-02-04","2025-01-31","SF FuneralF988063       250201","","126.5","","2034307.51"
"2025-02-04","2025-01-31","SF FuneralF988078       250201","","126.5","","2034434.01"
"2025-02-04","2025-01-31","SF FuneralF988732       250201","","126.5","","2034560.51"
"2025-02-04","2025-01-31","SF FuneralF988970       250201","","126.5","","2034687.01"
"2025-02-04","2025-01-31","SF FuneralF988972       250201","","126.5","","2034813.51"
"2025-02-04","2025-01-31","SF FuneralF989123       250201","","126.5","","2034940.01"
"2025-02-04","2025-01-31","SF FuneralF989603       250201","","126.5","","2035066.51"
"2025-02-04","2025-01-31","SF FuneralF989697       250201","","126.5","","2035193.01"
"2025-02-04","2025-01-31","SF FuneralF990100       250201","","126.5","","2035319.51"
"2025-02-04","2025-01-31","SF FuneralF990241       250201","","126.5","","2035446.01"
"2025-02-04","2025-01-31","SF FuneralF993572       250131","","31.63","","2035477.64"
"2025-02-04","2025-01-31","SF FuneralF1021663      250131","","126.5","","2035604.14"
"2025-02-04","2025-01-31","SF FuneralF1104078      250131","","126.5","","2035730.64"
"2025-02-04","2025-01-31","SF FuneralF1128182      250131","","126.5","","2035857.14"
"2025-02-04","2025-02-01","SF FuneralFDC00000002RF1250201","","220","","2036077.14"
"2025-02-04","2025-02-01","SF FuneralFDC00000002V49250201","","220","","2036297.14"
"2025-02-04","2025-02-01","SF FuneralFDC00000002V8X250201","","220","","2036517.14"
"2025-02-04","2025-02-01","SF FuneralFDC00000002VW6250201","","220","","2036737.14"
"2025-02-04","2025-02-01","SF FuneralFDC00000002VZ6250201","","220","","2036957.14"
"2025-02-04","2025-02-01","SF FuneralFDC00000002WTM250201","","220","","2037177.14"
"2025-02-04","2025-02-01","SF FuneralFDC00000002WW3250201","","220","","2037397.14"
"2025-02-04","2025-02-01","SF FuneralFDC00000002X65250201","","220","","2037617.14"
"2025-02-04","2025-02-01","SF FuneralFDC00000002XDL250201","","220","","2037837.14"
"2025-02-04","2025-02-01","SF FuneralFDC000000032YT250201","","220","","2038057.14"
"2025-02-04","2025-02-01","SF FuneralFDC0000000334T250201","","220","","2038277.14"
"2025-02-04","2025-02-01","SF FuneralFDC000000033FH250201","","220","","2038497.14"
"2025-02-04","2025-02-01","SF FuneralFDC000000033R6250201","","220","","2038717.14"
"2025-02-04","2025-02-01","SF FuneralFDC000000034R2250201","","220","","2038937.14"
"2025-02-04","2025-02-01","SF FuneralFDC0000000378C250201","","220","","2039157.14"
"2025-02-04","2025-02-01","SF FuneralFDC00000003F03250201","","220","","2039377.14"
"2025-02-04","2025-02-01","SF FuneralFDC000000057WZ250201","","220","","2039597.14"
"2025-02-04","2025-02-01","SF FuneralFDC00000005BTX250201","","220","","2039817.14"
"2025-02-04","2025-02-01","SF FuneralFDC00000005G6L250201","","126.5","","2039943.64"
"2025-02-04","2025-02-01","SF FuneralFDC00000005GS4250201","","126.5","","2040070.14"
"2025-02-04","2025-02-01","SF FuneralFDC00000005H9Q250201","","126.5","","2040196.64"
"2025-02-04","2025-02-01","SF FuneralFDC00000005M6V250201","","126.5","","2040323.14"
"2025-02-04","2025-02-01","SF FuneralFDC00000005NG6250201","","126.5","","2040449.64"
"2025-02-04","2025-02-01","SF FuneralFDC00000005XYJ250201","","126.5","","2040576.14"
"2025-02-04","2025-02-01","SF FuneralFDC000000067Y6250201","","126.5","","2040702.64"
"2025-02-04","2025-02-01","SF FuneralFDC00000006844250201","","126.5","","2040829.14"
"2025-02-04","2025-02-01","SF FuneralFDC000000068QQ250201","","126.5","","2040955.64"
"2025-02-04","2025-02-01","SF FuneralFDC0000000693P250201","","126.5","","2041082.14"
"2025-02-04","2025-02-01","SF FuneralFDC000000069SD250201","","126.5","","2041208.64"
"2025-02-04","2025-02-01","SF FuneralFDC00000006B7L250201","","126.5","","2041335.14"
"2025-02-04","2025-02-01","SF FuneralFDC00000006CT7250201","","126.5","","2041461.64"
"2025-02-04","2025-02-01","SF FuneralFDC00000006F0Z250201","","126.5","","2041588.14"
"2025-02-04","2025-02-01","SF FuneralFDC00000006FLL250201","","126.5","","2041714.64"
"2025-02-04","2025-02-01","SF FuneralFDC00000006FNV250201","","126.5","","2041841.14"
"2025-02-04","2025-02-01","SF FuneralFDC00000006FRB250201","","126.5","","2041967.64"
"2025-02-04","2025-02-01","SF FuneralFDC00000006GDH250201","","126.5","","2042094.14"
"2025-02-04","2025-02-01","SF FuneralFDC00000006GKD250201","","191.5","","2042285.64"
"2025-02-04","2025-02-01","SF FuneralFDC00000006GNC250201","","126.5","","2042412.14"
"2025-02-04","2025-02-01","SF FuneralFDC00000006H2P250201","","126.5","","2042538.64"
"2025-02-04","2025-02-01","SF FuneralFDC00000006J77250201","","126.5","","2042665.14"
"2025-02-04","2025-02-01","SF FuneralFDC00000006JQJ250201","","126.5","","2042791.64"
"2025-02-04","2025-02-01","SF FuneralFDC00000006JQW250201","","126.5","","2042918.14"
"2025-02-04","2025-02-01","SF FuneralFDC00000006JW6250201","","126.5","","2043044.64"
"2025-02-04","2025-02-01","SF FuneralFDC00000006K2K250201","","126.5","","2043171.14"
"2025-02-04","2025-02-01","SF FuneralFDC00000006KQ2250201","","126.5","","2043297.64"
"2025-02-04","2025-02-01","SF FuneralFDC00000006LKT250201","","126.5","","2043424.14"
"2025-02-04","2025-02-01","SF FuneralFDC00000006M1B250201","","126.5","","2043550.64"
"2025-02-04","2025-02-01","SF FuneralFDC00000006PHG250201","","126.5","","2043677.14"
"2025-02-04","2025-02-01","SF FuneralFDC00000006S7X250201","","126.5","","2043803.64"
"2025-02-04","2025-02-01","SF FuneralFDC00000006WZ6250201","","126.5","","2043930.14"
"2025-02-04","2025-02-01","SF FuneralFDC00000006XN2250201","","126.5","","2044056.64"
"2025-02-04","2025-02-01","SF FuneralFDC0000000723V250201","","126.5","","2044183.14"
"2025-02-04","2025-02-01","SF FuneralFDC000000073CY250201","","126.5","","2044309.64"
"2025-02-04","2025-02-01","SF FuneralFDC000000073F7250201","","126.5","","2044436.14"
"2025-02-04","2025-02-01","SF FuneralFDC000000073N7250201","","126.5","","2044562.64"
"2025-02-04","2025-02-01","SF FuneralFDC0000000743Y250201","","126.5","","2044689.14"
"2025-02-04","2025-02-01","SF FuneralFDC0000000757H250201","","126.5","","2044815.64"
"2025-02-04","2025-02-01","SF FuneralFDC0000000758Q250201","","126.5","","2044942.14"
"2025-02-04","2025-02-01","SF FuneralFDC000000075G6250201","","126.5","","2045068.64"
"2025-02-04","2025-02-01","SF FuneralFDC000000075KH250201","","126.5","","2045195.14"
"2025-02-04","2025-02-01","SF FuneralFDC000000075Y1250201","","126.5","","2045321.64"
"2025-02-04","2025-02-01","SF FuneralFDC000000076LB250201","","126.5","","2045448.14"
"2025-02-04","2025-02-01","SF FuneralFDC000000076MD250201","","126.5","","2045574.64"
"2025-02-04","2025-02-01","SF FuneralFDC0000000773X250201","","126.5","","2045701.14"
"2025-02-04","2025-02-01","SF FuneralFDC00000007811250201","","126.5","","2045827.64"
"2025-02-04","2025-02-01","SF FuneralFDC00000007872250201","","126.5","","2045954.14"
"2025-02-04","2025-02-01","SF FuneralFDC000000078D7250201","","126.5","","2046080.64"
"2025-02-04","2025-02-01","SF FuneralFDC000000078RY250201","","256.5","","2046337.14"
"2025-02-04","2025-02-01","SF FuneralFDC000000078VG250201","","220","","2046557.14"
"2025-02-04","2025-02-01","SF FuneralFDC00000007BG1250201","","126.5","","2046683.64"
"2025-02-04","2025-02-01","SF FuneralFDC00000007DWN250201","","220","","2046903.64"
"2025-02-04","2025-02-01","SF FuneralFDC00000007DYY250201","","126.5","","2047030.14"
"2025-02-04","2025-02-01","SF FuneralFDC00000007QQK250201","","126.5","","2047156.64"
"2025-02-04","2025-02-01","SF FuneralF793977       250201","","126.5","","2047283.14"
"2025-02-04","2025-02-01","SF FuneralFDC00000007R50250201","","126.5","","2047409.64"
"2025-02-04","2025-02-01","SF FuneralFDC00000007R83250201","","126.5","","2047536.14"
"2025-02-04","2025-02-01","SF FuneralFDC00000007RP5250201","","126.5","","2047662.64"
"2025-02-04","2025-02-01","SF FuneralF794669       250201","","126.5","","2047789.14"
"2025-02-04","2025-02-01","SF FuneralF795467       250201","","126.5","","2047915.64"
"2025-02-04","2025-02-01","SF FuneralF795530       250201","","126.5","","2048042.14"
"2025-02-04","2025-02-01","SF FuneralFDC00000007WJM250201","","126.5","","2048168.64"
"2025-02-04","2025-02-01","SF FuneralFDC00000007X0L250201","","126.5","","2048295.14"
"2025-02-04","2025-02-01","SF FuneralFDC00000007X32250201","","126.5","","2048421.64"
"2025-02-04","2025-02-01","SF FuneralFDC00000007XG1250201","","126.5","","2048548.14"
"2025-02-04","2025-02-01","SF FuneralFDC00000007XYM250201","","126.5","","2048674.64"
"2025-02-04","2025-02-01","SF FuneralFDC00000007YQ6250201","","126.5","","2048801.14"
"2025-02-04","2025-02-01","SF FuneralFDC00000007YR1250201","","126.5","","2048927.64"
"2025-02-04","2025-02-01","SF FuneralFDC00000007Z6H250201","","126.5","","2049054.14"
"2025-02-04","2025-02-01","SF FuneralFDC000000080NF250201","","126.5","","2049180.64"
"2025-02-04","2025-02-01","SF FuneralF798048       250201","","126.5","","2049307.14"
"2025-02-04","2025-02-01","SF FuneralF798093       250201","","126.5","","2049433.64"
"2025-02-04","2025-02-01","SF FuneralF798104       250201","","126.5","","2049560.14"
"2025-02-04","2025-02-01","SF FuneralF798108       250201","","126.5","","2049686.64"
"2025-02-04","2025-02-01","SF FuneralFDC000000084D0250201","","126.5","","2049813.14"
"2025-02-04","2025-02-01","SF FuneralF798355       250201","","126.5","","2049939.64"
"2025-02-04","2025-02-01","SF FuneralFDC000000084P7250201","","126.5","","2050066.14"
"2025-02-04","2025-02-01","SF FuneralFDC000000085FB250201","","126.5","","2050192.64"
"2025-02-04","2025-02-01","SF FuneralFDC000000085FJ250201","","126.5","","2050319.14"
"2025-02-04","2025-02-01","SF FuneralFDC000000085V2250201","","126.5","","2050445.64"
"2025-02-04","2025-02-01","SF FuneralFDC000000085V6250201","","126.5","","2050572.14"
"2025-02-04","2025-02-01","SF FuneralF798762       250201","","126.5","","2050698.64"
"2025-02-04","2025-02-01","SF FuneralF798822       250201","","126.5","","2050825.14"
"2025-02-04","2025-02-01","SF FuneralF798946       250201","","126.5","","2050951.64"
"2025-02-04","2025-02-01","SF FuneralF799397       250201","","126.5","","2051078.14"
"2025-02-04","2025-02-01","SF FuneralFDC000000087RN250201","","126.5","","2051204.64"
"2025-02-04","2025-02-01","SF FuneralF800526       250201","","126.5","","2051331.14"
"2025-02-04","2025-02-01","SF FuneralF800588       250201","","126.5","","2051457.64"
"2025-02-04","2025-02-01","SF FuneralFDC00000008FQ3250201","","126.5","","2051584.14"
"2025-02-04","2025-02-01","SF FuneralF802576       250201","","126.5","","2051710.64"
"2025-02-04","2025-02-01","SF FuneralF802594       250201","","126.5","","2051837.14"
"2025-02-04","2025-02-01","SF FuneralF802705       250201","","126.5","","2051963.64"
"2025-02-04","2025-02-01","SF FuneralF802708       250201","","126.5","","2052090.14"
"2025-02-04","2025-02-01","SF FuneralF802764       250201","","126.5","","2052216.64"
"2025-02-04","2025-02-01","SF FuneralFDC00000008LKC250201","","126.5","","2052343.14"
"2025-02-04","2025-02-01","SF FuneralF802922       250201","","126.5","","2052469.64"
"2025-02-04","2025-02-01","SF FuneralF802972       250201","","126.5","","2052596.14"
"2025-02-04","2025-02-01","SF FuneralFDC00000008LQJ250201","","126.5","","2052722.64"
"2025-02-04","2025-02-01","SF FuneralF803756       250201","","126.5","","2052849.14"
"2025-02-04","2025-02-01","SF FuneralF804109       250201","","126.5","","2052975.64"
"2025-02-04","2025-02-01","SF FuneralF805513       250201","","126.5","","2053102.14"
"2025-02-04","2025-02-01","SF FuneralF805652       250201","","126.5","","2053228.64"
"2025-02-04","2025-02-01","SF FuneralF808004       250201","","126.5","","2053355.14"
"2025-02-04","2025-02-01","SF FuneralF808175       250201","","126.5","","2053481.64"
"2025-02-04","2025-02-01","SF FuneralF808434       250201","","126.5","","2053608.14"
"2025-02-04","2025-02-01","SF FuneralF808573       250201","","126.5","","2053734.64"
"2025-02-04","2025-02-01","SF FuneralF808636       250201","","126.5","","2053861.14"
"2025-02-04","2025-02-01","SF FuneralF808835       250201","","126.5","","2053987.64"
"2025-02-04","2025-02-01","SF FuneralF809339       250201","","126.5","","2054114.14"
"2025-02-04","2025-02-01","SF FuneralF809768       250201","","126.5","","2054240.64"
"2025-02-04","2025-02-01","SF FuneralF810209       250201","","126.5","","2054367.14"
"2025-02-04","2025-02-01","SF FuneralF810741       250201","","126.5","","2054493.64"
"2025-02-04","2025-02-01","SF FuneralF810856       250201","","126.5","","2054620.14"
"2025-02-04","2025-02-01","SF FuneralF811040       250201","","126.5","","2054746.64"
"2025-02-04","2025-02-01","SF FuneralF787192       250201","","126.5","","2054873.14"
"2025-02-04","2025-02-01","SF FuneralF811267       250201","","126.5","","2054999.64"
"2025-02-04","2025-02-01","SF FuneralF811381       250201","","126.5","","2055126.14"
"2025-02-04","2025-02-01","SF FuneralF812251       250201","","126.5","","2055252.64"
"2025-02-04","2025-02-01","SF FuneralF812396       250201","","126.5","","2055379.14"
"2025-02-04","2025-02-01","SF FuneralF812457       250201","","126.5","","2055505.64"
"2025-02-04","2025-02-01","SF FuneralF812489       250201","","126.5","","2055632.14"
"2025-02-04","2025-02-01","SF FuneralF812542       250201","","126.5","","2055758.64"
"2025-02-04","2025-02-01","SF FuneralF812561       250201","","126.5","","2055885.14"
"2025-02-04","2025-02-01","SF FuneralF812611       250201","","126.5","","2056011.64"
"2025-02-04","2025-02-01","SF FuneralF812727       250201","","126.5","","2056138.14"
"2025-02-04","2025-02-01","SF FuneralF813305       250201","","126.5","","2056264.64"
"2025-02-04","2025-02-01","SF FuneralF813440       250201","","126.5","","2056391.14"
"2025-02-04","2025-02-01","SF FuneralF813919       250201","","126.5","","2056517.64"
"2025-02-04","2025-02-01","SF FuneralF815659       250201","","126.5","","2056644.14"
"2025-02-04","2025-02-01","SF FuneralF816419       250201","","126.5","","2056770.64"
"2025-02-04","2025-02-01","SF FuneralF816640       250201","","126.5","","2056897.14"
"2025-02-04","2025-02-01","SF FuneralF781116       250201","","126.5","","2057023.64"
"2025-02-04","2025-02-01","SF FuneralF816769       250201","","126.5","","2057150.14"
"2025-02-04","2025-02-01","SF FuneralF816785       250201","","126.5","","2057276.64"
"2025-02-04","2025-02-01","SF FuneralF816792       250201","","126.5","","2057403.14"
"2025-02-04","2025-02-01","SF FuneralF816950       250201","","126.5","","2057529.64"
"2025-02-04","2025-02-01","SF FuneralF812236       250201","","126.5","","2057656.14"
"2025-02-04","2025-02-01","SF FuneralF817148       250201","","126.5","","2057782.64"
"2025-02-04","2025-02-01","SF FuneralF817187       250201","","126.5","","2057909.14"
"2025-02-04","2025-02-01","SF FuneralF817211       250201","","126.5","","2058035.64"
"2025-02-04","2025-02-01","SF FuneralF817221       250201","","126.5","","2058162.14"
"2025-02-04","2025-02-01","SF FuneralF817464       250201","","126.5","","2058288.64"
"2025-02-04","2025-02-01","SF FuneralF817561       250201","","126.5","","2058415.14"
"2025-02-04","2025-02-01","SF FuneralF819163       250201","","126.5","","2058541.64"
"2025-02-04","2025-02-01","SF FuneralF819728       250201","","126.5","","2058668.14"
"2025-02-04","2025-02-01","SF FuneralF820640       250201","","126.5","","2058794.64"
"2025-02-04","2025-02-01","SF FuneralF820656       250201","","126.5","","2058921.14"
"2025-02-04","2025-02-01","SF FuneralF820738       250201","","126.5","","2059047.64"
"2025-02-04","2025-02-01","SF FuneralF820779       250201","","126.5","","2059174.14"
"2025-02-04","2025-02-01","SF FuneralF820843       250201","","126.5","","2059300.64"
"2025-02-04","2025-02-01","SF FuneralF821016       250201","","126.5","","2059427.14"
"2025-02-04","2025-02-01","SF FuneralF821074       250201","","126.5","","2059553.64"
"2025-02-04","2025-02-01","SF FuneralF821128       250201","","126.5","","2059680.14"
"2025-02-04","2025-02-01","SF FuneralFDC0000000B9N7250201","","126.5","","2059806.64"
"2025-02-04","2025-02-01","SF FuneralFDC0000000BB12250201","","126.5","","2059933.14"
"2025-02-04","2025-02-01","SF FuneralF821519       250201","","126.5","","2060059.64"
"2025-02-04","2025-02-01","SF FuneralF821625       250201","","126.5","","2060186.14"
"2025-02-04","2025-02-01","SF FuneralF821989       250201","","126.5","","2060312.64"
"2025-02-04","2025-02-01","SF FuneralF822137       250201","","126.5","","2060439.14"
"2025-02-04","2025-02-01","SF FuneralF822290       250201","","126.5","","2060565.64"
"2025-02-04","2025-02-01","SF FuneralF823427       250201","","126.5","","2060692.14"
"2025-02-04","2025-02-01","SF FuneralF828080       250201","","126.5","","2060818.64"
"2025-02-04","2025-02-01","SF FuneralFDC0000000BP12250201","","126.5","","2060945.14"
"2025-02-04","2025-02-01","SF FuneralF828192       250201","","126.5","","2061071.64"
"2025-02-04","2025-02-01","SF FuneralF828220       250201","","126.5","","2061198.14"
"2025-02-04","2025-02-01","SF FuneralF828390       250201","","126.5","","2061324.64"
"2025-02-04","2025-02-01","SF FuneralF828423       250201","","126.5","","2061451.14"
"2025-02-04","2025-02-01","SF FuneralF821326       250201","","126.5","","2061577.64"
"2025-02-04","2025-02-01","SF FuneralF828470       250201","","126.5","","2061704.14"
"2025-02-04","2025-02-01","SF FuneralF828491       250201","","126.5","","2061830.64"
"2025-02-04","2025-02-01","SF FuneralF828720       250201","","126.5","","2061957.14"
"2025-02-04","2025-02-01","SF FuneralF829645       250201","","126.5","","2062083.64"
"2025-02-04","2025-02-01","SF FuneralF829748       250201","","126.5","","2062210.14"
"2025-02-04","2025-02-01","SF FuneralF830040       250201","","126.5","","2062336.64"
"2025-02-04","2025-02-01","SF FuneralF830077       250201","","126.5","","2062463.14"
"2025-02-04","2025-02-01","SF FuneralF830735       250201","","126.5","","2062589.64"
"2025-02-04","2025-02-01","SF FuneralF832126       250201","","126.5","","2062716.14"
"2025-02-04","2025-02-01","SF FuneralF832278       250201","","126.5","","2062842.64"
"2025-02-04","2025-02-01","SF FuneralF832311       250201","","126.5","","2062969.14"
"2025-02-04","2025-02-01","SF FuneralF832315       250201","","126.5","","2063095.64"
"2025-02-04","2025-02-01","SF FuneralF832385       250201","","191.5","","2063287.14"
"2025-02-04","2025-02-01","SF FuneralF832396       250201","","126.5","","2063413.64"
"2025-02-04","2025-02-01","SF FuneralF832442       250201","","126.5","","2063540.14"
"2025-02-04","2025-02-01","SF FuneralF832464       250201","","126.5","","2063666.64"
"2025-02-04","2025-02-01","SF FuneralF832496       250201","","126.5","","2063793.14"
"2025-02-04","2025-02-01","SF FuneralF832624       250201","","126.5","","2063919.64"
"2025-02-04","2025-02-01","SF FuneralF832702       250201","","126.5","","2064046.14"
"2025-02-04","2025-02-01","SF FuneralFDC0000000CQVZ250201","","126.5","","2064172.64"
"2025-02-04","2025-02-01","SF FuneralF833547       250201","","126.5","","2064299.14"
"2025-02-04","2025-02-01","SF FuneralF833759       250201","","126.5","","2064425.64"
"2025-02-04","2025-02-01","SF FuneralF834234       250201","","126.5","","2064552.14"
"2025-02-04","2025-02-01","SF FuneralF834771       250201","","126.5","","2064678.64"
"2025-02-04","2025-02-01","SF FuneralF838797       250201","","126.5","","2064805.14"
"2025-02-04","2025-02-01","SF FuneralF841568       250201","","126.5","","2064931.64"
"2025-02-04","2025-02-01","SF FuneralF841807       250201","","126.5","","2065058.14"
"2025-02-04","2025-02-01","SF FuneralF841861       250201","","126.5","","2065184.64"
"2025-02-04","2025-02-01","SF FuneralF842263       250201","","126.5","","2065311.14"
"2025-02-04","2025-02-01","SF FuneralF842506       250201","","126.5","","2065437.64"
"2025-02-04","2025-02-01","SF FuneralF842551       250201","","126.5","","2065564.14"
"2025-02-04","2025-02-01","SF FuneralF992240       250201","","126.5","","2065690.64"
"2025-02-04","2025-02-01","SF FuneralF992461       250201","","126.5","","2065817.14"
"2025-02-04","2025-02-01","SF FuneralF992611       250201","","126.5","","2065943.64"
"2025-02-04","2025-02-01","SF FuneralF992766       250201","","126.5","","2066070.14"
"2025-02-04","2025-02-01","SF FuneralF992808       250201","","126.5","","2066196.64"
"2025-02-04","2025-02-01","SF FuneralF789986       250201","","191.5","","2066388.14"
"2025-02-04","2025-02-01","SF FuneralF993067       250201","","126.5","","2066514.64"
"2025-02-04","2025-02-01","SF FuneralF993091       250201","","126.5","","2066641.14"
"2025-02-04","2025-02-01","SF FuneralF993547       250201","","126.5","","2066767.64"
"2025-02-04","2025-02-01","SF FuneralF993612       250202","","126.5","","2066894.14"
"2025-02-04","2025-02-01","SF FuneralF1010506      250201","","126.5","","2067020.64"
"2025-02-04","2025-02-01","SF FuneralF1017563      250201","","126.5","","2067147.14"
"2025-02-04","2025-02-01","SF FuneralFDC0000000JMST250201","","126.5","","2067273.64"
"2025-02-04","2025-02-01","SF FuneralF1021700      250201","","126.5","","2067400.14"
"2025-02-04","2025-02-01","SF FuneralF1021513      250201","","126.5","","2067526.64"
"2025-02-04","2025-02-01","SF FuneralF1021976      250201","","126.5","","2067653.14"
"2025-02-04","2025-02-01","SF FuneralF789313       250201","","126.5","","2067779.64"
"2025-02-04","2025-02-01","SF FuneralF1022155      250201","","126.5","","2067906.14"
"2025-02-04","2025-02-01","SF FuneralF1022195      250201","","126.5","","2068032.64"
"2025-02-04","2025-02-01","SF FuneralF1022213      250201","","126.5","","2068159.14"
"2025-02-04","2025-02-01","SF FuneralF1051771      250201","","126.5","","2068285.64"
"2025-02-04","2025-02-01","SF FuneralF1055255      250201","","126.5","","2068412.14"
"2025-02-04","2025-02-01","SF FuneralF1058646      250201","","126.5","","2068538.64"
"2025-02-04","2025-02-01","SF FuneralF1058674      250201","","126.5","","2068665.14"
"2025-02-04","2025-02-01","SF FuneralF1058695      250201","","126.5","","2068791.64"
"2025-02-04","2025-02-01","SF FuneralF1058844      250201","","126.5","","2068918.14"
"2025-02-04","2025-02-01","SF FuneralF1058870      250201","","126.5","","2069044.64"
"2025-02-04","2025-02-01","SF FuneralF1059828      250201","","126.5","","2069171.14"
"2025-02-04","2025-02-01","SF FuneralF1060324      250201","","126.5","","2069297.64"
"2025-02-04","2025-02-01","SF FuneralFDC0000000KH1N250201","","126.5","","2069424.14"
"2025-02-04","2025-02-01","SF FuneralF1060790      250201","","126.5","","2069550.64"
"2025-02-04","2025-02-01","SF FuneralF1060786      250201","","126.5","","2069677.14"
"2025-02-04","2025-02-01","SF FuneralF1060908      250201","","126.5","","2069803.64"
"2025-02-04","2025-02-01","SF FuneralF1060911      250201","","126.5","","2069930.14"
"2025-02-04","2025-02-01","SF FuneralF1061807      250201","","126.5","","2070056.64"
"2025-02-04","2025-02-01","SF FuneralF1061829      250201","","126.5","","2070183.14"
"2025-02-04","2025-02-01","SF FuneralF1066132      250201","","126.5","","2070309.64"
"2025-02-04","2025-02-01","SF FuneralF1066198      250201","","126.5","","2070436.14"
"2025-02-04","2025-02-01","SF FuneralF1066514      250201","","126.5","","2070562.64"
"2025-02-04","2025-02-01","SF FuneralF1066626      250201","","126.5","","2070689.14"
"2025-02-04","2025-02-01","SF FuneralF1066744      250201","","126.5","","2070815.64"
"2025-02-04","2025-02-01","SF FuneralF1066752      250201","","126.5","","2070942.14"
"2025-02-04","2025-02-01","SF FuneralF1067886      250201","","126.5","","2071068.64"
"2025-02-04","2025-02-01","SF FuneralF1068040      250201","","126.5","","2071195.14"
"2025-02-04","2025-02-01","SF FuneralF1068098      250201","","126.5","","2071321.64"
"2025-02-04","2025-02-01","SF FuneralFDC0000000L010250201","","126.5","","2071448.14"
"2025-02-04","2025-02-01","SF FuneralF1072712      250201","","126.5","","2071574.64"
"2025-02-04","2025-02-01","SF FuneralF1073223      250201","","126.5","","2071701.14"
"2025-02-04","2025-02-01","SF FuneralF1073364      250201","","126.5","","2071827.64"
"2025-02-04","2025-02-01","SF FuneralF1075044      250201","","126.5","","2071954.14"
"2025-02-04","2025-02-01","SF FuneralF1075231      250201","","126.5","","2072080.64"
"2025-02-04","2025-02-01","SF FuneralF1075269      250201","","126.5","","2072207.14"
"2025-02-04","2025-02-01","SF FuneralF1075321      250201","","126.5","","2072333.64"
"2025-02-04","2025-02-01","SF FuneralF1078231      250201","","126.5","","2072460.14"
"2025-02-04","2025-02-01","SF FuneralF1078569      250201","","126.5","","2072586.64"
"2025-02-04","2025-02-01","SF FuneralF1078661      250201","","126.5","","2072713.14"
"2025-02-04","2025-02-01","SF FuneralF1079116      250201","","126.5","","2072839.64"
"2025-02-04","2025-02-01","SF FuneralF1080163      250201","","126.5","","2072966.14"
"2025-02-04","2025-02-01","SF FuneralF1084025      250201","","126.5","","2073092.64"
"2025-02-04","2025-02-01","SF FuneralF1084373      250201","","126.5","","2073219.14"
"2025-02-04","2025-02-01","SF FuneralF1084430      250201","","126.5","","2073345.64"
"2025-02-04","2025-02-01","SF FuneralF1084589      250201","","126.5","","2073472.14"
"2025-02-04","2025-02-01","SF FuneralF1085038      250201","","126.5","","2073598.64"
"2025-02-04","2025-02-01","SF FuneralF1085049      250201","","126.5","","2073725.14"
"2025-02-04","2025-02-01","SF FuneralF1085190      250201","","126.5","","2073851.64"
"2025-02-04","2025-02-01","SF FuneralF1088482      250201","","126.5","","2073978.14"
"2025-02-04","2025-02-01","SF FuneralF1103560      250201","","126.5","","2074104.64"
"2025-02-04","2025-02-01","SF FuneralF1103740      250201","","126.5","","2074231.14"
"2025-02-04","2025-02-01","SF FuneralF1103836      250201","","126.5","","2074357.64"
"2025-02-04","2025-02-01","SF FuneralF1108314      250201","","126.5","","2074484.14"
"2025-02-04","2025-02-01","SF FuneralF1108998      250201","","126.5","","2074610.64"
"2025-02-04","2025-02-01","SF FuneralF1109027      250201","","126.5","","2074737.14"
"2025-02-04","2025-02-01","SF FuneralF1109091      250201","","126.5","","2074863.64"
"2025-02-04","2025-02-01","SF FuneralF1109141      250201","","126.5","","2074990.14"
"2025-02-04","2025-02-01","SF FuneralF1109688      250201","","126.5","","2075116.64"
"2025-02-04","2025-02-01","SF FuneralF1109845      250201","","126.5","","2075243.14"
"2025-02-04","2025-02-01","SF FuneralF1110173      250201","","126.5","","2075369.64"
"2025-02-04","2025-02-01","SF FuneralF1110402      250201","","126.5","","2075496.14"
"2025-02-04","2025-02-01","SF FuneralF1110464      250201","","126.5","","2075622.64"
"2025-02-04","2025-02-01","SF FuneralF1110704      250201","","126.5","","2075749.14"
"2025-02-04","2025-02-01","SF FuneralF1111530      250201","","126.5","","2075875.64"
"2025-02-04","2025-02-01","SF FuneralF1113215      250201","","126.5","","2076002.14"
"2025-02-04","2025-02-01","SF FuneralF1113318      250201","","126.5","","2076128.64"
"2025-02-04","2025-02-01","SF FuneralF1113325      250201","","126.5","","2076255.14"
"2025-02-04","2025-02-01","SF FuneralF1113645      250201","","126.5","","2076381.64"
"2025-02-04","2025-02-01","SF FuneralF1113731      250202","","126.5","","2076508.14"
"2025-02-04","2025-02-01","SF FuneralF1113795      250201","","126.5","","2076634.64"
"2025-02-04","2025-02-01","SF FuneralF1113908      250201","","126.5","","2076761.14"
"2025-02-04","2025-02-01","SF FuneralF1114612      250201","","126.5","","2076887.64"
"2025-02-04","2025-02-01","SF FuneralF1115110      250201","","126.5","","2077014.14"
"2025-02-04","2025-02-01","SF FuneralF1115751      250201","","126.5","","2077140.64"
"2025-02-04","2025-02-01","SF FuneralF1115860      250201","","126.5","","2077267.14"
"2025-02-04","2025-02-01","SF FuneralF1115954      250201","","126.5","","2077393.64"
"2025-02-04","2025-02-01","SF FuneralF1116946      250201","","126.5","","2077520.14"
"2025-02-04","2025-02-01","SF FuneralF1116998      250201","","126.5","","2077646.64"
"2025-02-04","2025-02-01","SF FuneralF1117190      250201","","126.5","","2077773.14"
"2025-02-04","2025-02-01","SF FuneralF1117675      250201","","126.5","","2077899.64"
"2025-02-04","2025-02-01","SF FuneralF808468       250201","","126.5","","2078026.14"
"2025-02-04","2025-02-01","SF FuneralF1120687      250201","","126.5","","2078152.64"
"2025-02-04","2025-02-01","SF FuneralF1120834      250201","","126.5","","2078279.14"
"2025-02-04","2025-02-01","SF FuneralF1121935      250201","","126.5","","2078405.64"
"2025-02-04","2025-02-01","SF FuneralF1121934      250201","","126.5","","2078532.14"
"2025-02-04","2025-02-01","SF FuneralF1122013      250201","","126.5","","2078658.64"
"2025-02-04","2025-02-01","SF FuneralF1122226      250201","","126.5","","2078785.14"
"2025-02-04","2025-02-01","SF FuneralF1122572      250201","","126.5","","2078911.64"
"2025-02-04","2025-02-01","SF FuneralF1122657      250201","","126.5","","2079038.14"
"2025-02-04","2025-02-01","SF FuneralF1122659      250201","","126.5","","2079164.64"
"2025-02-04","2025-02-01","SF FuneralF1122722      250201","","126.5","","2079291.14"
"2025-02-04","2025-02-01","SF FuneralF1122939      250201","","126.5","","2079417.64"
"2025-02-04","2025-02-01","SF FuneralF1123067      250201","","126.5","","2079544.14"
"2025-02-04","2025-02-01","SF FuneralFDC0000000P3HW250201","","126.5","","2079670.64"
"2025-02-04","2025-02-01","SF FuneralF1123155      250201","","126.5","","2079797.14"
"2025-02-04","2025-02-01","SF FuneralF1124350      250201","","126.5","","2079923.64"
"2025-02-04","2025-02-01","SF FuneralF1124612      250201","","126.5","","2080050.14"
"2025-02-04","2025-02-01","SF FuneralF1125451      250201","","126.5","","2080176.64"
"2025-02-04","2025-02-01","SF FuneralFDC0000000PH4Y250201","","126.5","","2080303.14"
"2025-02-04","2025-02-01","SF FuneralF1125511      250201","","126.5","","2080429.64"
"2025-02-04","2025-02-01","SF FuneralFDC0000000PHWV250201","","126.5","","2080556.14"
"2025-02-04","2025-02-01","SF FuneralF1125795      250201","","126.5","","2080682.64"
"2025-02-04","2025-02-01","SF FuneralF1125950      250201","","126.5","","2080809.14"
"2025-02-04","2025-02-01","SF FuneralFDC0000000PJS4250201","","126.5","","2080935.64"
"2025-02-04","2025-02-01","SF FuneralF988463       250201","","126.5","","2081062.14"
"2025-02-04","2025-02-01","SF FuneralF1127344      250201","","126.5","","2081188.64"
"2025-02-04","2025-02-01","SF FuneralF1127894      250201","","126.5","","2081315.14"
"2025-02-04","2025-02-01","SF FuneralF1127916      250201","","126.5","","2081441.64"
"2025-02-04","2025-02-01","SF FuneralF1128169      250201","","126.5","","2081568.14"
"2025-02-04","2025-02-01","SF FuneralF1128326      250201","","126.5","","2081694.64"
"2025-02-04","2025-02-01","SF FuneralF1128969      250201","","126.5","","2081821.14"
"2025-02-04","2025-02-01","SF FuneralF1129092      250201","","126.5","","2081947.64"
"2025-02-04","2025-02-01","SF FuneralF1129154      250201","","126.5","","2082074.14"
"2025-02-04","2025-02-01","SF FuneralF1129219      250201","","126.5","","2082200.64"
"2025-02-04","2025-02-01","SF FuneralFDC0000000PYZT250201","","126.5","","2082327.14"
"2025-02-04","2025-02-01","SF FuneralF1129445      250201","","126.5","","2082453.64"
"2025-02-04","2025-01-31","SF FuneralFDC0000000HGD3250201","","126.5","","2082580.14"
"2025-02-04","2025-02-01","SF FuneralFDC0000000NM53250201","","126.5","","2082706.64"
"2025-02-04","2025-02-01","SF FuneralFDC0000000PKF7250201","","126.5","","2082833.14"
"2025-02-04","2025-01-31","Rev SF FuneralFDC00000008BHF250131","","-126.5","","2082706.64"
"2025-02-04","2025-01-24","Rev SF FuneralFDC0000000PRPN250125","","-126.5","","2082580.14"
"2025-02-04","2025-01-24","Rev SF FuneralFDC0000000768V250128","","-126.5","","2082453.64"
"2025-02-04","2025-02-01","Rev SF FuneralFDC00000007HBC250201","","-126.5","","2082327.14"
"2025-02-04","2025-02-03","Rev SF FuneralFDC0000000BDNZ250203","","-126.5","","2082200.64"
"2025-02-04","2025-01-24","Rev SF FuneralFDC00000007191250128","","-126.5","","2082074.14"
"2025-02-04","2025-02-01","Rev SF FuneralFDC00000005LZ0250201","","-126.5","","2081947.64"
"2025-02-04","2025-02-01","Rev SF FuneralFDC00000005LZC250201","","-126.5","","2081821.14"
"2025-02-04","2025-01-24","Rev SF FuneralFDC0000000N3SL250128","","-126.5","","2081694.64"
"2025-02-04","2025-01-24","Rev SF FuneralFDC00000006R8Z250128","","-126.5","","2081568.14"
"2025-02-04","2025-02-03","SF FuneralF815501       250203","","63.25","","2081631.39"
"2025-02-04","2025-01-27","SF FuneralF827664       250127","","63.25","","2081694.64"
"2025-02-04","2025-02-01","SF FuneralFDC000000069G3250201","","126.5","","2081821.14"
"2025-02-04","2025-02-01","SF FuneralF1073205      250201","","126.5","","2081947.64"
"2025-02-04","2025-01-31","SF FuneralFDC00000006YWV250131","","63.25","","2082010.89"
"2025-02-04","2025-02-01","SF FuneralFDC00000005MQW250201","","126.5","","2082137.39"
"2025-02-04","2025-02-01","SF FuneralF821521       250201","","126.5","","2082263.89"
"2025-02-04","2025-02-01","SF FuneralF992967       250201","","126.5","","2082390.39"
"2025-02-04","2025-02-03","SF FuneralFDC0000000376D250203","","55","","2082445.39"
"2025-02-04","2025-02-03","SF FuneralFDC000000050LF250202","","220","","2082665.39"
"2025-02-04","2025-02-03","SF FuneralF1017652      250203","","126.5","","2082791.89"
"2025-02-04","2025-02-04","SF FuneralF816436       250204","","31.63","","2082823.52"
"2025-02-04","2025-02-04","SF FuneralF1130733      250204","","31.63","","2082855.15"
"2025-02-04","2025-01-31","SF FuneralF1125946      250131","","126.5","","2082981.65"
"2025-02-04","2025-01-31","Rev SF FuneralFDC0000000HCQR250201","","-126.5","","2082855.15"
"2025-02-04","2025-02-04","SF FuneralF1078281      250204","","63.25","","2082918.4"
"2025-02-04","2025-02-03","SF FuneralF1079187      250203","","126.5","","2083044.9"
"2025-02-04","2025-01-31","SF FuneralF989084       250201","","126.5","","2083171.4"
"2025-02-04","2025-02-01","SF FuneralFDC000000067LB250201","","126.5","","2083297.9"
"2025-02-04","2025-02-01","SF FuneralF812978       250201","","126.5","","2083424.4"
"2025-02-04","2025-02-01","SF FuneralF1128065      250201","","126.5","","2083550.9"
"2025-02-04","2025-02-04","SF FuneralF829691       250204","","126.5","","2083677.4"
"2025-02-04","2025-02-04","SF FuneralF1080249      250204","","31.63","","2083709.03"
"2025-02-04","2025-01-31","SF FuneralFDC0000000HFLZ250201","","126.5","","2083835.53"
"2025-02-04","2025-01-31","SF FuneralF981551       250201","","126.5","","2083962.03"
"2025-02-04","2025-02-01","SF FuneralFDC0000000NLY9250201","","31.63","","2083993.66"
"2025-02-04","2025-02-01","SF FuneralF1117993      250201","","31.63","","2084025.29"
"2025-02-04","2025-01-29","SF FuneralF1060979      250129","","126.5","","2084151.79"
"2025-02-04","2025-02-01","SF FuneralFDC000000033XY250201","","220","","2084371.79"
"2025-02-04","2025-02-01","SF FuneralF1066409      250201","","126.5","","2084498.29"
"2025-02-04","2025-02-01","SF FuneralF1109841      250201","","126.5","","2084624.79"
"2025-02-04","2025-02-01","SF FuneralF1123126      250201","","31.63","","2084656.42"
"2025-02-04","2025-02-03","SF FuneralF804126       250203","","31.63","","2084688.05"
"2025-02-04","2025-02-04","SF FuneralFDC00000005YYS250204","","31.63","","2084719.68"
"2025-02-04","2025-02-04","SF FuneralFDC00000007J73250204","","63.25","","2084782.93"
"2025-02-04","2025-02-04","SF FuneralFDC000000088HM250204","","63.25","","2084846.18"
"2025-02-04","2025-02-04","SF FuneralFDC00000008JVD250204","","31.63","","2084877.81"
"2025-02-04","2025-02-04","SF FuneralF808707       250204","","31.63","","2084909.44"
"2025-02-04","2025-02-04","SF FuneralF809863       250204","","126.5","","2085035.94"
"2025-02-04","2025-02-04","SF FuneralF820828       250204","","63.25","","2085099.19"
"2025-02-04","2025-02-04","SF FuneralF987241       250204","","31.63","","2085130.82"
"2025-02-04","2025-02-04","SF FuneralFDC0000000NL0D250204","","63.25","","2085194.07"
"2025-02-04","2025-02-03","Rev SF FuneralFDC00000007MVX250203","","-126.5","","2085067.57"
"2025-02-04","2025-02-01","Rev SF FuneralFDC00000009WGZ250201","","-126.5","","2084941.07"
"2025-02-04","2025-02-01","Rev SF FuneralFDC00000006M99250201","","-126.5","","2084814.57"
"2025-02-04","2025-02-01","Rev SF FuneralFDC0000000D0HF250201","","-126.5","","2084688.07"
"2025-02-04","2025-01-17","Rev SF FuneralFDC00000005ZMX250117","","-126.5","","2084561.57"
"2025-02-04","2025-01-17","Rev SF FuneralFDC00000005ZN9250117","","-126.5","","2084435.07"
"2025-02-04","2025-02-04","Rev SF FuneralFDC0000000HN9N250204","","-31.63","","2084403.44"
"2025-02-04","2025-01-28","Rev SF FuneralFDC0000000HN9N250128","","-31.63","","2084371.81"
"2025-02-04","2025-02-04","Rev SF FuneralFDC000000088HM250204","","-63.25","","2084308.56"
"2025-02-04","2025-01-27","Rev SF FuneralFDC0000000NB2N250127","","-126.5","","2084182.06"
"2025-02-04","2025-02-01","Rev SF FuneralFDC0000000K902250201","","-126.5","","2084055.56"
"2025-02-04","2024-12-31","Rev SF FuneralFDC0000000K902250101","","-126.5","","2083929.06"
"2025-02-04","2025-01-24","Rev SF FuneralF1115169      250128","","-126.5","","2083802.56"
"2025-02-04","2025-01-31","SF FuneralF901526       250201","","126.5","","2083929.06"
"2025-02-04","2025-02-03","SF FuneralF1126202      250203","","126.5","","2084055.56"
"2025-02-04","2025-01-30","SF FuneralF1084933      250130","","126.5","","2084182.06"
"2025-02-04","2025-02-01","SF FuneralF1080486      250201","","126.5","","2084308.56"
"2025-02-04","2025-02-03","SF FuneralFDC000000042HH250202","","55","","2084363.56"
"2025-02-04","2025-02-01","SF FuneralF1129269      250201","","126.5","","2084490.06"
"2025-02-04","2025-02-01","SF FuneralF810830       250201","","126.5","","2084616.56"
"2025-02-04","2025-02-01","SF FuneralFDC0000000PQSL250201","","126.5","","2084743.06"
"2025-02-04","2025-02-04","EFT-EFT DEBIT TRANSFERS 061051","","53942","","2138685.06"
"2025-02-04","2025-02-04","Fee-ACB Debit Order","","-19.5","","2138665.56"
"2025-02-04","2025-02-04","EFTNP-NUPAY  33560/250203","","-98059.01","19.5","2040606.55"
"2025-02-05","2025-01-27","SF FuneralFDC00000007SM6250127","","126.5","","2040733.05"
"2025-02-05","2025-01-28","SF FuneralFDC0000000341Z250128","","220","","2040953.05"
"2025-02-05","2025-01-29","SF FuneralFDC00000005XML250129","","126.5","","2041079.55"
"2025-02-05","2025-01-29","SF FuneralFDC00000007857250129","","126.5","","2041206.05"
"2025-02-05","2025-01-29","SF FuneralFDC00000007859250129","","126.5","","2041332.55"
"2025-02-05","2025-01-29","SF FuneralF832889       250129","","126.5","","2041459.05"
"2025-02-05","2025-01-29","SF FuneralF817468       250129","","126.5","","2041585.55"
"2025-02-05","2025-01-30","SF FuneralFDC0000000338L250130","","220","","2041805.55"
"2025-02-05","2025-01-30","SF FuneralF817546       250130","","126.5","","2041932.05"
"2025-02-05","2025-01-30","SF FuneralFDC0000000DXTJ250130","","126.5","","2042058.55"
"2025-02-05","2025-01-30","SF FuneralF980439       250130","","126.5","","2042185.05"
"2025-02-05","2025-02-03","SF FuneralFDC000000078NY250202","","126.5","","2042311.55"
"2025-02-05","2025-02-03","SF FuneralF812941       250202","","126.5","","2042438.05"
"2025-02-05","2025-02-03","SF FuneralF813154       250203","","126.5","","2042564.55"
"2025-02-05","2025-02-03","SF FuneralF843049       250201","","126.5","","2042691.05"
"2025-02-05","2025-02-03","SF FuneralF844172       250201","","126.5","","2042817.55"
"2025-02-05","2025-02-03","SF FuneralF1115794      250203","","31.63","","2042849.18"
"2025-02-05","2025-01-31","SF FuneralFDC00000006B89250131","","126.5","","2042975.68"
"2025-02-05","2025-01-31","SF FuneralF987695       250201","","126.5","","2043102.18"
"2025-02-05","2025-01-31","SF FuneralF987762       250201","","126.5","","2043228.68"
"2025-02-05","2025-01-31","SF FuneralF987843       250201","","126.5","","2043355.18"
"2025-02-05","2025-01-31","SF FuneralF987890       250201","","126.5","","2043481.68"
"2025-02-05","2025-01-31","SF FuneralF988467       250201","","126.5","","2043608.18"
"2025-02-05","2025-02-01","SF FuneralFDC00000005N57250201","","126.5","","2043734.68"
"2025-02-05","2025-02-01","SF FuneralFDC00000005RSX250201","","220","","2043954.68"
"2025-02-05","2025-02-01","SF FuneralFDC000000069MT250201","","126.5","","2044081.18"
"2025-02-05","2025-02-01","SF FuneralFDC00000006GK2250201","","126.5","","2044207.68"
"2025-02-05","2025-02-01","SF FuneralFDC00000006H2C250201","","126.5","","2044334.18"
"2025-02-05","2025-02-01","SF FuneralFDC00000006JVF250201","","126.5","","2044460.68"
"2025-02-05","2025-02-01","SF FuneralFDC00000006JVM250201","","126.5","","2044587.18"
"2025-02-05","2025-02-01","SF FuneralFDC00000006KB9250201","","126.5","","2044713.68"
"2025-02-05","2025-02-01","SF FuneralFDC00000006MBT250201","","126.5","","2044840.18"
"2025-02-05","2025-02-01","SF FuneralFDC00000006QQS250201","","126.5","","2044966.68"
"2025-02-05","2025-02-01","SF FuneralFDC00000006XNJ250201","","126.5","","2045093.18"
"2025-02-05","2025-02-01","SF FuneralFDC00000006ZPV250201","","126.5","","2045219.68"
"2025-02-05","2025-02-01","SF FuneralFDC000000072GT250201","","126.5","","2045346.18"
"2025-02-05","2025-02-01","SF FuneralFDC0000000730C250201","","126.5","","2045472.68"
"2025-02-05","2025-02-01","SF FuneralFDC000000074RT250201","","126.5","","2045599.18"
"2025-02-05","2025-02-01","SF FuneralFDC0000000797Y250201","","126.5","","2045725.68"
"2025-02-05","2025-02-01","SF FuneralFDC00000007FCP250201","","126.5","","2045852.18"
"2025-02-05","2025-02-01","SF FuneralFDC00000007H2S250201","","220","","2046072.18"
"2025-02-05","2025-02-01","SF FuneralFDC00000007QBR250201","","126.5","","2046198.68"
"2025-02-05","2025-02-01","SF FuneralFDC00000007QKL250201","","126.5","","2046325.18"
"2025-02-05","2025-02-01","SF FuneralFDC00000007QKS250201","","126.5","","2046451.68"
"2025-02-05","2025-02-01","SF FuneralF793929       250201","","126.5","","2046578.18"
"2025-02-05","2025-02-01","SF FuneralF793935       250201","","126.5","","2046704.68"
"2025-02-05","2025-02-01","SF FuneralFDC00000007R1W250201","","126.5","","2046831.18"
"2025-02-05","2025-02-01","SF FuneralFDC00000007SBL250201","","126.5","","2046957.68"
"2025-02-05","2025-02-01","SF FuneralFDC00000007T9M250201","","126.5","","2047084.18"
"2025-02-05","2025-02-01","SF FuneralFDC00000007YHX250201","","126.5","","2047210.68"
"2025-02-05","2025-02-01","SF FuneralFDC000000084VD250201","","126.5","","2047337.18"
"2025-02-05","2025-02-01","SF FuneralFDC000000085S3250201","","126.5","","2047463.68"
"2025-02-05","2025-02-01","SF FuneralFDC0000000877D250201","","126.5","","2047590.18"
"2025-02-05","2025-02-01","SF FuneralFDC0000000879X250201","","126.5","","2047716.68"
"2025-02-05","2025-02-01","SF FuneralF801891       250201","","126.5","","2047843.18"
"2025-02-05","2025-02-01","SF FuneralF803608       250201","","126.5","","2047969.68"
"2025-02-05","2025-02-01","SF FuneralF808745       250201","","126.5","","2048096.18"
"2025-02-05","2025-02-01","SF FuneralF808769       250201","","126.5","","2048222.68"
"2025-02-05","2025-02-01","SF FuneralF808940       250201","","126.5","","2048349.18"
"2025-02-05","2025-02-01","SF FuneralF808962       250201","","126.5","","2048475.68"
"2025-02-05","2025-02-01","SF FuneralF809000       250201","","126.5","","2048602.18"
"2025-02-05","2025-02-01","SF FuneralF809095       250201","","126.5","","2048728.68"
"2025-02-05","2025-02-01","SF FuneralFDC000000092PD250201","","126.5","","2048855.18"
"2025-02-05","2025-02-01","SF FuneralF809684       250201","","126.5","","2048981.68"
"2025-02-05","2025-02-01","SF FuneralF809959       250201","","126.5","","2049108.18"
"2025-02-05","2025-02-01","SF FuneralF810895       250201","","126.5","","2049234.68"
"2025-02-05","2025-02-01","SF FuneralF812643       250201","","126.5","","2049361.18"
"2025-02-05","2025-02-01","SF FuneralF812690       250201","","126.5","","2049487.68"
"2025-02-05","2025-02-01","SF FuneralF814923       250201","","126.5","","2049614.18"
"2025-02-05","2025-02-01","SF FuneralF816856       250201","","126.5","","2049740.68"
"2025-02-05","2025-02-01","SF FuneralF816929       250201","","126.5","","2049867.18"
"2025-02-05","2025-02-01","SF FuneralF817290       250201","","126.5","","2049993.68"
"2025-02-05","2025-02-01","SF FuneralF817901       250201","","126.5","","2050120.18"
"2025-02-05","2025-02-01","SF FuneralF818895       250201","","126.5","","2050246.68"
"2025-02-05","2025-02-01","SF FuneralF820923       250201","","126.5","","2050373.18"
"2025-02-05","2025-02-01","SF FuneralF821929       250201","","126.5","","2050499.68"
"2025-02-05","2025-02-01","SF FuneralF828382       250201","","126.5","","2050626.18"
"2025-02-05","2025-02-01","SF FuneralF828576       250201","","126.5","","2050752.68"
"2025-02-05","2025-02-01","SF FuneralF829024       250201","","126.5","","2050879.18"
"2025-02-05","2025-02-01","SF FuneralF829650       250201","","126.5","","2051005.68"
"2025-02-05","2025-02-01","SF FuneralF832415       250201","","126.5","","2051132.18"
"2025-02-05","2025-02-01","SF FuneralF832433       250201","","126.5","","2051258.68"
"2025-02-05","2025-02-01","SF FuneralFDC0000000CS5X250201","","126.5","","2051385.18"
"2025-02-05","2025-02-01","SF FuneralF833383       250201","","126.5","","2051511.68"
"2025-02-05","2025-02-01","SF FuneralFDC0000000CXVK250201","","126.5","","2051638.18"
"2025-02-05","2025-02-01","SF FuneralF838810       250201","","126.5","","2051764.68"
"2025-02-05","2025-02-01","SF FuneralF841719       250201","","126.5","","2051891.18"
"2025-02-05","2025-02-01","SF FuneralF842315       250201","","126.5","","2052017.68"
"2025-02-05","2025-02-01","SF FuneralF842584       250201","","126.5","","2052144.18"
"2025-02-05","2025-02-01","SF FuneralFDC0000000F6NW250201","","126.5","","2052270.68"
"2025-02-05","2025-02-01","SF FuneralFDC0000000F6W1250201","","126.5","","2052397.18"
"2025-02-05","2025-02-01","SF FuneralF842589       250201","","126.5","","2052523.68"
"2025-02-05","2025-02-01","SF FuneralF1017101      250201","","126.5","","2052650.18"
"2025-02-05","2025-02-01","SF FuneralF1017732      250201","","126.5","","2052776.68"
"2025-02-05","2025-02-01","SF FuneralF1021702      250201","","126.5","","2052903.18"
"2025-02-05","2025-02-01","SF FuneralF1021708      250201","","126.5","","2053029.68"
"2025-02-05","2025-02-01","SF FuneralF1021774      250201","","126.5","","2053156.18"
"2025-02-05","2025-02-01","SF FuneralF1022122      250201","","126.5","","2053282.68"
"2025-02-05","2025-02-01","SF FuneralF1058856      250202","","126.5","","2053409.18"
"2025-02-05","2025-02-01","SF FuneralF1066262      250201","","126.5","","2053535.68"
"2025-02-05","2025-02-01","SF FuneralF1066434      250201","","126.5","","2053662.18"
"2025-02-05","2025-02-01","SF FuneralF1072880      250201","","126.5","","2053788.68"
"2025-02-05","2025-02-01","SF FuneralF1073239      250201","","126.5","","2053915.18"
"2025-02-05","2025-02-01","SF FuneralF1073802      250201","","126.5","","2054041.68"
"2025-02-05","2025-02-01","SF FuneralF1079121      250201","","126.5","","2054168.18"
"2025-02-05","2025-02-01","SF FuneralF1084953      250201","","126.5","","2054294.68"
"2025-02-05","2025-02-01","SF FuneralF1085024      250201","","126.5","","2054421.18"
"2025-02-05","2025-02-01","SF FuneralF1109001      250201","","126.5","","2054547.68"
"2025-02-05","2025-02-01","SF FuneralF1109092      250201","","126.5","","2054674.18"
"2025-02-05","2025-02-01","SF FuneralFDC0000000MKQZ250201","","126.5","","2054800.68"
"2025-02-05","2025-02-01","SF FuneralF1109946      250202","","126.5","","2054927.18"
"2025-02-05","2025-02-01","SF FuneralF1110233      250201","","126.5","","2055053.68"
"2025-02-05","2025-02-01","SF FuneralF1110385      250201","","126.5","","2055180.18"
"2025-02-05","2025-02-01","SF FuneralF1113836      250201","","126.5","","2055306.68"
"2025-02-05","2025-02-01","SF FuneralF1113927      250201","","126.5","","2055433.18"
"2025-02-05","2025-02-01","SF FuneralF1114050      250201","","126.5","","2055559.68"
"2025-02-05","2025-02-01","SF FuneralF1114164      250201","","126.5","","2055686.18"
"2025-02-05","2025-02-01","SF FuneralF1114682      250201","","126.5","","2055812.68"
"2025-02-05","2025-02-01","SF FuneralF1117237      250201","","126.5","","2055939.18"
"2025-02-05","2025-02-01","SF FuneralF1117732      250201","","126.5","","2056065.68"
"2025-02-05","2025-02-01","SF FuneralF1117862      250202","","126.5","","2056192.18"
"2025-02-05","2025-02-01","SF FuneralFDC0000000P18J250201","","126.5","","2056318.68"
"2025-02-05","2025-02-01","SF FuneralF1122831      250201","","126.5","","2056445.18"
"2025-02-05","2025-02-01","SF FuneralF1122851      250201","","126.5","","2056571.68"
"2025-02-05","2025-02-01","SF FuneralF1122853      250201","","126.5","","2056698.18"
"2025-02-05","2025-02-01","SF FuneralFDC0000000P3B8250201","","126.5","","2056824.68"
"2025-02-05","2025-02-01","SF FuneralF1123066      250201","","126.5","","2056951.18"
"2025-02-05","2025-02-01","SF FuneralF1123114      250201","","126.5","","2057077.68"
"2025-02-05","2025-02-01","SF FuneralFDC0000000P3SR250201","","126.5","","2057204.18"
"2025-02-05","2025-02-01","SF FuneralF1123177      250201","","126.5","","2057330.68"
"2025-02-05","2025-02-01","SF FuneralF1124099      250201","","126.5","","2057457.18"
"2025-02-05","2025-02-01","SF FuneralFDC0000000P7G5250201","","126.5","","2057583.68"
"2025-02-05","2025-02-01","SF FuneralFDC0000000P7HD250201","","126.5","","2057710.18"
"2025-02-05","2025-02-01","SF FuneralF1128191      250201","","126.5","","2057836.68"
"2025-02-05","2025-02-01","SF FuneralF1128227      250202","","126.5","","2057963.18"
"2025-02-05","2025-02-01","SF FuneralF1129283      250201","","126.5","","2058089.68"
"2025-02-05","2025-02-01","SF FuneralFDC0000000PZ0P250201","","126.5","","2058216.18"
"2025-02-05","2025-01-29","SF FuneralFDC0000000J3GP250129","","126.5","","2058342.68"
"2025-02-05","2025-01-31","SF FuneralF981670       250131","","31.63","","2058374.31"
"2025-02-05","2025-02-01","SF FuneralFDC00000005XNC250201","","31.63","","2058405.94"
"2025-02-05","2025-02-01","SF FuneralFDC00000006BZV250201","","126.5","","2058532.44"
"2025-02-05","2025-02-01","SF FuneralFDC00000006F48250201","","126.5","","2058658.94"
"2025-02-05","2025-02-01","SF FuneralF814211       250201","","31.63","","2058690.57"
"2025-02-05","2025-02-01","SF FuneralF1017518      250201","","126.5","","2058817.07"
"2025-02-05","2025-02-01","SF FuneralFDC0000000K7W7250201","","126.5","","2058943.57"
"2025-02-05","2025-02-01","SF FuneralF1127843      250201","","31.63","","2058975.2"
"2025-02-05","2025-02-01","SF FuneralF1128172      250201","","126.5","","2059101.7"
"2025-02-05","2025-02-03","SF FuneralFDC000000069C5250203","","31.63","","2059133.33"
"2025-02-05","2025-02-03","SF FuneralFDC00000007PP8250203","","31.63","","2059164.96"
"2025-02-05","2025-02-03","SF FuneralFDC0000000FVPD250203","","31.63","","2059196.59"
"2025-02-05","2025-02-03","SF FuneralF847260       250202","","126.5","","2059323.09"
"2025-02-05","2025-02-03","SF FuneralF1108567      250203","","31.63","","2059354.72"
"2025-02-05","2025-02-03","SF FuneralF1130649      250203","","31.63","","2059386.35"
"2025-02-05","2025-02-04","SF FuneralFDC0000000HXY2250204","","31.63","","2059417.98"
"2025-02-05","2025-02-04","SF FuneralF1059304      250204","","31.63","","2059449.61"
"2025-02-05","2025-02-01","SF FuneralF1130776      250201","","31.63","","2059481.24"
"2025-02-05","2025-02-03","SF FuneralFDC00000006SV7250202","","31.63","","2059512.87"
"2025-02-05","2025-02-03","SF FuneralF1073147      250203","","31.63","","2059544.5"
"2025-02-05","2025-01-29","SF FuneralF1084158      250129","","126.5","","2059671"
"2025-02-05","2025-02-03","SF FuneralF844068       250203","","63.25","","2059734.25"
"2025-02-05","2025-02-03","SF FuneralF901048       250203","","126.5","","2059860.75"
"2025-02-05","2025-01-27","SF FuneralFDC00000006JDZ250127","","126.5","","2059987.25"
"2025-02-05","2025-01-27","SF FuneralF793966       250126","","126.5","","2060113.75"
"2025-02-05","2025-01-27","SF FuneralFDC00000007RB4250127","","126.5","","2060240.25"
"2025-02-05","2025-01-27","SF FuneralFDC00000007XMQ250127","","126.5","","2060366.75"
"2025-02-05","2025-01-28","SF FuneralFDC00000002W6B250128","","220","","2060586.75"
"2025-02-05","2025-01-28","SF FuneralFDC0000000338C250128","","220","","2060806.75"
"2025-02-05","2025-01-28","SF FuneralFDC00000005LZ5250128","","126.5","","2060933.25"
"2025-02-05","2025-01-28","SF FuneralFDC00000005SR2250128","","126.5","","2061059.75"
"2025-02-05","2025-01-28","SF FuneralFDC00000007QMM250128","","126.5","","2061186.25"
"2025-02-05","2025-01-28","SF FuneralFDC00000007R3P250128","","126.5","","2061312.75"
"2025-02-05","2025-01-28","SF FuneralF803646       250128","","126.5","","2061439.25"
"2025-02-05","2025-01-29","SF FuneralFDC00000003B8W250129","","220","","2061659.25"
"2025-02-05","2025-01-29","SF FuneralFDC00000003B99250129","","220","","2061879.25"
"2025-02-05","2025-01-29","SF FuneralFDC000000040XR250129","","220","","2062099.25"
"2025-02-05","2025-01-29","SF FuneralFDC0000000415M250129","","220","","2062319.25"
"2025-02-05","2025-01-29","SF FuneralFDC000000041FZ250129","","220","","2062539.25"
"2025-02-05","2025-01-29","SF FuneralFDC00000006BJD250129","","126.5","","2062665.75"
"2025-02-05","2025-01-29","SF FuneralFDC00000006JHP250129","","126.5","","2062792.25"
"2025-02-05","2025-01-29","SF FuneralFDC00000006Q46250129","","126.5","","2062918.75"
"2025-02-05","2025-01-29","SF FuneralFDC00000007836250129","","126.5","","2063045.25"
"2025-02-05","2025-01-29","SF FuneralF782668       250129","","256.5","","2063301.75"
"2025-02-05","2025-01-30","SF FuneralFDC000000033BJ250130","","220","","2063521.75"
"2025-02-05","2025-01-30","SF FuneralFDC00000003TRJ250130","","220","","2063741.75"
"2025-02-05","2025-01-30","SF FuneralFDC000000058Y5250130","","126.5","","2063868.25"
"2025-02-05","2025-01-30","SF FuneralFDC00000006BYW250130","","126.5","","2063994.75"
"2025-02-05","2025-01-30","SF FuneralF1080342      250130","","126.5","","2064121.25"
"2025-02-05","2025-01-31","SF FuneralFDC000000033B0250131","","220","","2064341.25"
"2025-02-05","2025-01-31","SF FuneralFDC000000035LF250131","","220","","2064561.25"
"2025-02-05","2025-01-31","SF FuneralFDC00000003BYB250131","","220","","2064781.25"
"2025-02-05","2025-01-31","SF FuneralFDC00000003BYF250131","","220","","2065001.25"
"2025-02-05","2025-01-31","SF FuneralFDC000000043NF250131","","220","","2065221.25"
"2025-02-05","2025-01-31","SF FuneralFDC00000005LWF250131","","126.5","","2065347.75"
"2025-02-05","2025-01-31","SF FuneralFDC00000005MJM250131","","126.5","","2065474.25"
"2025-02-05","2025-01-31","SF FuneralFDC000000069WB250131","","126.5","","2065600.75"
"2025-02-05","2025-01-31","SF FuneralFDC00000006BL4250131","","126.5","","2065727.25"
"2025-02-05","2025-01-31","SF FuneralFDC000000084JZ250131","","126.5","","2065853.75"
"2025-02-05","2025-01-31","SF FuneralF816643       250131","","126.5","","2065980.25"
"2025-02-05","2025-01-31","SF FuneralF901459       250201","","126.5","","2066106.75"
"2025-02-05","2025-01-31","SF FuneralF981138       250201","","126.5","","2066233.25"
"2025-02-05","2025-01-31","SF FuneralF784108       250201","","213.31","","2066446.56"
"2025-02-05","2025-01-31","SF FuneralF987784       250201","","126.5","","2066573.06"
"2025-02-05","2025-01-31","SF FuneralF986869       250201","","126.5","","2066699.56"
"2025-02-05","2025-01-31","SF FuneralF989651       250201","","126.5","","2066826.06"
"2025-02-05","2025-02-01","SF FuneralFDC00000002QXK250201","","220","","2067046.06"
"2025-02-05","2025-02-01","SF FuneralFDC00000002RB0250201","","220","","2067266.06"
"2025-02-05","2025-02-01","SF FuneralFDC00000002V0S250201","","220","","2067486.06"
"2025-02-05","2025-02-01","SF FuneralFDC00000002V11250201","","220","","2067706.06"
"2025-02-05","2025-02-01","SF FuneralFDC00000002V12250201","","220","","2067926.06"
"2025-02-05","2025-02-01","SF FuneralFDC00000002V2J250201","","220","","2068146.06"
"2025-02-05","2025-02-01","SF FuneralFDC00000002VHD250201","","220","","2068366.06"
"2025-02-05","2025-02-01","SF FuneralFDC00000002VP5250201","","220","","2068586.06"
"2025-02-05","2025-02-01","SF FuneralFDC00000002VR6250201","","220","","2068806.06"
"2025-02-05","2025-02-01","SF FuneralFDC00000002VVC250201","","220","","2069026.06"
"2025-02-05","2025-02-01","SF FuneralFDC00000002W26250201","","220","","2069246.06"
"2025-02-05","2025-02-01","SF FuneralFDC00000002W4Q250201","","220","","2069466.06"
"2025-02-05","2025-02-01","SF FuneralFDC00000002WPK250201","","220","","2069686.06"
"2025-02-05","2025-02-01","SF FuneralFDC00000002X4V250201","","220","","2069906.06"
"2025-02-05","2025-02-01","SF FuneralFDC00000002X9M250201","","220","","2070126.06"
"2025-02-05","2025-02-01","SF FuneralFDC00000002YDD250201","","220","","2070346.06"
"2025-02-05","2025-02-01","SF FuneralFDC00000002YV2250201","","220","","2070566.06"
"2025-02-05","2025-02-01","SF FuneralFDC000000031KH250201","","220","","2070786.06"
"2025-02-05","2025-02-01","SF FuneralFDC000000031Q6250201","","220","","2071006.06"
"2025-02-05","2025-02-01","SF FuneralFDC00000003363250201","","220","","2071226.06"
"2025-02-05","2025-02-01","SF FuneralFDC0000000337C250201","","220","","2071446.06"
"2025-02-05","2025-02-01","SF FuneralFDC0000000337R250201","","220","","2071666.06"
"2025-02-05","2025-02-01","SF FuneralFDC000000033D7250201","","220","","2071886.06"
"2025-02-05","2025-02-01","SF FuneralFDC000000033FC250201","","220","","2072106.06"
"2025-02-05","2025-02-01","SF FuneralFDC000000033GY250201","","220","","2072326.06"
"2025-02-05","2025-02-01","SF FuneralFDC000000033H3250201","","220","","2072546.06"
"2025-02-05","2025-02-01","SF FuneralFDC000000033KS250201","","220","","2072766.06"
"2025-02-05","2025-02-01","SF FuneralFDC000000033P9250201","","220","","2072986.06"
"2025-02-05","2025-02-01","SF FuneralFDC000000033RG250201","","220","","2073206.06"
"2025-02-05","2025-02-01","SF FuneralFDC00000003401250201","","220","","2073426.06"
"2025-02-05","2025-02-01","SF FuneralFDC00000003479250201","","220","","2073646.06"
"2025-02-05","2025-02-01","SF FuneralFDC000000034BY250201","","220","","2073866.06"
"2025-02-05","2025-02-01","SF FuneralFDC000000034PL250201","","220","","2074086.06"
"2025-02-05","2025-02-01","SF FuneralFDC000000034PN250201","","220","","2074306.06"
"2025-02-05","2025-02-01","SF FuneralFDC000000034R5250201","","220","","2074526.06"
"2025-02-05","2025-02-01","SF FuneralFDC000000037DS250201","","220","","2074746.06"
"2025-02-05","2025-02-01","SF FuneralFDC00000003DJ6250201","","220","","2074966.06"
"2025-02-05","2025-02-01","SF FuneralFDC00000003F4G250201","","220","","2075186.06"
"2025-02-05","2025-02-01","SF FuneralFDC00000003K85250201","","220","","2075406.06"
"2025-02-05","2025-02-01","SF FuneralFDC00000003M2S250201","","220","","2075626.06"
"2025-02-05","2025-02-01","SF FuneralFDC00000003TW0250201","","220","","2075846.06"
"2025-02-05","2025-02-01","SF FuneralFDC00000003VXG250201","","220","","2076066.06"
"2025-02-05","2025-02-01","SF FuneralFDC000000040WW250201","","220","","2076286.06"
"2025-02-05","2025-02-01","SF FuneralFDC0000000411V250201","","220","","2076506.06"
"2025-02-05","2025-02-01","SF FuneralFDC000000041RD250201","","220","","2076726.06"
"2025-02-05","2025-02-01","SF FuneralFDC000000041S9250201","","220","","2076946.06"
"2025-02-05","2025-02-01","SF FuneralFDC00000004321250201","","220","","2077166.06"
"2025-02-05","2025-02-01","SF FuneralFDC0000000455B250201","","220","","2077386.06"
"2025-02-05","2025-02-01","SF FuneralFDC00000004978250201","","220","","2077606.06"
"2025-02-05","2025-02-01","SF FuneralFDC00000004H3V250201","","220","","2077826.06"
"2025-02-05","2025-02-01","SF FuneralFDC00000004HXN250201","","220","","2078046.06"
"2025-02-05","2025-02-01","SF FuneralFDC000000057NB250201","","126.5","","2078172.56"
"2025-02-05","2025-02-01","SF FuneralFDC000000059GC250201","","126.5","","2078299.06"
"2025-02-05","2025-02-01","SF FuneralFDC00000005D42250201","","126.5","","2078425.56"
"2025-02-05","2025-02-01","SF FuneralFDC00000005D5Q250201","","126.5","","2078552.06"
"2025-02-05","2025-02-01","SF FuneralFDC00000005GGN250201","","126.5","","2078678.56"
"2025-02-05","2025-02-01","SF FuneralFDC00000005JBZ250201","","126.5","","2078805.06"
"2025-02-05","2025-02-01","SF FuneralFDC00000005MNG250201","","256.5","","2079061.56"
"2025-02-05","2025-02-01","SF FuneralFDC00000005PSC250201","","126.5","","2079188.06"
"2025-02-05","2025-02-01","SF FuneralFDC00000005Q2V250201","","126.5","","2079314.56"
"2025-02-05","2025-02-01","SF FuneralFDC00000005Q46250201","","126.5","","2079441.06"
"2025-02-05","2025-02-01","SF FuneralFDC00000005RWH250201","","220","","2079661.06"
"2025-02-05","2025-02-01","SF FuneralFDC00000005RZS250201","","126.5","","2079787.56"
"2025-02-05","2025-02-01","SF FuneralFDC00000005TS6250201","","126.5","","2079914.06"
"2025-02-05","2025-02-01","SF FuneralFDC00000005V30250201","","126.5","","2080040.56"
"2025-02-05","2025-02-01","SF FuneralFDC00000005VN4250201","","126.5","","2080167.06"
"2025-02-05","2025-02-01","SF FuneralFDC00000005VRF250201","","126.5","","2080293.56"
"2025-02-05","2025-02-01","SF FuneralFDC00000005X4G250201","","126.5","","2080420.06"
"2025-02-05","2025-02-01","SF FuneralFDC0000000696H250201","","126.5","","2080546.56"
"2025-02-05","2025-02-01","SF FuneralFDC000000069BZ250201","","126.5","","2080673.06"
"2025-02-05","2025-02-01","SF FuneralFDC000000069FR250201","","126.5","","2080799.56"
"2025-02-05","2025-02-01","SF FuneralFDC000000069XJ250201","","126.5","","2080926.06"
"2025-02-05","2025-02-01","SF FuneralFDC00000006B5L250201","","126.5","","2081052.56"
"2025-02-05","2025-02-01","SF FuneralFDC00000006B7V250201","","126.5","","2081179.06"
"2025-02-05","2025-02-01","SF FuneralFDC00000006B9K250201","","126.5","","2081305.56"
"2025-02-05","2025-02-01","SF FuneralFDC00000006BFT250201","","126.5","","2081432.06"
"2025-02-05","2025-02-01","SF FuneralFDC00000006BR9250201","","126.5","","2081558.56"
"2025-02-05","2025-02-01","SF FuneralFDC00000006BWD250201","","126.5","","2081685.06"
"2025-02-05","2025-02-01","SF FuneralFDC00000006C1Y250201","","126.5","","2081811.56"
"2025-02-05","2025-02-01","SF FuneralFDC00000006C59250201","","126.5","","2081938.06"
"2025-02-05","2025-02-01","SF FuneralFDC00000006C62250201","","126.5","","2082064.56"
"2025-02-05","2025-02-01","SF FuneralFDC00000006DBY250201","","126.5","","2082191.06"
"2025-02-05","2025-02-01","SF FuneralFDC00000006DDC250201","","256.5","","2082447.56"
"2025-02-05","2025-02-01","SF FuneralFDC00000006DJL250201","","126.5","","2082574.06"
"2025-02-05","2025-02-01","SF FuneralFDC00000006F3P250201","","126.5","","2082700.56"
"2025-02-05","2025-02-01","SF FuneralFDC00000006F84250201","","126.5","","2082827.06"
"2025-02-05","2025-02-01","SF FuneralFDC00000006FB0250201","","126.5","","2082953.56"
"2025-02-05","2025-02-01","SF FuneralFDC00000006FCH250201","","126.5","","2083080.06"
"2025-02-05","2025-02-01","SF FuneralFDC00000006GQ1250201","","126.5","","2083206.56"
"2025-02-05","2025-02-01","SF FuneralFDC00000006GT2250201","","126.5","","2083333.06"
"2025-02-05","2025-02-01","SF FuneralFDC00000006GV9250201","","126.5","","2083459.56"
"2025-02-05","2025-02-01","SF FuneralFDC00000006GZG250201","","126.5","","2083586.06"
"2025-02-05","2025-02-01","SF FuneralFDC00000006H1N250201","","126.5","","2083712.56"
"2025-02-05","2025-02-01","SF FuneralFDC00000006H5W250201","","126.5","","2083839.06"
"2025-02-05","2025-02-01","SF FuneralFDC00000006HH5250201","","126.5","","2083965.56"
"2025-02-05","2025-02-01","SF FuneralFDC00000006HL5250201","","126.5","","2084092.06"
"2025-02-05","2025-02-01","SF FuneralFDC00000006HLC250201","","126.5","","2084218.56"
"2025-02-05","2025-02-01","SF FuneralFDC00000006J0Q250201","","126.5","","2084345.06"
"2025-02-05","2025-02-01","SF FuneralFDC00000006J1P250201","","126.5","","2084471.56"
"2025-02-05","2025-02-01","SF FuneralFDC00000006K1H250201","","126.5","","2084598.06"
"2025-02-05","2025-02-01","SF FuneralFDC00000006K1L250201","","126.5","","2084724.56"
"2025-02-05","2025-02-01","SF FuneralFDC00000006KCZ250201","","126.5","","2084851.06"
"2025-02-05","2025-02-01","SF FuneralFDC00000006L4G250201","","126.5","","2084977.56"
"2025-02-05","2025-02-01","SF FuneralFDC00000006L6V250201","","126.5","","2085104.06"
"2025-02-05","2025-02-01","SF FuneralFDC00000006L8Y250201","","126.5","","2085230.56"
"2025-02-05","2025-02-01","SF FuneralFDC00000006LQ4250201","","126.5","","2085357.06"
"2025-02-05","2025-02-01","SF FuneralFDC00000006LXS250201","","126.5","","2085483.56"
"2025-02-05","2025-02-01","SF FuneralFDC00000006LY4250201","","126.5","","2085610.06"
"2025-02-05","2025-02-01","SF FuneralFDC00000006MJ4250201","","126.5","","2085736.56"
"2025-02-05","2025-02-01","SF FuneralFDC00000006MS2250201","","220","","2085956.56"
"2025-02-05","2025-02-01","SF FuneralFDC00000006NK1250201","","126.5","","2086083.06"
"2025-02-05","2025-02-01","SF FuneralFDC00000006NKF250201","","126.5","","2086209.56"
"2025-02-05","2025-02-01","SF FuneralFDC00000006S29250201","","126.5","","2086336.06"
"2025-02-05","2025-02-01","SF FuneralFDC00000006T59250201","","126.5","","2086462.56"
"2025-02-05","2025-02-01","SF FuneralFDC00000006T5F250201","","126.5","","2086589.06"
"2025-02-05","2025-02-01","SF FuneralFDC00000006VZJ250201","","126.5","","2086715.56"
"2025-02-05","2025-02-01","SF FuneralFDC00000006WPQ250201","","126.5","","2086842.06"
"2025-02-05","2025-02-01","SF FuneralFDC00000006WTM250201","","126.5","","2086968.56"
"2025-02-05","2025-02-01","SF FuneralFDC00000006X8L250201","","126.5","","2087095.06"
"2025-02-05","2025-02-01","SF FuneralFDC00000006XN9250201","","126.5","","2087221.56"
"2025-02-05","2025-02-01","SF FuneralFDC00000006XVM250201","","126.5","","2087348.06"
"2025-02-05","2025-02-01","SF FuneralFDC00000007193250201","","126.5","","2087474.56"
"2025-02-05","2025-02-01","SF FuneralFDC000000073PH250201","","126.5","","2087601.06"
"2025-02-05","2025-02-01","SF FuneralFDC0000000748P250201","","126.5","","2087727.56"
"2025-02-05","2025-02-01","SF FuneralFDC000000074C3250201","","126.5","","2087854.06"
"2025-02-05","2025-02-01","SF FuneralFDC000000074FF250201","","126.5","","2087980.56"
"2025-02-05","2025-02-01","SF FuneralFDC000000074PV250201","","126.5","","2088107.06"
"2025-02-05","2025-02-01","SF FuneralFDC000000074RG250201","","191.5","","2088298.56"
"2025-02-05","2025-02-01","SF FuneralFDC000000074SF250201","","126.5","","2088425.06"
"2025-02-05","2025-02-01","SF FuneralFDC000000074VJ250201","","126.5","","2088551.56"
"2025-02-05","2025-02-01","SF FuneralFDC0000000750P250201","","126.5","","2088678.06"
"2025-02-05","2025-02-01","SF FuneralFDC0000000754X250201","","126.5","","2088804.56"
"2025-02-05","2025-02-01","SF FuneralFDC00000007599250201","","126.5","","2088931.06"
"2025-02-05","2025-02-01","SF FuneralFDC000000075B1250201","","126.5","","2089057.56"
"2025-02-05","2025-02-01","SF FuneralFDC000000075DD250201","","126.5","","2089184.06"
"2025-02-05","2025-02-01","SF FuneralFDC000000075FP250201","","126.5","","2089310.56"
"2025-02-05","2025-02-01","SF FuneralFDC000000075H4250201","","126.5","","2089437.06"
"2025-02-05","2025-02-01","SF FuneralFDC000000075Q9250201","","126.5","","2089563.56"
"2025-02-05","2025-02-01","SF FuneralFDC000000075RB250201","","126.5","","2089690.06"
"2025-02-05","2025-02-01","SF FuneralFDC000000075TX250201","","126.5","","2089816.56"
"2025-02-05","2025-02-01","SF FuneralFDC000000075Y3250201","","126.5","","2089943.06"
"2025-02-05","2025-02-01","SF FuneralFDC0000000763V250201","","126.5","","2090069.56"
"2025-02-05","2025-02-01","SF FuneralFDC000000076K3250201","","126.5","","2090196.06"
"2025-02-05","2025-02-01","SF FuneralFDC000000076R3250201","","126.5","","2090322.56"
"2025-02-05","2025-02-01","SF FuneralFDC000000076YC250201","","126.5","","2090449.06"
"2025-02-05","2025-02-01","SF FuneralFDC000000077CX250201","","126.5","","2090575.56"
"2025-02-05","2025-02-01","SF FuneralFDC000000077VC250201","","126.5","","2090702.06"
"2025-02-05","2025-02-01","SF FuneralFDC0000000784P250201","","126.5","","2090828.56"
"2025-02-05","2025-02-01","SF FuneralFDC000000079H5250201","","126.5","","2090955.06"
"2025-02-05","2025-02-01","SF FuneralFDC000000079J6250201","","126.5","","2091081.56"
"2025-02-05","2025-02-01","SF FuneralFDC000000079JT250201","","126.5","","2091208.06"
"2025-02-05","2025-02-01","SF FuneralFDC000000079LY250201","","126.5","","2091334.56"
"2025-02-05","2025-02-01","SF FuneralFDC000000079S9250201","","126.5","","2091461.06"
"2025-02-05","2025-02-01","SF FuneralFDC000000079VD250201","","126.5","","2091587.56"
"2025-02-05","2025-02-01","SF FuneralFDC00000007B0N250201","","126.5","","2091714.06"
"2025-02-05","2025-02-01","SF FuneralFDC00000007BFG250201","","126.5","","2091840.56"
"2025-02-05","2025-02-01","SF FuneralFDC00000007BJ3250201","","126.5","","2091967.06"
"2025-02-05","2025-02-01","SF FuneralFDC00000007BSK250201","","220","","2092187.06"
"2025-02-05","2025-02-01","SF FuneralFDC00000007BV7250201","","126.5","","2092313.56"
"2025-02-05","2025-02-01","SF FuneralFDC00000007CZT250201","","126.5","","2092440.06"
"2025-02-05","2025-02-01","SF FuneralFDC00000007DB5250201","","126.5","","2092566.56"
"2025-02-05","2025-02-01","SF FuneralFDC00000007DCX250201","","126.5","","2092693.06"
"2025-02-05","2025-02-01","SF FuneralFDC00000007DCZ250201","","126.5","","2092819.56"
"2025-02-05","2025-02-01","SF FuneralFDC00000007F3Y250201","","220","","2093039.56"
"2025-02-05","2025-02-01","SF FuneralFDC00000007HQ5250201","","126.5","","2093166.06"
"2025-02-05","2025-02-01","SF FuneralFDC00000007HXV250201","","126.5","","2093292.56"
"2025-02-05","2025-02-01","SF FuneralFDC00000007KBZ250201","","126.5","","2093419.06"
"2025-02-05","2025-02-01","SF FuneralFDC00000007KMT250201","","126.5","","2093545.56"
"2025-02-05","2025-02-01","SF FuneralFDC00000007LYS250201","","126.5","","2093672.06"
"2025-02-05","2025-02-01","SF FuneralFDC00000007Q5S250201","","126.5","","2093798.56"
"2025-02-05","2025-02-01","SF FuneralF793825       250201","","126.5","","2093925.06"
"2025-02-05","2025-02-01","SF FuneralFDC00000007Q8G250201","","126.5","","2094051.56"
"2025-02-05","2025-02-01","SF FuneralFDC00000007QXX250201","","126.5","","2094178.06"
"2025-02-05","2025-02-01","SF FuneralFDC00000007R2G250201","","126.5","","2094304.56"
"2025-02-05","2025-02-01","SF FuneralFDC00000007R8B250201","","126.5","","2094431.06"
"2025-02-05","2025-02-01","SF FuneralFDC00000007R8F250201","","126.5","","2094557.56"
"2025-02-05","2025-02-01","SF FuneralFDC00000007RFT250201","","126.5","","2094684.06"
"2025-02-05","2025-02-01","SF FuneralFDC00000007RFV250201","","126.5","","2094810.56"
"2025-02-05","2025-02-01","SF FuneralFDC00000007RGG250201","","126.5","","2094937.06"
"2025-02-05","2025-02-01","SF FuneralFDC00000007RMK250201","","126.5","","2095063.56"
"2025-02-05","2025-02-01","SF FuneralFDC00000007RPY250201","","126.5","","2095190.06"
"2025-02-05","2025-02-01","SF FuneralFDC00000007SGT250201","","126.5","","2095316.56"
"2025-02-05","2025-02-01","SF FuneralFDC00000007T6M250201","","126.5","","2095443.06"
"2025-02-05","2025-02-01","SF FuneralFDC00000007TVX250201","","126.5","","2095569.56"
"2025-02-05","2025-02-01","SF FuneralFDC00000007VQQ250201","","126.5","","2095696.06"
"2025-02-05","2025-02-01","SF FuneralF795548       250201","","126.5","","2095822.56"
"2025-02-05","2025-02-01","SF FuneralFDC00000007XC2250201","","126.5","","2095949.06"
"2025-02-05","2025-02-01","SF FuneralFDC00000007ZGX250201","","126.5","","2096075.56"
"2025-02-05","2025-02-01","SF FuneralFDC0000000800G250201","","126.5","","2096202.06"
"2025-02-05","2025-02-01","SF FuneralFDC000000080GS250201","","126.5","","2096328.56"
"2025-02-05","2025-02-01","SF FuneralFDC000000080KN250201","","126.5","","2096455.06"
"2025-02-05","2025-02-01","SF FuneralFDC00000008229250201","","191.5","","2096646.56"
"2025-02-05","2025-02-01","SF FuneralFDC000000084GS250201","","126.5","","2096773.06"
"2025-02-05","2025-02-01","SF FuneralFDC000000085Q4250201","","126.5","","2096899.56"
"2025-02-05","2025-02-01","SF FuneralFDC000000085XR250201","","126.5","","2097026.06"
"2025-02-05","2025-02-01","SF FuneralF798769       250201","","126.5","","2097152.56"
"2025-02-05","2025-02-01","SF FuneralFDC00000008647250201","","126.5","","2097279.06"
"2025-02-05","2025-02-01","SF FuneralFDC000000086F3250201","","126.5","","2097405.56"
"2025-02-05","2025-02-01","SF FuneralF782386       250201","","191.5","","2097597.06"
"2025-02-05","2025-02-01","SF FuneralFDC000000087LY250201","","126.5","","2097723.56"
"2025-02-05","2025-02-01","SF FuneralF799522       250201","","126.5","","2097850.06"
"2025-02-05","2025-02-01","SF FuneralF799523       250201","","126.5","","2097976.56"
"2025-02-05","2025-02-01","SF FuneralFDC000000088WG250201","","126.5","","2098103.06"
"2025-02-05","2025-02-01","SF FuneralFDC000000089NV250201","","126.5","","2098229.56"
"2025-02-05","2025-02-01","SF FuneralF800779       250201","","126.5","","2098356.06"
"2025-02-05","2025-02-01","SF FuneralFDC00000008CMF250201","","256.5","","2098612.56"
"2025-02-05","2025-02-01","SF FuneralFDC00000008JB8250201","","126.5","","2098739.06"
"2025-02-05","2025-02-01","SF FuneralFDC00000008L8Y250201","","126.5","","2098865.56"
"2025-02-05","2025-02-01","SF FuneralF802839       250201","","126.5","","2098992.06"
"2025-02-05","2025-02-01","SF FuneralFDC00000008LFL250201","","126.5","","2099118.56"
"2025-02-05","2025-02-01","SF FuneralFDC00000008LY4250201","","126.5","","2099245.06"
"2025-02-05","2025-02-01","SF FuneralFDC00000008M0P250201","","126.5","","2099371.56"
"2025-02-05","2025-02-01","SF FuneralFDC00000008M1P250201","","126.5","","2099498.06"
"2025-02-05","2025-02-01","SF FuneralF803195       250201","","126.5","","2099624.56"
"2025-02-05","2025-02-01","SF FuneralF781930       250201","","256.5","","2099881.06"
"2025-02-05","2025-02-01","SF FuneralF803984       250201","","126.5","","2100007.56"
"2025-02-05","2025-02-01","SF FuneralF789872       250201","","126.5","","2100134.06"
"2025-02-05","2025-02-01","SF FuneralF804086       250201","","126.5","","2100260.56"
"2025-02-05","2025-02-01","SF FuneralF804107       250201","","126.5","","2100387.06"
"2025-02-05","2025-02-01","SF FuneralFDC00000008PY6250201","","126.5","","2100513.56"
"2025-02-05","2025-02-01","SF FuneralFDC00000008PY8250201","","126.5","","2100640.06"
"2025-02-05","2025-02-01","SF FuneralF805280       250201","","126.5","","2100766.56"
"2025-02-05","2025-02-01","SF FuneralFDC00000009100250201","","126.5","","2100893.06"
"2025-02-05","2025-02-01","SF FuneralF809226       250201","","126.5","","2101019.56"
"2025-02-05","2025-02-01","SF FuneralF809252       250201","","126.5","","2101146.06"
"2025-02-05","2025-02-01","SF FuneralF810253       250201","","126.5","","2101272.56"
"2025-02-05","2025-02-01","SF FuneralFDC000000097F5250201","","126.5","","2101399.06"
"2025-02-05","2025-02-01","SF FuneralF812606       250201","","126.5","","2101525.56"
"2025-02-05","2025-02-01","SF FuneralF812640       250201","","126.5","","2101652.06"
"2025-02-05","2025-02-01","SF FuneralFDC00000009FL9250201","","126.5","","2101778.56"
"2025-02-05","2025-02-01","SF FuneralF812742       250201","","126.5","","2101905.06"
"2025-02-05","2025-02-01","SF FuneralFDC00000009FQ8250201","","256.5","","2102161.56"
"2025-02-05","2025-02-01","SF FuneralF812757       250201","","126.5","","2102288.06"
"2025-02-05","2025-02-01","SF FuneralF812852       250201","","126.5","","2102414.56"
"2025-02-05","2025-02-01","SF FuneralF812862       250201","","126.5","","2102541.06"
"2025-02-05","2025-02-01","SF FuneralF812939       250201","","126.5","","2102667.56"
"2025-02-05","2025-02-01","SF FuneralF814097       250201","","126.5","","2102794.06"
"2025-02-05","2025-02-01","SF FuneralF814388       250201","","126.5","","2102920.56"
"2025-02-05","2025-02-01","SF FuneralFDC00000009MDJ250201","","126.5","","2103047.06"
"2025-02-05","2025-02-01","SF FuneralFDC00000009VPX250201","","126.5","","2103173.56"
"2025-02-05","2025-02-01","SF FuneralF816636       250201","","126.5","","2103300.06"
"2025-02-05","2025-02-01","SF FuneralF816646       250201","","126.5","","2103426.56"
"2025-02-05","2025-02-01","SF FuneralF816787       250201","","126.5","","2103553.06"
"2025-02-05","2025-02-01","SF FuneralF816934       250201","","126.5","","2103679.56"
"2025-02-05","2025-02-01","SF FuneralF817201       250201","","126.5","","2103806.06"
"2025-02-05","2025-02-01","SF FuneralF817382       250201","","126.5","","2103932.56"
"2025-02-05","2025-02-01","SF FuneralF817482       250201","","126.5","","2104059.06"
"2025-02-05","2025-02-01","SF FuneralF817740       250201","","126.5","","2104185.56"
"2025-02-05","2025-02-01","SF FuneralFDC00000009ZXC250201","","220","","2104405.56"
"2025-02-05","2025-02-01","SF FuneralF818295       250201","","126.5","","2104532.06"
"2025-02-05","2025-02-01","SF FuneralF818950       250201","","126.5","","2104658.56"
"2025-02-05","2025-02-01","SF FuneralF820585       250201","","126.5","","2104785.06"
"2025-02-05","2025-02-01","SF FuneralF820596       250201","","126.5","","2104911.56"
"2025-02-05","2025-02-01","SF FuneralFDC0000000B863250201","","126.5","","2105038.06"
"2025-02-05","2025-02-01","SF FuneralF820628       250201","","126.5","","2105164.56"
"2025-02-05","2025-02-01","SF FuneralFDC0000000B8D7250201","","256.5","","2105421.06"
"2025-02-05","2025-02-01","SF FuneralF820739       250201","","126.5","","2105547.56"
"2025-02-05","2025-02-01","SF FuneralF820893       250201","","126.5","","2105674.06"
"2025-02-05","2025-02-01","SF FuneralF821842       250201","","126.5","","2105800.56"
"2025-02-05","2025-02-01","SF FuneralF822123       250201","","126.5","","2105927.06"
"2025-02-05","2025-02-01","SF FuneralF822151       250201","","126.5","","2106053.56"
"2025-02-05","2025-02-01","SF FuneralF823204       250201","","126.5","","2106180.06"
"2025-02-05","2025-02-01","SF FuneralF828235       250201","","126.5","","2106306.56"
"2025-02-05","2025-02-01","SF FuneralF828244       250201","","126.5","","2106433.06"
"2025-02-05","2025-02-01","SF FuneralF828247       250201","","126.5","","2106559.56"
"2025-02-05","2025-02-01","SF FuneralFDC0000000BP85250201","","126.5","","2106686.06"
"2025-02-05","2025-02-01","SF FuneralF828339       250201","","126.5","","2106812.56"
"2025-02-05","2025-02-01","SF FuneralF828417       250201","","126.5","","2106939.06"
"2025-02-05","2025-02-01","SF FuneralF828434       250201","","126.5","","2107065.56"
"2025-02-05","2025-02-01","SF FuneralF829614       250201","","126.5","","2107192.06"
"2025-02-05","2025-02-01","SF FuneralF830573       250201","","126.5","","2107318.56"
"2025-02-05","2025-02-01","SF FuneralF831562       250201","","126.5","","2107445.06"
"2025-02-05","2025-02-01","SF FuneralF832788       250201","","126.5","","2107571.56"
"2025-02-05","2025-02-01","SF FuneralF833129       250201","","126.5","","2107698.06"
"2025-02-05","2025-02-01","SF FuneralF833170       250201","","126.5","","2107824.56"
"2025-02-05","2025-02-01","SF FuneralFDC0000000CR3B250201","","126.5","","2107951.06"
"2025-02-05","2025-02-01","SF FuneralF834560       250201","","126.5","","2108077.56"
"2025-02-05","2025-02-01","SF FuneralFDC0000000DBYW250201","","191.5","","2108269.06"
"2025-02-05","2025-02-01","SF FuneralF841309       250201","","126.5","","2108395.56"
"2025-02-05","2025-02-01","SF FuneralF841478       250201","","126.5","","2108522.06"
"2025-02-05","2025-02-01","SF FuneralF841623       250201","","126.5","","2108648.56"
"2025-02-05","2025-02-01","SF FuneralF841760       250201","","126.5","","2108775.06"
"2025-02-05","2025-02-01","SF FuneralF841982       250201","","126.5","","2108901.56"
"2025-02-05","2025-02-01","SF FuneralF842112       250201","","126.5","","2109028.06"
"2025-02-05","2025-02-01","SF FuneralF842553       250201","","126.5","","2109154.56"
"2025-02-05","2025-02-01","SF FuneralF842586       250201","","126.5","","2109281.06"
"2025-02-05","2025-02-01","SF FuneralF993062       250201","","126.5","","2109407.56"
"2025-02-05","2025-02-01","SF FuneralF1016880      250201","","126.5","","2109534.06"
"2025-02-05","2025-02-01","SF FuneralF1021949      250201","","126.5","","2109660.56"
"2025-02-05","2025-02-01","SF FuneralFDC0000000JYD2250201","","126.5","","2109787.06"
"2025-02-05","2025-02-01","SF FuneralFDC0000000JZ4D250201","","126.5","","2109913.56"
"2025-02-05","2025-02-01","SF FuneralFDC0000000JZWN250201","","256.5","","2110170.06"
"2025-02-05","2025-02-01","SF FuneralF1052080      250201","","126.5","","2110296.56"
"2025-02-05","2025-02-01","SF FuneralFDC0000000K275250201","","126.5","","2110423.06"
"2025-02-05","2025-02-01","SF FuneralF1052685      250201","","126.5","","2110549.56"
"2025-02-05","2025-02-01","SF FuneralF1058770      250201","","126.5","","2110676.06"
"2025-02-05","2025-02-01","SF FuneralFDC0000000KCDD250201","","126.5","","2110802.56"
"2025-02-05","2025-02-01","SF FuneralF1060103      250201","","126.5","","2110929.06"
"2025-02-05","2025-02-01","SF FuneralFDC0000000KM0P250201","","126.5","","2111055.56"
"2025-02-05","2025-02-01","SF FuneralF1061702      250201","","126.5","","2111182.06"
"2025-02-05","2025-02-01","SF FuneralFDC0000000KVSP250201","","126.5","","2111308.56"
"2025-02-05","2025-02-01","SF FuneralF1066492      250201","","126.5","","2111435.06"
"2025-02-05","2025-02-01","SF FuneralF1079067      250201","","126.5","","2111561.56"
"2025-02-05","2025-02-01","SF FuneralF1079812      250201","","126.5","","2111688.06"
"2025-02-05","2025-02-01","SF FuneralF1084554      250201","","126.5","","2111814.56"
"2025-02-05","2025-02-01","SF FuneralF1084732      250201","","126.5","","2111941.06"
"2025-02-05","2025-02-01","SF FuneralF1109014      250201","","126.5","","2112067.56"
"2025-02-05","2025-02-01","SF FuneralF1109077      250201","","126.5","","2112194.06"
"2025-02-05","2025-02-01","SF FuneralF1109139      250201","","126.5","","2112320.56"
"2025-02-05","2025-02-01","SF FuneralF1109555      250201","","126.5","","2112447.06"
"2025-02-05","2025-02-01","SF FuneralF1110072      250201","","126.5","","2112573.56"
"2025-02-05","2025-02-01","SF FuneralF1110189      250201","","126.5","","2112700.06"
"2025-02-05","2025-02-01","SF FuneralF1111529      250201","","126.5","","2112826.56"
"2025-02-05","2025-02-01","SF FuneralF1113338      250201","","126.5","","2112953.06"
"2025-02-05","2025-02-01","SF FuneralF1114484      250201","","126.5","","2113079.56"
"2025-02-05","2025-02-01","SF FuneralF1114649      250201","","126.5","","2113206.06"
"2025-02-05","2025-02-01","SF FuneralFDC0000000N9X2250201","","126.5","","2113332.56"
"2025-02-05","2025-02-01","SF FuneralF1117657      250201","","126.5","","2113459.06"
"2025-02-05","2025-02-01","SF FuneralF1117658      250201","","126.5","","2113585.56"
"2025-02-05","2025-02-01","SF FuneralF744097       250201","","220","","2113805.56"
"2025-02-05","2025-02-01","SF FuneralFDC0000000NMVB250201","","126.5","","2113932.06"
"2025-02-05","2025-02-01","SF FuneralF1118461      250201","","126.5","","2114058.56"
"2025-02-05","2025-02-01","SF FuneralF1118977      250201","","126.5","","2114185.06"
"2025-02-05","2025-02-01","SF FuneralF1119075      250201","","126.5","","2114311.56"
"2025-02-05","2025-02-01","SF FuneralFDC0000000NXN8250201","","126.5","","2114438.06"
"2025-02-05","2025-02-01","SF FuneralFDC0000000P0MM250201","","126.5","","2114564.56"
"2025-02-05","2025-02-01","SF FuneralFDC0000000P0MS250201","","126.5","","2114691.06"
"2025-02-05","2025-02-01","SF FuneralFDC0000000P0W9250201","","126.5","","2114817.56"
"2025-02-05","2025-02-01","SF FuneralF1122279      250201","","126.5","","2114944.06"
"2025-02-05","2025-02-01","SF FuneralF1123259      250201","","126.5","","2115070.56"
"2025-02-05","2025-02-01","SF FuneralFDC0000000P5VL250201","","126.5","","2115197.06"
"2025-02-05","2025-02-01","SF FuneralF1123917      250201","","126.5","","2115323.56"
"2025-02-05","2025-02-01","SF FuneralF1125113      250201","","126.5","","2115450.06"
"2025-02-05","2025-02-01","SF FuneralF1127117      250201","","126.5","","2115576.56"
"2025-02-05","2025-02-01","SF FuneralFDC0000000PTNT250201","","256.5","","2115833.06"
"2025-02-05","2025-02-01","SF FuneralFDC0000000Q1NV250201","","191.5","","2116024.56"
"2025-02-05","2025-02-03","SF FuneralFDC00000002VR4250203","","220","","2116244.56"
"2025-02-05","2025-02-03","SF FuneralFDC000000033BP250202","","220","","2116464.56"
"2025-02-05","2025-02-03","SF FuneralFDC00000003KYJ250203","","220","","2116684.56"
"2025-02-05","2025-02-03","SF FuneralFDC00000003V13250202","","220","","2116904.56"
"2025-02-05","2025-02-03","SF FuneralFDC00000004741250202","","220","","2117124.56"
"2025-02-05","2025-02-03","SF FuneralFDC00000006HBF250202","","126.5","","2117251.06"
"2025-02-05","2025-02-03","SF FuneralFDC00000006PG3250202","","256.5","","2117507.56"
"2025-02-05","2025-02-03","SF FuneralFDC00000007517250202","","126.5","","2117634.06"
"2025-02-05","2025-02-03","SF FuneralF810852       250202","","126.5","","2117760.56"
"2025-02-05","2025-02-03","SF FuneralFDC00000009DX2250202","","126.5","","2117887.06"
"2025-02-05","2025-02-03","SF FuneralF814262       250202","","126.5","","2118013.56"
"2025-02-05","2025-02-03","SF FuneralF842473       250202","","126.5","","2118140.06"
"2025-02-05","2025-02-03","SF FuneralF842940       250201","","126.5","","2118266.56"
"2025-02-05","2025-02-03","SF FuneralF1078902      250203","","126.5","","2118393.06"
"2025-02-05","2025-02-03","SF FuneralF793892       250203","","191.5","","2118584.56"
"2025-02-05","2025-02-04","SF FuneralF812901       250204","","126.5","","2118711.06"
"2025-02-05","2025-01-31","SF FuneralF991163       250201","","126.5","","2118837.56"
"2025-02-05","2025-02-01","SF FuneralFDC00000003375250201","","220","","2119057.56"
"2025-02-05","2025-02-01","SF FuneralFDC000000034CS250201","","220","","2119277.56"
"2025-02-05","2025-02-01","SF FuneralFDC00000005N3K250201","","126.5","","2119404.06"
"2025-02-05","2025-02-01","SF FuneralFDC00000007FXX250201","","126.5","","2119530.56"
"2025-02-05","2025-02-01","SF FuneralFDC00000007J6M250201","","126.5","","2119657.06"
"2025-02-05","2025-02-01","SF FuneralF789403       250201","","126.5","","2119783.56"
"2025-02-05","2025-02-01","SF FuneralF815037       250201","","126.5","","2119910.06"
"2025-02-05","2025-02-01","SF FuneralF1022194      250201","","126.5","","2120036.56"
"2025-02-05","2025-02-01","SF FuneralF1066706      250201","","126.5","","2120163.06"
"2025-02-05","2025-02-01","SF FuneralF1118057      250201","","126.5","","2120289.56"
"2025-02-05","2025-01-29","SF FuneralFDC00000006F75250129","","126.5","","2120416.06"
"2025-02-05","2025-01-29","SF FuneralF816763       250129","","126.5","","2120542.56"
"2025-02-05","2025-01-29","SF FuneralF981229       250129","","126.5","","2120669.06"
"2025-02-05","2025-01-29","SF FuneralF1125981      250129","","126.5","","2120795.56"
"2025-02-05","2025-02-01","SF FuneralFDC00000002XML250201","","220","","2121015.56"
"2025-02-05","2025-02-01","SF FuneralFDC000000034P1250201","","220","","2121235.56"
"2025-02-05","2025-02-01","SF FuneralFDC00000005CYL250201","","126.5","","2121362.06"
"2025-02-05","2025-02-01","SF FuneralFDC00000005MJ0250201","","126.5","","2121488.56"
"2025-02-05","2025-02-01","SF FuneralFDC000000069CF250201","","126.5","","2121615.06"
"2025-02-05","2025-02-01","SF FuneralFDC00000006B2F250201","","126.5","","2121741.56"
"2025-02-05","2025-02-01","SF FuneralFDC00000006DKH250201","","126.5","","2121868.06"
"2025-02-05","2025-02-01","SF FuneralFDC00000006F2R250201","","126.5","","2121994.56"
"2025-02-05","2025-02-01","SF FuneralFDC00000006GPK250201","","126.5","","2122121.06"
"2025-02-05","2025-02-01","SF FuneralFDC00000006M1X250201","","126.5","","2122247.56"
"2025-02-05","2025-02-01","SF FuneralFDC00000006QPF250201","","126.5","","2122374.06"
"2025-02-05","2025-02-01","SF FuneralFDC000000074NC250201","","126.5","","2122500.56"
"2025-02-05","2025-02-01","SF FuneralFDC000000074Q6250201","","126.5","","2122627.06"
"2025-02-05","2025-02-01","SF FuneralFDC0000000784W250201","","126.5","","2122753.56"
"2025-02-05","2025-02-01","SF FuneralFDC00000007881250201","","126.5","","2122880.06"
"2025-02-05","2025-02-01","SF FuneralFDC0000000798V250201","","126.5","","2123006.56"
"2025-02-05","2025-02-01","SF FuneralFDC00000007F7C250201","","126.5","","2123133.06"
"2025-02-05","2025-02-01","SF FuneralFDC00000007HC4250201","","126.5","","2123259.56"
"2025-02-05","2025-02-01","SF FuneralFDC00000007JLL250201","","126.5","","2123386.06"
"2025-02-05","2025-02-01","SF FuneralF794498       250201","","126.5","","2123512.56"
"2025-02-05","2025-02-01","SF FuneralF795480       250201","","126.5","","2123639.06"
"2025-02-05","2025-02-01","SF FuneralFDC00000007ZGS250201","","126.5","","2123765.56"
"2025-02-05","2025-02-01","SF FuneralFDC000000084DF250201","","126.5","","2123892.06"
"2025-02-05","2025-02-01","SF FuneralF798732       250201","","126.5","","2124018.56"
"2025-02-05","2025-02-01","SF FuneralF799858       250201","","126.5","","2124145.06"
"2025-02-05","2025-02-01","SF FuneralF802992       250201","","126.5","","2124271.56"
"2025-02-05","2025-02-01","SF FuneralF803799       250201","","126.5","","2124398.06"
"2025-02-05","2025-02-01","SF FuneralF808817       250201","","126.5","","2124524.56"
"2025-02-05","2025-02-01","SF FuneralF803357       250201","","191.5","","2124716.06"
"2025-02-05","2025-02-01","SF FuneralF809123       250201","","126.5","","2124842.56"
"2025-02-05","2025-02-01","SF FuneralF809453       250201","","126.5","","2124969.06"
"2025-02-05","2025-02-01","SF FuneralF809715       250201","","126.5","","2125095.56"
"2025-02-05","2025-02-01","SF FuneralF809785       250201","","126.5","","2125222.06"
"2025-02-05","2025-02-01","SF FuneralF810040       250201","","126.5","","2125348.56"
"2025-02-05","2025-02-01","SF FuneralF810420       250201","","126.5","","2125475.06"
"2025-02-05","2025-02-01","SF FuneralF812423       250201","","126.5","","2125601.56"
"2025-02-05","2025-02-01","SF FuneralF812494       250201","","126.5","","2125728.06"
"2025-02-05","2025-02-01","SF FuneralF812504       250201","","126.5","","2125854.56"
"2025-02-05","2025-02-01","SF FuneralF812677       250201","","126.5","","2125981.06"
"2025-02-05","2025-02-01","SF FuneralFDC00000009GM8250201","","191.5","","2126172.56"
"2025-02-05","2025-02-01","SF FuneralF813520       250201","","126.5","","2126299.06"
"2025-02-05","2025-02-01","SF FuneralF814016       250201","","126.5","","2126425.56"
"2025-02-05","2025-02-01","SF FuneralF814354       250201","","126.5","","2126552.06"
"2025-02-05","2025-02-01","SF FuneralF814444       250201","","126.5","","2126678.56"
"2025-02-05","2025-02-01","SF FuneralF793915       250201","","126.5","","2126805.06"
"2025-02-05","2025-02-01","SF FuneralF817236       250201","","126.5","","2126931.56"
"2025-02-05","2025-02-01","SF FuneralF819142       250201","","126.5","","2127058.06"
"2025-02-05","2025-02-01","SF FuneralF820875       250201","","126.5","","2127184.56"
"2025-02-05","2025-02-01","SF FuneralF820963       250201","","126.5","","2127311.06"
"2025-02-05","2025-02-01","SF FuneralF821409       250201","","126.5","","2127437.56"
"2025-02-05","2025-02-01","SF FuneralF821554       250201","","126.5","","2127564.06"
"2025-02-05","2025-02-01","SF FuneralF822038       250201","","126.5","","2127690.56"
"2025-02-05","2025-02-01","SF FuneralF822269       250201","","126.5","","2127817.06"
"2025-02-05","2025-02-01","SF FuneralF822508       250201","","126.5","","2127943.56"
"2025-02-05","2025-02-01","SF FuneralF822609       250201","","126.5","","2128070.06"
"2025-02-05","2025-02-01","SF FuneralF824018       250201","","126.5","","2128196.56"
"2025-02-05","2025-02-01","SF FuneralF828239       250201","","126.5","","2128323.06"
"2025-02-05","2025-02-01","SF FuneralF828327       250201","","126.5","","2128449.56"
"2025-02-05","2025-02-01","SF FuneralF828367       250201","","126.5","","2128576.06"
"2025-02-05","2025-02-01","SF FuneralF828427       250201","","126.5","","2128702.56"
"2025-02-05","2025-02-01","SF FuneralF828489       250201","","126.5","","2128829.06"
"2025-02-05","2025-02-01","SF FuneralF828984       250201","","126.5","","2128955.56"
"2025-02-05","2025-02-01","SF FuneralF829100       250201","","126.5","","2129082.06"
"2025-02-05","2025-02-01","SF FuneralF829539       250201","","126.5","","2129208.56"
"2025-02-05","2025-02-01","SF FuneralF829895       250201","","126.5","","2129335.06"
"2025-02-05","2025-02-01","SF FuneralF832530       250201","","126.5","","2129461.56"
"2025-02-05","2025-02-01","SF FuneralF832871       250201","","126.5","","2129588.06"
"2025-02-05","2025-02-01","SF FuneralF833268       250201","","126.5","","2129714.56"
"2025-02-05","2025-02-01","SF FuneralF833421       250201","","126.5","","2129841.06"
"2025-02-05","2025-02-01","SF FuneralF838876       250201","","126.5","","2129967.56"
"2025-02-05","2025-02-01","SF FuneralF840973       250201","","126.5","","2130094.06"
"2025-02-05","2025-02-01","SF FuneralF842468       250201","","126.5","","2130220.56"
"2025-02-05","2025-02-01","SF FuneralF992688       250201","","126.5","","2130347.06"
"2025-02-05","2025-02-01","SF FuneralF992856       250201","","126.5","","2130473.56"
"2025-02-05","2025-02-01","SF FuneralF993150       250201","","126.5","","2130600.06"
"2025-02-05","2025-02-01","SF FuneralF993285       250201","","126.5","","2130726.56"
"2025-02-05","2025-02-01","SF FuneralF993356       250201","","126.5","","2130853.06"
"2025-02-05","2025-02-01","SF FuneralF993504       250201","","126.5","","2130979.56"
"2025-02-05","2025-02-01","SF FuneralF1050796      250201","","126.5","","2131106.06"
"2025-02-05","2025-02-01","SF FuneralF1052114      250201","","126.5","","2131232.56"
"2025-02-05","2025-02-01","SF FuneralF1052335      250202","","126.5","","2131359.06"
"2025-02-05","2025-02-01","SF FuneralF1052759      250201","","126.5","","2131485.56"
"2025-02-05","2025-02-01","SF FuneralF1058769      250201","","126.5","","2131612.06"
"2025-02-05","2025-02-01","SF FuneralF1059535      250201","","126.5","","2131738.56"
"2025-02-05","2025-02-01","SF FuneralF1060180      250201","","126.5","","2131865.06"
"2025-02-05","2025-02-01","SF FuneralF1060257      250201","","191.5","","2132056.56"
"2025-02-05","2025-02-01","SF FuneralF1066423      250201","","126.5","","2132183.06"
"2025-02-05","2025-02-01","SF FuneralF1066634      250201","","126.5","","2132309.56"
"2025-02-05","2025-02-01","SF FuneralF1067012      250201","","126.5","","2132436.06"
"2025-02-05","2025-02-01","SF FuneralF1068339      250202","","126.5","","2132562.56"
"2025-02-05","2025-02-01","SF FuneralFDC0000000L03C250201","","126.5","","2132689.06"
"2025-02-05","2025-02-01","SF FuneralF1074441      250201","","126.5","","2132815.56"
"2025-02-05","2025-02-01","SF FuneralF1074785      250201","","31.63","","2132847.19"
"2025-02-05","2025-02-01","SF FuneralF1075254      250201","","126.5","","2132973.69"
"2025-02-05","2025-02-01","SF FuneralF1078206      250201","","126.5","","2133100.19"
"2025-02-05","2025-02-01","SF FuneralF1078258      250201","","126.5","","2133226.69"
"2025-02-05","2025-02-01","SF FuneralF1078387      250201","","126.5","","2133353.19"
"2025-02-05","2025-02-01","SF FuneralF1078973      250201","","126.5","","2133479.69"
"2025-02-05","2025-02-01","SF FuneralFDC0000000LHZH250201","","126.5","","2133606.19"
"2025-02-05","2025-02-01","SF FuneralF1084737      250201","","126.5","","2133732.69"
"2025-02-05","2025-02-01","SF FuneralF1084769      250201","","126.5","","2133859.19"
"2025-02-05","2025-02-01","SF FuneralF1085000      250201","","126.5","","2133985.69"
"2025-02-05","2025-02-01","SF FuneralF1104022      250201","","126.5","","2134112.19"
"2025-02-05","2025-02-01","SF FuneralF1104182      250201","","126.5","","2134238.69"
"2025-02-05","2025-02-01","SF FuneralF782723       250201","","256.5","","2134495.19"
"2025-02-05","2025-02-01","SF FuneralF1109750      250201","","126.5","","2134621.69"
"2025-02-05","2025-02-01","SF FuneralF1109889      250202","","126.5","","2134748.19"
"2025-02-05","2025-02-01","SF FuneralF1110239      250201","","126.5","","2134874.69"
"2025-02-05","2025-02-01","SF FuneralF1110333      250201","","126.5","","2135001.19"
"2025-02-05","2025-02-01","SF FuneralF1110570      250201","","126.5","","2135127.69"
"2025-02-05","2025-02-01","SF FuneralF1111314      250201","","126.5","","2135254.19"
"2025-02-05","2025-02-01","SF FuneralF1112256      250201","","126.5","","2135380.69"
"2025-02-05","2025-02-01","SF FuneralF1113757      250201","","126.5","","2135507.19"
"2025-02-05","2025-02-01","SF FuneralF1114224      250201","","126.5","","2135633.69"
"2025-02-05","2025-02-01","SF FuneralF1114436      250201","","126.5","","2135760.19"
"2025-02-05","2025-02-01","SF FuneralF1114499      250201","","126.5","","2135886.69"
"2025-02-05","2025-02-01","SF FuneralF1114732      250202","","126.5","","2136013.19"
"2025-02-05","2025-02-01","SF FuneralF794829       250201","","126.5","","2136139.69"
"2025-02-05","2025-02-01","SF FuneralF1116019      250201","","126.5","","2136266.19"
"2025-02-05","2025-02-01","SF FuneralF1117240      250201","","126.5","","2136392.69"
"2025-02-05","2025-02-01","SF FuneralF1052233      250201","","126.5","","2136519.19"
"2025-02-05","2025-02-01","SF FuneralF1117414      250201","","126.5","","2136645.69"
"2025-02-05","2025-02-01","SF FuneralF1118021      250201","","126.5","","2136772.19"
"2025-02-05","2025-02-01","SF FuneralF1118117      250201","","126.5","","2136898.69"
"2025-02-05","2025-02-01","SF FuneralF1118943      250201","","126.5","","2137025.19"
"2025-02-05","2025-02-01","SF FuneralF1119089      250201","","126.5","","2137151.69"
"2025-02-05","2025-02-01","SF FuneralF1119688      250201","","126.5","","2137278.19"
"2025-02-05","2025-02-01","SF FuneralF1120132      250201","","126.5","","2137404.69"
"2025-02-05","2025-02-01","SF FuneralF1122026      250201","","126.5","","2137531.19"
"2025-02-05","2025-02-01","SF FuneralF1122045      250201","","126.5","","2137657.69"
"2025-02-05","2025-02-01","SF FuneralF1122049      250201","","126.5","","2137784.19"
"2025-02-05","2025-02-01","SF FuneralF1122060      250201","","126.5","","2137910.69"
"2025-02-05","2025-02-01","SF FuneralF1122205      250201","","126.5","","2138037.19"
"2025-02-05","2025-02-01","SF FuneralF1122347      250201","","126.5","","2138163.69"
"2025-02-05","2025-02-01","SF FuneralF1122674      250201","","126.5","","2138290.19"
"2025-02-05","2025-02-01","SF FuneralF1122779      250201","","126.5","","2138416.69"
"2025-02-05","2025-02-01","SF FuneralF1122873      250201","","126.5","","2138543.19"
"2025-02-05","2025-02-01","SF FuneralF1122914      250201","","126.5","","2138669.69"
"2025-02-05","2025-02-01","SF FuneralF1123194      250201","","126.5","","2138796.19"
"2025-02-05","2025-02-01","SF FuneralF1123540      250201","","126.5","","2138922.69"
"2025-02-05","2025-02-01","SF FuneralF1123901      250201","","126.5","","2139049.19"
"2025-02-05","2025-02-01","SF FuneralF1124514      250201","","126.5","","2139175.69"
"2025-02-05","2025-02-01","SF FuneralF1125675      250201","","126.5","","2139302.19"
"2025-02-05","2025-02-01","SF FuneralF1125686      250201","","126.5","","2139428.69"
"2025-02-05","2025-02-01","SF FuneralF1125709      250201","","126.5","","2139555.19"
"2025-02-05","2025-02-01","SF FuneralF1125955      250201","","126.5","","2139681.69"
"2025-02-05","2025-02-01","SF FuneralFDC0000000PKBR250201","","126.5","","2139808.19"
"2025-02-05","2025-02-01","SF FuneralF1126119      250201","","126.5","","2139934.69"
"2025-02-05","2025-02-01","SF FuneralF1126224      250201","","126.5","","2140061.19"
"2025-02-05","2025-02-01","SF FuneralF1126859      250201","","126.5","","2140187.69"
"2025-02-05","2025-02-01","SF FuneralFDC0000000PLGJ250201","","126.5","","2140314.19"
"2025-02-05","2025-02-01","SF FuneralF1127362      250201","","126.5","","2140440.69"
"2025-02-05","2025-02-01","SF FuneralF1127534      250201","","126.5","","2140567.19"
"2025-02-05","2025-02-01","SF FuneralF1127666      250201","","126.5","","2140693.69"
"2025-02-05","2025-02-01","SF FuneralF736069       250201","","220","","2140913.69"
"2025-02-05","2025-02-01","SF FuneralFDC0000000PTP5250201","","220","","2141133.69"
"2025-02-05","2025-02-01","SF FuneralF1128068      250201","","126.5","","2141260.19"
"2025-02-05","2025-02-01","SF FuneralF1128073      250202","","126.5","","2141386.69"
"2025-02-05","2025-02-01","SF FuneralF1128126      250201","","126.5","","2141513.19"
"2025-02-05","2025-02-01","SF FuneralF1128661      250201","","126.5","","2141639.69"
"2025-02-05","2025-02-01","SF FuneralF1128689      250201","","126.5","","2141766.19"
"2025-02-05","2025-02-01","SF FuneralF1128775      250201","","126.5","","2141892.69"
"2025-02-05","2025-02-01","SF FuneralF1128864      250201","","126.5","","2142019.19"
"2025-02-05","2025-02-01","SF FuneralF1129033      250201","","126.5","","2142145.69"
"2025-02-05","2025-02-01","SF FuneralF1129099      250201","","126.5","","2142272.19"
"2025-02-05","2025-02-01","SF FuneralF1129406      250201","","126.5","","2142398.69"
"2025-02-05","2025-02-01","SF FuneralF1129496      250201","","126.5","","2142525.19"
"2025-02-05","2025-02-03","SF FuneralFDC00000008B0X250203","","126.5","","2142651.69"
"2025-02-05","2025-02-03","SF FuneralF843968       250201","","126.5","","2142778.19"
"2025-02-05","2025-02-03","SF FuneralF844034       250201","","126.5","","2142904.69"
"2025-02-05","2025-02-03","SF FuneralF844205       250201","","126.5","","2143031.19"
"2025-02-05","2025-02-03","SF FuneralF844368       250201","","126.5","","2143157.69"
"2025-02-05","2025-02-03","SF FuneralF900779       250201","","126.5","","2143284.19"
"2025-02-05","2025-02-03","SF FuneralF1115792      250203","","126.5","","2143410.69"
"2025-02-05","2025-01-30","SF FuneralF842552       250130","","126.5","","2143537.19"
"2025-02-05","2025-02-05","SF FuneralFDC00000007RSM250205","","126.5","","2143663.69"
"2025-02-05","2025-01-31","SF FuneralF901022       250202","","126.5","","2143790.19"
"2025-02-05","2025-01-31","SF FuneralF901087       250202","","126.5","","2143916.69"
"2025-02-05","2025-01-31","SF FuneralF986680       250201","","126.5","","2144043.19"
"2025-02-05","2025-01-31","SF FuneralF987791       250201","","126.5","","2144169.69"
"2025-02-05","2025-01-31","SF FuneralF987808       250201","","126.5","","2144296.19"
"2025-02-05","2025-01-31","SF FuneralF987848       250201","","126.5","","2144422.69"
"2025-02-05","2025-01-31","SF FuneralF987928       250201","","126.5","","2144549.19"
"2025-02-05","2025-01-31","SF FuneralF987971       250201","","126.5","","2144675.69"
"2025-02-05","2025-01-31","SF FuneralF719196       250201","","220","","2144895.69"
"2025-02-05","2025-01-31","SF FuneralF988289       250201","","126.5","","2145022.19"
"2025-02-05","2025-01-31","SF FuneralF988301       250201","","126.5","","2145148.69"
"2025-02-05","2025-01-31","SF FuneralF988612       250201","","126.5","","2145275.19"
"2025-02-05","2025-01-31","SF FuneralF990173       250201","","126.5","","2145401.69"
"2025-02-05","2025-01-31","SF FuneralF990616       250201","","126.5","","2145528.19"
"2025-02-05","2025-02-01","SF FuneralF1128990      250201","","126.5","","2145654.69"
"2025-02-05","2025-02-01","SF FuneralF1128996      250201","","126.5","","2145781.19"
"2025-02-05","2025-02-01","SF FuneralF1129146      250201","","126.5","","2145907.69"
"2025-02-05","2025-02-01","SF FuneralF1129148      250201","","126.5","","2146034.19"
"2025-02-05","2025-02-01","SF FuneralF1129150      250202","","126.5","","2146160.69"
"2025-02-05","2025-02-03","SF FuneralFDC00000003CHV250202","","220","","2146380.69"
"2025-02-05","2025-02-03","SF FuneralFDC00000005XTF250202","","126.5","","2146507.19"
"2025-02-05","2025-02-03","SF FuneralFDC00000006XCZ250202","","126.5","","2146633.69"
"2025-02-05","2025-02-03","SF FuneralFDC00000006XD1250202","","126.5","","2146760.19"
"2025-02-05","2025-02-03","SF FuneralF802871       250202","","126.5","","2146886.69"
"2025-02-05","2025-02-03","SF FuneralFDC00000008N59250203","","63.25","","2146949.94"
"2025-02-05","2025-02-03","SF FuneralF804746       250202","","126.5","","2147076.44"
"2025-02-05","2025-02-03","SF FuneralF811590       250203","","126.5","","2147202.94"
"2025-02-05","2025-02-03","SF FuneralF812446       250202","","126.5","","2147329.44"
"2025-02-05","2025-02-03","SF FuneralF812740       250202","","126.5","","2147455.94"
"2025-02-05","2025-02-03","SF FuneralF816762       250202","","126.5","","2147582.44"
"2025-02-05","2025-02-03","SF FuneralF828285       250203","","126.5","","2147708.94"
"2025-02-05","2025-02-03","SF FuneralF843096       250201","","126.5","","2147835.44"
"2025-02-05","2025-02-03","SF FuneralF843124       250201","","126.5","","2147961.94"
"2025-02-05","2025-02-03","SF FuneralF843729       250201","","126.5","","2148088.44"
"2025-02-05","2025-02-03","SF FuneralF843829       250201","","126.5","","2148214.94"
"2025-02-05","2025-02-03","SF FuneralF844156       250201","","126.5","","2148341.44"
"2025-02-05","2025-02-03","SF FuneralF844437       250201","","126.5","","2148467.94"
"2025-02-05","2025-02-03","SF FuneralF844469       250201","","126.5","","2148594.44"
"2025-02-05","2025-02-03","SF FuneralF844700       250201","","126.5","","2148720.94"
"2025-02-05","2025-02-03","SF FuneralF847276       250201","","126.5","","2148847.44"
"2025-02-05","2025-02-03","SF FuneralF900762       250201","","126.5","","2148973.94"
"2025-02-05","2025-02-03","SF FuneralF1021419      250203","","126.5","","2149100.44"
"2025-02-05","2025-02-03","SF FuneralF1066376      250203","","126.5","","2149226.94"
"2025-02-05","2025-02-03","SF FuneralF1073276      250203","","126.5","","2149353.44"
"2025-02-05","2025-02-03","SF FuneralF1079632      250203","","126.5","","2149479.94"
"2025-02-05","2025-02-03","SF FuneralF1084470      250203","","126.5","","2149606.44"
"2025-02-05","2025-02-03","SF FuneralFDC0000000M3PX250203","","126.5","","2149732.94"
"2025-02-05","2025-02-03","SF FuneralF1114105      250203","","126.5","","2149859.44"
"2025-02-05","2025-02-03","SF FuneralF1118041      250203","","126.5","","2149985.94"
"2025-02-05","2025-02-03","SF FuneralFDC0000000NMNL250203","","126.5","","2150112.44"
"2025-02-05","2025-02-03","SF FuneralF1118485      250203","","126.5","","2150238.94"
"2025-02-05","2025-02-03","SF FuneralFDC0000000NR4T250203","","126.5","","2150365.44"
"2025-02-05","2025-02-03","SF FuneralF1119008      250203","","126.5","","2150491.94"
"2025-02-05","2025-02-03","SF FuneralF1119762      250203","","126.5","","2150618.44"
"2025-02-05","2025-02-03","SF FuneralF1129332      250203","","126.5","","2150744.94"
"2025-02-05","2025-02-01","SF FuneralFDC000000039XF250201","","220","","2150964.94"
"2025-02-05","2025-02-01","SF FuneralFDC00000005QGT250201","","126.5","","2151091.44"
"2025-02-05","2025-02-01","SF FuneralFDC00000005RYS250201","","126.5","","2151217.94"
"2025-02-05","2025-02-01","SF FuneralFDC00000005S0L250201","","126.5","","2151344.44"
"2025-02-05","2025-02-01","SF FuneralFDC00000005TWP250201","","126.5","","2151470.94"
"2025-02-05","2025-02-01","SF FuneralFDC00000006KQY250201","","126.5","","2151597.44"
"2025-02-05","2025-02-01","SF FuneralFDC00000006L17250201","","126.5","","2151723.94"
"2025-02-05","2025-02-01","SF FuneralFDC00000006L89250201","","126.5","","2151850.44"
"2025-02-05","2025-02-01","SF FuneralFDC00000006Q77250201","","126.5","","2151976.94"
"2025-02-05","2025-02-01","SF FuneralFDC00000006QYV250201","","126.5","","2152103.44"
"2025-02-05","2025-02-01","SF FuneralFDC00000006W8H250201","","126.5","","2152229.94"
"2025-02-05","2025-02-01","SF FuneralFDC00000007446250201","","126.5","","2152356.44"
"2025-02-05","2025-02-01","SF FuneralFDC0000000749C250201","","126.5","","2152482.94"
"2025-02-05","2025-02-01","SF FuneralFDC0000000749F250201","","126.5","","2152609.44"
"2025-02-05","2025-02-01","SF FuneralFDC000000075J9250201","","126.5","","2152735.94"
"2025-02-05","2025-02-01","SF FuneralFDC000000078YM250201","","126.5","","2152862.44"
"2025-02-05","2025-02-01","SF FuneralFDC0000000792L250201","","126.5","","2152988.94"
"2025-02-05","2025-02-01","SF FuneralFDC00000007FSK250201","","126.5","","2153115.44"
"2025-02-05","2025-02-01","SF FuneralFDC00000007HMD250201","","126.5","","2153241.94"
"2025-02-05","2025-02-01","SF FuneralFDC00000007QBF250201","","126.5","","2153368.44"
"2025-02-05","2025-02-01","SF FuneralFDC00000007QLK250201","","126.5","","2153494.94"
"2025-02-05","2025-02-01","SF FuneralFDC00000007QLN250201","","126.5","","2153621.44"
"2025-02-05","2025-02-01","SF FuneralFDC00000007QZ5250201","","126.5","","2153747.94"
"2025-02-05","2025-02-01","SF FuneralF794059       250201","","126.5","","2153874.44"
"2025-02-05","2025-02-01","SF FuneralF794301       250201","","126.5","","2154000.94"
"2025-02-05","2025-02-01","SF FuneralF794476       250201","","126.5","","2154127.44"
"2025-02-05","2025-02-01","SF FuneralFDC00000007RZG250201","","126.5","","2154253.94"
"2025-02-05","2025-02-01","SF FuneralF794703       250201","","126.5","","2154380.44"
"2025-02-05","2025-02-01","SF FuneralFDC00000007TBZ250201","","220","","2154600.44"
"2025-02-05","2025-02-01","SF FuneralFDC00000007VNC250201","","126.5","","2154726.94"
"2025-02-05","2025-02-01","SF FuneralFDC00000007W2J250201","","126.5","","2154853.44"
"2025-02-05","2025-02-01","SF FuneralFDC00000007YXP250201","","126.5","","2154979.94"
"2025-02-05","2025-02-01","SF FuneralF798004       250201","","126.5","","2155106.44"
"2025-02-05","2025-02-01","SF FuneralFDC000000084F9250201","","126.5","","2155232.94"
"2025-02-05","2025-02-01","SF FuneralFDC000000084L2250201","","126.5","","2155359.44"
"2025-02-05","2025-02-01","SF FuneralF799649       250201","","126.5","","2155485.94"
"2025-02-05","2025-02-01","SF FuneralF799704       250201","","126.5","","2155612.44"
"2025-02-05","2025-02-01","SF FuneralFDC00000008N4V250201","","126.5","","2155738.94"
"2025-02-05","2025-02-01","SF FuneralF803598       250201","","126.5","","2155865.44"
"2025-02-05","2025-02-01","SF FuneralFDC00000008NPV250201","","126.5","","2155991.94"
"2025-02-05","2025-02-01","SF FuneralF804016       250201","","126.5","","2156118.44"
"2025-02-05","2025-02-01","SF FuneralF805053       250201","","126.5","","2156244.94"
"2025-02-05","2025-02-01","SF FuneralF820993       250201","","126.5","","2156371.44"
"2025-02-05","2025-02-01","SF FuneralF821374       250201","","126.5","","2156497.94"
"2025-02-05","2025-02-01","SF FuneralF821659       250201","","126.5","","2156624.44"
"2025-02-05","2025-02-01","SF FuneralF821898       250201","","126.5","","2156750.94"
"2025-02-05","2025-02-01","SF FuneralF831159       250201","","126.5","","2156877.44"
"2025-02-05","2025-02-01","SF FuneralF831249       250201","","126.5","","2157003.94"
"2025-02-05","2025-02-01","SF FuneralF831271       250201","","126.5","","2157130.44"
"2025-02-05","2025-02-01","SF FuneralF832028       250201","","191.5","","2157321.94"
"2025-02-05","2025-02-01","SF FuneralF832304       250201","","126.5","","2157448.44"
"2025-02-05","2025-02-01","SF FuneralF832345       250201","","126.5","","2157574.94"
"2025-02-05","2025-02-01","SF FuneralF832427       250201","","126.5","","2157701.44"
"2025-02-05","2025-02-01","SF FuneralF828561       250201","","126.5","","2157827.94"
"2025-02-05","2025-02-01","SF FuneralF832651       250201","","126.5","","2157954.44"
"2025-02-05","2025-02-01","SF FuneralF832665       250201","","126.5","","2158080.94"
"2025-02-05","2025-02-01","SF FuneralF833476       250201","","126.5","","2158207.44"
"2025-02-05","2025-02-01","SF FuneralF842266       250201","","126.5","","2158333.94"
"2025-02-05","2025-02-01","SF FuneralF991956       250201","","126.5","","2158460.44"
"2025-02-05","2025-02-01","SF FuneralF992920       250201","","126.5","","2158586.94"
"2025-02-05","2025-02-01","SF FuneralF992921       250201","","126.5","","2158713.44"
"2025-02-05","2025-02-01","SF FuneralF992963       250201","","126.5","","2158839.94"
"2025-02-05","2025-02-01","SF FuneralFDC0000000JBPV250201","","408.31","","2159248.25"
"2025-02-05","2025-02-01","SF FuneralF1021469      250201","","126.5","","2159374.75"
"2025-02-05","2025-02-01","SF FuneralF1021473      250201","","126.5","","2159501.25"
"2025-02-05","2025-02-01","SF FuneralF1021492      250201","","126.5","","2159627.75"
"2025-02-05","2025-02-01","SF FuneralF1021826      250201","","126.5","","2159754.25"
"2025-02-05","2025-02-01","SF FuneralF1022233      250201","","126.5","","2159880.75"
"2025-02-05","2025-02-01","SF FuneralF1033524      250201","","126.5","","2160007.25"
"2025-02-05","2025-02-01","SF FuneralF1033871      250201","","126.5","","2160133.75"
"2025-02-05","2025-02-01","SF FuneralF1034029      250201","","126.5","","2160260.25"
"2025-02-05","2025-02-01","SF FuneralF1052538      250201","","126.5","","2160386.75"
"2025-02-05","2025-02-01","SF FuneralF1058681      250201","","126.5","","2160513.25"
"2025-02-05","2025-02-01","SF FuneralF1058682      250201","","126.5","","2160639.75"
"2025-02-05","2025-02-01","SF FuneralF1058685      250201","","126.5","","2160766.25"
"2025-02-05","2025-02-01","SF FuneralF1058711      250201","","126.5","","2160892.75"
"2025-02-05","2025-02-01","SF FuneralF1058774      250201","","126.5","","2161019.25"
"2025-02-05","2025-02-01","SF FuneralF1058777      250201","","126.5","","2161145.75"
"2025-02-05","2025-02-01","SF FuneralF1058835      250201","","126.5","","2161272.25"
"2025-02-05","2025-02-01","SF FuneralF1059291      250202","","126.5","","2161398.75"
"2025-02-05","2025-02-01","SF FuneralF1061641      250202","","126.5","","2161525.25"
"2025-02-05","2025-02-01","SF FuneralF1066199      250201","","126.5","","2161651.75"
"2025-02-05","2025-02-01","SF FuneralF1066407      250201","","126.5","","2161778.25"
"2025-02-05","2025-02-01","SF FuneralF1066417      250201","","126.5","","2161904.75"
"2025-02-05","2025-02-01","SF FuneralF1066441      250201","","126.5","","2162031.25"
"2025-02-05","2025-02-01","SF FuneralF1067907      250201","","126.5","","2162157.75"
"2025-02-05","2025-02-01","SF FuneralFDC0000000LCZ4250201","","126.5","","2162284.25"
"2025-02-05","2025-02-01","SF FuneralF1078097      250201","","126.5","","2162410.75"
"2025-02-05","2025-02-01","SF FuneralF1078494      250201","","126.5","","2162537.25"
"2025-02-05","2025-02-01","SF FuneralF1078512      250201","","126.5","","2162663.75"
"2025-02-05","2025-02-01","SF FuneralF1078563      250201","","126.5","","2162790.25"
"2025-02-05","2025-02-01","SF FuneralF1078593      250201","","126.5","","2162916.75"
"2025-02-05","2025-02-01","SF FuneralFDC0000000LGTL250201","","126.5","","2163043.25"
"2025-02-05","2025-02-01","SF FuneralF1079055      250201","","126.5","","2163169.75"
"2025-02-05","2025-02-01","SF FuneralF1079249      250201","","126.5","","2163296.25"
"2025-02-05","2025-02-01","SF FuneralF1079326      250201","","126.5","","2163422.75"
"2025-02-05","2025-02-01","SF FuneralF1079711      250201","","126.5","","2163549.25"
"2025-02-05","2025-02-01","SF FuneralF1079723      250201","","126.5","","2163675.75"
"2025-02-05","2025-02-01","SF FuneralF1080211      250201","","126.5","","2163802.25"
"2025-02-05","2025-02-01","SF FuneralF1080381      250201","","126.5","","2163928.75"
"2025-02-05","2025-02-01","SF FuneralF1084572      250201","","126.5","","2164055.25"
"2025-02-05","2025-02-01","SF FuneralF1084631      250201","","126.5","","2164181.75"
"2025-02-05","2025-02-01","SF FuneralF1102923      250201","","126.5","","2164308.25"
"2025-02-05","2025-02-01","SF FuneralF1109078      250201","","126.5","","2164434.75"
"2025-02-05","2025-02-01","SF FuneralF1109585      250201","","126.5","","2164561.25"
"2025-02-05","2025-02-01","SF FuneralF1109692      250201","","126.5","","2164687.75"
"2025-02-05","2025-02-01","SF FuneralF1109759      250201","","126.5","","2164814.25"
"2025-02-05","2025-02-01","SF FuneralF1110049      250201","","126.5","","2164940.75"
"2025-02-05","2025-02-01","SF FuneralF1110118      250201","","126.5","","2165067.25"
"2025-02-05","2025-02-01","SF FuneralF1085222      250201","","126.5","","2165193.75"
"2025-02-05","2025-02-01","SF FuneralF1110199      250201","","126.5","","2165320.25"
"2025-02-05","2025-02-01","SF FuneralFDC0000000MN79250201","","126.5","","2165446.75"
"2025-02-05","2025-02-01","SF FuneralF1110553      250201","","126.5","","2165573.25"
"2025-02-05","2025-02-01","SF FuneralF1110619      250201","","126.5","","2165699.75"
"2025-02-05","2025-02-01","SF FuneralF1110651      250201","","126.5","","2165826.25"
"2025-02-05","2025-02-01","SF FuneralF1111387      250201","","126.5","","2165952.75"
"2025-02-05","2025-02-01","SF FuneralF1111611      250201","","126.5","","2166079.25"
"2025-02-05","2025-02-01","SF FuneralFDC0000000MTJW250201","","126.5","","2166205.75"
"2025-02-05","2025-02-01","SF FuneralF1113284      250201","","126.5","","2166332.25"
"2025-02-05","2025-02-01","SF FuneralF1115179      250201","","126.5","","2166458.75"
"2025-02-05","2025-02-01","SF FuneralF1115742      250201","","126.5","","2166585.25"
"2025-02-05","2025-02-01","SF FuneralF1117679      250201","","126.5","","2166711.75"
"2025-02-05","2025-02-01","SF FuneralF1117704      250201","","126.5","","2166838.25"
"2025-02-05","2025-02-01","SF FuneralF1117927      250201","","126.5","","2166964.75"
"2025-02-05","2025-02-01","SF FuneralF1117999      250201","","126.5","","2167091.25"
"2025-02-05","2025-02-01","SF FuneralF1118036      250201","","126.5","","2167217.75"
"2025-02-05","2025-02-01","SF FuneralF1118093      250201","","126.5","","2167344.25"
"2025-02-05","2025-02-01","SF FuneralF1118283      250201","","126.5","","2167470.75"
"2025-02-05","2025-02-01","SF FuneralF1118286      250201","","126.5","","2167597.25"
"2025-02-05","2025-02-01","SF FuneralF1118438      250201","","126.5","","2167723.75"
"2025-02-05","2025-02-01","SF FuneralF1118532      250201","","126.5","","2167850.25"
"2025-02-05","2025-02-01","SF FuneralF1118982      250201","","126.5","","2167976.75"
"2025-02-05","2025-02-01","SF FuneralF1122016      250201","","126.5","","2168103.25"
"2025-02-05","2025-02-01","SF FuneralF1122034      250202","","126.5","","2168229.75"
"2025-02-05","2025-02-01","SF FuneralF1122268      250201","","126.5","","2168356.25"
"2025-02-05","2025-02-01","SF FuneralF1122311      250201","","126.5","","2168482.75"
"2025-02-05","2025-02-01","SF FuneralF765176       250201","","220","","2168702.75"
"2025-02-05","2025-02-01","SF FuneralFDC0000000P9CK250201","","126.5","","2168829.25"
"2025-02-05","2025-02-01","SF FuneralF1125030      250201","","126.5","","2168955.75"
"2025-02-05","2025-02-01","SF FuneralFDC0000000PDDF250201","","126.5","","2169082.25"
"2025-02-05","2025-02-01","SF FuneralF1126022      250201","","126.5","","2169208.75"
"2025-02-05","2025-02-01","SF FuneralFDC0000000PKN5250201","","126.5","","2169335.25"
"2025-02-05","2025-02-01","SF FuneralF1126269      250201","","126.5","","2169461.75"
"2025-02-05","2025-02-01","SF FuneralF1127569      250201","","126.5","","2169588.25"
"2025-02-05","2025-02-01","SF FuneralFDC0000000PQ0N250201","","126.5","","2169714.75"
"2025-02-05","2025-02-01","SF FuneralFDC0000000PQ35250201","","126.5","","2169841.25"
"2025-02-05","2025-02-01","SF FuneralF1127585      250201","","126.5","","2169967.75"
"2025-02-05","2025-02-01","SF FuneralF1127587      250201","","126.5","","2170094.25"
"2025-02-05","2025-02-01","SF FuneralFDC0000000PRPQ250201","","126.5","","2170220.75"
"2025-02-05","2025-02-01","SF FuneralF1127969      250201","","126.5","","2170347.25"
"2025-02-05","2025-02-01","SF FuneralF1128048      250201","","126.5","","2170473.75"
"2025-02-05","2025-02-01","SF FuneralFDC0000000PV3G250201","","126.5","","2170600.25"
"2025-02-05","2025-02-01","SF FuneralF1128196      250201","","126.5","","2170726.75"
"2025-02-05","2025-02-01","SF FuneralF1128346      250201","","126.5","","2170853.25"
"2025-02-05","2025-02-01","SF FuneralFDC0000000PVZW250201","","126.5","","2170979.75"
"2025-02-05","2025-02-01","SF FuneralF1128752      250201","","126.5","","2171106.25"
"2025-02-05","2025-02-01","SF FuneralF1128827      250201","","126.5","","2171232.75"
"2025-02-05","2025-02-05","SF FuneralFDC000000032C2250205","","55","","2171287.75"
"2025-02-05","2025-02-05","SF FuneralFDC000000040X5250205","","220","","2171507.75"
"2025-02-05","2025-02-05","SF FuneralF799232       250205","","126.5","","2171634.25"
"2025-02-05","2025-02-05","SF FuneralF777738       250205","","126.5","","2171760.75"
"2025-02-05","2025-02-05","SF FuneralFDC0000000JB70250205","","126.5","","2171887.25"
"2025-02-05","2025-02-05","SF FuneralF1117883      250205","","126.5","","2172013.75"
"2025-02-05","2025-02-05","SF FuneralF1124159      250205","","63.25","","2172077"
"2025-02-05","2025-01-31","SF FuneralF841749       250131","","31.63","","2172108.63"
"2025-02-05","2025-01-27","SF FuneralF1122072      250127","","126.5","","2172235.13"
"2025-02-05","2025-01-28","SF FuneralFDC00000005WZF250128","","220","","2172455.13"
"2025-02-05","2025-01-28","SF FuneralF804886       250128","","126.5","","2172581.63"
"2025-02-05","2025-01-28","SF FuneralF1114477      250128","","126.5","","2172708.13"
"2025-02-05","2025-01-28","SF FuneralF1114593      250128","","126.5","","2172834.63"
"2025-02-05","2025-01-28","SF FuneralF1119708      250128","","126.5","","2172961.13"
"2025-02-05","2025-01-29","SF FuneralFDC00000006LT6250129","","126.5","","2173087.63"
"2025-02-05","2025-01-29","SF FuneralFDC000000077RV250129","","126.5","","2173214.13"
"2025-02-05","2025-01-30","SF FuneralFDC00000006Q13250130","","126.5","","2173340.63"
"2025-02-05","2025-01-30","SF FuneralF798304       250130","","126.5","","2173467.13"
"2025-02-05","2025-01-30","SF FuneralF809045       250130","","126.5","","2173593.63"
"2025-02-05","2025-01-30","SF FuneralF841452       250130","","126.5","","2173720.13"
"2025-02-05","2025-01-30","SF FuneralF1060071      250130","","126.5","","2173846.63"
"2025-02-05","2025-01-30","SF FuneralF1121992      250130","","126.5","","2173973.13"
"2025-02-05","2025-01-30","SF FuneralFDC0000000P0J8250130","","126.5","","2174099.63"
"2025-02-05","2025-01-31","SF FuneralFDC00000006QWS250131","","126.5","","2174226.13"
"2025-02-05","2025-01-31","SF FuneralFDC00000007449250131","","126.5","","2174352.63"
"2025-02-05","2025-01-31","SF FuneralFDC00000007787250131","","126.5","","2174479.13"
"2025-02-05","2025-01-31","SF FuneralFDC000000078LS250131","","126.5","","2174605.63"
"2025-02-05","2025-01-31","SF FuneralFDC00000007DR9250131","","126.5","","2174732.13"
"2025-02-05","2025-01-31","SF FuneralFDC000000084MQ250131","","126.5","","2174858.63"
"2025-02-05","2025-01-31","SF FuneralFDC0000000B7Y7250131","","126.5","","2174985.13"
"2025-02-05","2025-01-31","SF FuneralFDC0000000H1LF250201","","126.5","","2175111.63"
"2025-02-05","2025-01-31","SF FuneralF901037       250201","","126.5","","2175238.13"
"2025-02-05","2025-01-31","SF FuneralF901069       250201","","126.5","","2175364.63"
"2025-02-05","2025-01-31","SF FuneralF901353       250201","","126.5","","2175491.13"
"2025-02-05","2025-01-31","SF FuneralFDC0000000H6N1250201","","126.5","","2175617.63"
"2025-02-05","2025-01-31","SF FuneralF901494       250201","","126.5","","2175744.13"
"2025-02-05","2025-01-31","SF FuneralF980334       250201","","126.5","","2175870.63"
"2025-02-05","2025-01-31","SF FuneralF980541       250201","","126.5","","2175997.13"
"2025-02-05","2025-01-31","SF FuneralF981079       250201","","126.5","","2176123.63"
"2025-02-05","2025-01-31","SF FuneralF981145       250201","","126.5","","2176250.13"
"2025-02-05","2025-01-31","SF FuneralF981153       250201","","126.5","","2176376.63"
"2025-02-05","2025-01-31","SF FuneralF981369       250201","","126.5","","2176503.13"
"2025-02-05","2025-01-31","SF FuneralF981512       250201","","126.5","","2176629.63"
"2025-02-05","2025-01-31","SF FuneralF981567       250201","","126.5","","2176756.13"
"2025-02-05","2025-01-31","SF FuneralF981814       250201","","126.5","","2176882.63"
"2025-02-05","2025-01-31","SF FuneralF986750       250201","","126.5","","2177009.13"
"2025-02-05","2025-01-31","SF FuneralFDC0000000HLZJ250201","","126.5","","2177135.63"
"2025-02-05","2025-01-31","SF FuneralF987003       250201","","126.5","","2177262.13"
"2025-02-05","2025-01-31","SF FuneralF987385       250201","","126.5","","2177388.63"
"2025-02-05","2025-01-31","SF FuneralF987689       250201","","126.5","","2177515.13"
"2025-02-05","2025-01-31","SF FuneralF987747       250201","","126.5","","2177641.63"
"2025-02-05","2025-01-31","SF FuneralF987907       250201","","126.5","","2177768.13"
"2025-02-05","2025-01-31","SF FuneralFDC0000000HTXZ250201","","126.5","","2177894.63"
"2025-02-05","2025-01-31","SF FuneralF987987       250201","","126.5","","2178021.13"
"2025-02-05","2025-01-31","SF FuneralF988037       250201","","126.5","","2178147.63"
"2025-02-05","2025-01-31","SF FuneralFDC0000000HW71250202","","126.5","","2178274.13"
"2025-02-05","2025-01-31","SF FuneralF988309       250202","","126.5","","2178400.63"
"2025-02-05","2025-01-31","SF FuneralF776209       250201","","126.5","","2178527.13"
"2025-02-05","2025-01-31","SF FuneralF988320       250201","","256.5","","2178783.63"
"2025-02-05","2025-01-31","SF FuneralF988370       250201","","126.5","","2178910.13"
"2025-02-05","2025-01-31","SF FuneralF988383       250201","","126.5","","2179036.63"
"2025-02-05","2025-01-31","SF FuneralF988631       250202","","126.5","","2179163.13"
"2025-02-05","2025-01-31","SF FuneralF988762       250201","","126.5","","2179289.63"
"2025-02-05","2025-01-31","SF FuneralFDC0000000HY31250201","","126.5","","2179416.13"
"2025-02-05","2025-01-31","SF FuneralF989115       250201","","126.5","","2179542.63"
"2025-02-05","2025-01-31","SF FuneralFDC0000000HYPG250201","","126.5","","2179669.13"
"2025-02-05","2025-01-31","SF FuneralF989602       250201","","126.5","","2179795.63"
"2025-02-05","2025-01-31","SF FuneralFDC0000000J0BL250201","","126.5","","2179922.13"
"2025-02-05","2025-01-31","SF FuneralF990764       250201","","126.5","","2180048.63"
"2025-02-05","2025-01-31","SF FuneralF1109852      250131","","126.5","","2180175.13"
"2025-02-05","2025-01-31","SF FuneralF1126131      250131","","126.5","","2180301.63"
"2025-02-05","2025-02-01","SF FuneralFDC00000005YZC250201","","126.5","","2180428.13"
"2025-02-05","2025-02-01","SF FuneralFDC00000005YZR250201","","126.5","","2180554.63"
"2025-02-05","2025-02-01","SF FuneralFDC000000063HZ250201","","126.5","","2180681.13"
"2025-02-05","2025-02-01","SF FuneralFDC00000006BGX250201","","126.5","","2180807.63"
"2025-02-05","2025-02-01","SF FuneralFDC00000006BSS250201","","126.5","","2180934.13"
"2025-02-05","2025-02-01","SF FuneralFDC00000006C6C250201","","126.5","","2181060.63"
"2025-02-05","2025-02-01","SF FuneralFDC00000006HJH250201","","126.5","","2181187.13"
"2025-02-05","2025-02-01","SF FuneralFDC00000006PN6250201","","126.5","","2181313.63"
"2025-02-05","2025-02-01","SF FuneralFDC000000070NN250201","","126.5","","2181440.13"
"2025-02-05","2025-02-01","SF FuneralFDC0000000751X250201","","126.5","","2181566.63"
"2025-02-05","2025-02-01","SF FuneralFDC0000000787Z250201","","126.5","","2181693.13"
"2025-02-05","2025-02-01","SF FuneralFDC00000007RK9250201","","126.5","","2181819.63"
"2025-02-05","2025-02-01","SF FuneralFDC00000007RM4250201","","126.5","","2181946.13"
"2025-02-05","2025-02-01","SF FuneralF808759       250201","","126.5","","2182072.63"
"2025-02-05","2025-02-01","SF FuneralF816898       250201","","126.5","","2182199.13"
"2025-02-05","2025-02-01","SF FuneralF816901       250201","","126.5","","2182325.63"
"2025-02-05","2025-02-01","SF FuneralF816923       250201","","126.5","","2182452.13"
"2025-02-05","2025-02-01","SF FuneralF821279       250201","","126.5","","2182578.63"
"2025-02-05","2025-02-01","SF FuneralF821289       250201","","126.5","","2182705.13"
"2025-02-05","2025-02-01","SF FuneralF821317       250201","","126.5","","2182831.63"
"2025-02-05","2025-02-01","SF FuneralF822938       250201","","126.5","","2182958.13"
"2025-02-05","2025-02-01","SF FuneralF822957       250201","","126.5","","2183084.63"
"2025-02-05","2025-02-01","SF FuneralF823271       250201","","126.5","","2183211.13"
"2025-02-05","2025-02-01","SF FuneralF827808       250201","","126.5","","2183337.63"
"2025-02-05","2025-02-01","SF FuneralF828403       250201","","126.5","","2183464.13"
"2025-02-05","2025-02-01","SF FuneralF828475       250201","","126.5","","2183590.63"
"2025-02-05","2025-02-01","SF FuneralF832406       250201","","126.5","","2183717.13"
"2025-02-05","2025-02-01","SF FuneralF841495       250201","","126.5","","2183843.63"
"2025-02-05","2025-02-01","SF FuneralF841626       250201","","126.5","","2183970.13"
"2025-02-05","2025-02-01","SF FuneralF789788       250201","","126.5","","2184096.63"
"2025-02-05","2025-02-01","SF FuneralF841638       250201","","126.5","","2184223.13"
"2025-02-05","2025-02-01","SF FuneralF841660       250201","","126.5","","2184349.63"
"2025-02-05","2025-02-01","SF FuneralF841766       250201","","126.5","","2184476.13"
"2025-02-05","2025-02-01","SF FuneralF841786       250201","","126.5","","2184602.63"
"2025-02-05","2025-02-01","SF FuneralF842836       250201","","126.5","","2184729.13"
"2025-02-05","2025-02-01","SF FuneralF842849       250201","","126.5","","2184855.63"
"2025-02-05","2025-02-01","SF FuneralF842884       250201","","126.5","","2184982.13"
"2025-02-05","2025-02-01","SF FuneralF992603       250201","","126.5","","2185108.63"
"2025-02-05","2025-02-01","SF FuneralF992641       250201","","126.5","","2185235.13"
"2025-02-05","2025-02-01","SF FuneralF992655       250201","","126.5","","2185361.63"
"2025-02-05","2025-02-01","SF FuneralF993218       250201","","126.5","","2185488.13"
"2025-02-05","2025-02-01","SF FuneralF993333       250201","","126.5","","2185614.63"
"2025-02-05","2025-02-01","SF FuneralFDC0000000JCN7250201","","126.5","","2185741.13"
"2025-02-05","2025-02-01","SF FuneralFDC0000000JXLN250201","","126.5","","2185867.63"
"2025-02-05","2025-02-01","SF FuneralF1060083      250201","","126.5","","2185994.13"
"2025-02-05","2025-02-01","SF FuneralFDC0000000KCJJ250201","","126.5","","2186120.63"
"2025-02-05","2025-02-01","SF FuneralF1060196      250201","","126.5","","2186247.13"
"2025-02-05","2025-02-01","SF FuneralF1060234      250201","","126.5","","2186373.63"
"2025-02-05","2025-02-01","SF FuneralF1060389      250201","","126.5","","2186500.13"
"2025-02-05","2025-02-01","SF FuneralF1060441      250202","","126.5","","2186626.63"
"2025-02-05","2025-02-01","SF FuneralF1060696      250201","","126.5","","2186753.13"
"2025-02-05","2025-02-01","SF FuneralF1060799      250201","","126.5","","2186879.63"
"2025-02-05","2025-02-01","SF FuneralF1061045      250201","","126.5","","2187006.13"
"2025-02-05","2025-02-01","SF FuneralF1066566      250201","","126.5","","2187132.63"
"2025-02-05","2025-02-01","SF FuneralF1066568      250201","","126.5","","2187259.13"
"2025-02-05","2025-02-01","SF FuneralF1066569      250201","","126.5","","2187385.63"
"2025-02-05","2025-02-01","SF FuneralF1066580      250201","","126.5","","2187512.13"
"2025-02-05","2025-02-01","SF FuneralF1066696      250201","","126.5","","2187638.63"
"2025-02-05","2025-02-01","SF FuneralF1078193      250201","","126.5","","2187765.13"
"2025-02-05","2025-02-01","SF FuneralF1078223      250201","","126.5","","2187891.63"
"2025-02-05","2025-02-01","SF FuneralF1078331      250201","","126.5","","2188018.13"
"2025-02-05","2025-02-01","SF FuneralF1078370      250201","","126.5","","2188144.63"
"2025-02-05","2025-02-01","SF FuneralF1078417      250201","","126.5","","2188271.13"
"2025-02-05","2025-02-01","SF FuneralF1103563      250201","","126.5","","2188397.63"
"2025-02-05","2025-02-01","SF FuneralF1103609      250201","","126.5","","2188524.13"
"2025-02-05","2025-02-01","SF FuneralF1103640      250201","","126.5","","2188650.63"
"2025-02-05","2025-02-01","SF FuneralF1103659      250202","","126.5","","2188777.13"
"2025-02-05","2025-02-01","SF FuneralF1109643      250201","","126.5","","2188903.63"
"2025-02-05","2025-02-01","SF FuneralF1110238      250201","","126.5","","2189030.13"
"2025-02-05","2025-02-01","SF FuneralF1111351      250201","","126.5","","2189156.63"
"2025-02-05","2025-02-01","SF FuneralF1111671      250201","","126.5","","2189283.13"
"2025-02-05","2025-02-01","SF FuneralFDC0000000MY34250201","","126.5","","2189409.63"
"2025-02-05","2025-02-01","SF FuneralF1112097      250201","","126.5","","2189536.13"
"2025-02-05","2025-02-01","SF FuneralF1113267      250201","","126.5","","2189662.63"
"2025-02-05","2025-02-01","SF FuneralF1113335      250201","","126.5","","2189789.13"
"2025-02-05","2025-02-01","SF FuneralF1111515      250201","","126.5","","2189915.63"
"2025-02-05","2025-02-01","SF FuneralF1113347      250201","","126.5","","2190042.13"
"2025-02-05","2025-02-01","SF FuneralF1114074      250201","","126.5","","2190168.63"
"2025-02-05","2025-02-01","SF FuneralF1114093      250201","","126.5","","2190295.13"
"2025-02-05","2025-02-01","SF FuneralF1114582      250201","","126.5","","2190421.63"
"2025-02-05","2025-02-01","SF FuneralF1117741      250201","","126.5","","2190548.13"
"2025-02-05","2025-02-01","SF FuneralF1117910      250201","","126.5","","2190674.63"
"2025-02-05","2025-02-01","SF FuneralF1120175      250201","","126.5","","2190801.13"
"2025-02-05","2025-02-01","SF FuneralF1120774      250201","","126.5","","2190927.63"
"2025-02-05","2025-02-01","SF FuneralF1121778      250202","","126.5","","2191054.13"
"2025-02-05","2025-02-01","SF FuneralF1122053      250201","","126.5","","2191180.63"
"2025-02-05","2025-02-01","SF FuneralF1122582      250201","","126.5","","2191307.13"
"2025-02-05","2025-02-01","SF FuneralFDC0000000PKGR250201","","126.5","","2191433.63"
"2025-02-05","2025-02-01","SF FuneralF1126175      250201","","126.5","","2191560.13"
"2025-02-05","2025-02-01","SF FuneralFDC0000000PTDT250201","","126.5","","2191686.63"
"2025-02-05","2025-02-01","SF FuneralF1128019      250201","","126.5","","2191813.13"
"2025-02-05","2025-02-01","SF FuneralF1128224      250201","","126.5","","2191939.63"
"2025-02-05","2025-02-01","SF FuneralF1128673      250201","","126.5","","2192066.13"
"2025-02-05","2025-02-01","SF FuneralFDC000000035VW250201","","220","","2192286.13"
"2025-02-05","2025-02-01","SF FuneralFDC00000003KD1250201","","220","","2192506.13"
"2025-02-05","2025-02-01","SF FuneralFDC000000058DP250201","","126.5","","2192632.63"
"2025-02-05","2025-02-01","SF FuneralFDC000000058HZ250201","","126.5","","2192759.13"
"2025-02-05","2025-02-01","SF FuneralFDC000000058KJ250201","","126.5","","2192885.63"
"2025-02-05","2025-02-01","SF FuneralFDC0000000695W250201","","126.5","","2193012.13"
"2025-02-05","2025-02-01","SF FuneralFDC000000069N4250201","","126.5","","2193138.63"
"2025-02-05","2025-02-01","SF FuneralFDC000000069N9250201","","126.5","","2193265.13"
"2025-02-05","2025-02-01","SF FuneralFDC000000069TJ250201","","126.5","","2193391.63"
"2025-02-05","2025-02-01","SF FuneralFDC000000069WV250201","","126.5","","2193518.13"
"2025-02-05","2025-02-01","SF FuneralFDC00000006B43250201","","126.5","","2193644.63"
"2025-02-05","2025-02-01","SF FuneralFDC00000006B9L250201","","126.5","","2193771.13"
"2025-02-05","2025-02-01","SF FuneralFDC00000006DH9250201","","126.5","","2193897.63"
"2025-02-05","2025-02-01","SF FuneralFDC00000006F09250201","","126.5","","2194024.13"
"2025-02-05","2025-02-01","SF FuneralFDC00000006GC4250201","","126.5","","2194150.63"
"2025-02-05","2025-02-01","SF FuneralFDC00000006H1K250201","","191.5","","2194342.13"
"2025-02-05","2025-02-01","SF FuneralFDC00000006H4R250201","","126.5","","2194468.63"
"2025-02-05","2025-02-01","SF FuneralFDC00000006HNV250201","","126.5","","2194595.13"
"2025-02-05","2025-02-01","SF FuneralFDC00000006J26250201","","126.5","","2194721.63"
"2025-02-05","2025-02-01","SF FuneralFDC00000006NLQ250201","","126.5","","2194848.13"
"2025-02-05","2025-02-01","SF FuneralFDC00000006NT8250201","","126.5","","2194974.63"
"2025-02-05","2025-02-01","SF FuneralFDC000000072QS250201","","126.5","","2195101.13"
"2025-02-05","2025-02-01","SF FuneralFDC000000074DV250201","","126.5","","2195227.63"
"2025-02-05","2025-02-01","SF FuneralFDC000000074H8250201","","126.5","","2195354.13"
"2025-02-05","2025-02-01","SF FuneralFDC000000074MD250201","","126.5","","2195480.63"
"2025-02-05","2025-02-01","SF FuneralFDC0000000765P250201","","126.5","","2195607.13"
"2025-02-05","2025-02-01","SF FuneralFDC000000076QP250201","","220","","2195827.13"
"2025-02-05","2025-02-01","SF FuneralFDC000000076QQ250201","","220","","2196047.13"
"2025-02-05","2025-02-01","SF FuneralFDC000000077RY250201","","126.5","","2196173.63"
"2025-02-05","2025-02-01","SF FuneralFDC00000007V2T250201","","126.5","","2196300.13"
"2025-02-05","2025-02-01","SF FuneralFDC00000007V6C250201","","191.5","","2196491.63"
"2025-02-05","2025-02-01","SF FuneralFDC000000086F4250201","","126.5","","2196618.13"
"2025-02-05","2025-02-01","SF FuneralF799015       250201","","126.5","","2196744.63"
"2025-02-05","2025-02-01","SF FuneralF802861       250201","","126.5","","2196871.13"
"2025-02-05","2025-02-01","SF FuneralF802860       250201","","126.5","","2196997.63"
"2025-02-05","2025-02-01","SF FuneralF808804       250201","","126.5","","2197124.13"
"2025-02-05","2025-02-01","SF FuneralF808799       250201","","126.5","","2197250.63"
"2025-02-05","2025-02-01","SF FuneralF808831       250201","","126.5","","2197377.13"
"2025-02-05","2025-02-01","SF FuneralF809062       250201","","126.5","","2197503.63"
"2025-02-05","2025-02-01","SF FuneralF809319       250201","","126.5","","2197630.13"
"2025-02-05","2025-02-01","SF FuneralF809371       250201","","126.5","","2197756.63"
"2025-02-05","2025-02-01","SF FuneralF809611       250201","","126.5","","2197883.13"
"2025-02-05","2025-02-01","SF FuneralF809865       250201","","126.5","","2198009.63"
"2025-02-05","2025-02-01","SF FuneralF810176       250201","","126.5","","2198136.13"
"2025-02-05","2025-02-01","SF FuneralF810855       250201","","126.5","","2198262.63"
"2025-02-05","2025-02-01","SF FuneralF812370       250201","","126.5","","2198389.13"
"2025-02-05","2025-02-01","SF FuneralF812560       250201","","126.5","","2198515.63"
"2025-02-05","2025-02-01","SF FuneralF812856       250201","","126.5","","2198642.13"
"2025-02-05","2025-02-01","SF FuneralF813255       250201","","126.5","","2198768.63"
"2025-02-05","2025-02-01","SF FuneralF813317       250201","","126.5","","2198895.13"
"2025-02-05","2025-02-01","SF FuneralF813319       250201","","126.5","","2199021.63"
"2025-02-05","2025-02-01","SF FuneralF813654       250201","","126.5","","2199148.13"
"2025-02-05","2025-02-01","SF FuneralF813768       250201","","126.5","","2199274.63"
"2025-02-05","2025-02-01","SF FuneralF814552       250201","","126.5","","2199401.13"
"2025-02-05","2025-02-01","SF FuneralF815030       250201","","126.5","","2199527.63"
"2025-02-05","2025-02-01","SF FuneralF816156       250201","","126.5","","2199654.13"
"2025-02-05","2025-02-01","SF FuneralF816674       250201","","126.5","","2199780.63"
"2025-02-05","2025-02-01","SF FuneralF816687       250201","","126.5","","2199907.13"
"2025-02-05","2025-02-01","SF FuneralF816750       250201","","126.5","","2200033.63"
"2025-02-05","2025-02-01","SF FuneralF816768       250201","","126.5","","2200160.13"
"2025-02-05","2025-02-01","SF FuneralF817042       250201","","126.5","","2200286.63"
"2025-02-05","2025-02-01","SF FuneralF817163       250201","","126.5","","2200413.13"
"2025-02-05","2025-02-01","SF FuneralF817173       250201","","126.5","","2200539.63"
"2025-02-05","2025-02-01","SF FuneralF802812       250201","","126.5","","2200666.13"
"2025-02-05","2025-02-01","SF FuneralF820562       250201","","126.5","","2200792.63"
"2025-02-05","2025-02-01","SF FuneralF820567       250201","","126.5","","2200919.13"
"2025-02-05","2025-02-01","SF FuneralF820611       250201","","126.5","","2201045.63"
"2025-02-05","2025-02-01","SF FuneralF820693       250201","","126.5","","2201172.13"
"2025-02-05","2025-02-01","SF FuneralF820717       250201","","126.5","","2201298.63"
"2025-02-05","2025-02-01","SF FuneralF820883       250201","","126.5","","2201425.13"
"2025-02-05","2025-02-01","SF FuneralF820917       250201","","126.5","","2201551.63"
"2025-02-05","2025-02-01","SF FuneralF821061       250201","","126.5","","2201678.13"
"2025-02-05","2025-02-01","SF FuneralF821809       250201","","126.5","","2201804.63"
"2025-02-05","2025-02-01","SF FuneralFDC0000000BPTK250201","","126.5","","2201931.13"
"2025-02-05","2025-02-01","SF FuneralF828552       250201","","126.5","","2202057.63"
"2025-02-05","2025-02-01","SF FuneralF828551       250201","","126.5","","2202184.13"
"2025-02-05","2025-02-01","SF FuneralF828781       250201","","126.5","","2202310.63"
"2025-02-05","2025-02-01","SF FuneralF828841       250201","","126.5","","2202437.13"
"2025-02-05","2025-02-01","SF FuneralF829548       250201","","126.5","","2202563.63"
"2025-02-05","2025-02-01","SF FuneralF830289       250201","","126.5","","2202690.13"
"2025-02-05","2025-02-01","SF FuneralFDC0000000CGDG250201","","126.5","","2202816.63"
"2025-02-05","2025-02-01","SF FuneralF832255       250201","","126.5","","2202943.13"
"2025-02-05","2025-02-01","SF FuneralF832275       250201","","126.5","","2203069.63"
"2025-02-05","2025-02-01","SF FuneralF832349       250201","","126.5","","2203196.13"
"2025-02-05","2025-02-01","SF FuneralF834499       250201","","126.5","","2203322.63"
"2025-02-05","2025-02-01","SF FuneralF834897       250201","","126.5","","2203449.13"
"2025-02-05","2025-02-01","SF FuneralF841611       250201","","126.5","","2203575.63"
"2025-02-05","2025-02-01","SF FuneralF841840       250201","","126.5","","2203702.13"
"2025-02-05","2025-02-01","SF FuneralF841879       250201","","126.5","","2203828.63"
"2025-02-05","2025-02-01","SF FuneralF841961       250201","","126.5","","2203955.13"
"2025-02-05","2025-02-01","SF FuneralF842575       250201","","126.5","","2204081.63"
"2025-02-05","2025-02-01","SF FuneralF992804       250201","","126.5","","2204208.13"
"2025-02-05","2025-02-01","SF FuneralF992966       250201","","126.5","","2204334.63"
"2025-02-05","2025-02-01","SF FuneralF992969       250201","","126.5","","2204461.13"
"2025-02-05","2025-02-01","SF FuneralF993081       250201","","126.5","","2204587.63"
"2025-02-05","2025-02-01","SF FuneralF993297       250201","","126.5","","2204714.13"
"2025-02-05","2025-02-01","SF FuneralF994106       250201","","126.5","","2204840.63"
"2025-02-05","2025-02-01","SF FuneralF1017548      250201","","126.5","","2204967.13"
"2025-02-05","2025-02-01","SF FuneralF1017786      250201","","126.5","","2205093.63"
"2025-02-05","2025-02-01","SF FuneralF1021504      250201","","126.5","","2205220.13"
"2025-02-05","2025-02-01","SF FuneralF1021520      250201","","126.5","","2205346.63"
"2025-02-05","2025-02-01","SF FuneralF1021541      250201","","126.5","","2205473.13"
"2025-02-05","2025-02-01","SF FuneralF1021599      250201","","126.5","","2205599.63"
"2025-02-05","2025-02-01","SF FuneralF1021616      250201","","126.5","","2205726.13"
"2025-02-05","2025-02-01","SF FuneralF1022028      250201","","126.5","","2205852.63"
"2025-02-05","2025-02-01","SF FuneralF1055284      250201","","126.5","","2205979.13"
"2025-02-05","2025-02-01","SF FuneralF1058610      250201","","126.5","","2206105.63"
"2025-02-05","2025-02-01","SF FuneralF1059880      250201","","126.5","","2206232.13"
"2025-02-05","2025-02-01","SF FuneralF1060791      250201","","126.5","","2206358.63"
"2025-02-05","2025-02-01","SF FuneralF1060941      250201","","126.5","","2206485.13"
"2025-02-05","2025-02-01","SF FuneralFDC0000000KJM2250201","","126.5","","2206611.63"
"2025-02-05","2025-02-01","SF FuneralF1061538      250202","","126.5","","2206738.13"
"2025-02-05","2025-02-01","SF FuneralF1066255      250201","","126.5","","2206864.63"
"2025-02-05","2025-02-01","SF FuneralF1066267      250201","","126.5","","2206991.13"
"2025-02-05","2025-02-01","SF FuneralF1066302      250201","","126.5","","2207117.63"
"2025-02-05","2025-02-01","SF FuneralF1066343      250201","","126.5","","2207244.13"
"2025-02-05","2025-02-01","SF FuneralF1066359      250201","","126.5","","2207370.63"
"2025-02-05","2025-02-01","SF FuneralF1066561      250201","","126.5","","2207497.13"
"2025-02-05","2025-02-01","SF FuneralF1066590      250201","","126.5","","2207623.63"
"2025-02-05","2025-02-01","SF FuneralF1066781      250201","","126.5","","2207750.13"
"2025-02-05","2025-02-01","SF FuneralF1067942      250201","","126.5","","2207876.63"
"2025-02-05","2025-02-01","SF FuneralF1068051      250201","","126.5","","2208003.13"
"2025-02-05","2025-02-01","SF FuneralF1068153      250201","","126.5","","2208129.63"
"2025-02-05","2025-02-01","SF FuneralF1072725      250201","","126.5","","2208256.13"
"2025-02-05","2025-02-01","SF FuneralF1072926      250201","","126.5","","2208382.63"
"2025-02-05","2025-02-01","SF FuneralF1073101      250201","","126.5","","2208509.13"
"2025-02-05","2025-02-01","SF FuneralF1073130      250201","","126.5","","2208635.63"
"2025-02-05","2025-02-01","SF FuneralF1073662      250201","","126.5","","2208762.13"
"2025-02-05","2025-02-01","SF FuneralF1074456      250201","","126.5","","2208888.63"
"2025-02-05","2025-02-01","SF FuneralFDC0000000LCCF250201","","126.5","","2209015.13"
"2025-02-05","2025-02-01","SF FuneralF1075203      250202","","126.5","","2209141.63"
"2025-02-05","2025-02-01","SF FuneralF1075211      250201","","126.5","","2209268.13"
"2025-02-05","2025-02-01","SF FuneralF1075233      250201","","126.5","","2209394.63"
"2025-02-05","2025-02-01","SF FuneralF1075235      250201","","126.5","","2209521.13"
"2025-02-05","2025-02-01","SF FuneralF1075257      250202","","126.5","","2209647.63"
"2025-02-05","2025-02-01","SF FuneralF1075270      250201","","126.5","","2209774.13"
"2025-02-05","2025-02-01","SF FuneralF1078202      250201","","126.5","","2209900.63"
"2025-02-05","2025-02-01","SF FuneralF1078383      250201","","126.5","","2210027.13"
"2025-02-05","2025-02-01","SF FuneralF1078401      250201","","126.5","","2210153.63"
"2025-02-05","2025-02-01","SF FuneralF1078406      250201","","126.5","","2210280.13"
"2025-02-05","2025-02-01","SF FuneralF1078489      250201","","126.5","","2210406.63"
"2025-02-05","2025-02-01","SF FuneralF1078859      250201","","126.5","","2210533.13"
"2025-02-05","2025-02-01","SF FuneralF1079068      250201","","126.5","","2210659.63"
"2025-02-05","2025-02-01","SF FuneralF1079295      250201","","126.5","","2210786.13"
"2025-02-05","2025-02-01","SF FuneralF1079315      250201","","126.5","","2210912.63"
"2025-02-05","2025-02-01","SF FuneralF1084447      250201","","126.5","","2211039.13"
"2025-02-05","2025-02-01","SF FuneralF1084520      250201","","126.5","","2211165.63"
"2025-02-05","2025-02-01","SF FuneralF1084559      250201","","126.5","","2211292.13"
"2025-02-05","2025-02-01","SF FuneralF1084984      250201","","126.5","","2211418.63"
"2025-02-05","2025-02-01","SF FuneralF1084989      250201","","126.5","","2211545.13"
"2025-02-05","2025-02-01","SF FuneralF1085044      250201","","126.5","","2211671.63"
"2025-02-05","2025-02-01","SF FuneralF1085450      250201","","126.5","","2211798.13"
"2025-02-05","2025-02-01","SF FuneralF1104108      250201","","126.5","","2211924.63"
"2025-02-05","2025-02-01","SF FuneralF1104110      250201","","126.5","","2212051.13"
"2025-02-05","2025-02-01","SF FuneralFDC0000000M9VP250201","","126.5","","2212177.63"
"2025-02-05","2025-02-01","SF FuneralFDC0000000M9VT250201","","126.5","","2212304.13"
"2025-02-05","2025-02-01","SF FuneralF1108333      250201","","126.5","","2212430.63"
"2025-02-05","2025-02-01","SF FuneralF1109066      250201","","126.5","","2212557.13"
"2025-02-05","2025-02-01","SF FuneralF1109070      250201","","126.5","","2212683.63"
"2025-02-05","2025-02-01","SF FuneralFDC0000000MJWF250201","","126.5","","2212810.13"
"2025-02-05","2025-02-01","SF FuneralFDC0000000MLKF250201","","126.5","","2212936.63"
"2025-02-05","2025-02-01","SF FuneralF1110178      250201","","126.5","","2213063.13"
"2025-02-05","2025-02-01","SF FuneralF1110319      250201","","126.5","","2213189.63"
"2025-02-05","2025-02-01","SF FuneralF1113272      250201","","126.5","","2213316.13"
"2025-02-05","2025-02-01","SF FuneralF1113559      250202","","126.5","","2213442.63"
"2025-02-05","2025-02-01","SF FuneralF1114537      250201","","126.5","","2213569.13"
"2025-02-05","2025-02-01","SF FuneralF1114655      250201","","126.5","","2213695.63"
"2025-02-05","2025-02-01","SF FuneralF1114663      250201","","126.5","","2213822.13"
"2025-02-05","2025-02-01","SF FuneralF1114980      250201","","126.5","","2213948.63"
"2025-02-05","2025-02-01","SF FuneralF1115008      250201","","126.5","","2214075.13"
"2025-02-05","2025-02-01","SF FuneralF1115047      250201","","126.5","","2214201.63"
"2025-02-05","2025-02-01","SF FuneralF1116925      250201","","126.5","","2214328.13"
"2025-02-05","2025-02-01","SF FuneralF1117183      250202","","126.5","","2214454.63"
"2025-02-05","2025-02-01","SF FuneralF1117375      250201","","126.5","","2214581.13"
"2025-02-05","2025-02-01","SF FuneralF1117614      250201","","126.5","","2214707.63"
"2025-02-05","2025-02-01","SF FuneralF1117638      250201","","126.5","","2214834.13"
"2025-02-05","2025-02-01","SF FuneralF1117895      250201","","126.5","","2214960.63"
"2025-02-05","2025-02-01","SF FuneralF1117902      250201","","126.5","","2215087.13"
"2025-02-05","2025-02-01","SF FuneralF1118451      250201","","126.5","","2215213.63"
"2025-02-05","2025-02-01","SF FuneralF1118557      250201","","126.5","","2215340.13"
"2025-02-05","2025-02-01","SF FuneralF1118648      250201","","126.5","","2215466.63"
"2025-02-05","2025-02-01","SF FuneralF1118652      250201","","126.5","","2215593.13"
"2025-02-05","2025-02-01","SF FuneralFDC0000000NQPC250201","","126.5","","2215719.63"
"2025-02-05","2025-02-01","SF FuneralF1119774      250201","","126.5","","2215846.13"
"2025-02-05","2025-02-01","SF FuneralF1120383      250201","","126.5","","2215972.63"
"2025-02-05","2025-02-01","SF FuneralF1120532      250201","","126.5","","2216099.13"
"2025-02-05","2025-02-01","SF FuneralF1121985      250201","","126.5","","2216225.63"
"2025-02-05","2025-02-01","SF FuneralF1122184      250201","","126.5","","2216352.13"
"2025-02-05","2025-02-01","SF FuneralFDC0000000P14H250201","","126.5","","2216478.63"
"2025-02-05","2025-02-01","SF FuneralF1122825      250201","","126.5","","2216605.13"
"2025-02-05","2025-02-01","SF FuneralF1122878      250201","","126.5","","2216731.63"
"2025-02-05","2025-02-01","SF FuneralF1122886      250201","","126.5","","2216858.13"
"2025-02-05","2025-02-01","SF FuneralF755071       250201","","126.5","","2216984.63"
"2025-02-05","2025-02-01","SF FuneralF1122964      250201","","126.5","","2217111.13"
"2025-02-05","2025-02-01","SF FuneralF1123113      250201","","126.5","","2217237.63"
"2025-02-05","2025-02-01","SF FuneralF1123222      250201","","126.5","","2217364.13"
"2025-02-05","2025-02-01","SF FuneralFDC0000000P89K250201","","126.5","","2217490.63"
"2025-02-05","2025-02-01","SF FuneralF1125130      250201","","126.5","","2217617.13"
"2025-02-05","2025-02-01","SF FuneralF1125291      250201","","126.5","","2217743.63"
"2025-02-05","2025-02-01","SF FuneralF1125464      250201","","126.5","","2217870.13"
"2025-02-05","2025-02-01","SF FuneralF1125469      250201","","126.5","","2217996.63"
"2025-02-05","2025-02-01","SF FuneralF1125834      250201","","126.5","","2218123.13"
"2025-02-05","2025-02-01","SF FuneralF1125871      250201","","126.5","","2218249.63"
"2025-02-05","2025-02-01","SF FuneralF1125960      250201","","126.5","","2218376.13"
"2025-02-05","2025-02-01","SF FuneralF1127521      250201","","126.5","","2218502.63"
"2025-02-05","2025-02-01","SF FuneralF1127819      250201","","126.5","","2218629.13"
"2025-02-05","2025-02-01","SF FuneralF1128007      250201","","126.5","","2218755.63"
"2025-02-05","2025-02-01","SF FuneralF1128017      250201","","126.5","","2218882.13"
"2025-02-05","2025-02-01","SF FuneralF1128872      250201","","126.5","","2219008.63"
"2025-02-05","2025-02-01","SF FuneralF1128906      250201","","126.5","","2219135.13"
"2025-02-05","2025-02-01","SF FuneralF1128932      250201","","126.5","","2219261.63"
"2025-02-05","2025-02-01","SF FuneralF1128954      250201","","256.5","","2219518.13"
"2025-02-05","2025-02-01","SF FuneralF1128970      250201","","126.5","","2219644.63"
"2025-02-05","2025-02-01","SF FuneralF1128994      250201","","126.5","","2219771.13"
"2025-02-05","2025-02-01","SF FuneralF793868       250201","","126.5","","2219897.63"
"2025-02-05","2025-02-01","SF FuneralF1129251      250201","","126.5","","2220024.13"
"2025-02-05","2025-02-01","SF FuneralF1129271      250201","","126.5","","2220150.63"
"2025-02-05","2025-02-01","SF FuneralF1129370      250201","","126.5","","2220277.13"
"2025-02-05","2025-02-01","SF FuneralF1129373      250201","","126.5","","2220403.63"
"2025-02-05","2025-02-01","SF FuneralF1129414      250201","","126.5","","2220530.13"
"2025-02-05","2025-02-01","SF FuneralF1129441      250201","","126.5","","2220656.63"
"2025-02-05","2025-02-01","SF FuneralF1130036      250202","","126.5","","2220783.13"
"2025-02-05","2025-02-01","SF FuneralFDC0000000Q009250201","","126.5","","2220909.63"
"2025-02-05","2025-02-01","SF FuneralFDC0000000Q00B250201","","126.5","","2221036.13"
"2025-02-05","2025-02-01","SF FuneralF1130654      250202","","126.5","","2221162.63"
"2025-02-05","2025-02-04","SF FuneralF1122031      250204","","126.5","","2221289.13"
"2025-02-05","2025-02-03","SF FuneralFDC00000002WSV250203","","55","","2221344.13"
"2025-02-05","2025-02-03","SF FuneralF834627       250202","","31.63","","2221375.76"
"2025-02-05","2025-02-05","SF FuneralF1122926      250205","","31.63","","2221407.39"
"2025-02-05","2025-02-05","SF FuneralF1127493      250205","","31.63","","2221439.02"
"2025-02-05","2025-02-04","SF FuneralF989270       250204","","31.63","","2221470.65"
"2025-02-05","2025-02-04","SF FuneralF990591       250204","","31.63","","2221502.28"
"2025-02-05","2025-02-04","SF FuneralF1121908      250204","","31.63","","2221533.91"
"2025-02-05","2025-02-01","SF FuneralFDC00000005D70250201","","126.5","","2221660.41"
"2025-02-05","2025-02-01","SF FuneralFDC00000005DB4250201","","191.5","","2221851.91"
"2025-02-05","2025-02-01","SF FuneralFDC00000005GVB250201","","126.5","","2221978.41"
"2025-02-05","2025-02-01","SF FuneralFDC00000005K0V250201","","126.5","","2222104.91"
"2025-02-05","2025-02-01","SF FuneralFDC00000005X70250201","","126.5","","2222231.41"
"2025-02-05","2025-02-01","SF FuneralFDC000000064R1250201","","126.5","","2222357.91"
"2025-02-05","2025-02-01","SF FuneralFDC0000000697T250201","","126.5","","2222484.41"
"2025-02-05","2025-02-01","SF FuneralFDC0000000699J250201","","220","","2222704.41"
"2025-02-05","2025-02-01","SF FuneralFDC00000006FMB250201","","126.5","","2222830.91"
"2025-02-05","2025-02-01","SF FuneralFDC00000006FY8250201","","126.5","","2222957.41"
"2025-02-05","2025-02-01","SF FuneralFDC00000006G09250201","","126.5","","2223083.91"
"2025-02-05","2025-02-01","SF FuneralFDC00000006G13250201","","126.5","","2223210.41"
"2025-02-05","2025-02-01","SF FuneralFDC00000006G20250201","","126.5","","2223336.91"
"2025-02-05","2025-02-01","SF FuneralFDC00000006G4N250201","","126.5","","2223463.41"
"2025-02-05","2025-02-01","SF FuneralFDC00000006G56250201","","126.5","","2223589.91"
"2025-02-05","2025-02-01","SF FuneralFDC00000006GFT250201","","126.5","","2223716.41"
"2025-02-05","2025-02-01","SF FuneralFDC00000006GS9250201","","126.5","","2223842.91"
"2025-02-05","2025-02-01","SF FuneralFDC00000006GX0250201","","126.5","","2223969.41"
"2025-02-05","2025-02-01","SF FuneralFDC00000006JXF250201","","126.5","","2224095.91"
"2025-02-05","2025-02-01","SF FuneralFDC00000006K3T250201","","126.5","","2224222.41"
"2025-02-05","2025-02-01","SF FuneralFDC00000006LC3250201","","126.5","","2224348.91"
"2025-02-05","2025-02-01","SF FuneralFDC00000006LDV250201","","126.5","","2224475.41"
"2025-02-05","2025-02-01","SF FuneralFDC00000006LWL250201","","126.5","","2224601.91"
"2025-02-05","2025-02-01","SF FuneralFDC00000006QW1250201","","126.5","","2224728.41"
"2025-02-05","2025-02-01","SF FuneralFDC00000006R92250201","","126.5","","2224854.91"
"2025-02-05","2025-02-01","SF FuneralFDC00000006SR7250201","","126.5","","2224981.41"
"2025-02-05","2025-02-01","SF FuneralFDC00000006T2P250201","","126.5","","2225107.91"
"2025-02-05","2025-02-01","SF FuneralFDC00000006Y3H250201","","126.5","","2225234.41"
"2025-02-05","2025-02-01","SF FuneralFDC00000006YK3250201","","220","","2225454.41"
"2025-02-05","2025-02-01","SF FuneralFDC0000000744T250201","","126.5","","2225580.91"
"2025-02-05","2025-02-01","SF FuneralFDC0000000744X250201","","126.5","","2225707.41"
"2025-02-05","2025-02-01","SF FuneralFDC000000074FB250201","","126.5","","2225833.91"
"2025-02-05","2025-02-01","SF FuneralFDC000000074PK250201","","126.5","","2225960.41"
"2025-02-05","2025-02-01","SF FuneralFDC000000074TT250201","","126.5","","2226086.91"
"2025-02-05","2025-02-01","SF FuneralFDC000000075KQ250201","","126.5","","2226213.41"
"2025-02-05","2025-02-01","SF FuneralFDC00000007C9G250201","","126.5","","2226339.91"
"2025-02-05","2025-02-01","SF FuneralFDC00000007HRP250201","","126.5","","2226466.41"
"2025-02-05","2025-02-01","SF FuneralFDC00000007L2T250201","","126.5","","2226592.91"
"2025-02-05","2025-02-01","SF FuneralFDC00000007Q6T250201","","126.5","","2226719.41"
"2025-02-05","2025-02-01","SF FuneralFDC00000007QVL250201","","126.5","","2226845.91"
"2025-02-05","2025-02-01","SF FuneralFDC00000007ZCG250201","","126.5","","2226972.41"
"2025-02-05","2025-02-01","SF FuneralFDC000000081TN250201","","126.5","","2227098.91"
"2025-02-05","2025-02-01","SF FuneralF798288       250201","","126.5","","2227225.41"
"2025-02-05","2025-02-01","SF FuneralF798293       250201","","126.5","","2227351.91"
"2025-02-05","2025-02-01","SF FuneralF798295       250201","","126.5","","2227478.41"
"2025-02-05","2025-02-01","SF FuneralFDC000000084X8250201","","126.5","","2227604.91"
"2025-02-05","2025-02-01","SF FuneralFDC0000000861Q250201","","126.5","","2227731.41"
"2025-02-05","2025-02-01","SF FuneralFDC0000000864L250201","","126.5","","2227857.91"
"2025-02-05","2025-02-01","SF FuneralFDC000000088QX250201","","126.5","","2227984.41"
"2025-02-05","2025-02-01","SF FuneralF799845       250201","","126.5","","2228110.91"
"2025-02-05","2025-02-01","SF FuneralF800150       250201","","126.5","","2228237.41"
"2025-02-05","2025-02-01","SF FuneralF800440       250201","","126.5","","2228363.91"
"2025-02-05","2025-02-01","SF FuneralFDC00000008FVB250201","","126.5","","2228490.41"
"2025-02-05","2025-02-01","SF FuneralF802219       250201","","126.5","","2228616.91"
"2025-02-05","2025-02-01","SF FuneralF802789       250201","","126.5","","2228743.41"
"2025-02-05","2025-02-01","SF FuneralF802798       250201","","126.5","","2228869.91"
"2025-02-05","2025-02-01","SF FuneralF802809       250201","","126.5","","2228996.41"
"2025-02-05","2025-02-01","SF FuneralFDC00000008LK6250201","","126.5","","2229122.91"
"2025-02-05","2025-02-01","SF FuneralF803046       250201","","126.5","","2229249.41"
"2025-02-05","2025-02-01","SF FuneralFDC00000008LSX250201","","126.5","","2229375.91"
"2025-02-05","2025-02-01","SF FuneralF766445       250201","","220","","2229595.91"
"2025-02-05","2025-02-01","SF FuneralF803112       250201","","126.5","","2229722.41"
"2025-02-05","2025-02-01","SF FuneralFDC00000008MYH250201","","126.5","","2229848.91"
"2025-02-05","2025-02-01","SF FuneralFDC00000008NCQ250201","","126.5","","2229975.41"
"2025-02-05","2025-02-01","SF FuneralF803849       250201","","126.5","","2230101.91"
"2025-02-05","2025-02-01","SF FuneralF803921       250201","","126.5","","2230228.41"
"2025-02-05","2025-02-01","SF FuneralF804181       250201","","126.5","","2230354.91"
"2025-02-05","2025-02-01","SF FuneralF805491       250201","","126.5","","2230481.41"
"2025-02-05","2025-02-01","SF FuneralF809046       250201","","126.5","","2230607.91"
"2025-02-05","2025-02-01","SF FuneralF809305       250201","","126.5","","2230734.41"
"2025-02-05","2025-02-01","SF FuneralF809590       250201","","126.5","","2230860.91"
"2025-02-05","2025-02-01","SF FuneralF809716       250201","","126.5","","2230987.41"
"2025-02-05","2025-02-01","SF FuneralF809738       250201","","126.5","","2231113.91"
"2025-02-05","2025-02-01","SF FuneralF809944       250201","","126.5","","2231240.41"
"2025-02-05","2025-02-01","SF FuneralFDC000000096CX250201","","126.5","","2231366.91"
"2025-02-05","2025-02-01","SF FuneralF812549       250201","","126.5","","2231493.41"
"2025-02-05","2025-02-01","SF FuneralF812569       250201","","126.5","","2231619.91"
"2025-02-05","2025-02-01","SF FuneralF812637       250201","","126.5","","2231746.41"
"2025-02-05","2025-02-01","SF FuneralF813623       250201","","126.5","","2231872.91"
"2025-02-05","2025-02-01","SF FuneralF813932       250201","","126.5","","2231999.41"
"2025-02-05","2025-02-01","SF FuneralF813934       250201","","126.5","","2232125.91"
"2025-02-05","2025-02-01","SF FuneralF814709       250201","","126.5","","2232252.41"
"2025-02-05","2025-02-01","SF FuneralF814911       250201","","126.5","","2232378.91"
"2025-02-05","2025-02-01","SF FuneralF817301       250201","","126.5","","2232505.41"
"2025-02-05","2025-02-01","SF FuneralF817352       250201","","126.5","","2232631.91"
"2025-02-05","2025-02-01","SF FuneralF817397       250201","","126.5","","2232758.41"
"2025-02-05","2025-02-01","SF FuneralF817623       250201","","126.5","","2232884.91"
"2025-02-05","2025-02-01","SF FuneralF817717       250201","","126.5","","2233011.41"
"2025-02-05","2025-02-01","SF FuneralF818549       250201","","126.5","","2233137.91"
"2025-02-05","2025-02-01","SF FuneralF818857       250201","","126.5","","2233264.41"
"2025-02-05","2025-02-01","SF FuneralF819096       250201","","126.5","","2233390.91"
"2025-02-05","2025-02-01","SF FuneralF819247       250201","","126.5","","2233517.41"
"2025-02-05","2025-02-01","SF FuneralF820493       250201","","126.5","","2233643.91"
"2025-02-05","2025-02-01","SF FuneralF822416       250201","","126.5","","2233770.41"
"2025-02-05","2025-02-01","SF FuneralF823673       250201","","126.5","","2233896.91"
"2025-02-05","2025-02-01","SF FuneralF828236       250201","","126.5","","2234023.41"
"2025-02-05","2025-02-01","SF FuneralF829563       250201","","126.5","","2234149.91"
"2025-02-05","2025-02-01","SF FuneralF829576       250201","","126.5","","2234276.41"
"2025-02-05","2025-02-01","SF FuneralF829600       250201","","126.5","","2234402.91"
"2025-02-05","2025-02-01","SF FuneralF829806       250201","","126.5","","2234529.41"
"2025-02-05","2025-02-01","SF FuneralF829818       250201","","126.5","","2234655.91"
"2025-02-05","2025-02-01","SF FuneralF833008       250201","","126.5","","2234782.41"
"2025-02-05","2025-02-01","SF FuneralF833041       250201","","126.5","","2234908.91"
"2025-02-05","2025-02-01","SF FuneralFDC0000000CQMW250201","","126.5","","2235035.41"
"2025-02-05","2025-02-01","SF FuneralF833521       250201","","126.5","","2235161.91"
"2025-02-05","2025-02-01","SF FuneralF816669       250201","","126.5","","2235288.41"
"2025-02-05","2025-02-01","SF FuneralF834283       250201","","126.5","","2235414.91"
"2025-02-05","2025-02-01","SF FuneralF841855       250201","","126.5","","2235541.41"
"2025-02-05","2025-02-01","SF FuneralF841983       250201","","126.5","","2235667.91"
"2025-02-05","2025-02-01","SF FuneralF842060       250201","","126.5","","2235794.41"
"2025-02-05","2025-02-01","SF FuneralF842073       250201","","126.5","","2235920.91"
"2025-02-05","2025-02-01","SF FuneralF842204       250201","","126.5","","2236047.41"
"2025-02-05","2025-02-01","SF FuneralF842240       250201","","126.5","","2236173.91"
"2025-02-05","2025-02-01","SF FuneralF842251       250201","","126.5","","2236300.41"
"2025-02-05","2025-02-01","SF FuneralF842345       250201","","126.5","","2236426.91"
"2025-02-05","2025-02-01","SF FuneralF842352       250201","","126.5","","2236553.41"
"2025-02-05","2025-02-01","SF FuneralFDC0000000F643250201","","126.5","","2236679.91"
"2025-02-05","2025-02-01","SF FuneralF842592       250201","","126.5","","2236806.41"
"2025-02-05","2025-02-01","SF FuneralF842652       250201","","126.5","","2236932.91"
"2025-02-05","2025-02-01","SF FuneralF993416       250201","","126.5","","2237059.41"
"2025-02-05","2025-02-01","SF FuneralF993428       250201","","126.5","","2237185.91"
"2025-02-05","2025-02-01","SF FuneralF993588       250201","","126.5","","2237312.41"
"2025-02-05","2025-02-01","SF FuneralF993744       250201","","126.5","","2237438.91"
"2025-02-05","2025-02-01","SF FuneralF1016657      250201","","126.5","","2237565.41"
"2025-02-05","2025-02-01","SF FuneralF1021434      250201","","126.5","","2237691.91"
"2025-02-05","2025-02-01","SF FuneralF1033542      250201","","126.5","","2237818.41"
"2025-02-05","2025-02-01","SF FuneralF1033566      250201","","126.5","","2237944.91"
"2025-02-05","2025-02-01","SF FuneralF834567       250201","","126.5","","2238071.41"
"2025-02-05","2025-02-01","SF FuneralF1052712      250201","","126.5","","2238197.91"
"2025-02-05","2025-02-01","SF FuneralF1052713      250201","","126.5","","2238324.41"
"2025-02-05","2025-02-01","SF FuneralFDC0000000K8VX250201","","126.5","","2238450.91"
"2025-02-05","2025-02-01","SF FuneralF1058666      250201","","126.5","","2238577.41"
"2025-02-05","2025-02-01","SF FuneralFDC0000000K9ZW250201","","126.5","","2238703.91"
"2025-02-05","2025-02-01","SF FuneralF1060062      250201","","126.5","","2238830.41"
"2025-02-05","2025-02-01","SF FuneralF1060076      250201","","126.5","","2238956.91"
"2025-02-05","2025-02-01","SF FuneralF1073593      250201","","126.5","","2239083.41"
"2025-02-05","2025-02-01","SF FuneralF1075205      250201","","126.5","","2239209.91"
"2025-02-05","2025-02-01","SF FuneralF1080424      250201","","126.5","","2239336.41"
"2025-02-05","2025-02-01","SF FuneralF1084742      250201","","126.5","","2239462.91"
"2025-02-05","2025-02-01","SF FuneralF1103787      250201","","126.5","","2239589.41"
"2025-02-05","2025-02-01","SF FuneralF1103810      250201","","126.5","","2239715.91"
"2025-02-05","2025-02-01","SF FuneralF1109057      250202","","126.5","","2239842.41"
"2025-02-05","2025-02-01","SF FuneralF1109761      250201","","126.5","","2239968.91"
"2025-02-05","2025-02-01","SF FuneralFDC0000000MKQG250201","","126.5","","2240095.41"
"2025-02-05","2025-02-01","SF FuneralF1110542      250201","","126.5","","2240221.91"
"2025-02-05","2025-02-01","SF FuneralF1111378      250201","","126.5","","2240348.41"
"2025-02-05","2025-02-01","SF FuneralF1111487      250201","","126.5","","2240474.91"
"2025-02-05","2025-02-01","SF FuneralFDC0000000MTKT250201","","126.5","","2240601.41"
"2025-02-05","2025-02-01","SF FuneralF1111775      250201","","126.5","","2240727.91"
"2025-02-05","2025-02-01","SF FuneralF1112051      250201","","126.5","","2240854.41"
"2025-02-05","2025-02-01","SF FuneralFDC0000000MY2S250201","","126.5","","2240980.91"
"2025-02-05","2025-02-01","SF FuneralFDC0000000MY5T250201","","126.5","","2241107.41"
"2025-02-05","2025-02-01","SF FuneralFDC0000000N4B6250201","","126.5","","2241233.91"
"2025-02-05","2025-02-01","SF FuneralF1113906      250201","","126.5","","2241360.41"
"2025-02-05","2025-02-01","SF FuneralF1113958      250201","","126.5","","2241486.91"
"2025-02-05","2025-02-01","SF FuneralF1113996      250201","","126.5","","2241613.41"
"2025-02-05","2025-02-01","SF FuneralF1114636      250201","","126.5","","2241739.91"
"2025-02-05","2025-02-01","SF FuneralF1114784      250201","","126.5","","2241866.41"
"2025-02-05","2025-02-01","SF FuneralF1114906      250201","","126.5","","2241992.91"
"2025-02-05","2025-02-01","SF FuneralF1115775      250201","","126.5","","2242119.41"
"2025-02-05","2025-02-01","SF FuneralF1115824      250201","","126.5","","2242245.91"
"2025-02-05","2025-02-01","SF FuneralF1117173      250201","","126.5","","2242372.41"
"2025-02-05","2025-02-01","SF FuneralF1117233      250201","","126.5","","2242498.91"
"2025-02-05","2025-02-01","SF FuneralF1117408      250201","","126.5","","2242625.41"
"2025-02-05","2025-02-01","SF FuneralFDC0000000NKCH250201","","126.5","","2242751.91"
"2025-02-05","2025-02-01","SF FuneralF1117985      250201","","126.5","","2242878.41"
"2025-02-05","2025-02-01","SF FuneralF1119771      250201","","126.5","","2243004.91"
"2025-02-05","2025-02-01","SF FuneralF1121978      250201","","126.5","","2243131.41"
"2025-02-05","2025-02-01","SF FuneralF1122308      250201","","126.5","","2243257.91"
"2025-02-05","2025-02-01","SF FuneralF1122316      250201","","126.5","","2243384.41"
"2025-02-05","2025-02-01","SF FuneralF1122567      250201","","126.5","","2243510.91"
"2025-02-05","2025-02-01","SF FuneralF1122626      250201","","126.5","","2243637.41"
"2025-02-05","2025-02-01","SF FuneralF1122629      250201","","126.5","","2243763.91"
"2025-02-05","2025-02-01","SF FuneralF1122833      250201","","126.5","","2243890.41"
"2025-02-05","2025-02-01","SF FuneralF1122850      250201","","126.5","","2244016.91"
"2025-02-05","2025-02-01","SF FuneralF1122857      250201","","126.5","","2244143.41"
"2025-02-05","2025-02-01","SF FuneralF1122859      250201","","126.5","","2244269.91"
"2025-02-05","2025-02-01","SF FuneralF1122900      250201","","126.5","","2244396.41"
"2025-02-05","2025-02-01","SF FuneralF1122950      250201","","126.5","","2244522.91"
"2025-02-05","2025-02-01","SF FuneralFDC0000000P2ZJ250201","","126.5","","2244649.41"
"2025-02-05","2025-02-01","SF FuneralFDC0000000P2ZN250201","","126.5","","2244775.91"
"2025-02-05","2025-02-01","SF FuneralF1123018      250202","","126.5","","2244902.41"
"2025-02-05","2025-02-01","SF FuneralF1123064      250201","","126.5","","2245028.91"
"2025-02-05","2025-02-01","SF FuneralFDC0000000P4M0250201","","126.5","","2245155.41"
"2025-02-05","2025-02-01","SF FuneralF1123399      250201","","126.5","","2245281.91"
"2025-02-05","2025-02-01","SF FuneralF1123515      250201","","126.5","","2245408.41"
"2025-02-05","2025-02-01","SF FuneralF784391       250201","","126.5","","2245534.91"
"2025-02-05","2025-02-01","SF FuneralF1123581      250201","","126.5","","2245661.41"
"2025-02-05","2025-02-01","SF FuneralFDC0000000P5WY250201","","126.5","","2245787.91"
"2025-02-05","2025-02-01","SF FuneralF1123624      250201","","126.5","","2245914.41"
"2025-02-05","2025-02-01","SF FuneralF1123898      250201","","126.5","","2246040.91"
"2025-02-05","2025-02-01","SF FuneralF1123905      250201","","126.5","","2246167.41"
"2025-02-05","2025-02-01","SF FuneralF1123984      250201","","126.5","","2246293.91"
"2025-02-05","2025-02-01","SF FuneralF1124075      250201","","126.5","","2246420.41"
"2025-02-05","2025-02-01","SF FuneralF1125486      250201","","126.5","","2246546.91"
"2025-02-05","2025-02-01","SF FuneralFDC0000000PH3R250201","","126.5","","2246673.41"
"2025-02-05","2025-02-01","SF FuneralF1125687      250202","","126.5","","2246799.91"
"2025-02-05","2025-02-01","SF FuneralFDC0000000PK19250201","","126.5","","2246926.41"
"2025-02-05","2025-02-01","SF FuneralF754528       250201","","126.5","","2247052.91"
"2025-02-05","2025-02-01","SF FuneralF1126165      250201","","126.5","","2247179.41"
"2025-02-05","2025-02-01","SF FuneralF1126315      250201","","126.5","","2247305.91"
"2025-02-05","2025-02-01","SF FuneralF1126835      250201","","126.5","","2247432.41"
"2025-02-05","2025-02-01","SF FuneralF1126847      250201","","126.5","","2247558.91"
"2025-02-05","2025-02-01","SF FuneralF1127613      250201","","126.5","","2247685.41"
"2025-02-05","2025-02-01","SF FuneralF1127629      250201","","126.5","","2247811.91"
"2025-02-05","2025-02-01","SF FuneralF1127680      250201","","126.5","","2247938.41"
"2025-02-05","2025-02-01","SF FuneralFDC0000000PRPP250201","","126.5","","2248064.91"
"2025-02-05","2025-02-01","SF FuneralF1127893      250201","","126.5","","2248191.41"
"2025-02-05","2025-02-01","SF FuneralF1127966      250201","","126.5","","2248317.91"
"2025-02-05","2025-02-01","SF FuneralF1127998      250201","","126.5","","2248444.41"
"2025-02-05","2025-02-01","SF FuneralF1128021      250201","","126.5","","2248570.91"
"2025-02-05","2025-02-01","SF FuneralF1128033      250201","","126.5","","2248697.41"
"2025-02-05","2025-02-01","SF FuneralF1128042      250201","","126.5","","2248823.91"
"2025-02-05","2025-02-01","SF FuneralF1128064      250201","","126.5","","2248950.41"
"2025-02-05","2025-02-01","SF FuneralF1128144      250201","","126.5","","2249076.91"
"2025-02-05","2025-02-01","SF FuneralF1128240      250201","","126.5","","2249203.41"
"2025-02-05","2025-02-01","SF FuneralF793826       250201","","126.5","","2249329.91"
"2025-02-05","2025-02-01","SF FuneralF1128683      250202","","126.5","","2249456.41"
"2025-02-05","2025-02-01","SF FuneralF1128713      250201","","126.5","","2249582.91"
"2025-02-05","2025-02-01","SF FuneralFDC0000000PVZ5250201","","126.5","","2249709.41"
"2025-02-05","2025-02-01","SF FuneralFDC0000000PVZL250201","","126.5","","2249835.91"
"2025-02-05","2025-02-01","SF FuneralFDC0000000PVZM250201","","126.5","","2249962.41"
"2025-02-05","2025-02-01","SF FuneralFDC0000000PVZP250201","","126.5","","2250088.91"
"2025-02-05","2025-02-01","SF FuneralF1128756      250201","","126.5","","2250215.41"
"2025-02-05","2025-02-01","SF FuneralF1128747      250201","","126.5","","2250341.91"
"2025-02-05","2025-01-27","SF FuneralF802792       250127","","126.5","","2250468.41"
"2025-02-05","2025-01-29","SF FuneralFDC000000062ZX250129","","126.5","","2250594.91"
"2025-02-05","2025-01-29","SF FuneralF811149       250129","","126.5","","2250721.41"
"2025-02-05","2025-01-29","SF FuneralF841616       250129","","126.5","","2250847.91"
"2025-02-05","2025-01-30","SF FuneralFDC00000006BF5250130","","126.5","","2250974.41"
"2025-02-05","2025-01-31","SF FuneralFDC00000007CXR250131","","126.5","","2251100.91"
"2025-02-05","2025-01-31","SF FuneralF900838       250201","","126.5","","2251227.41"
"2025-02-05","2025-01-31","SF FuneralF900992       250201","","126.5","","2251353.91"
"2025-02-05","2025-01-31","SF FuneralF980925       250201","","126.5","","2251480.41"
"2025-02-05","2025-01-31","SF FuneralFDC0000000HDST250201","","126.5","","2251606.91"
"2025-02-05","2025-01-31","SF FuneralF989128       250201","","126.5","","2251733.41"
"2025-02-05","2025-01-31","SF FuneralF990455       250201","","126.5","","2251859.91"
"2025-02-05","2025-01-31","SF FuneralF990840       250201","","126.5","","2251986.41"
"2025-02-05","2025-01-31","SF FuneralF1112103      250131","","126.5","","2252112.91"
"2025-02-05","2025-01-31","SF FuneralF1128179      250131","","126.5","","2252239.41"
"2025-02-05","2025-02-01","SF FuneralFDC00000002V68250201","","220","","2252459.41"
"2025-02-05","2025-02-01","SF FuneralFDC00000002V75250201","","220","","2252679.41"
"2025-02-05","2025-02-01","SF FuneralFDC00000002V8L250201","","220","","2252899.41"
"2025-02-05","2025-02-01","SF FuneralFDC00000002VHC250201","","220","","2253119.41"
"2025-02-05","2025-02-01","SF FuneralFDC00000002WX1250201","","220","","2253339.41"
"2025-02-05","2025-02-01","SF FuneralFDC00000002XKX250201","","220","","2253559.41"
"2025-02-05","2025-02-01","SF FuneralFDC00000003C8D250201","","220","","2253779.41"
"2025-02-05","2025-02-01","SF FuneralFDC00000003LFT250201","","220","","2253999.41"
"2025-02-05","2025-02-01","SF FuneralFDC00000005DY8250201","","126.5","","2254125.91"
"2025-02-05","2025-02-01","SF FuneralFDC00000005QTQ250201","","126.5","","2254252.41"
"2025-02-05","2025-02-01","SF FuneralFDC00000005X48250201","","126.5","","2254378.91"
"2025-02-05","2025-02-01","SF FuneralFDC00000005XF8250201","","220","","2254598.91"
"2025-02-05","2025-02-01","SF FuneralFDC00000005XFS250201","","126.5","","2254725.41"
"2025-02-05","2025-02-01","SF FuneralFDC0000000696N250201","","126.5","","2254851.91"
"2025-02-05","2025-02-01","SF FuneralFDC0000000696X250201","","126.5","","2254978.41"
"2025-02-05","2025-02-01","SF FuneralFDC000000069K5250201","","126.5","","2255104.91"
"2025-02-05","2025-02-01","SF FuneralFDC00000006BLX250201","","126.5","","2255231.41"
"2025-02-05","2025-02-01","SF FuneralFDC00000006DQ3250201","","126.5","","2255357.91"
"2025-02-05","2025-02-01","SF FuneralFDC00000006DTN250201","","126.5","","2255484.41"
"2025-02-05","2025-02-01","SF FuneralFDC00000006DVG250201","","126.5","","2255610.91"
"2025-02-05","2025-02-01","SF FuneralFDC00000006G0V250201","","126.5","","2255737.41"
"2025-02-05","2025-02-01","SF FuneralFDC00000006GFH250201","","126.5","","2255863.91"
"2025-02-05","2025-02-01","SF FuneralFDC00000006H2Z250201","","126.5","","2255990.41"
"2025-02-05","2025-02-01","SF FuneralFDC00000006HMY250201","","126.5","","2256116.91"
"2025-02-05","2025-02-01","SF FuneralFDC00000006J70250201","","126.5","","2256243.41"
"2025-02-05","2025-02-01","SF FuneralFDC00000006J88250201","","126.5","","2256369.91"
"2025-02-05","2025-02-01","SF FuneralFDC00000006JFH250201","","126.5","","2256496.41"
"2025-02-05","2025-02-01","SF FuneralFDC00000006MSC250201","","126.5","","2256622.91"
"2025-02-05","2025-02-01","SF FuneralFDC00000006N7Y250201","","126.5","","2256749.41"
"2025-02-05","2025-02-01","SF FuneralFDC00000006NBH250201","","126.5","","2256875.91"
"2025-02-05","2025-02-01","SF FuneralFDC00000006XYH250201","","126.5","","2257002.41"
"2025-02-05","2025-02-01","SF FuneralFDC00000007496250201","","126.5","","2257128.91"
"2025-02-05","2025-02-01","SF FuneralFDC000000074C8250201","","126.5","","2257255.41"
"2025-02-05","2025-02-01","SF FuneralFDC000000074NW250201","","126.5","","2257381.91"
"2025-02-05","2025-02-01","SF FuneralFDC000000074P0250201","","126.5","","2257508.41"
"2025-02-05","2025-02-01","SF FuneralFDC000000074P3250201","","126.5","","2257634.91"
"2025-02-05","2025-02-01","SF FuneralFDC000000074TM250201","","126.5","","2257761.41"
"2025-02-05","2025-02-01","SF FuneralFDC0000000755K250201","","126.5","","2257887.91"
"2025-02-05","2025-02-01","SF FuneralFDC00000007665250201","","126.5","","2258014.41"
"2025-02-05","2025-02-01","SF FuneralFDC00000007732250201","","126.5","","2258140.91"
"2025-02-05","2025-02-01","SF FuneralFDC000000077QZ250201","","126.5","","2258267.41"
"2025-02-05","2025-02-01","SF FuneralFDC00000007DK4250201","","126.5","","2258393.91"
"2025-02-05","2025-02-01","SF FuneralFDC00000007R6W250201","","126.5","","2258520.41"
"2025-02-05","2025-02-01","SF FuneralF796648       250201","","126.5","","2258646.91"
"2025-02-05","2025-02-01","SF FuneralFDC000000086JW250201","","126.5","","2258773.41"
"2025-02-05","2025-02-01","SF FuneralFDC0000000876Q250201","","126.5","","2258899.91"
"2025-02-05","2025-02-01","SF FuneralFDC00000008BKT250201","","126.5","","2259026.41"
"2025-02-05","2025-02-01","SF FuneralF803074       250201","","126.5","","2259152.91"
"2025-02-05","2025-02-01","SF FuneralF803560       250201","","126.5","","2259279.41"
"2025-02-05","2025-02-01","SF FuneralF804150       250201","","126.5","","2259405.91"
"2025-02-05","2025-02-01","SF FuneralFDC00000008PTP250201","","126.5","","2259532.41"
"2025-02-05","2025-02-01","SF FuneralF804402       250201","","126.5","","2259658.91"
"2025-02-05","2025-02-01","SF FuneralF804581       250201","","126.5","","2259785.41"
"2025-02-05","2025-02-01","SF FuneralF808877       250201","","126.5","","2259911.91"
"2025-02-05","2025-02-01","SF FuneralF808911       250201","","126.5","","2260038.41"
"2025-02-05","2025-02-01","SF FuneralF809034       250201","","126.5","","2260164.91"
"2025-02-05","2025-02-01","SF FuneralF794472       250201","","191.5","","2260356.41"
"2025-02-05","2025-02-01","SF FuneralF809571       250201","","126.5","","2260482.91"
"2025-02-05","2025-02-01","SF FuneralF810668       250201","","126.5","","2260609.41"
"2025-02-05","2025-02-01","SF FuneralF811114       250201","","126.5","","2260735.91"
"2025-02-05","2025-02-01","SF FuneralF812647       250201","","126.5","","2260862.41"
"2025-02-05","2025-02-01","SF FuneralF813113       250201","","126.5","","2260988.91"
"2025-02-05","2025-02-01","SF FuneralF813382       250201","","126.5","","2261115.41"
"2025-02-05","2025-02-01","SF FuneralF816667       250201","","126.5","","2261241.91"
"2025-02-05","2025-02-01","SF FuneralF816696       250201","","126.5","","2261368.41"
"2025-02-05","2025-02-01","SF FuneralF816746       250201","","126.5","","2261494.91"
"2025-02-05","2025-02-01","SF FuneralF817169       250201","","126.5","","2261621.41"
"2025-02-05","2025-02-01","SF FuneralF817763       250201","","126.5","","2261747.91"
"2025-02-05","2025-02-01","SF FuneralF817972       250201","","126.5","","2261874.41"
"2025-02-05","2025-02-01","SF FuneralF818348       250201","","126.5","","2262000.91"
"2025-02-05","2025-02-01","SF FuneralF819673       250201","","126.5","","2262127.41"
"2025-02-05","2025-02-01","SF FuneralF820537       250201","","126.5","","2262253.91"
"2025-02-05","2025-02-01","SF FuneralF820590       250201","","126.5","","2262380.41"
"2025-02-05","2025-02-01","SF FuneralF820658       250201","","126.5","","2262506.91"
"2025-02-05","2025-02-01","SF FuneralF820874       250201","","126.5","","2262633.41"
"2025-02-05","2025-02-01","SF FuneralF820921       250201","","126.5","","2262759.91"
"2025-02-05","2025-02-01","SF FuneralF821265       250201","","126.5","","2262886.41"
"2025-02-05","2025-02-01","SF FuneralF822270       250201","","126.5","","2263012.91"
"2025-02-05","2025-02-01","SF FuneralF828278       250201","","126.5","","2263139.41"
"2025-02-05","2025-02-01","SF FuneralF828337       250201","","126.5","","2263265.91"
"2025-02-05","2025-02-01","SF FuneralF828629       250201","","126.5","","2263392.41"
"2025-02-05","2025-02-01","SF FuneralF828751       250201","","191.5","","2263583.91"
"2025-02-05","2025-02-01","SF FuneralF829693       250201","","126.5","","2263710.41"
"2025-02-05","2025-02-01","SF FuneralFDC0000000BVWY250201","","126.5","","2263836.91"
"2025-02-05","2025-02-01","SF FuneralF832316       250201","","126.5","","2263963.41"
"2025-02-05","2025-02-01","SF FuneralF832407       250201","","126.5","","2264089.91"
"2025-02-05","2025-02-01","SF FuneralF832567       250201","","126.5","","2264216.41"
"2025-02-05","2025-02-01","SF FuneralF832583       250201","","126.5","","2264342.91"
"2025-02-05","2025-02-01","SF FuneralF832689       250201","","126.5","","2264469.41"
"2025-02-05","2025-02-01","SF FuneralF817208       250201","","126.5","","2264595.91"
"2025-02-05","2025-02-01","SF FuneralF833943       250201","","126.5","","2264722.41"
"2025-02-05","2025-02-01","SF FuneralF838900       250201","","126.5","","2264848.91"
"2025-02-05","2025-02-01","SF FuneralF841697       250201","","126.5","","2264975.41"
"2025-02-05","2025-02-01","SF FuneralF841993       250201","","126.5","","2265101.91"
"2025-02-05","2025-02-01","SF FuneralF842056       250201","","126.5","","2265228.41"
"2025-02-05","2025-02-01","SF FuneralF812149       250201","","126.5","","2265354.91"
"2025-02-05","2025-02-01","SF FuneralF992737       250201","","126.5","","2265481.41"
"2025-02-05","2025-02-01","SF FuneralF841734       250201","","126.5","","2265607.91"
"2025-02-05","2025-02-01","SF FuneralF993125       250201","","126.5","","2265734.41"
"2025-02-05","2025-02-01","SF FuneralF993437       250201","","126.5","","2265860.91"
"2025-02-05","2025-02-01","SF FuneralF1020601      250201","","31.63","","2265892.54"
"2025-02-05","2025-02-01","SF FuneralF1021470      250201","","126.5","","2266019.04"
"2025-02-05","2025-02-01","SF FuneralF1021536      250201","","126.5","","2266145.54"
"2025-02-05","2025-02-01","SF FuneralF1033928      250201","","126.5","","2266272.04"
"2025-02-05","2025-02-01","SF FuneralF1059434      250201","","126.5","","2266398.54"
"2025-02-05","2025-02-01","SF FuneralF1059457      250201","","126.5","","2266525.04"
"2025-02-05","2025-02-01","SF FuneralFDC0000000KQKZ250201","","126.5","","2266651.54"
"2025-02-05","2025-02-01","SF FuneralF1062685      250201","","213.31","","2266864.85"
"2025-02-05","2025-02-01","SF FuneralF1066389      250201","","126.5","","2266991.35"
"2025-02-05","2025-02-01","SF FuneralF1066403      250201","","126.5","","2267117.85"
"2025-02-05","2025-02-01","SF FuneralF1066783      250201","","126.5","","2267244.35"
"2025-02-05","2025-02-01","SF FuneralF1075237      250201","","126.5","","2267370.85"
"2025-02-05","2025-02-01","SF FuneralF1078367      250201","","126.5","","2267497.35"
"2025-02-05","2025-02-01","SF FuneralFDC0000000LHMJ250201","","126.5","","2267623.85"
"2025-02-05","2025-02-01","SF FuneralF1079271      250201","","126.5","","2267750.35"
"2025-02-05","2025-02-01","SF FuneralF1084314      250201","","126.5","","2267876.85"
"2025-02-05","2025-02-01","SF FuneralF1084316      250201","","126.5","","2268003.35"
"2025-02-05","2025-02-01","SF FuneralF1084362      250201","","126.5","","2268129.85"
"2025-02-05","2025-02-01","SF FuneralF1084428      250201","","126.5","","2268256.35"
"2025-02-05","2025-02-01","SF FuneralF1084600      250201","","126.5","","2268382.85"
"2025-02-05","2025-02-01","SF FuneralF1084937      250201","","126.5","","2268509.35"
"2025-02-05","2025-02-01","SF FuneralF1102858      250201","","126.5","","2268635.85"
"2025-02-05","2025-02-01","SF FuneralF1103873      250201","","126.5","","2268762.35"
"2025-02-05","2025-02-01","SF FuneralF1113331      250201","","126.5","","2268888.85"
"2025-02-05","2025-02-01","SF FuneralFDC0000000N4TX250201","","126.5","","2269015.35"
"2025-02-05","2025-02-01","SF FuneralF1113356      250201","","126.5","","2269141.85"
"2025-02-05","2025-02-01","SF FuneralF1113575      250201","","126.5","","2269268.35"
"2025-02-05","2025-02-01","SF FuneralF1080379      250201","","126.5","","2269394.85"
"2025-02-05","2025-02-01","SF FuneralF1113850      250201","","126.5","","2269521.35"
"2025-02-05","2025-02-01","SF FuneralF1114040      250201","","126.5","","2269647.85"
"2025-02-05","2025-02-01","SF FuneralFDC0000000N78R250201","","126.5","","2269774.35"
"2025-02-05","2025-02-01","SF FuneralF1114319      250201","","126.5","","2269900.85"
"2025-02-05","2025-02-01","SF FuneralF1114394      250201","","126.5","","2270027.35"
"2025-02-05","2025-02-01","SF FuneralF1114618      250201","","126.5","","2270153.85"
"2025-02-05","2025-02-01","SF FuneralFDC0000000NBJ1250201","","126.5","","2270280.35"
"2025-02-05","2025-02-01","SF FuneralF1115033      250201","","126.5","","2270406.85"
"2025-02-05","2025-02-01","SF FuneralF1115145      250201","","126.5","","2270533.35"
"2025-02-05","2025-02-01","SF FuneralF1115769      250201","","126.5","","2270659.85"
"2025-02-05","2025-02-01","SF FuneralF1117221      250201","","126.5","","2270786.35"
"2025-02-05","2025-02-01","SF FuneralF1117585      250201","","126.5","","2270912.85"
"2025-02-05","2025-02-01","SF FuneralF1117714      250201","","126.5","","2271039.35"
"2025-02-05","2025-02-01","SF FuneralF803891       250201","","126.5","","2271165.85"
"2025-02-05","2025-02-01","SF FuneralF1118104      250201","","126.5","","2271292.35"
"2025-02-05","2025-02-01","SF FuneralF1118179      250201","","191.5","","2271483.85"
"2025-02-05","2025-02-01","SF FuneralF1118888      250201","","126.5","","2271610.35"
"2025-02-05","2025-02-01","SF FuneralF1120315      250201","","126.5","","2271736.85"
"2025-02-05","2025-02-01","SF FuneralF1122006      250201","","126.5","","2271863.35"
"2025-02-05","2025-02-01","SF FuneralF1122246      250201","","126.5","","2271989.85"
"2025-02-05","2025-02-01","SF FuneralF1122334      250202","","126.5","","2272116.35"
"2025-02-05","2025-02-01","SF FuneralF1122376      250201","","126.5","","2272242.85"
"2025-02-05","2025-02-01","SF FuneralF1122866      250201","","126.5","","2272369.35"
"2025-02-05","2025-02-01","SF FuneralF1124073      250201","","126.5","","2272495.85"
"2025-02-05","2025-02-01","SF FuneralF1125474      250201","","126.5","","2272622.35"
"2025-02-05","2025-02-01","SF FuneralFDC0000000PJL8250201","","220","","2272842.35"
"2025-02-05","2025-02-01","SF FuneralF753426       250201","","220","","2273062.35"
"2025-02-05","2025-02-01","SF FuneralF1126230      250201","","126.5","","2273188.85"
"2025-02-05","2025-02-01","SF FuneralF1126927      250201","","126.5","","2273315.35"
"2025-02-05","2025-02-01","SF FuneralFDC0000000PNXG250201","","126.5","","2273441.85"
"2025-02-05","2025-02-01","SF FuneralF1127980      250201","","126.5","","2273568.35"
"2025-02-05","2025-02-01","SF FuneralF1127993      250201","","126.5","","2273694.85"
"2025-02-05","2025-02-01","SF FuneralF1128070      250201","","126.5","","2273821.35"
"2025-02-05","2025-02-01","SF FuneralF1128877      250201","","126.5","","2273947.85"
"2025-02-05","2025-02-01","SF FuneralFDC0000000PWFN250201","","126.5","","2274074.35"
"2025-02-05","2025-02-01","SF FuneralF1129377      250201","","126.5","","2274200.85"
"2025-02-05","2025-02-01","SF FuneralF1129520      250201","","126.5","","2274327.35"
"2025-02-05","2025-02-03","SF FuneralF813494       250203","","126.5","","2274453.85"
"2025-02-05","2025-02-02","SF FuneralFDC0000000B8QX250202","","126.5","","2274580.35"
"2025-02-05","2025-02-03","SF FuneralF842952       250201","","126.5","","2274706.85"
"2025-02-05","2025-02-03","SF FuneralF844036       250201","","126.5","","2274833.35"
"2025-02-05","2025-02-03","SF FuneralF900444       250201","","126.5","","2274959.85"
"2025-02-05","2025-02-03","SF FuneralF900775       250201","","126.5","","2275086.35"
"2025-02-05","2025-02-03","SF FuneralF1084340      250203","","126.5","","2275212.85"
"2025-02-05","2025-02-03","SF FuneralF1117267      250203","","126.5","","2275339.35"
"2025-02-05","2025-02-03","SF FuneralF1128119      250203","","126.5","","2275465.85"
"2025-02-05","2025-02-04","SF FuneralF988913       250204","","31.63","","2275497.48"
"2025-02-05","2025-02-04","SF FuneralF1079281      250204","","126.5","","2275623.98"
"2025-02-05","2025-02-05","SF FuneralF988205       250205","","126.5","","2275750.48"
"2025-02-05","2025-01-27","SF FuneralFDC00000007SLC250126","","126.5","","2275876.98"
"2025-02-05","2025-01-29","SF FuneralFDC000000069S7250129","","126.5","","2276003.48"
"2025-02-05","2025-01-29","SF FuneralFDC00000006GWX250129","","126.5","","2276129.98"
"2025-02-05","2025-01-30","SF FuneralF808765       250130","","126.5","","2276256.48"
"2025-02-05","2025-01-31","SF FuneralF901016       250201","","126.5","","2276382.98"
"2025-02-05","2025-01-31","SF FuneralF901379       250201","","126.5","","2276509.48"
"2025-02-05","2025-01-31","SF FuneralF981430       250201","","126.5","","2276635.98"
"2025-02-05","2025-01-31","SF FuneralF981543       250201","","126.5","","2276762.48"
"2025-02-05","2025-01-31","SF FuneralF981702       250201","","126.5","","2276888.98"
"2025-02-05","2025-01-31","SF FuneralF987705       250201","","126.5","","2277015.48"
"2025-02-05","2025-01-31","SF FuneralF987781       250201","","126.5","","2277141.98"
"2025-02-05","2025-01-31","SF FuneralF987854       250201","","126.5","","2277268.48"
"2025-02-05","2025-01-31","SF FuneralF988120       250201","","126.5","","2277394.98"
"2025-02-05","2025-01-31","SF FuneralF988316       250201","","126.5","","2277521.48"
"2025-02-05","2025-01-31","SF FuneralF988977       250201","","126.5","","2277647.98"
"2025-02-05","2025-01-31","SF FuneralF988983       250201","","126.5","","2277774.48"
"2025-02-05","2025-01-31","SF FuneralF989221       250201","","126.5","","2277900.98"
"2025-02-05","2025-01-31","SF FuneralF990233       250201","","126.5","","2278027.48"
"2025-02-05","2025-01-31","SF FuneralF990400       250201","","126.5","","2278153.98"
"2025-02-05","2025-01-31","SF FuneralF991122       250201","","126.5","","2278280.48"
"2025-02-05","2025-02-01","SF FuneralFDC00000002V56250201","","220","","2278500.48"
"2025-02-05","2025-02-01","SF FuneralFDC00000002VT6250201","","220","","2278720.48"
"2025-02-05","2025-02-01","SF FuneralFDC00000002XW8250201","","220","","2278940.48"
"2025-02-05","2025-02-01","SF FuneralFDC00000002Z7B250201","","220","","2279160.48"
"2025-02-05","2025-02-01","SF FuneralFDC000000033G7250201","","220","","2279380.48"
"2025-02-05","2025-02-01","SF FuneralFDC000000057VL250201","","126.5","","2279506.98"
"2025-02-05","2025-02-01","SF FuneralFDC00000005CZ1250201","","126.5","","2279633.48"
"2025-02-05","2025-02-01","SF FuneralFDC00000005LXB250201","","126.5","","2279759.98"
"2025-02-05","2025-02-01","SF FuneralFDC000000063W2250201","","126.5","","2279886.48"
"2025-02-05","2025-02-01","SF FuneralFDC000000069C8250201","","126.5","","2280012.98"
"2025-02-05","2025-02-01","SF FuneralFDC000000069GS250201","","126.5","","2280139.48"
"2025-02-05","2025-02-01","SF FuneralFDC000000069PT250201","","126.5","","2280265.98"
"2025-02-05","2025-02-01","SF FuneralFDC00000006BKL250201","","126.5","","2280392.48"
"2025-02-05","2025-02-01","SF FuneralFDC00000006BL3250201","","126.5","","2280518.98"
"2025-02-05","2025-02-01","SF FuneralFDC00000006BZ8250201","","126.5","","2280645.48"
"2025-02-05","2025-02-01","SF FuneralFDC00000006C12250201","","126.5","","2280771.98"
"2025-02-05","2025-02-01","SF FuneralFDC00000006C13250201","","126.5","","2280898.48"
"2025-02-05","2025-02-01","SF FuneralFDC00000006CSQ250201","","126.5","","2281024.98"
"2025-02-05","2025-02-01","SF FuneralFDC00000006DCJ250201","","126.5","","2281151.48"
"2025-02-05","2025-02-01","SF FuneralFDC00000006DCV250201","","126.5","","2281277.98"
"2025-02-05","2025-02-01","SF FuneralFDC00000006FB3250201","","126.5","","2281404.48"
"2025-02-05","2025-02-01","SF FuneralFDC00000006FDC250201","","126.5","","2281530.98"
"2025-02-05","2025-02-01","SF FuneralFDC00000006FNR250201","","126.5","","2281657.48"
"2025-02-05","2025-02-01","SF FuneralFDC00000006H8R250201","","126.5","","2281783.98"
"2025-02-05","2025-02-01","SF FuneralFDC00000006JN2250201","","126.5","","2281910.48"
"2025-02-05","2025-02-01","SF FuneralFDC00000006L56250201","","126.5","","2282036.98"
"2025-02-05","2025-02-01","SF FuneralFDC00000006PVC250201","","126.5","","2282163.48"
"2025-02-05","2025-02-01","SF FuneralFDC00000006R1Y250201","","126.5","","2282289.98"
"2025-02-05","2025-02-01","SF FuneralFDC00000006XXZ250201","","126.5","","2282416.48"
"2025-02-05","2025-02-01","SF FuneralFDC00000007120250201","","126.5","","2282542.98"
"2025-02-05","2025-02-01","SF FuneralFDC00000006R2K250201","","126.5","","2282669.48"
"2025-02-05","2025-02-01","SF FuneralFDC000000072VN250201","","126.5","","2282795.98"
"2025-02-05","2025-02-01","SF FuneralFDC000000074XF250201","","126.5","","2282922.48"
"2025-02-05","2025-02-01","SF FuneralFDC0000000754T250201","","126.5","","2283048.98"
"2025-02-05","2025-02-01","SF FuneralFDC000000075C9250201","","126.5","","2283175.48"
"2025-02-05","2025-02-01","SF FuneralFDC000000076Y7250201","","126.5","","2283301.98"
"2025-02-05","2025-02-01","SF FuneralFDC000000076Y9250201","","126.5","","2283428.48"
"2025-02-05","2025-02-01","SF FuneralFDC000000077QR250201","","126.5","","2283554.98"
"2025-02-05","2025-02-01","SF FuneralFDC000000078KF250201","","126.5","","2283681.48"
"2025-02-05","2025-02-01","SF FuneralFDC000000078VR250201","","126.5","","2283807.98"
"2025-02-05","2025-02-01","SF FuneralFDC000000079TZ250201","","126.5","","2283934.48"
"2025-02-05","2025-02-01","SF FuneralFDC00000007F7F250201","","126.5","","2284060.98"
"2025-02-05","2025-02-01","SF FuneralFDC00000007F7Q250201","","126.5","","2284187.48"
"2025-02-05","2025-02-01","SF FuneralFDC00000007JRZ250201","","126.5","","2284313.98"
"2025-02-05","2025-02-01","SF FuneralF793817       250201","","126.5","","2284440.48"
"2025-02-05","2025-02-01","SF FuneralFDC00000007Q78250201","","126.5","","2284566.98"
"2025-02-05","2025-02-01","SF FuneralFDC00000007QNP250201","","126.5","","2284693.48"
"2025-02-05","2025-02-01","SF FuneralFDC00000007QX0250201","","126.5","","2284819.98"
"2025-02-05","2025-02-01","SF FuneralF794319       250201","","126.5","","2284946.48"
"2025-02-05","2025-02-01","SF FuneralFDC00000007SZH250201","","126.5","","2285072.98"
"2025-02-05","2025-02-01","SF FuneralF795027       250201","","126.5","","2285199.48"
"2025-02-05","2025-02-01","SF FuneralFDC00000007V9K250201","","126.5","","2285325.98"
"2025-02-05","2025-02-01","SF FuneralFDC00000007X4J250201","","126.5","","2285452.48"
"2025-02-05","2025-02-01","SF FuneralF796400       250201","","126.5","","2285578.98"
"2025-02-05","2025-02-01","SF FuneralF798298       250201","","126.5","","2285705.48"
"2025-02-05","2025-02-01","SF FuneralFDC000000084JK250201","","126.5","","2285831.98"
"2025-02-05","2025-02-01","SF FuneralF798395       250201","","126.5","","2285958.48"
"2025-02-05","2025-02-01","SF FuneralF798610       250201","","126.5","","2286084.98"
"2025-02-05","2025-02-01","SF FuneralF798827       250201","","126.5","","2286211.48"
"2025-02-05","2025-02-01","SF FuneralF800737       250201","","126.5","","2286337.98"
"2025-02-05","2025-02-01","SF FuneralFDC00000008CG1250201","","126.5","","2286464.48"
"2025-02-05","2025-02-01","SF FuneralF802008       250201","","126.5","","2286590.98"
"2025-02-05","2025-02-01","SF FuneralF802815       250201","","126.5","","2286717.48"
"2025-02-05","2025-02-01","SF FuneralF803467       250201","","126.5","","2286843.98"
"2025-02-05","2025-02-01","SF FuneralF803671       250201","","126.5","","2286970.48"
"2025-02-05","2025-02-01","SF FuneralF803887       250201","","126.5","","2287096.98"
"2025-02-05","2025-02-01","SF FuneralFDC00000008P2T250201","","126.5","","2287223.48"
"2025-02-05","2025-02-01","SF FuneralF803923       250201","","126.5","","2287349.98"
"2025-02-05","2025-02-01","SF FuneralF804771       250201","","126.5","","2287476.48"
"2025-02-05","2025-02-01","SF FuneralF805646       250201","","126.5","","2287602.98"
"2025-02-05","2025-02-01","SF FuneralF808846       250201","","126.5","","2287729.48"
"2025-02-05","2025-02-01","SF FuneralF809051       250201","","126.5","","2287855.98"
"2025-02-05","2025-02-01","SF FuneralF809075       250201","","126.5","","2287982.48"
"2025-02-05","2025-02-01","SF FuneralF809217       250201","","126.5","","2288108.98"
"2025-02-05","2025-02-01","SF FuneralF809334       250201","","126.5","","2288235.48"
"2025-02-05","2025-02-01","SF FuneralF809358       250201","","126.5","","2288361.98"
"2025-02-05","2025-02-01","SF FuneralF809465       250201","","126.5","","2288488.48"
"2025-02-05","2025-02-01","SF FuneralF810225       250201","","126.5","","2288614.98"
"2025-02-05","2025-02-01","SF FuneralF812527       250201","","126.5","","2288741.48"
"2025-02-05","2025-02-01","SF FuneralF814297       250201","","126.5","","2288867.98"
"2025-02-05","2025-02-01","SF FuneralF816701       250201","","126.5","","2288994.48"
"2025-02-05","2025-02-01","SF FuneralF816765       250201","","126.5","","2289120.98"
"2025-02-05","2025-02-01","SF FuneralF817476       250201","","126.5","","2289247.48"
"2025-02-05","2025-02-01","SF FuneralF818240       250201","","126.5","","2289373.98"
"2025-02-05","2025-02-01","SF FuneralF818642       250201","","126.5","","2289500.48"
"2025-02-05","2025-02-01","SF FuneralF818976       250201","","126.5","","2289626.98"
"2025-02-05","2025-02-01","SF FuneralF808997       250201","","126.5","","2289753.48"
"2025-02-05","2025-02-01","SF FuneralF820748       250201","","126.5","","2289879.98"
"2025-02-05","2025-02-01","SF FuneralF820876       250201","","126.5","","2290006.48"
"2025-02-05","2025-02-01","SF FuneralF820970       250201","","126.5","","2290132.98"
"2025-02-05","2025-02-01","SF FuneralF821162       250201","","126.5","","2290259.48"
"2025-02-05","2025-02-01","SF FuneralF821786       250201","","126.5","","2290385.98"
"2025-02-05","2025-02-01","SF FuneralF828482       250201","","126.5","","2290512.48"
"2025-02-05","2025-02-01","SF FuneralFDC0000000BHHC250201","","126.5","","2290638.98"
"2025-02-05","2025-02-01","SF FuneralF828296       250201","","126.5","","2290765.48"
"2025-02-05","2025-02-01","SF FuneralF828515       250201","","126.5","","2290891.98"
"2025-02-05","2025-02-01","SF FuneralF828572       250201","","126.5","","2291018.48"
"2025-02-05","2025-02-01","SF FuneralF830139       250201","","126.5","","2291144.98"
"2025-02-05","2025-02-01","SF FuneralF830516       250201","","126.5","","2291271.48"
"2025-02-05","2025-02-01","SF FuneralFDC0000000BVL4250201","","126.5","","2291397.98"
"2025-02-05","2025-02-01","SF FuneralF830828       250201","","126.5","","2291524.48"
"2025-02-05","2025-02-01","SF FuneralF832534       250201","","126.5","","2291650.98"
"2025-02-05","2025-02-01","SF FuneralF832638       250201","","126.5","","2291777.48"
"2025-02-05","2025-02-01","SF FuneralF832844       250201","","126.5","","2291903.98"
"2025-02-05","2025-02-01","SF FuneralF833418       250201","","126.5","","2292030.48"
"2025-02-05","2025-02-01","SF FuneralF834946       250201","","126.5","","2292156.98"
"2025-02-05","2025-02-01","SF FuneralF841706       250201","","126.5","","2292283.48"
"2025-02-05","2025-02-01","SF FuneralF841784       250201","","126.5","","2292409.98"
"2025-02-05","2025-02-01","SF FuneralF841877       250201","","126.5","","2292536.48"
"2025-02-05","2025-02-01","SF FuneralF842657       250201","","126.5","","2292662.98"
"2025-02-05","2025-02-01","SF FuneralF842801       250201","","126.5","","2292789.48"
"2025-02-05","2025-02-01","SF FuneralF992580       250201","","126.5","","2292915.98"
"2025-02-05","2025-02-01","SF FuneralF992817       250201","","126.5","","2293042.48"
"2025-02-05","2025-02-01","SF FuneralFDC0000000JB57250201","","126.5","","2293168.98"
"2025-02-05","2025-02-01","SF FuneralF993082       250201","","126.5","","2293295.48"
"2025-02-05","2025-02-01","SF FuneralF993182       250201","","126.5","","2293421.98"
"2025-02-05","2025-02-01","SF FuneralF993211       250201","","126.5","","2293548.48"
"2025-02-05","2025-02-01","SF FuneralF993304       250202","","126.5","","2293674.98"
"2025-02-05","2025-02-01","SF FuneralF993414       250201","","126.5","","2293801.48"
"2025-02-05","2025-02-01","SF FuneralF993534       250201","","126.5","","2293927.98"
"2025-02-05","2025-02-01","SF FuneralFDC0000000JDWG250201","","126.5","","2294054.48"
"2025-02-05","2025-02-01","SF FuneralF1010503      250201","","126.5","","2294180.98"
"2025-02-05","2025-02-01","SF FuneralF1017410      250201","","126.5","","2294307.48"
"2025-02-05","2025-02-01","SF FuneralF1021669      250201","","126.5","","2294433.98"
"2025-02-05","2025-02-01","SF FuneralF1052334      250201","","126.5","","2294560.48"
"2025-02-05","2025-02-01","SF FuneralF1052927      250201","","126.5","","2294686.98"
"2025-02-05","2025-02-01","SF FuneralF1059331      250201","","126.5","","2294813.48"
"2025-02-05","2025-02-01","SF FuneralF1059484      250201","","126.5","","2294939.98"
"2025-02-05","2025-02-01","SF FuneralF1060080      250201","","126.5","","2295066.48"
"2025-02-05","2025-02-01","SF FuneralF1060245      250201","","126.5","","2295192.98"
"2025-02-05","2025-02-01","SF FuneralF1060343      250201","","126.5","","2295319.48"
"2025-02-05","2025-02-01","SF FuneralF1061622      250201","","126.5","","2295445.98"
"2025-02-05","2025-02-01","SF FuneralF1066259      250201","","126.5","","2295572.48"
"2025-02-05","2025-02-01","SF FuneralF1066308      250201","","126.5","","2295698.98"
"2025-02-05","2025-02-01","SF FuneralF1066425      250201","","126.5","","2295825.48"
"2025-02-05","2025-02-01","SF FuneralF1072769      250201","","126.5","","2295951.98"
"2025-02-05","2025-02-01","SF FuneralF1066456      250201","","126.5","","2296078.48"
"2025-02-05","2025-02-01","SF FuneralF1066763      250201","","126.5","","2296204.98"
"2025-02-05","2025-02-01","SF FuneralF1068238      250201","","126.5","","2296331.48"
"2025-02-05","2025-02-01","SF FuneralF1074907      250201","","126.5","","2296457.98"
"2025-02-05","2025-02-01","SF FuneralF1075220      250201","","126.5","","2296584.48"
"2025-02-05","2025-02-01","SF FuneralF1083613      250201","","126.5","","2296710.98"
"2025-02-05","2025-02-01","SF FuneralF1084511      250201","","126.5","","2296837.48"
"2025-02-05","2025-02-01","SF FuneralF1084632      250201","","126.5","","2296963.98"
"2025-02-05","2025-02-01","SF FuneralF1084745      250201","","126.5","","2297090.48"
"2025-02-05","2025-02-01","SF FuneralF1084770      250201","","126.5","","2297216.98"
"2025-02-05","2025-02-01","SF FuneralF1085080      250201","","126.5","","2297343.48"
"2025-02-05","2025-02-01","SF FuneralF1085469      250201","","126.5","","2297469.98"
"2025-02-05","2025-02-01","SF FuneralFDC0000000M3SD250201","","126.5","","2297596.48"
"2025-02-05","2025-02-01","SF FuneralF1103654      250202","","126.5","","2297722.98"
"2025-02-05","2025-02-01","SF FuneralF1103935      250202","","31.63","","2297754.61"
"2025-02-05","2025-02-01","SF FuneralF1109069      250201","","126.5","","2297881.11"
"2025-02-05","2025-02-01","SF FuneralF1109103      250201","","126.5","","2298007.61"
"2025-02-05","2025-02-01","SF FuneralF822145       250201","","191.5","","2298199.11"
"2025-02-05","2025-02-01","SF FuneralF1110029      250201","","126.5","","2298325.61"
"2025-02-05","2025-02-01","SF FuneralF1110061      250201","","126.5","","2298452.11"
"2025-02-05","2025-02-01","SF FuneralF1110606      250201","","126.5","","2298578.61"
"2025-02-05","2025-02-01","SF FuneralF1110815      250201","","126.5","","2298705.11"
"2025-02-05","2025-02-01","SF FuneralF1113337      250201","","126.5","","2298831.61"
"2025-02-05","2025-02-01","SF FuneralF1113641      250201","","126.5","","2298958.11"
"2025-02-05","2025-02-01","SF FuneralF1113739      250201","","126.5","","2299084.61"
"2025-02-05","2025-02-01","SF FuneralF1113786      250201","","126.5","","2299211.11"
"2025-02-05","2025-02-01","SF FuneralF1113832      250201","","126.5","","2299337.61"
"2025-02-05","2025-02-01","SF FuneralF1113903      250201","","126.5","","2299464.11"
"2025-02-05","2025-02-01","SF FuneralF1114104      250201","","126.5","","2299590.61"
"2025-02-05","2025-02-01","SF FuneralF1104065      250201","","386.5","","2299977.11"
"2025-02-05","2025-02-01","SF FuneralF1117171      250201","","126.5","","2300103.61"
"2025-02-05","2025-02-01","SF FuneralF1117701      250201","","126.5","","2300230.11"
"2025-02-05","2025-02-01","SF FuneralF1117716      250201","","126.5","","2300356.61"
"2025-02-05","2025-02-01","SF FuneralF1117873      250201","","126.5","","2300483.11"
"2025-02-05","2025-02-01","SF FuneralF1118025      250201","","126.5","","2300609.61"
"2025-02-05","2025-02-01","SF FuneralF1119721      250201","","126.5","","2300736.11"
"2025-02-05","2025-02-01","SF FuneralF1119872      250201","","126.5","","2300862.61"
"2025-02-05","2025-02-01","SF FuneralFDC0000000NVJD250201","","126.5","","2300989.11"
"2025-02-05","2025-02-01","SF FuneralFDC0000000NVJH250201","","126.5","","2301115.61"
"2025-02-05","2025-02-01","SF FuneralF1122073      250201","","126.5","","2301242.11"
"2025-02-05","2025-02-01","SF FuneralF1122191      250201","","126.5","","2301368.61"
"2025-02-05","2025-02-01","SF FuneralF1122292      250201","","126.5","","2301495.11"
"2025-02-05","2025-02-01","SF FuneralF1122610      250201","","126.5","","2301621.61"
"2025-02-05","2025-02-01","SF FuneralF1122621      250201","","126.5","","2301748.11"
"2025-02-05","2025-02-01","SF FuneralF1122660      250201","","126.5","","2301874.61"
"2025-02-05","2025-02-01","SF FuneralF1122943      250201","","126.5","","2302001.11"
"2025-02-05","2025-02-01","SF FuneralF1123268      250201","","126.5","","2302127.61"
"2025-02-05","2025-02-01","SF FuneralF1123897      250201","","126.5","","2302254.11"
"2025-02-05","2025-02-01","SF FuneralF1123904      250201","","126.5","","2302380.61"
"2025-02-05","2025-02-01","SF FuneralF1125680      250201","","126.5","","2302507.11"
"2025-02-05","2025-02-01","SF FuneralFDC0000000PHYJ250201","","126.5","","2302633.61"
"2025-02-05","2025-02-01","SF FuneralFDC0000000PJGC250201","","126.5","","2302760.11"
"2025-02-05","2025-02-01","SF FuneralF1125952      250201","","126.5","","2302886.61"
"2025-02-05","2025-02-01","SF FuneralF1126828      250201","","126.5","","2303013.11"
"2025-02-05","2025-02-01","SF FuneralFDC0000000PLGZ250202","","126.5","","2303139.61"
"2025-02-05","2025-02-01","SF FuneralF1127516      250201","","126.5","","2303266.11"
"2025-02-05","2025-02-01","SF FuneralF1127533      250201","","126.5","","2303392.61"
"2025-02-05","2025-02-01","SF FuneralF1127557      250201","","126.5","","2303519.11"
"2025-02-05","2025-02-01","SF FuneralF1127764      250201","","126.5","","2303645.61"
"2025-02-05","2025-02-01","SF FuneralF1127955      250201","","126.5","","2303772.11"
"2025-02-05","2025-02-01","SF FuneralF1127995      250201","","126.5","","2303898.61"
"2025-02-05","2025-02-01","SF FuneralF1128035      250201","","126.5","","2304025.11"
"2025-02-05","2025-02-01","SF FuneralFDC0000000PVKR250201","","126.5","","2304151.61"
"2025-02-05","2025-02-01","SF FuneralF1128876      250201","","126.5","","2304278.11"
"2025-02-05","2025-02-01","SF FuneralF1129541      250201","","126.5","","2304404.61"
"2025-02-05","2025-02-01","SF FuneralFDC0000000PZZK250201","","126.5","","2304531.11"
"2025-02-05","2025-02-01","SF FuneralF1128209      250201","","126.5","","2304657.61"
"2025-02-05","2025-02-03","SF FuneralFDC00000007GXX250202","","126.5","","2304784.11"
"2025-02-05","2025-02-03","SF FuneralF802937       250202","","126.5","","2304910.61"
"2025-02-05","2025-02-03","SF FuneralF828231       250202","","126.5","","2305037.11"
"2025-02-05","2025-02-03","SF FuneralF843018       250201","","126.5","","2305163.61"
"2025-02-05","2025-02-03","SF FuneralFDC0000000FHMJ250201","","126.5","","2305290.11"
"2025-02-05","2025-02-03","SF FuneralFDC0000000LDPQ250203","","126.5","","2305416.61"
"2025-02-05","2025-02-03","SF FuneralF738067       250203","","220","","2305636.61"
"2025-02-05","2025-02-04","SF FuneralF901250       250204","","63.25","","2305699.86"
"2025-02-05","2025-02-05","SF FuneralFDC00000005Q2Z250205","","63.25","","2305763.11"
"2025-02-05","2025-02-05","SF FuneralFDC00000005Q5T250205","","63.25","","2305826.36"
"2025-02-05","2025-02-01","SF FuneralFDC0000000MM9X250201","","126.5","","2305952.86"
"2025-02-05","2025-01-24","Rev SF FuneralFDC00000005HJM250124","","-31.63","","2305921.23"
"2025-02-05","2025-02-03","Rev SF FuneralFDC0000000NMNL250203","","-126.5","","2305794.73"
"2025-02-05","2025-02-01","Rev SF FuneralFDC000000039PJ250201","","-220","","2305574.73"
"2025-02-05","2025-01-24","Rev SF FuneralF810567       250128","","-126.5","","2305448.23"
"2025-02-05","2025-01-29","SF FuneralF831255       250129","","126.5","","2305574.73"
"2025-02-05","2025-01-31","SF FuneralF833005       250131","","126.5","","2305701.23"
"2025-02-05","2025-01-31","SF FuneralF1128243      250131","","126.5","","2305827.73"
"2025-02-05","2025-02-01","SF FuneralFDC0000000860N250201","","126.5","","2305954.23"
"2025-02-05","2025-02-01","SF FuneralFDC0000000L5VH250201","","126.5","","2306080.73"
"2025-02-05","2025-02-01","SF FuneralF1122382      250202","","126.5","","2306207.23"
"2025-02-05","2025-02-04","SF FuneralFDC000000086B2250204","","31.63","","2306238.86"
"2025-02-05","2025-02-04","SF FuneralFDC0000000BWTD250204","","31.63","","2306270.49"
"2025-02-05","2025-02-04","SF FuneralF799620       250204","","64.13","","2306334.62"
"2025-02-05","2025-02-04","SF FuneralF993633       250204","","31.63","","2306366.25"
"2025-02-05","2025-02-04","SF FuneralF775280       250204","","126.5","","2306492.75"
"2025-02-05","2025-02-05","SF FuneralFDC00000007DMT250205","","31.63","","2306524.38"
"2025-02-05","2025-02-01","Rev SF FuneralFDC000000035X4250201","","-220","","2306304.38"
"2025-02-05","2025-02-01","SF FuneralFDC00000007WGB250201","","126.5","","2306430.88"
"2025-02-05","2025-02-05","FuneralSFTEW2022752496","","7040","","2313470.88"
"2025-02-05","2025-02-01","SF FuneralFDC00000006HV8250201","","126.5","","2313597.38"
"2025-02-05","2025-02-01","SF FuneralF809227       250201","","126.5","","2313723.88"
"2025-02-05","2025-02-01","SF FuneralF1114755      250202","","126.5","","2313850.38"
"2025-02-05","2025-02-03","SF FuneralFDC00000009958250203","","31.63","","2313882.01"
"2025-02-05","2025-02-04","SF FuneralF1058830      250204","","63.25","","2313945.26"
"2025-02-05","2025-02-01","Rev SF FuneralFDC00000007QKL250201","","-126.5","","2313818.76"
"2025-02-05","2025-01-31","SF FuneralF981587       250201","","126.5","","2313945.26"
"2025-02-05","2025-02-03","SF FuneralFDC00000005LS9250203","","31.63","","2313976.89"
"2025-02-05","2025-02-03","SF FuneralF801680       250202","","126.5","","2314103.39"
"2025-02-05","2025-02-03","SF FuneralF832990       250202","","31.63","","2314135.02"
"2025-02-05","2025-02-03","SF FuneralF1052798      250203","","31.63","","2314166.65"
"2025-02-05","2025-02-04","SF FuneralF1128951      250204","","31.63","","2314198.28"
"2025-02-05","2025-01-24","Rev SF FuneralF1021761      250128","","-126.5","","2314071.78"
"2025-02-05","2025-02-01","SF FuneralF822218       250201","","126.5","","2314198.28"
"2025-02-05","2025-02-01","SF FuneralF1066770      250202","","126.5","","2314324.78"
"2025-02-05","2025-02-03","SF FuneralFDC00000005NKJ250203","","31.63","","2314356.41"
"2025-02-05","2025-02-04","SF FuneralFDC0000000KQ5F250204","","31.63","","2314388.04"
"2025-02-05","2025-02-01","SF FuneralF1129917      250202","","31.63","","2314419.67"
"2025-02-05","2025-02-05","Supreme Fun Comm","","-1194407.73","","1120011.94"
"2025-02-05","2025-02-05","Fee-Txn Notify E-Mail","","-1","","1120010.94"
"2025-02-05","2025-02-05","Fee-Txn Notify E-Mail","","-1","","1120009.94"
"2025-02-05","2025-01-29","SF FuneralF1066005      250129","","126.5","","1120136.44"
"2025-02-05","2025-01-31","SF FuneralFDC00000007JNH250131","","31.63","","1120168.07"
"2025-02-05","2025-01-31","SF FuneralF987189       250201","","126.5","","1120294.57"
"2025-02-05","2025-02-01","SF FuneralF784736       250201","","31.63","","1120326.2"
"2025-02-05","2025-02-01","SF FuneralF1079110      250202","","126.5","","1120452.7"
"2025-02-05","2025-02-03","SF FuneralFDC00000009G6B250202","","31.63","","1120484.33"
"2025-02-05","2025-02-03","SF FuneralFDC00000009G6R250203","","31.63","","1120515.96"
"2025-02-05","2025-02-03","SF FuneralFDC00000009XWR250202","","31.63","","1120547.59"
"2025-02-05","2025-02-04","SF FuneralFDC00000005PFJ250204","","31.63","","1120579.22"
"2025-02-05","2025-02-04","SF FuneralF843037       250204","","31.63","","1120610.85"
"2025-02-05","2025-02-04","SF FuneralFDC0000000K09P250204","","65","","1120675.85"
"2025-02-05","2025-02-05","SF FuneralFDC00000005MXX250205","","126.5","","1120802.35"
"2025-02-05","2025-02-01","Rev SF FuneralFDC00000006Y3H250201","","-126.5","","1120675.85"
"2025-02-05","2025-02-01","Rev SF FuneralFDC00000006NLQ250201","","-126.5","","1120549.35"
"2025-02-05","2025-01-03","Rev SF FuneralFDC0000000PKBK250103","","-126.5","","1120422.85"
"2025-02-05","2025-01-24","Rev SF FuneralFDC000000089WZ250125","","-126.5","","1120296.35"
"2025-02-05","2024-12-20","Rev SF FuneralFDC0000000PKMP241220","","-126.5","","1120169.85"
"2025-02-05","2024-11-04","Rev SF FuneralF847260       241102","","-126.5","","1120043.35"
"2025-02-05","2025-01-20","Rev SF FuneralFDC0000000PKMP250120","","-126.5","","1119916.85"
"2025-02-05","2024-12-11","Rev SF FuneralFDC00000006YXS241228","","-126.5","","1119790.35"
"2025-02-05","2025-02-01","Rev SF FuneralFDC0000000MLKF250201","","-126.5","","1119663.85"
"2025-02-05","2025-02-01","Rev SF FuneralFDC00000006B43250201","","-126.5","","1119537.35"
"2025-02-05","2025-02-01","Rev SF FuneralFDC0000000KJM2250201","","-126.5","","1119410.85"
"2025-02-05","2025-02-01","Rev SF FuneralFDC000000076QP250201","","-220","","1119190.85"
"2025-02-05","2025-02-01","Rev SF FuneralFDC000000076QQ250201","","-220","","1118970.85"
"2025-02-05","2025-02-05","Rev SF FuneralFDC00000007DMT250205","","-31.63","","1118939.22"
"2025-02-05","2025-02-01","Rev SF FuneralFDC0000000LGTL250201","","-126.5","","1118812.72"
"2025-02-05","2025-02-01","Rev SF FuneralFDC00000006QYV250201","","-126.5","","1118686.22"
"2025-02-05","2025-02-03","Rev SF FuneralFDC0000000PKBK250203","","-126.5","","1118559.72"
"2025-02-05","2024-12-23","Rev SF FuneralF992066       241226","","-126.5","","1118433.22"
"2025-02-05","2025-01-20","Rev SF FuneralFDC00000007HMX250119","","-126.5","","1118306.72"
"2025-02-05","2025-01-24","Rev SF FuneralFDC0000000NY14250128","","-126.5","","1118180.22"
"2025-02-05","2025-02-03","Rev SF FuneralFDC00000006XD1250202","","-126.5","","1118053.72"
"2025-02-05","2025-01-02","Rev SF FuneralFDC00000006QYV250101","","-126.5","","1117927.22"
"2025-02-05","2025-01-24","Rev SF FuneralFDC00000006YXS250128","","-126.5","","1117800.72"
"2025-02-05","2025-02-01","Rev SF FuneralFDC0000000ML98250201","","-126.5","","1117674.22"
"2025-02-05","2025-02-01","SF FuneralFDC00000006JPT250201","","220","","1117894.22"
"2025-02-05","2025-01-29","SF FuneralF799698       250129","","126.5","","1118020.72"
"2025-02-05","2025-02-01","SF FuneralF1113585      250201","","126.5","","1118147.22"
"2025-02-05","2025-01-31","SF FuneralF989917       250131","","126.5","","1118273.72"
"2025-02-05","2025-02-04","SF FuneralF828867       250204","","31.63","","1118305.35"
"2025-02-05","2025-02-04","SF FuneralF1111329      250204","","31.63","","1118336.98"
"2025-02-05","2025-02-01","SF FuneralF1058746      250201","","126.5","","1118463.48"
"2025-02-05","2025-02-01","SF FuneralF1118662      250202","","126.5","","1118589.98"
"2025-02-05","2025-02-01","SF FuneralFDC0000000PHGP250201","","126.5","","1118716.48"
"2025-02-05","2024-12-02","Rev SF FuneralFDC000000069RR241201","","-126.5","","1118589.98"
"2025-02-05","2025-02-05","EFT-EFT DEBIT TRANSFERS 061061","","35362","","1153951.98"
