"Txn date","Effective","Description","Truncated card number","Amount","Charges","Balance"
"2025-03-16","2025-03-12","SF FuneralF844166       250312","","126.5","","306665.5"
"2025-03-16","2025-03-12","SF FuneralF986932       250312","","126.5","","306792"
"2025-03-16","2025-03-12","SF FuneralFDC0000000KJ62250312","","126.5","","306918.5"
"2025-03-16","2025-03-12","SF FuneralF1083800      250312","","126.5","","307045"
"2025-03-16","2025-03-12","SF FuneralF1102951      250312","","126.5","","307171.5"
"2025-03-16","2025-03-12","SF FuneralF1111673      250312","","126.5","","307298"
"2025-03-16","2025-03-13","SF FuneralF1132775      250313","","126.5","","307424.5"
"2025-03-16","2025-03-11","SF FuneralF813326       250311","","31.63","","307456.13"
"2025-03-16","2025-03-11","SF FuneralF814431       250311","","31.63","","307487.76"
"2025-03-16","2025-03-12","SF FuneralFDC00000005N7Y250312","","126.5","","307614.26"
"2025-03-16","2025-03-12","SF FuneralFDC00000005N85250312","","126.5","","307740.76"
"2025-03-16","2025-03-12","SF FuneralFDC00000007NND250312","","126.5","","307867.26"
"2025-03-16","2025-03-14","SF FuneralFDC000000034WF250314","","220","","308087.26"
"2025-03-16","2025-03-14","SF FuneralFDC00000008NYM250314","","31.63","","308118.89"
"2025-03-16","2025-03-12","SF FuneralF819141       250312","","126.5","","308245.39"
"2025-03-16","2025-03-12","SF FuneralF989548       250312","","126.5","","308371.89"
"2025-03-16","2025-03-12","SF FuneralFDC0000000K8XN250312","","126.5","","308498.39"
"2025-03-16","2025-03-15","SF FuneralFDC00000007M50250315","","126.5","","308624.89"
"2025-03-16","2025-03-15","SF FuneralF1020559      250316","","126.5","","308751.39"
"2025-03-16","2025-03-11","SF FuneralFDC00000006YDC250311","","126.5","","308877.89"
"2025-03-16","2025-03-12","SF FuneralF1072854      250312","","126.5","","309004.39"
"2025-03-16","2025-03-12","SF FuneralF1072855      250312","","126.5","","309130.89"
"2025-03-16","2025-03-12","SF FuneralF1132406      250312","","126.5","","309257.39"
"2025-03-16","2025-03-12","SF FuneralF802401       250312","","63.25","","309320.64"
"2025-03-16","2025-03-12","SF FuneralF990133       250312","","126.5","","309447.14"
"2025-03-16","2025-03-12","SF FuneralFDC0000000KBFK250312","","126.5","","309573.64"
"2025-03-16","2025-03-12","SF FuneralF1079376      250312","","126.5","","309700.14"
"2025-03-16","2025-03-12","SF FuneralF1132973      250312","","126.5","","309826.64"
"2025-03-16","2025-03-11","SF FuneralFDC00000006L9F250311","","31.63","","309858.27"
"2025-03-16","2025-03-16","SF FuneralF833253       250316","","31.63","","309889.9"
"2025-03-16","2025-03-12","SF FuneralF1132911      250312","","31.63","","309921.53"
"2025-03-16","2025-03-12","SF FuneralFDC00000005NXL250312","","126.5","","310048.03"
"2025-03-16","2025-03-12","SF FuneralF1117363      250312","","126.5","","310174.53"
"2025-03-16","2025-03-14","SF FuneralFDC00000007MW5250314","","31.63","","310206.16"
"2025-03-16","2025-03-14","SF FuneralF818785       250314","","31.63","","310237.79"
"2025-03-16","2025-03-14","SF FuneralF1123029      250314","","126.5","","310364.29"
"2025-03-16","2025-03-16","SF FuneralF829764       250316","","63.25","","310427.54"
"2025-03-17","2025-03-12","SF FuneralF1119760      250312","","126.5","","310554.04"
"2025-03-17","2025-03-10","SF FuneralF827664       250310","","63.25","","310617.29"
"2025-03-17","2025-03-12","SF FuneralF1123492      250312","","126.5","","310743.79"
"2025-03-17","2025-03-13","SF FuneralF843570       250313","","31.63","","310775.42"
"2025-03-17","2025-03-14","SF FuneralF812905       250314","","31.63","","310807.05"
"2025-03-17","2025-03-14","SF FuneralF815510       250314","","31.63","","310838.68"
"2025-03-17","2025-03-15","SF FuneralF1079004      250316","","31.63","","310870.31"
"2025-03-17","2025-03-12","SF FuneralFDC000000075BD250312","","126.5","","310996.81"
"2025-03-17","2025-03-12","SF FuneralF815877       250312","","126.5","","311123.31"
"2025-03-17","2025-03-15","SF FuneralF1079334      250315","","126.5","","311249.81"
"2025-03-17","2025-03-12","SF FuneralFDC00000006XJG250312","","126.5","","311376.31"
"2025-03-17","2025-03-12","SF FuneralF808341       250312","","126.5","","311502.81"
"2025-03-17","2025-03-12","SF FuneralF990706       250312","","63.25","","311566.06"
"2025-03-17","2025-03-12","SF FuneralFDC0000000M2N1250312","","63.25","","311629.31"
"2025-03-17","2025-03-14","SF FuneralFDC00000006PSF250314","","31.63","","311660.94"
"2025-03-17","2025-03-14","SF FuneralFDC0000000L8B0250314","","31.63","","311692.57"
"2025-03-17","2025-03-14","SF FuneralF1126874      250314","","31.63","","311724.2"
"2025-03-17","2025-03-17","SF FuneralFDC00000005H8J250316","","31.63","","311755.83"
"2025-03-17","2025-03-17","SF FuneralFDC00000008H2Z250317","","126.5","","311882.33"
"2025-03-17","2025-03-17","SF FuneralF815501       250317","","63.25","","311945.58"
"2025-03-17","2025-03-17","SF FuneralF823244       250317","","126.5","","312072.08"
"2025-03-17","2025-03-17","SF FuneralF1066274      250317","","31.63","","312103.71"
"2025-03-17","2025-03-17","SF FuneralF1123277      250317","","31.63","","312135.34"
"2025-03-17","2025-03-14","SF FuneralFDC00000005PXF250314","","31.63","","312166.97"
"2025-03-17","2025-03-14","SF FuneralFDC00000005QCT250314","","31.63","","312198.6"
"2025-03-17","2025-03-14","SF FuneralFDC00000005V4S250314","","31.63","","312230.23"
"2025-03-17","2025-03-14","SF FuneralFDC00000007WBL250314","","31.63","","312261.86"
"2025-03-17","2025-03-14","SF FuneralFDC00000007WJL250314","","31.63","","312293.49"
"2025-03-17","2025-03-14","SF FuneralF795812       250314","","31.63","","312325.12"
"2025-03-17","2025-03-14","SF FuneralF790399       250314","","47.88","","312373"
"2025-03-17","2025-03-14","SF FuneralF817463       250314","","31.63","","312404.63"
"2025-03-17","2025-03-14","SF FuneralF830931       250314","","31.63","","312436.26"
"2025-03-17","2025-03-14","SF FuneralF832777       250314","","31.63","","312467.89"
"2025-03-17","2025-03-14","SF FuneralF819053       250314","","31.63","","312499.52"
"2025-03-17","2025-03-14","SF FuneralFDC0000000FQWF250314","","31.63","","312531.15"
"2025-03-17","2025-03-14","SF FuneralF844636       250314","","31.63","","312562.78"
"2025-03-17","2025-03-14","SF FuneralF986934       250314","","31.63","","312594.41"
"2025-03-17","2025-03-14","SF FuneralF993478       250314","","31.63","","312626.04"
"2025-03-17","2025-03-14","SF FuneralFDC0000000JFC4250314","","31.63","","312657.67"
"2025-03-17","2025-03-14","SF FuneralF1033620      250314","","31.63","","312689.3"
"2025-03-17","2025-03-14","SF FuneralF1052348      250314","","31.63","","312720.93"
"2025-03-17","2025-03-14","SF FuneralF1111672      250314","","31.63","","312752.56"
"2025-03-17","2025-03-14","SF FuneralF1122752      250314","","31.63","","312784.19"
"2025-03-17","2025-03-14","SF FuneralF1123947      250314","","31.63","","312815.82"
"2025-03-17","2025-03-14","SF FuneralF1127351      250314","","31.63","","312847.45"
"2025-03-17","2025-03-14","SF FuneralF1132933      250314","","31.63","","312879.08"
"2025-03-17","2025-03-14","SF FuneralF1134612      250314","","31.63","","312910.71"
"2025-03-17","2025-03-17","SF FuneralFDC0000000376D250317","","55","","312965.71"
"2025-03-17","2025-03-17","SF FuneralFDC00000005NR4250317","","31.63","","312997.34"
"2025-03-17","2025-03-17","SF FuneralFDC00000005RZQ250317","","31.63","","313028.97"
"2025-03-17","2025-03-17","SF FuneralFDC000000069C5250317","","31.63","","313060.6"
"2025-03-17","2025-03-17","SF FuneralFDC000000070Z5250316","","31.63","","313092.23"
"2025-03-17","2025-03-17","SF FuneralF814420       250317","","63.25","","313155.48"
"2025-03-17","2025-03-17","SF FuneralF831617       250317","","31.63","","313187.11"
"2025-03-17","2025-03-17","SF FuneralF1017111      250317","","31.63","","313218.74"
"2025-03-17","2025-03-17","SF FuneralF1052717      250317","","31.63","","313250.37"
"2025-03-17","2025-03-17","SF FuneralF1117767      250317","","31.63","","313282"
"2025-03-17","2025-03-17","SF FuneralF1118957      250317","","31.63","","313313.63"
"2025-03-17","2025-03-17","SF FuneralF1123098      250317","","31.63","","313345.26"
"2025-03-17","2025-03-17","SF FuneralF1124331      250317","","126.5","","313471.76"
"2025-03-17","2025-03-17","SF FuneralF1124411      250317","","31.63","","313503.39"
"2025-03-17","2025-03-17","SF FuneralFDC0000000PYVQ250317","","31.63","","313535.02"
"2025-03-17","2025-03-17","SF FuneralF1129402      250317","","31.63","","313566.65"
"2025-03-17","2025-03-17","SF FuneralF1131541      250317","","31.63","","313598.28"
"2025-03-17","2025-03-11","SF FuneralF805662       250311","","31.63","","313629.91"
"2025-03-17","2025-03-11","SF FuneralF1104197      250311","","31.63","","313661.54"
"2025-03-17","2025-03-13","SF FuneralF1085168      250313","","31.63","","313693.17"
"2025-03-17","2025-03-13","SF FuneralF1108113      250313","","31.63","","313724.8"
"2025-03-17","2025-03-14","SF FuneralFDC00000006R81250314","","31.63","","313756.43"
"2025-03-17","2025-03-14","SF FuneralFDC000000086Y9250314","","31.63","","313788.06"
"2025-03-17","2025-03-14","SF FuneralF813030       250314","","31.63","","313819.69"
"2025-03-17","2025-03-14","SF FuneralF815340       250314","","31.63","","313851.32"
"2025-03-17","2025-03-14","SF FuneralF823750       250314","","31.63","","313882.95"
"2025-03-17","2025-03-14","SF FuneralF829118       250314","","31.63","","313914.58"
"2025-03-17","2025-03-14","SF FuneralF832185       250314","","31.63","","313946.21"
"2025-03-17","2025-03-14","SF FuneralF843596       250314","","31.63","","313977.84"
"2025-03-17","2025-03-14","SF FuneralF901122       250314","","31.63","","314009.47"
"2025-03-17","2025-03-14","SF FuneralFDC0000000HBD0250314","","31.63","","314041.1"
"2025-03-17","2025-03-14","SF FuneralF774474       250314","","156.28","","314197.38"
"2025-03-17","2025-03-14","SF FuneralFDC0000000HXHK250314","","47.88","","314245.26"
"2025-03-17","2025-03-14","SF FuneralFDC0000000J2XM250316","","31.63","","314276.89"
"2025-03-17","2025-03-14","SF FuneralF992752       250314","","31.63","","314308.52"
"2025-03-17","2025-03-14","SF FuneralF993205       250314","","31.63","","314340.15"
"2025-03-17","2025-03-14","SF FuneralFDC0000000K7CQ250314","","31.63","","314371.78"
"2025-03-17","2025-03-14","SF FuneralFDC0000000KLCD250314","","31.63","","314403.41"
"2025-03-17","2025-03-14","SF FuneralF1061613      250314","","31.63","","314435.04"
"2025-03-17","2025-03-14","SF FuneralF1065649      250314","","31.63","","314466.67"
"2025-03-17","2025-03-14","SF FuneralF1068145      250314","","31.63","","314498.3"
"2025-03-17","2025-03-14","SF FuneralF1073030      250314","","31.63","","314529.93"
"2025-03-17","2025-03-14","SF FuneralFDC0000000L3MT250314","","31.63","","314561.56"
"2025-03-17","2025-03-14","SF FuneralF1078056      250314","","31.63","","314593.19"
"2025-03-17","2025-03-14","SF FuneralF1084400      250314","","31.63","","314624.82"
"2025-03-17","2025-03-14","SF FuneralF1085355      250314","","31.63","","314656.45"
"2025-03-17","2025-03-14","SF FuneralF1104196      250314","","31.63","","314688.08"
"2025-03-17","2025-03-14","SF FuneralF1104243      250314","","31.63","","314719.71"
"2025-03-17","2025-03-14","SF FuneralFDC0000000NNGY250314","","31.63","","314751.34"
"2025-03-17","2025-03-14","SF FuneralF1123008      250314","","31.63","","314782.97"
"2025-03-17","2025-03-14","SF FuneralF1130369      250314","","31.63","","314814.6"
"2025-03-17","2025-03-14","SF FuneralF1131924      250314","","31.63","","314846.23"
"2025-03-17","2025-03-14","SF FuneralFDC0000000Q7FQ250314","","31.63","","314877.86"
"2025-03-17","2025-03-14","SF FuneralF1132194      250314","","31.63","","314909.49"
"2025-03-17","2025-03-14","SF FuneralFDC0000000Q9Z0250314","","31.63","","314941.12"
"2025-03-17","2025-03-15","SF FuneralFDC00000006HHY250315","","31.63","","314972.75"
"2025-03-17","2025-03-15","SF FuneralF1060024      250315","","31.63","","315004.38"
"2025-03-17","2025-03-17","SF FuneralFDC00000007BGG250316","","31.63","","315036.01"
"2025-03-17","2025-03-17","SF FuneralFDC00000007DSV250317","","31.63","","315067.64"
"2025-03-17","2025-03-17","SF FuneralFDC00000007GS9250317","","31.63","","315099.27"
"2025-03-17","2025-03-17","SF FuneralFDC00000007H6K250317","","31.63","","315130.9"
"2025-03-17","2025-03-17","SF FuneralFDC000000086PW250316","","31.63","","315162.53"
"2025-03-17","2025-03-17","SF FuneralFDC000000086PX250316","","31.63","","315194.16"
"2025-03-17","2025-03-17","SF FuneralFDC0000000918Q250317","","47.88","","315242.04"
"2025-03-17","2025-03-17","SF FuneralF988318       250317","","31.63","","315273.67"
"2025-03-17","2025-03-17","SF FuneralF1072930      250317","","31.63","","315305.3"
"2025-03-17","2025-03-17","SF FuneralF1073147      250317","","31.63","","315336.93"
"2025-03-17","2025-03-17","SF FuneralF1117477      250317","","31.63","","315368.56"
"2025-03-17","2025-03-17","SF FuneralF1118005      250317","","31.63","","315400.19"
"2025-03-17","2025-03-17","SF FuneralF1128005      250317","","31.63","","315431.82"
"2025-03-17","2025-03-15","SF FuneralFDC0000000740L250315","","126.5","","315558.32"
"2025-03-17","2025-03-17","SF FuneralFDC000000067RJ250317","","126.5","","315684.82"
"2025-03-17","2025-03-17","SF FuneralFDC00000006T5D250317","","126.5","","315811.32"
"2025-03-17","2025-03-17","SF FuneralFDC000000072B6250317","","63.25","","315874.57"
"2025-03-17","2025-03-17","SF FuneralF814669       250317","","126.5","","316001.07"
"2025-03-17","2025-03-17","SF FuneralF988180       250317","","126.5","","316127.57"
"2025-03-17","2025-03-17","SF FuneralF1022097      250317","","126.5","","316254.07"
"2025-03-17","2025-03-17","SF FuneralF1075050      250317","","126.5","","316380.57"
"2025-03-17","2025-03-17","SF FuneralF1111949      250317","","63.25","","316443.82"
"2025-03-17","2025-03-17","SF FuneralFDC0000000PDM3250317","","126.5","","316570.32"
"2025-03-17","2025-03-14","SF FuneralFDC0000000HYW8250314","","63.25","","316633.57"
"2025-03-17","2025-03-14","SF FuneralFDC0000000QJ68250314","","126.5","","316760.07"
"2025-03-17","2025-03-15","SF FuneralF1074580      250315","","63.25","","316823.32"
"2025-03-17","2025-03-17","SF FuneralFDC00000005NYD250317","","63.25","","316886.57"
"2025-03-17","2025-03-17","SF FuneralFDC00000005SZ4250317","","63.25","","316949.82"
"2025-03-17","2025-03-17","SF FuneralFDC00000005XK1250317","","220","","317169.82"
"2025-03-17","2025-03-17","SF FuneralFDC00000006NPV250316","","110","","317279.82"
"2025-03-17","2025-03-17","SF FuneralFDC00000007JPM250316","","63.25","","317343.07"
"2025-03-17","2025-03-17","SF FuneralFDC00000007M2D250316","","63.25","","317406.32"
"2025-03-17","2025-03-17","SF FuneralFDC00000007VKQ250317","","126.5","","317532.82"
"2025-03-17","2025-03-17","SF FuneralFDC0000000812F250317","","126.5","","317659.32"
"2025-03-17","2025-03-17","SF FuneralF799122       250317","","126.5","","317785.82"
"2025-03-17","2025-03-17","SF FuneralF834810       250317","","126.5","","317912.32"
"2025-03-17","2025-03-17","SF FuneralF898925       250315","","126.5","","318038.82"
"2025-03-17","2025-03-17","SF FuneralF900540       250317","","126.5","","318165.32"
"2025-03-17","2025-03-17","SF FuneralF989598       250317","","63.25","","318228.57"
"2025-03-17","2025-03-17","SF FuneralF1073148      250317","","126.5","","318355.07"
"2025-03-17","2025-03-17","SF FuneralF1103852      250317","","63.25","","318418.32"
"2025-03-17","2025-03-17","SF FuneralFDC0000000N82R250317","","126.5","","318544.82"
"2025-03-17","2025-03-17","SF FuneralF1130859      250317","","126.5","","318671.32"
"2025-03-17","2025-03-17","SF FuneralFDC00000005LYM250317","","220","","318891.32"
"2025-03-17","2025-03-17","SF FuneralFDC00000005Z25250317","","31.63","","318922.95"
"2025-03-17","2025-03-17","SF FuneralFDC00000007RDZ250317","","126.5","","319049.45"
"2025-03-17","2025-03-17","SF FuneralFDC00000008KX0250317","","31.63","","319081.08"
"2025-03-17","2025-03-17","SF FuneralF820956       250316","","31.63","","319112.71"
"2025-03-17","2025-03-17","SF FuneralFDC0000000HGDW250317","","126.5","","319239.21"
"2025-03-17","2025-03-17","SF FuneralF1111332      250317","","31.63","","319270.84"
"2025-03-17","2025-03-14","SF FuneralFDC00000005VPZ250314","","31.63","","319302.47"
"2025-03-17","2025-03-14","SF FuneralFDC00000007G54250314","","31.63","","319334.1"
"2025-03-17","2025-03-14","SF FuneralF821927       250314","","31.63","","319365.73"
"2025-03-17","2025-03-14","SF FuneralFDC0000000HX7W250314","","31.63","","319397.36"
"2025-03-17","2025-03-14","SF FuneralFDC00000005TX1250314","","31.63","","319428.99"
"2025-03-17","2025-03-14","SF FuneralFDC00000006NFW250314","","31.63","","319460.62"
"2025-03-17","2025-03-11","SF FuneralF811655       250311","","31.63","","319492.25"
"2025-03-17","2025-03-17","SF FuneralFDC00000005XM4250317","","126.5","","319618.75"
"2025-03-17","2025-03-17","SF FuneralFDC00000006QFW250317","","126.5","","319745.25"
"2025-03-17","2025-03-17","SF FuneralFDC0000000723H250317","","126.5","","319871.75"
"2025-03-17","2025-03-17","SF FuneralFDC00000007V0Z250317","","126.5","","319998.25"
"2025-03-17","2025-03-17","SF FuneralFDC000000089G2250316","","31.63","","320029.88"
"2025-03-17","2025-03-17","SF FuneralF813616       250317","","126.5","","320156.38"
"2025-03-17","2025-03-17","SF FuneralF900440       250317","","126.5","","320282.88"
"2025-03-17","2025-03-17","SF FuneralFDC0000000LMGS250317","","126.5","","320409.38"
"2025-03-17","2025-03-17","SF FuneralF1102815      250317","","31.63","","320441.01"
"2025-03-17","2025-03-17","SF FuneralFDC0000000MR2H250317","","31.63","","320472.64"
"2025-03-17","2025-03-17","SF FuneralF1113735      250317","","31.63","","320504.27"
"2025-03-17","2025-03-17","SF FuneralF1127801      250317","","31.63","","320535.9"
"2025-03-17","2025-03-14","SF FuneralFDC000000070CD250314","","31.63","","320567.53"
"2025-03-17","2025-03-14","SF FuneralF814074       250314","","31.63","","320599.16"
"2025-03-17","2025-03-14","SF FuneralF842737       250314","","31.63","","320630.79"
"2025-03-17","2025-03-14","SF FuneralF1104255      250314","","31.63","","320662.42"
"2025-03-17","2025-03-14","SF FuneralF1128672      250314","","31.63","","320694.05"
"2025-03-17","2025-03-17","SF FuneralFDC00000005NWL250317","","31.63","","320725.68"
"2025-03-17","2025-03-17","SF FuneralFDC00000005Z3L250317","","31.63","","320757.31"
"2025-03-17","2025-03-17","SF FuneralFDC00000006GNR250317","","31.63","","320788.94"
"2025-03-17","2025-03-17","SF FuneralF823862       250317","","63.25","","320852.19"
"2025-03-17","2025-03-17","SF FuneralFDC0000000BV0W250317","","63.25","","320915.44"
"2025-03-17","2025-03-17","SF FuneralF830930       250317","","126.5","","321041.94"
"2025-03-17","2025-03-17","SF FuneralF1022279      250317","","126.5","","321168.44"
"2025-03-17","2025-03-17","SF FuneralF1073862      250317","","31.63","","321200.07"
"2025-03-17","2025-03-17","SF FuneralF1110284      250317","","126.5","","321326.57"
"2025-03-17","2025-03-17","SF FuneralFDC0000000MSC7250317","","47.88","","321374.45"
"2025-03-17","2025-03-17","SF FuneralF1112136      250317","","31.63","","321406.08"
"2025-03-17","2025-03-17","SF FuneralFDC0000000N81T250317","","126.5","","321532.58"
"2025-03-17","2025-03-17","SF FuneralF1122650      250317","","126.5","","321659.08"
"2025-03-17","2025-03-17","SF FuneralF1124114      250317","","31.63","","321690.71"
"2025-03-17","2025-03-17","SF FuneralF1128062      250317","","31.63","","321722.34"
"2025-03-17","2025-03-04","Rev SF FuneralFDC00000007ZH7250304","","-31.63","","321690.71"
"2025-03-17","2025-03-15","Rev SF FuneralFDC0000000LNR4250316","","-31.63","","321659.08"
"2025-03-17","2025-03-11","Rev SF FuneralFDC00000007ZH7250311","","-31.63","","321627.45"
"2025-03-17","2025-03-14","Rev SF FuneralFDC00000007MW5250314","","-31.63","","321595.82"
"2025-03-17","2025-03-14","Rev SF FuneralFDC0000000NNGY250314","","-31.63","","321564.19"
"2025-03-17","2025-03-14","Rev SF FuneralFDC0000000JXK7250314","","-31.63","","321532.56"
"2025-03-17","2025-03-14","Rev SF FuneralFDC0000000KLCD250314","","-31.63","","321500.93"
"2025-03-17","2025-03-14","Rev SF FuneralFDC00000008NYM250314","","-31.63","","321469.3"
"2025-03-17","2024-09-23","Rev SF FuneralFDC000000085FV240922","","-126.5","","321342.8"
"2025-03-17","2024-10-22","Rev SF FuneralFDC000000085FV241022","","-126.5","","321216.3"
"2025-03-17","2024-11-22","Rev SF FuneralFDC000000085FV241122","","-126.5","","321089.8"
"2025-03-17","2024-12-11","Rev SF FuneralFDC000000085FV241222","","-126.5","","320963.3"
"2025-03-17","2025-01-22","Rev SF FuneralFDC000000085FV250122","","-126.5","","320836.8"
"2025-03-17","2025-02-22","Rev SF FuneralFDC000000085FV250222","","-126.5","","320710.3"
"2025-03-17","2025-02-22","Rev SF FuneralFDC000000072JN250222","","-126.5","","320583.8"
"2025-03-17","2025-03-10","Rev SF FuneralFDC00000007F71250310","","-63.25","","320520.55"
"2025-03-17","2025-03-11","Rev SF FuneralFDC0000000L20G250311","","-126.5","","320394.05"
"2025-03-17","2025-03-12","Rev SF FuneralFDC0000000JG7T250312","","-126.5","","320267.55"
"2025-03-17","2025-03-12","Rev SF FuneralFDC0000000718V250312","","-126.5","","320141.05"
"2025-03-17","2025-03-12","Rev SF FuneralFDC0000000K8XN250312","","-126.5","","320014.55"
"2025-03-17","2025-03-12","Rev SF FuneralFDC00000005HXT250312","","-126.5","","319888.05"
"2025-03-17","2025-03-12","Rev SF FuneralFDC00000007CFW250312","","-126.5","","319761.55"
"2025-03-17","2025-03-14","Rev SF FuneralFDC000000034WF250314","","-220","","319541.55"
"2025-03-17","2025-03-15","Rev SF FuneralFDC00000005N9V250315","","-126.5","","319415.05"
"2025-03-17","2025-03-15","Rev SF FuneralFDC000000071GW250315","","-126.5","","319288.55"
"2025-03-17","2025-02-27","Rev SF FuneralFDC00000005W51250227","","-126.5","","319162.05"
"2025-03-17","2025-03-12","Rev SF FuneralFDC00000005N85250312","","-126.5","","319035.55"
"2025-03-17","2025-03-12","Rev SF FuneralFDC00000005VF8250312","","-126.5","","318909.05"
"2025-03-17","2025-03-05","Rev SF FuneralFDC00000005X1Y250305","","-126.5","","318782.55"
"2025-03-17","2025-03-12","Rev SF FuneralFDC00000007CK1250312","","-126.5","","318656.05"
"2025-03-17","2025-03-12","Rev SF FuneralFDC00000005N7Y250312","","-126.5","","318529.55"
"2025-03-17","2025-03-11","SF FuneralF1111516      250311","","63.25","","318592.8"
"2025-03-17","2025-03-12","SF FuneralFDC00000003L9L250312","","220","","318812.8"
"2025-03-17","2025-03-12","SF FuneralF820742       250312","","126.5","","318939.3"
"2025-03-17","2025-03-12","SF FuneralF981146       250312","","126.5","","319065.8"
"2025-03-17","2025-03-12","SF FuneralF1061004      250312","","63.25","","319129.05"
"2025-03-17","2025-03-12","SF FuneralF1115094      250312","","126.5","","319255.55"
"2025-03-17","2025-03-14","SF FuneralFDC000000085Z5250314","","31.63","","319287.18"
"2025-03-17","2025-03-14","SF FuneralF1118332      250314","","63.25","","319350.43"
"2025-03-17","2025-03-14","SF FuneralF1131039      250314","","63.25","","319413.68"
"2025-03-17","2025-03-17","SF FuneralF844712       250317","","126.5","","319540.18"
"2025-03-17","2025-03-17","SF FuneralF1124373      250317","","126.5","","319666.68"
"2025-03-17","2025-03-14","SF FuneralFDC0000000H5YY250316","","31.63","","319698.31"
"2025-03-17","2025-03-14","SF FuneralFDC0000000LMH8250314","","31.63","","319729.94"
"2025-03-17","2025-03-17","SF FuneralFDC00000006R9T250317","","126.5","","319856.44"
"2025-03-17","2025-03-17","SF FuneralF1129915      250317","","31.63","","319888.07"
"2025-03-17","2025-03-17","SF FuneralFDC00000006XFK250317","","31.63","","319919.7"
"2025-03-17","2025-03-17","SF FuneralFDC00000006XFM250317","","31.63","","319951.33"
"2025-03-17","2025-03-12","SF FuneralF1115002      250312","","126.5","","320077.83"
"2025-03-17","2025-03-12","SF FuneralFDC000000060PJ250312","","126.5","","320204.33"
"2025-03-17","2025-03-12","SF FuneralF1054873      250312","","126.5","","320330.83"
"2025-03-17","2025-03-14","SF FuneralF834544       250314","","31.63","","320362.46"
"2025-03-17","2025-03-14","SF FuneralF1061782      250314","","31.63","","320394.09"
"2025-03-17","2025-03-14","SF FuneralF1121971      250314","","31.63","","320425.72"
"2025-03-17","2025-03-15","SF FuneralF1130825      250315","","31.63","","320457.35"
"2025-03-17","2025-03-17","SF FuneralFDC00000006BK1250317","","31.63","","320488.98"
"2025-03-17","2025-03-12","SF FuneralFDC00000003D51250312","","220","","320708.98"
"2025-03-17","2025-03-12","SF FuneralF1120680      250312","","126.5","","320835.48"
"2025-03-17","2025-03-14","SF FuneralF1130754      250314","","31.63","","320867.11"
"2025-03-17","2025-03-15","SF FuneralF1016990      250315","","126.5","","320993.61"
"2025-03-17","2025-03-15","SF FuneralFDC0000000NK1Z250315","","126.5","","321120.11"
"2025-03-17","2025-03-17","SF FuneralF801722       250317","","31.63","","321151.74"
"2025-03-17","2025-03-17","SF FuneralF820012       250317","","31.63","","321183.37"
"2025-03-17","2025-03-11","Rev SF FuneralFDC0000000NRVB250311","","-31.63","","321151.74"
"2025-03-17","2025-03-14","Rev SF FuneralFDC00000007WBL250314","","-31.63","","321120.11"
"2025-03-17","2025-03-07","Rev SF FuneralFDC00000007WBL250307","","-31.63","","321088.48"
"2025-03-17","2025-03-17","Rev SF FuneralFDC00000007M2D250316","","-63.25","","321025.23"
"2025-03-17","2025-03-17","Rev SF FuneralFDC00000006R9T250317","","-126.5","","320898.73"
"2025-03-17","2025-03-12","Rev SF FuneralFDC00000007FWM250312","","-126.5","","320772.23"
"2025-03-17","2025-03-12","Rev SF FuneralFDC0000000PN9W250312","","-126.5","","320645.73"
"2025-03-17","2025-03-12","Rev SF FuneralFDC0000000PN9Y250312","","-126.5","","320519.23"
"2025-03-17","2025-02-22","Rev SF FuneralFDC0000000P7KT250222","","-126.5","","320392.73"
"2025-03-17","2025-03-10","Rev SF FuneralFDC000000037KM250310","","-220","","320172.73"
"2025-03-17","2025-02-24","Rev SF FuneralFDC0000000Q5N9250224","","-126.5","","320046.23"
"2025-03-17","2025-03-14","Rev SF FuneralFDC0000000JFC4250314","","-31.63","","320014.6"
"2025-03-17","2025-03-17","Rev SF FuneralFDC00000007H6K250317","","-31.63","","319982.97"
"2025-03-17","2025-03-09","SF FuneralF804555       250309","","126.5","","320109.47"
"2025-03-17","2025-03-12","SF FuneralF987016       250312","","31.63","","320141.1"
"2025-03-17","2025-03-12","SF FuneralF1118902      250312","","126.5","","320267.6"
"2025-03-17","2025-03-17","SF FuneralF819956       250317","","126.5","","320394.1"
"2025-03-18","2025-03-12","SF FuneralF1073149      250312","","126.5","","320520.6"
"2025-03-18","2025-03-17","SF FuneralFDC00000005Z06250317","","31.63","","320552.23"
"2025-03-18","2025-03-17","SF FuneralFDC00000005Z12250317","","31.63","","320583.86"
"2025-03-18","2025-03-17","SF FuneralFDC000000075NF250317","","126.5","","320710.36"
"2025-03-18","2025-03-14","SF FuneralF1123167      250314","","31.63","","320741.99"
"2025-03-18","2025-03-13","SF FuneralF1111321      250313","","126.5","","320868.49"
"2025-03-18","2025-03-12","SF FuneralFDC00000005KR5250312","","126.5","","320994.99"
"2025-03-18","2025-03-11","SF FuneralF1073187      250311","","126.5","","321121.49"
"2025-03-18","2025-03-12","SF FuneralFDC00000008FDG250312","","126.5","","321247.99"
"2025-03-18","2025-03-12","SF FuneralF810293       250312","","126.5","","321374.49"
"2025-03-18","2025-03-12","SF FuneralF1020902      250312","","126.5","","321500.99"
"2025-03-18","2025-03-12","SF FuneralF1079666      250312","","126.5","","321627.49"
"2025-03-18","2025-03-12","SF FuneralF1120144      250312","","126.5","","321753.99"
"2025-03-18","2025-03-14","SF FuneralF981788       250314","","31.63","","321785.62"
"2025-03-18","2025-03-17","SF FuneralFDC00000009958250317","","31.63","","321817.25"
"2025-03-18","2025-03-17","SF FuneralF811324       250317","","112.88","","321930.13"
"2025-03-18","2025-03-11","SF FuneralF834708       250311","","126.5","","322056.63"
"2025-03-18","2025-03-11","SF FuneralF1111732      250311","","63.25","","322119.88"
"2025-03-18","2025-03-11","SF FuneralF1112093      250311","","63.25","","322183.13"
"2025-03-18","2025-03-12","SF FuneralFDC00000005M38250312","","126.5","","322309.63"
"2025-03-18","2025-03-12","SF FuneralFDC00000005V3N250312","","126.5","","322436.13"
"2025-03-18","2025-03-12","SF FuneralFDC00000005WPK250312","","126.5","","322562.63"
"2025-03-18","2025-03-12","SF FuneralFDC00000006TQ1250312","","126.5","","322689.13"
"2025-03-18","2025-03-12","SF FuneralFDC00000009FB5250312","","126.5","","322815.63"
"2025-03-18","2025-03-12","SF FuneralF818773       250312","","126.5","","322942.13"
"2025-03-18","2025-03-12","SF FuneralF822321       250312","","126.5","","323068.63"
"2025-03-18","2025-03-12","SF FuneralF1060675      250312","","126.5","","323195.13"
"2025-03-18","2025-03-12","SF FuneralF1072851      250312","","126.5","","323321.63"
"2025-03-18","2025-03-12","SF FuneralFDC0000000NBPX250312","","126.5","","323448.13"
"2025-03-18","2025-03-12","SF FuneralF1129969      250312","","126.5","","323574.63"
"2025-03-18","2025-03-13","SF FuneralF830649       250313","","31.63","","323606.26"
"2025-03-18","2025-03-13","SF FuneralFDC0000000CZ73250313","","126.5","","323732.76"
"2025-03-18","2025-03-13","SF FuneralFDC0000000MKTG250313","","126.5","","323859.26"
"2025-03-18","2025-03-14","SF FuneralFDC00000006YPP250314","","126.5","","323985.76"
"2025-03-18","2025-03-14","SF FuneralFDC00000006YQ5250314","","126.5","","324112.26"
"2025-03-18","2025-03-14","SF FuneralF819116       250314","","63.25","","324175.51"
"2025-03-18","2025-03-14","SF FuneralF1073818      250314","","31.63","","324207.14"
"2025-03-18","2025-03-14","SF FuneralF1054780      250314","","31.63","","324238.77"
"2025-03-18","2025-03-15","SF FuneralF814211       250315","","31.63","","324270.4"
"2025-03-18","2025-03-15","SF FuneralF1054925      250316","","31.63","","324302.03"
"2025-03-18","2025-03-15","SF FuneralFDC0000000KHNV250315","","126.5","","324428.53"
"2025-03-18","2025-03-17","SF FuneralFDC00000005LQV250317","","31.63","","324460.16"
"2025-03-18","2025-03-17","SF FuneralFDC00000006B73250317","","126.5","","324586.66"
"2025-03-18","2025-03-17","SF FuneralF814448       250316","","31.63","","324618.29"
"2025-03-18","2025-03-17","SF FuneralF814505       250317","","126.5","","324744.79"
"2025-03-18","2025-03-17","SF FuneralF816565       250317","","31.63","","324776.42"
"2025-03-18","2025-03-17","SF FuneralF841739       250316","","126.5","","324902.92"
"2025-03-18","2025-03-17","SF FuneralF1102870      250317","","63.25","","324966.17"
"2025-03-18","2025-03-17","SF FuneralF1103857      250317","","31.63","","324997.8"
"2025-03-18","2025-03-17","SF FuneralF1125116      250317","","31.63","","325029.43"
"2025-03-18","2025-03-10","SF FuneralF804527       250309","","126.5","","325155.93"
"2025-03-18","2025-03-12","SF FuneralF810930       250312","","126.5","","325282.43"
"2025-03-18","2025-03-12","SF FuneralF833962       250312","","126.5","","325408.93"
"2025-03-18","2025-03-13","SF FuneralF810417       250313","","126.5","","325535.43"
"2025-03-18","2025-03-17","SF FuneralFDC00000005PJH250317","","126.5","","325661.93"
"2025-03-18","2025-03-17","SF FuneralF1079692      250317","","126.5","","325788.43"
"2025-03-18","2025-03-17","SF FuneralF1120376      250317","","126.5","","325914.93"
"2025-03-18","2025-03-17","SF FuneralFDC0000000QCN0250317","","191.5","","326106.43"
"2025-03-18","2025-03-17","SF FuneralF1066299      250317","","31.63","","326138.06"
"2025-03-18","2025-03-18","SF FuneralFDC0000000455X250318","","55","","326193.06"
"2025-03-18","2025-03-18","SF FuneralFDC00000005L57250318","","31.63","","326224.69"
"2025-03-18","2025-03-18","SF FuneralFDC00000005YYS250318","","31.63","","326256.32"
"2025-03-18","2025-03-18","SF FuneralFDC00000007YH4250318","","31.63","","326287.95"
"2025-03-18","2025-03-18","SF FuneralFDC00000007YZB250318","","31.63","","326319.58"
"2025-03-18","2025-03-18","SF FuneralFDC00000007ZD3250318","","31.63","","326351.21"
"2025-03-18","2025-03-18","SF FuneralFDC000000086B2250318","","31.63","","326382.84"
"2025-03-18","2025-03-18","SF FuneralFDC00000008H47250318","","31.63","","326414.47"
"2025-03-18","2025-03-18","SF FuneralF805662       250318","","31.63","","326446.1"
"2025-03-18","2025-03-18","SF FuneralF811401       250318","","31.63","","326477.73"
"2025-03-18","2025-03-18","SF FuneralF814431       250318","","31.63","","326509.36"
"2025-03-18","2025-03-18","SF FuneralF817293       250318","","31.63","","326540.99"
"2025-03-18","2025-03-18","SF FuneralFDC0000000CWFK250318","","31.63","","326572.62"
"2025-03-18","2025-03-18","SF FuneralFDC0000000HK7D250318","","31.63","","326604.25"
"2025-03-18","2025-03-18","SF FuneralF990591       250318","","31.63","","326635.88"
"2025-03-18","2025-03-18","SF FuneralF991480       250318","","31.63","","326667.51"
"2025-03-18","2025-03-18","SF FuneralFDC0000000K09P250318","","65","","326732.51"
"2025-03-18","2025-03-18","SF FuneralF1068027      250318","","31.63","","326764.14"
"2025-03-18","2025-03-18","SF FuneralFDC0000000L0TL250318","","31.63","","326795.77"
"2025-03-18","2025-03-18","SF FuneralF1073801      250318","","31.63","","326827.4"
"2025-03-18","2025-03-18","SF FuneralFDC0000000LVMD250318","","31.63","","326859.03"
"2025-03-18","2025-03-18","SF FuneralF1104197      250318","","31.63","","326890.66"
"2025-03-18","2025-03-18","SF FuneralF1111742      250318","","31.63","","326922.29"
"2025-03-18","2025-03-18","SF FuneralF1113741      250318","","31.63","","326953.92"
"2025-03-18","2025-03-18","SF FuneralF1118335      250318","","31.63","","326985.55"
"2025-03-18","2025-03-18","SF FuneralFDC0000000NT58250318","","31.63","","327017.18"
"2025-03-18","2025-03-18","SF FuneralF1128762      250318","","31.63","","327048.81"
"2025-03-18","2025-03-18","SF FuneralF1130733      250318","","31.63","","327080.44"
"2025-03-18","2025-03-18","SF FuneralF1132366      250318","","31.63","","327112.07"
"2025-03-18","2025-03-18","SF FuneralF1134866      250318","","31.63","","327143.7"
"2025-03-18","2025-03-15","SF FuneralFDC00000005KXR250315","","31.63","","327175.33"
"2025-03-18","2025-03-18","SF FuneralFDC00000005P3Q250318","","31.63","","327206.96"
"2025-03-18","2025-03-18","SF FuneralFDC000000078FZ250318","","31.63","","327238.59"
"2025-03-18","2025-03-18","SF FuneralFDC00000007X30250318","","31.63","","327270.22"
"2025-03-18","2025-03-18","SF FuneralFDC00000007X31250318","","31.63","","327301.85"
"2025-03-18","2025-03-18","SF FuneralF819158       250318","","31.63","","327333.48"
"2025-03-18","2025-03-18","SF FuneralFDC0000000BT1S250318","","31.63","","327365.11"
"2025-03-18","2025-03-18","SF FuneralF841781       250318","","31.63","","327396.74"
"2025-03-18","2025-03-18","SF FuneralF987241       250318","","31.63","","327428.37"
"2025-03-18","2025-03-18","SF FuneralF1079430      250318","","63.25","","327491.62"
"2025-03-18","2025-03-18","SF FuneralF1112035      250318","","31.63","","327523.25"
"2025-03-18","2025-03-18","SF FuneralF1120133      250318","","31.63","","327554.88"
"2025-03-18","2025-03-18","SF FuneralF1128820      250318","","31.63","","327586.51"
"2025-03-18","2025-03-18","SF FuneralF1133704      250318","","31.63","","327618.14"
"2025-03-18","2025-03-18","SF FuneralF833247       250318","","63.25","","327681.39"
"2025-03-18","2025-03-18","SF FuneralF1111770      250318","","63.25","","327744.64"
"2025-03-18","2025-03-18","SF FuneralFDC0000000Q9Y4250318","","63.25","","327807.89"
"2025-03-18","2025-03-12","SF FuneralF822745       250312","","126.5","","327934.39"
"2025-03-18","2025-03-18","SF FuneralFDC00000005XGZ250318","","126.5","","328060.89"
"2025-03-18","2025-03-18","SF FuneralFDC00000008L2B250318","","63.25","","328124.14"
"2025-03-18","2025-03-18","SF FuneralF1065745      250318","","63.25","","328187.39"
"2025-03-18","2025-03-14","SF FuneralF1124033      250314","","126.5","","328313.89"
"2025-03-18","2025-03-18","SF FuneralFDC00000007G81250318","","63.25","","328377.14"
"2025-03-18","2025-03-18","SF FuneralF818153       250318","","31.63","","328408.77"
"2025-03-18","2025-03-18","SF FuneralF1022184      250318","","31.63","","328440.4"
"2025-03-18","2025-03-18","SF FuneralF1125777      250318","","31.63","","328472.03"
"2025-03-18","2025-03-17","SF FuneralF1125114      250317","","31.63","","328503.66"
"2025-03-18","2025-03-18","SF FuneralFDC0000000595N250318","","31.62","","328535.28"
"2025-03-18","2025-03-18","SF FuneralFDC00000006L9F250318","","31.63","","328566.91"
"2025-03-18","2025-03-18","SF FuneralFDC00000006P6H250318","","126.5","","328693.41"
"2025-03-18","2025-03-18","SF FuneralF811733       250318","","31.63","","328725.04"
"2025-03-18","2025-03-18","SF FuneralF829557       250318","","31.63","","328756.67"
"2025-03-18","2025-03-18","SF FuneralF1022115      250318","","31.63","","328788.3"
"2025-03-18","2025-03-18","SF FuneralF1052200      250318","","31.63","","328819.93"
"2025-03-18","2025-03-18","SF FuneralF1110796      250318","","31.63","","328851.56"
"2025-03-18","2025-03-18","SF FuneralF1116013      250318","","126.5","","328978.06"
"2025-03-18","2025-03-18","SF FuneralF1130345      250318","","31.63","","329009.69"
"2025-03-18","2025-03-18","SF FuneralF1130991      250318","","31.63","","329041.32"
"2025-03-18","2025-03-15","SF FuneralF1117998      250316","","31.63","","329072.95"
"2025-03-18","2025-03-13","SF FuneralFDC00000005L51250313","","126.5","","329199.45"
"2025-03-18","2025-03-12","SF FuneralFDC00000005VNK250312","","126.5","","329325.95"
"2025-03-18","2025-03-12","SF FuneralF989757       250312","","126.5","","329452.45"
"2025-03-18","2025-03-12","SF FuneralF1120385      250312","","126.5","","329578.95"
"2025-03-18","2025-03-12","SF FuneralFDC00000005MJS250312","","126.5","","329705.45"
"2025-03-18","2025-03-12","SF FuneralFDC00000005NC4250312","","126.5","","329831.95"
"2025-03-18","2025-03-12","SF FuneralF1017540      250312","","126.5","","329958.45"
"2025-03-18","2025-03-17","SF FuneralF1059415      250317","","126.5","","330084.95"
"2025-03-18","2025-03-18","SF FuneralFDC00000007HDM250318","","126.5","","330211.45"
"2025-03-18","2025-03-18","SF FuneralFDC000000080PW250318","","126.5","","330337.95"
"2025-03-18","2025-03-18","SF FuneralF804091       250318","","31.63","","330369.58"
"2025-03-18","2025-03-18","SF FuneralF753764       250318","","126.5","","330496.08"
"2025-03-18","2025-03-18","SF FuneralF796739       250318","","31.63","","330527.71"
"2025-03-18","2025-03-18","SF FuneralF840779       250318","","126.5","","330654.21"
"2025-03-18","2025-03-18","SF FuneralF1118898      250318","","63.25","","330717.46"
"2025-03-18","2025-03-12","SF FuneralFDC00000005PM9250312","","126.5","","330843.96"
"2025-03-18","2025-03-12","SF FuneralF816803       250312","","126.5","","330970.46"
"2025-03-18","2025-03-18","SF FuneralFDC00000007CF7250318","","63.25","","331033.71"
"2025-03-18","2025-03-18","SF FuneralFDC00000007CJF250318","","63.25","","331096.96"
"2025-03-18","2025-03-18","SF FuneralFDC0000000804H250318","","126.5","","331223.46"
"2025-03-18","2025-03-18","SF FuneralFDC000000080WH250318","","31.63","","331255.09"
"2025-03-18","2025-03-18","SF FuneralF802375       250318","","31.63","","331286.72"
"2025-03-18","2025-03-18","SF FuneralF805332       250318","","126.5","","331413.22"
"2025-03-18","2025-03-18","SF FuneralF990232       250318","","31.63","","331444.85"
"2025-03-18","2025-03-18","SF FuneralFDC000000061YD250318","","31.63","","331476.48"
"2025-03-18","2025-03-18","SF FuneralF1074649      250318","","31.63","","331508.11"
"2025-03-18","2025-03-18","SF FuneralF1080286      250318","","31.63","","331539.74"
"2025-03-18","2025-03-18","SF FuneralF1115105      250318","","31.63","","331571.37"
"2025-03-18","2025-03-18","SF FuneralF1115749      250318","","31.63","","331603"
"2025-03-18","2025-03-18","SF FuneralF1129103      250318","","31.63","","331634.63"
"2025-03-18","2025-03-18","SF FuneralF1131768      250318","","126.5","","331761.13"
"2025-03-18","2025-03-18","SF FuneralF1132314      250318","","31.63","","331792.76"
"2025-03-18","2025-03-12","SF FuneralF1103752      250312","","126.5","","331919.26"
"2025-03-18","2025-03-14","Rev SF FuneralFDC00000006YQ5250314","","-126.5","","331792.76"
"2025-03-18","2025-03-12","Rev SF FuneralFDC00000009FB5250312","","-126.5","","331666.26"
"2025-03-18","2025-03-12","Rev SF FuneralFDC0000000NBPX250312","","-126.5","","331539.76"
"2025-03-18","2025-03-12","Rev SF FuneralFDC00000006TQ1250312","","-126.5","","331413.26"
"2025-03-18","2025-03-12","Rev SF FuneralFDC0000000DRNV250312","","-126.5","","331286.76"
"2025-03-18","2025-03-12","Rev SF FuneralFDC00000003D51250312","","-220","","331066.76"
"2025-03-18","2025-03-07","Rev SF FuneralFDC00000007Q3J250307","","-126.5","","330940.26"
"2025-03-18","2025-03-18","SF FuneralFDC000000074HC250318","","126.5","","331066.76"
"2025-03-18","2025-03-10","SF FuneralF1059325      250310","","63.25","","331130.01"
"2025-03-18","2025-03-13","SF FuneralFDC00000006W0Z250313","","126.5","","331256.51"
"2025-03-18","2025-03-15","SF FuneralF1124826      250315","","126.5","","331383.01"
"2025-03-18","2025-03-17","SF FuneralFDC00000005F1K250317","","31.63","","331414.64"
"2025-03-18","2025-03-17","SF FuneralFDC00000005ZJC250317","","126.5","","331541.14"
"2025-03-18","2025-03-17","SF FuneralFDC00000005ZJD250317","","126.5","","331667.64"
"2025-03-18","2025-03-17","SF FuneralFDC000000087Z5250317","","126.5","","331794.14"
"2025-03-18","2025-03-17","SF FuneralF843937       250315","","126.5","","331920.64"
"2025-03-18","2025-03-17","SF FuneralF843944       250317","","63.25","","331983.89"
"2025-03-18","2025-03-17","SF FuneralF1110342      250317","","63.25","","332047.14"
"2025-03-18","2025-03-17","SF FuneralF1118181      250317","","31.63","","332078.77"
"2025-03-18","2025-03-18","SF FuneralFDC00000007J6D250318","","63.25","","332142.02"
"2025-03-18","2025-03-18","SF FuneralF797213       250318","","31.63","","332173.65"
"2025-03-18","2025-03-17","SF FuneralFDC00000005NT1250317","","31.63","","332205.28"
"2025-03-18","2025-03-17","SF FuneralF810849       250317","","126.5","","332331.78"
"2025-03-18","2025-03-17","SF FuneralF844407       250317","","126.5","","332458.28"
"2025-03-18","2025-03-18","SF FuneralFDC0000000HTVZ250318","","63.25","","332521.53"
"2025-03-18","2025-03-17","SF FuneralFDC00000006G7S250317","","126.5","","332648.03"
"2025-03-18","2025-03-18","SF FuneralFDC00000005DH3250318","","110","","332758.03"
"2025-03-18","2025-03-12","SF FuneralFDC00000006J82250312","","31.63","","332789.66"
"2025-03-18","2025-03-12","SF FuneralFDC00000006TNT250312","","126.5","","332916.16"
"2025-03-18","2025-03-12","SF FuneralFDC00000009MNT250312","","126.5","","333042.66"
"2025-03-18","2025-03-12","SF FuneralF844001       250312","","126.5","","333169.16"
"2025-03-18","2025-03-12","SF FuneralF1073393      250312","","126.5","","333295.66"
"2025-03-18","2025-03-18","SF FuneralFDC00000006Q68250318","","31.63","","333327.29"
"2025-03-18","2025-03-18","SF FuneralFDC00000008YCZ250318","","31.63","","333358.92"
"2025-03-18","2025-03-18","SF FuneralF819740       250318","","126.5","","333485.42"
"2025-03-18","2025-03-18","SF FuneralF1050833      250318","","31.63","","333517.05"
"2025-03-18","2025-03-02","Rev SF FuneralF829764       250302","","-63.25","","333453.8"
"2025-03-18","2025-03-16","Rev SF FuneralF829764       250316","","-63.25","","333390.55"
"2025-03-18","2025-03-12","SF FuneralFDC00000007ZRT250312","","126.5","","333517.05"
"2025-03-18","2025-03-17","SF FuneralF993861       250317","","126.5","","333643.55"
"2025-03-18","2025-03-15","SF FuneralFDC0000000NLY9250315","","31.63","","333675.18"
"2025-03-18","2025-03-15","SF FuneralF1117993      250315","","31.63","","333706.81"
"2025-03-18","2025-03-17","SF FuneralFDC00000002R4Q250317","","220","","333926.81"
"2025-03-18","2025-03-17","SF FuneralF815135       250317","","31.63","","333958.44"
"2025-03-18","2025-03-18","SF FuneralFDC0000000N8G1250318","","31.63","","333990.07"
"2025-03-18","2025-03-17","Rev SF FuneralFDC00000005NT1250317","","-31.63","","333958.44"
"2025-03-18","2025-03-11","Rev SF FuneralFDC00000006STJ250311","","-31.63","","333926.81"
"2025-03-18","2025-03-18","Rev SF FuneralFDC0000000N8G1250318","","-31.63","","333895.18"
"2025-03-18","2024-10-15","Rev SF FuneralFDC0000000KHNV241015","","-126.5","","333768.68"
"2025-03-18","2025-03-15","Rev SF FuneralFDC0000000NK1Z250315","","-126.5","","333642.18"
"2025-03-18","2025-03-15","Rev SF FuneralFDC0000000KHNV250315","","-126.5","","333515.68"
"2025-03-18","2025-02-15","Rev SF FuneralFDC0000000KHNV250215","","-126.5","","333389.18"
"2025-03-18","2025-03-12","Rev SF FuneralFDC0000000HJLD250312","","-126.5","","333262.68"
"2025-03-18","2024-12-11","Rev SF FuneralFDC0000000KHNV241215","","-126.5","","333136.18"
"2025-03-18","2024-11-15","Rev SF FuneralFDC0000000KHNV241115","","-126.5","","333009.68"
"2025-03-18","2025-03-17","SF FuneralFDC000000069CL250317","","31.63","","333041.31"
"2025-03-18","2025-03-14","SF FuneralF1079321      250314","","63.25","","333104.56"
"2025-03-18","2025-03-17","SF FuneralF1073199      250317","","126.5","","333231.06"
"2025-03-18","2025-03-11","SF FuneralF992487       250311","","63.25","","333294.31"
"2025-03-18","2025-03-18","SF FuneralF1073137      250318","","63.25","","333357.56"
"2025-03-18","2025-03-18","SF FuneralFDC0000000L7RR250318","","126.5","","333484.06"
"2025-03-18","2025-03-12","SF FuneralFDC00000005MGJ250312","","126.5","","333610.56"
"2025-03-18","2025-03-13","SF FuneralF1104032      250313","","126.5","","333737.06"
"2025-03-18","2025-03-13","SF FuneralFDC0000000NWZ1250313","","126.5","","333863.56"
"2025-03-18","2025-03-15","SF FuneralFDC00000005MWG250315","","31.63","","333895.19"
"2025-03-18","2025-03-15","SF FuneralF1111567      250316","","126.5","","334021.69"
"2025-03-18","2025-03-15","SF FuneralF1127843      250315","","31.63","","334053.32"
"2025-03-18","2025-03-15","SF FuneralF1130776      250315","","31.63","","334084.95"
"2025-03-18","2025-03-17","SF FuneralFDC00000005N4P250317","","31.63","","334116.58"
"2025-03-18","2025-03-17","SF FuneralFDC0000000NYB2250317","","126.5","","334243.08"
"2025-03-18","2025-03-18","SF FuneralF814063       250318","","31.63","","334274.71"
"2025-03-18","2025-03-18","SF FuneralF1080249      250318","","31.63","","334306.34"
"2025-03-18","2025-03-18","SF FuneralFDC0000000P3GS250318","","126.5","","334432.84"
"2025-03-19","2025-03-12","SF FuneralFDC0000000600K250312","","126.5","","334559.34"
"2025-03-19","2025-03-12","SF FuneralFDC00000006011250312","","126.5","","334685.84"
"2025-03-19","2025-03-17","SF FuneralF1083929      250317","","63.25","","334749.09"
"2025-03-19","2025-03-18","SF FuneralF827812       250318","","31.63","","334780.72"
"2025-03-19","2025-03-17","SF FuneralF1108567      250317","","31.63","","334812.35"
"2025-03-19","2025-03-18","SF FuneralF1060316      250318","","31.63","","334843.98"
"2025-03-19","2025-03-12","SF FuneralFDC0000000PY4R250312","","126.5","","334970.48"
"2025-03-19","2025-03-15","SF FuneralF1126000      250315","","126.5","","335096.98"
"2025-03-19","2025-03-17","SF FuneralFDC00000006HWC250317","","126.5","","335223.48"
"2025-03-19","2025-03-17","SF FuneralF844580       250315","","126.5","","335349.98"
"2025-03-19","2025-03-18","SF FuneralFDC00000007J73250318","","63.25","","335413.23"
"2025-03-19","2025-03-18","SF FuneralF989331       250318","","63.25","","335476.48"
"2025-03-19","2025-03-17","SF FuneralF834627       250316","","31.63","","335508.11"
"2025-03-19","2025-03-18","SF FuneralF814290       250318","","63.25","","335571.36"
"2025-03-19","2025-03-19","SF FuneralFDC00000005Y44250319","","126.5","","335697.86"
"2025-03-19","2025-03-19","SF FuneralFDC000000061SG250319","","126.5","","335824.36"
"2025-03-19","2025-03-19","SF FuneralF805474       250319","","126.5","","335950.86"
"2025-03-19","2025-03-19","SF FuneralF1052889      250319","","126.5","","336077.36"
"2025-03-19","2025-03-19","SF FuneralF840787       250319","","126.5","","336203.86"
"2025-03-19","2025-03-19","SF FuneralF980614       250319","","126.5","","336330.36"
"2025-03-19","2025-03-15","SF FuneralFDC00000005M7N250315","","220","","336550.36"
"2025-03-19","2025-03-17","SF FuneralF813239       250317","","63.25","","336613.61"
"2025-03-19","2025-03-18","SF FuneralF992519       250318","","31.63","","336645.24"
"2025-03-19","2025-03-19","SF FuneralFDC00000006J82250319","","31.63","","336676.87"
"2025-03-19","2025-03-19","SF FuneralF800771       250319","","31.63","","336708.5"
"2025-03-19","2025-03-19","SF FuneralF1020962      250319","","126.5","","336835"
"2025-03-19","2025-03-19","SF FuneralF1124159      250319","","63.25","","336898.25"
"2025-03-19","2025-03-19","SF FuneralFDC0000000PNDR250319","","126.5","","337024.75"
"2025-03-19","2025-03-19","SF FuneralF1133572      250319","","126.5","","337151.25"
"2025-03-19","2025-03-19","SF FuneralFDC000000060CN250319","","126.5","","337277.75"
"2025-03-19","2025-03-19","SF FuneralF810934       250319","","126.5","","337404.25"
"2025-03-19","2025-03-19","SF FuneralF1072876      250319","","126.5","","337530.75"
"2025-03-19","2025-03-19","SF FuneralF1124426      250319","","126.5","","337657.25"
"2025-03-19","2025-03-19","SF FuneralFDC0000000PX2H250319","","126.5","","337783.75"
"2025-03-19","2025-03-19","SF FuneralFDC0000000PX2N250319","","126.5","","337910.25"
"2025-03-19","2025-03-19","SF FuneralFDC0000000QB62250319","","126.5","","338036.75"
"2025-03-19","2025-03-19","SF FuneralFDC0000000QB63250319","","126.5","","338163.25"
"2025-03-19","2025-03-18","SF FuneralF803520       250318","","31.63","","338194.88"
"2025-03-19","2025-03-18","SF FuneralF828867       250318","","31.63","","338226.51"
"2025-03-19","2025-03-14","SF FuneralF823416       250314","","126.5","","338353.01"
"2025-03-19","2025-03-15","SF FuneralF1074785      250315","","31.63","","338384.64"
"2025-03-19","2025-03-19","SF FuneralFDC00000005WLM250319","","126.5","","338511.14"
"2025-03-19","2025-03-19","SF FuneralFDC0000000NC3V250319","","126.5","","338637.64"
"2025-03-19","2025-03-19","SF FuneralFDC0000000NWFK250319","","126.5","","338764.14"
"2025-03-19","2025-03-19","SF FuneralF782339       250319","","126.5","","338890.64"
"2025-03-19","2025-03-19","SF FuneralF1127716      250319","","126.5","","339017.14"
"2025-03-19","2025-03-19","SF FuneralFDC0000000PZX0250319","","126.5","","339143.64"
"2025-03-19","2025-03-19","SF FuneralFDC0000000KQN5250319","","126.5","","339270.14"
"2025-03-19","2025-03-19","SF FuneralF1129960      250319","","126.5","","339396.64"
"2025-03-19","2025-03-15","SF FuneralF1020601      250315","","31.63","","339428.27"
"2025-03-19","2025-03-15","SF FuneralFDC0000000PZ0F250316","","126.5","","339554.77"
"2025-03-19","2025-03-18","SF FuneralFDC00000006X91250318","","31.63","","339586.4"
"2025-03-19","2025-03-18","SF FuneralF1052659      250318","","31.63","","339618.03"
"2025-03-19","2025-03-18","SF FuneralF1122882      250318","","126.5","","339744.53"
"2025-03-19","2025-03-19","SF FuneralF1073355      250319","","126.5","","339871.03"
"2025-03-19","2025-03-19","SF FuneralFDC0000000PQ6W250319","","126.5","","339997.53"
"2025-03-19","2025-03-14","Rev SF FuneralFDC0000000K7CQ250314","","-31.63","","339965.9"
"2025-03-19","2025-03-11","Rev SF FuneralFDC00000006ST9250311","","-31.63","","339934.27"
"2025-03-19","2025-03-12","Rev SF FuneralFDC00000005MGJ250312","","-126.5","","339807.77"
"2025-03-19","2025-03-17","Rev SF FuneralFDC00000006HWC250317","","-126.5","","339681.27"
"2025-03-19","2025-03-11","SF FuneralF823295       250311","","63.25","","339744.52"
"2025-03-19","2025-03-11","SF FuneralFDC0000000BJSH250311","","63.25","","339807.77"
"2025-03-19","2025-03-12","SF FuneralFDC00000006VJZ250312","","126.5","","339934.27"
"2025-03-19","2025-03-12","SF FuneralF1104247      250312","","126.5","","340060.77"
"2025-03-19","2025-03-14","SF FuneralF844157       250314","","126.5","","340187.27"
"2025-03-19","2025-03-15","SF FuneralFDC0000000B7LZ250315","","126.5","","340313.77"
"2025-03-19","2025-03-15","SF FuneralFDC0000000NQTZ250316","","126.5","","340440.27"
"2025-03-19","2025-03-15","SF FuneralF1124433      250315","","126.5","","340566.77"
"2025-03-19","2025-03-18","SF FuneralF816436       250318","","31.63","","340598.4"
"2025-03-19","2025-03-18","SF FuneralF993719       250318","","31.63","","340630.03"
"2025-03-19","2025-03-18","SF FuneralF1131484      250318","","31.63","","340661.66"
"2025-03-19","2025-03-10","SF FuneralF1125079      250310","","126.5","","340788.16"
"2025-03-19","2025-03-12","SF FuneralF822898       250312","","126.5","","340914.66"
"2025-03-19","2025-03-15","SF FuneralF784736       250315","","31.63","","340946.29"
"2025-03-19","2025-03-17","SF FuneralFDC00000006M8H250316","","126.5","","341072.79"
"2025-03-19","2025-03-17","SF FuneralFDC00000009G6B250316","","31.63","","341104.42"
"2025-03-19","2025-03-18","SF FuneralFDC0000000N526250318","","31.63","","341136.05"
"2025-03-19","2025-03-19","SF FuneralFDC00000006X01250319","","321.5","","341457.55"
"2025-03-19","2025-03-19","SF FuneralF987016       250319","","31.63","","341489.18"
"2025-03-19","2025-03-14","SF FuneralF981670       250314","","31.63","","341520.81"
"2025-03-19","2025-03-17","SF FuneralFDC00000005LS9250317","","31.63","","341552.44"
"2025-03-19","2025-03-17","SF FuneralF1132295      250317","","31.63","","341584.07"
"2025-03-19","2025-03-18","SF FuneralFDC00000008JVD250318","","31.63","","341615.7"
"2025-03-19","2025-03-18","SF FuneralF1110634      250318","","31.63","","341647.33"
"2025-03-19","2025-03-18","SF FuneralF1111675      250318","","31.63","","341678.96"
"2025-03-19","2025-03-18","SF FuneralF1135056      250318","","31.63","","341710.59"
"2025-03-19","2025-03-19","SF FuneralFDC000000068V7250319","","126.5","","341837.09"
"2025-03-19","2025-03-19","SF FuneralF990934       250319","","126.5","","341963.59"
"2025-03-19","2025-03-12","SF FuneralFDC00000006X2W250312","","126.5","","342090.09"
"2025-03-19","2025-03-17","SF FuneralFDC000000042HH250316","","55","","342145.09"
"2025-03-19","2025-03-17","SF FuneralFDC00000005NKJ250317","","31.63","","342176.72"
"2025-03-19","2025-03-19","SF FuneralF815056       250319","","126.5","","342303.22"
"2025-03-19","2025-03-10","SF FuneralF1120229      250310","","95.75","","342398.97"
"2025-03-19","2025-03-19","SF FuneralFDC00000005TXN250319","","126.5","","342525.47"
"2025-03-19","2025-03-15","SF FuneralF1129917      250316","","31.63","","342557.1"
"2025-03-19","2025-03-12","SF FuneralF810350       250312","","126.5","","342683.6"
"2025-03-19","2025-03-12","SF FuneralF1129502      250312","","126.5","","342810.1"
"2025-03-19","2025-03-17","SF FuneralFDC00000006RQ8250316","","31.63","","342841.73"
"2025-03-19","2025-03-17","SF FuneralFDC00000006SV7250316","","31.63","","342873.36"
"2025-03-19","2025-03-17","SF FuneralF804126       250317","","31.63","","342904.99"
"2025-03-19","2025-03-17","SF FuneralFDC00000009XWR250316","","31.63","","342936.62"
"2025-03-19","2025-03-17","SF FuneralFDC0000000C26W250317","","126.5","","343063.12"
"2025-03-19","2025-03-17","SF FuneralF831186       250317","","126.5","","343189.62"
"2025-03-19","2025-03-17","SF FuneralF832990       250316","","31.63","","343221.25"
"2025-03-19","2025-03-17","SF FuneralF1052798      250317","","31.63","","343252.88"
"2025-03-19","2025-03-17","SF FuneralF1115983      250317","","126.5","","343379.38"
"2025-03-19","2025-03-17","SF FuneralF1122727      250317","","31.63","","343411.01"
"2025-03-19","2025-03-17","SF FuneralF1131037      250317","","31.63","","343442.64"
"2025-03-19","2025-03-17","SF FuneralFDC0000000QBQQ250317","","126.5","","343569.14"
"2025-03-19","2025-03-18","SF FuneralF831704       250318","","31.63","","343600.77"
"2025-03-19","2025-03-18","SF FuneralF1118865      250318","","31.63","","343632.4"
"2025-03-19","2025-03-18","SF FuneralF1123129      250318","","31.63","","343664.03"
"2025-03-19","2025-03-19","SF FuneralFDC00000005K0B250319","","126.5","","343790.53"
"2025-03-19","2025-03-19","SF FuneralF1133512      250319","","126.5","","343917.03"
"2025-03-19","2025-03-12","Rev SF FuneralFDC00000006V5J250312","","-126.5","","343790.53"
"2025-03-19","2025-03-12","Rev SF FuneralFDC0000000PY4R250312","","-126.5","","343664.03"
"2025-03-19","2025-01-15","Rev SF FuneralFDC0000000KHNV250115","","-126.5","","343537.53"
"2025-03-19","2025-03-18","Rev SF FuneralFDC0000000N526250318","","-31.63","","343505.9"
"2025-03-19","2025-03-19","Rev SF FuneralFDC00000006X01250319","","-321.5","","343184.4"
"2025-03-19","2025-03-17","SF FuneralFDC00000008CPQ250317","","126.5","","343310.9"
"2025-03-19","2025-03-17","SF FuneralFDC00000009DX3250316","","31.63","","343342.53"
"2025-03-19","2025-03-17","SF FuneralFDC00000007CPH250317","","126.5","","343469.03"
"2025-03-19","2025-03-17","SF FuneralF1017423      250317","","126.5","","343595.53"
"2025-03-19","2025-03-17","SF FuneralF1118373      250317","","126.5","","343722.03"
"2025-03-19","2025-03-17","SF FuneralFDC00000003MYN250317","","220","","343942.03"
"2025-03-19","2025-03-17","SF FuneralFDC00000006HDS250317","","126.5","","344068.53"
"2025-03-19","2025-03-17","SF FuneralF834614       250317","","31.63","","344100.16"
"2025-03-19","2025-03-17","SF FuneralF844135       250317","","126.5","","344226.66"
"2025-03-19","2025-03-17","SF FuneralF987492       250317","","31.63","","344258.29"
"2025-03-19","2025-03-17","SF FuneralF1100809      250317","","31.63","","344289.92"
"2025-03-19","2025-03-18","SF FuneralF986694       250318","","31.63","","344321.55"
"2025-03-19","2025-03-18","SF FuneralF1118809      250318","","31.63","","344353.18"
"2025-03-19","2025-03-18","SF FuneralF1118848      250318","","31.63","","344384.81"
"2025-03-19","2025-03-15","SF FuneralF1102798      250316","","126.5","","344511.31"
"2025-03-19","2025-03-15","SF FuneralF1114730      250316","","31.63","","344542.94"
"2025-03-19","2025-03-19","SF FuneralFDC00000008X5B250319","","31.63","","344574.57"
"2025-03-19","2025-03-15","SF FuneralFDC0000000JY24250316","","31.63","","344606.2"
"2025-03-19","2025-03-15","SF FuneralF1115201      250316","","126.5","","344732.7"
"2025-03-19","2025-03-17","SF FuneralF1133240      250317","","126.5","","344859.2"
"2025-03-19","2025-03-18","Rev SF FuneralFDC000000074HC250318","","-126.5","","344732.7"
"2025-03-19","2025-03-12","SF FuneralF830628       250312","","126.5","","344859.2"
"2025-03-19","2025-03-15","SF FuneralFDC0000000N01R250316","","126.5","","344985.7"
"2025-03-19","2025-03-15","SF FuneralF1122295      250316","","31.63","","345017.33"
"2025-03-19","2025-03-15","SF FuneralF1130409      250316","","126.5","","345143.83"
"2025-03-19","2025-03-17","SF FuneralFDC00000005YNL250317","","55","","345198.83"
"2025-03-19","2025-03-17","SF FuneralFDC00000005YW3250317","","31.63","","345230.46"
"2025-03-19","2025-03-17","SF FuneralFDC00000006SLY250316","","126.5","","345356.96"
"2025-03-19","2025-03-17","SF FuneralFDC00000006SLZ250316","","126.5","","345483.46"
"2025-03-19","2025-03-17","SF FuneralFDC000000071C5250316","","126.5","","345609.96"
"2025-03-19","2025-03-17","SF FuneralFDC00000007488250317","","126.5","","345736.46"
"2025-03-19","2025-03-17","SF FuneralFDC000000076WX250317","","126.5","","345862.96"
"2025-03-19","2025-03-17","SF FuneralFDC00000007J5C250317","","126.5","","345989.46"
"2025-03-19","2025-03-17","SF FuneralFDC000000080Y5250317","","126.5","","346115.96"
"2025-03-19","2025-03-17","SF FuneralF805529       250317","","126.5","","346242.46"
"2025-03-19","2025-03-17","SF FuneralF810250       250317","","31.63","","346274.09"
"2025-03-19","2025-03-17","SF FuneralF819012       250317","","31.63","","346305.72"
"2025-03-19","2025-03-17","SF FuneralF819193       250317","","126.5","","346432.22"
"2025-03-19","2025-03-17","SF FuneralF822436       250317","","126.5","","346558.72"
"2025-03-19","2025-03-17","SF FuneralFDC0000000K18V250317","","126.5","","346685.22"
"2025-03-19","2025-03-17","SF FuneralF1114639      250317","","126.5","","346811.72"
"2025-03-19","2025-03-17","SF FuneralFDC0000000PQ01250317","","126.5","","346938.22"
"2025-03-19","2025-03-17","SF FuneralF1127574      250317","","126.5","","347064.72"
"2025-03-19","2025-03-17","SF FuneralFDC0000000Q8TF250317","","126.5","","347191.22"
"2025-03-19","2025-03-17","SF FuneralFDC0000000Q8TG250317","","126.5","","347317.72"
"2025-03-19","2025-03-17","SF FuneralF1134027      250317","","31.63","","347349.35"
"2025-03-19","2025-03-18","SF FuneralFDC00000005P3L250318","","31.63","","347380.98"
"2025-03-19","2025-03-18","SF FuneralFDC00000008JV9250318","","63.25","","347444.23"
"2025-03-19","2025-03-18","SF FuneralFDC0000000NTBQ250318","","31.63","","347475.86"
"2025-03-19","2025-03-19","SF FuneralFDC00000006W2Y250319","","126.5","","347602.36"
"2025-03-19","2025-03-19","SF FuneralFDC00000006W30250319","","126.5","","347728.86"
"2025-03-19","2025-03-19","SF FuneralF800844       250319","","126.5","","347855.36"
"2025-03-19","2025-03-19","SF FuneralFDC00000008FYX250319","","126.5","","347981.86"
"2025-03-19","2025-03-19","SF FuneralFDC0000000LG2D250319","","31.63","","348013.49"
"2025-03-19","2025-03-19","SF FuneralF1078566      250319","","31.63","","348045.12"
"2025-03-19","2025-03-13","SF FuneralF776616       250313","","126.5","","348171.62"
"2025-03-19","2025-03-17","SF FuneralF834853       250316","","126.5","","348298.12"
"2025-03-19","2025-03-17","SF FuneralF844661       250317","","126.5","","348424.62"
"2025-03-19","2025-03-17","SF FuneralFDC0000000K17R250317","","126.5","","348551.12"
"2025-03-19","2025-03-18","SF FuneralFDC00000008JVC250318","","63.25","","348614.37"
"2025-03-19","2025-03-18","SF FuneralF1079706      250318","","126.5","","348740.87"
"2025-03-19","2025-03-18","SF FuneralF1124197      250318","","126.5","","348867.37"
"2025-03-20","2025-03-11","SF FuneralF1120411      250311","","63.25","","348930.62"
"2025-03-20","2025-03-12","SF FuneralFDC00000005W8T250312","","126.5","","349057.12"
"2025-03-20","2025-03-19","SF FuneralFDC00000005V3Z250319","","126.5","","349183.62"
"2025-03-20","2025-03-19","SF FuneralFDC00000005V4Z250319","","31.63","","349215.25"
"2025-03-20","2025-03-19","SF FuneralF841017       250319","","126.5","","349341.75"
"2025-03-20","2025-03-17","SF FuneralFDC00000004CSK250317","","55","","349396.75"
"2025-03-20","2025-03-17","SF FuneralFDC00000004CSL250317","","55","","349451.75"
"2025-03-20","2025-03-17","SF FuneralFDC00000005LWP250316","","31.63","","349483.38"
"2025-03-20","2025-03-17","SF FuneralFDC00000005Q9X250317","","126.5","","349609.88"
"2025-03-20","2025-03-17","SF FuneralFDC00000006W4Y250317","","126.5","","349736.38"
"2025-03-20","2025-03-17","SF FuneralFDC00000006W66250316","","126.5","","349862.88"
"2025-03-20","2025-03-17","SF FuneralFDC000000071X2250317","","126.5","","349989.38"
"2025-03-20","2025-03-17","SF FuneralFDC00000007X59250317","","126.5","","350115.88"
"2025-03-20","2025-03-17","SF FuneralF797478       250317","","126.5","","350242.38"
"2025-03-20","2025-03-17","SF FuneralFDC00000008VKV250317","","126.5","","350368.88"
"2025-03-20","2025-03-17","SF FuneralFDC000000097F2250317","","63.25","","350432.13"
"2025-03-20","2025-03-17","SF FuneralFDC000000097G6250317","","63.25","","350495.38"
"2025-03-20","2025-03-17","SF FuneralF812202       250317","","31.63","","350527.01"
"2025-03-20","2025-03-17","SF FuneralF814567       250317","","126.5","","350653.51"
"2025-03-20","2025-03-17","SF FuneralF819102       250317","","126.5","","350780.01"
"2025-03-20","2025-03-17","SF FuneralFDC0000000CWBD250316","","31.63","","350811.64"
"2025-03-20","2025-03-17","SF FuneralF844276       250317","","126.5","","350938.14"
"2025-03-20","2025-03-17","SF FuneralF901219       250317","","126.5","","351064.64"
"2025-03-20","2025-03-17","SF FuneralF981748       250317","","126.5","","351191.14"
"2025-03-20","2025-03-17","SF FuneralF1111932      250317","","126.5","","351317.64"
"2025-03-20","2025-03-17","SF FuneralFDC0000000N2L5250317","","126.5","","351444.14"
"2025-03-20","2025-03-17","SF FuneralF1119704      250317","","126.5","","351570.64"
"2025-03-20","2025-03-17","SF FuneralF1127967      250317","","126.5","","351697.14"
"2025-03-20","2025-03-15","SF FuneralF1113937      250316","","63.25","","351760.39"
"2025-03-20","2025-03-18","SF FuneralFDC000000072SM250318","","31.63","","351792.02"
"2025-03-20","2025-03-18","SF FuneralFDC00000007LG1250318","","31.63","","351823.65"
"2025-03-20","2025-03-18","SF FuneralF797821       250318","","63.25","","351886.9"
"2025-03-20","2025-03-18","SF FuneralF814465       250318","","31.63","","351918.53"
"2025-03-20","2025-03-18","SF FuneralF818368       250318","","63.25","","351981.78"
"2025-03-20","2025-03-18","SF FuneralFDC0000000J8LQ250318","","63.25","","352045.03"
"2025-03-20","2025-03-18","SF FuneralFDC0000000KFFJ250318","","31.63","","352076.66"
"2025-03-20","2025-03-18","SF FuneralF1114513      250318","","31.63","","352108.29"
"2025-03-20","2025-03-18","SF FuneralF1130277      250318","","31.63","","352139.92"
"2025-03-20","2025-03-18","SF FuneralFDC00000005SDS250318","","126.5","","352266.42"
"2025-03-20","2025-03-17","SF FuneralF822865       250317","","31.63","","352298.05"
"2025-03-20","2025-03-17","SF FuneralF1134076      250317","","31.63","","352329.68"
"2025-03-20","2025-03-18","SF FuneralF802295       250318","","31.63","","352361.31"
"2025-03-20","2025-03-18","SF FuneralF821837       250318","","47.88","","352409.19"
"2025-03-20","2025-03-18","SF FuneralF1130942      250318","","31.63","","352440.82"
"2025-03-20","2025-03-15","SF FuneralFDC0000000JVCB250316","","31.63","","352472.45"
"2025-03-20","2025-03-15","SF FuneralF1054743      250316","","31.63","","352504.08"
"2025-03-20","2025-03-15","SF FuneralFDC0000000KH3D250316","","31.63","","352535.71"
"2025-03-20","2025-03-15","SF FuneralF1120593      250316","","31.63","","352567.34"
"2025-03-20","2025-03-15","SF FuneralFDC0000000PZBG250316","","31.63","","352598.97"
"2025-03-20","2025-03-17","SF FuneralFDC00000007WVJ250317","","31.63","","352630.6"
"2025-03-20","2025-03-17","SF FuneralF834650       250316","","31.63","","352662.23"
"2025-03-20","2025-03-17","SF FuneralFDC0000000FVPD250317","","31.63","","352693.86"
"2025-03-20","2025-03-17","SF FuneralFDC0000000K09V250317","","31.63","","352725.49"
"2025-03-20","2025-03-17","SF FuneralF1079351      250317","","31.63","","352757.12"
"2025-03-20","2025-03-18","SF FuneralF816581       250318","","31.63","","352788.75"
"2025-03-20","2025-03-18","SF FuneralF1066227      250318","","31.63","","352820.38"
"2025-03-20","2025-03-18","SF FuneralFDC0000000L0TM250318","","31.63","","352852.01"
"2025-03-20","2025-03-18","SF FuneralF1110079      250318","","31.63","","352883.64"
"2025-03-20","2025-03-18","SF FuneralFDC0000000PJX8250318","","31.63","","352915.27"
"2025-03-20","2025-03-18","SF FuneralF1131861      250318","","31.63","","352946.9"
"2025-03-20","2025-03-18","SF FuneralF1133043      250318","","31.63","","352978.53"
"2025-03-20","2025-03-19","SF FuneralF1124138      250319","","31.63","","353010.16"
"2025-03-20","2025-03-11","SF FuneralF1115170      250311","","63.25","","353073.41"
"2025-03-20","2025-03-12","SF FuneralF1111304      250312","","126.5","","353199.91"
"2025-03-20","2025-03-13","SF FuneralFDC00000008CQR250313","","126.5","","353326.41"
"2025-03-20","2025-03-15","SF FuneralF1017459      250316","","126.5","","353452.91"
"2025-03-20","2025-03-17","SF FuneralFDC00000005MBH250317","","126.5","","353579.41"
"2025-03-20","2025-03-17","SF FuneralFDC00000007CWW250317","","126.5","","353705.91"
"2025-03-20","2025-03-17","SF FuneralFDC00000007FTH250317","","126.5","","353832.41"
"2025-03-20","2025-03-17","SF FuneralFDC00000007HQQ250317","","126.5","","353958.91"
"2025-03-20","2025-03-17","SF FuneralF802762       250317","","126.5","","354085.41"
"2025-03-20","2025-03-17","SF FuneralF1061594      250317","","126.5","","354211.91"
"2025-03-20","2025-03-17","SF FuneralF1123031      250317","","126.5","","354338.41"
"2025-03-20","2025-03-17","SF FuneralF1124167      250317","","126.5","","354464.91"
"2025-03-20","2025-03-18","SF FuneralFDC00000006K8Z250318","","126.5","","354591.41"
"2025-03-20","2025-03-18","SF FuneralFDC00000007LTS250318","","63.25","","354654.66"
"2025-03-20","2025-03-18","SF FuneralFDC00000008T3Y250318","","63.25","","354717.91"
"2025-03-20","2025-03-18","SF FuneralF1131287      250318","","63.25","","354781.16"
"2025-03-20","2025-03-19","SF FuneralFDC00000005RRQ250319","","126.5","","354907.66"
"2025-03-20","2025-03-19","SF FuneralFDC00000005WV0250319","","126.5","","355034.16"
"2025-03-20","2025-03-19","SF FuneralFDC00000008CX1250319","","126.5","","355160.66"
"2025-03-20","2025-03-19","SF FuneralFDC00000008FCD250319","","126.5","","355287.16"
"2025-03-20","2025-03-19","SF FuneralF805493       250319","","126.5","","355413.66"
"2025-03-20","2025-03-19","SF FuneralFDC0000000KY1M250319","","126.5","","355540.16"
"2025-03-20","2025-03-19","SF FuneralF1134815      250319","","126.5","","355666.66"
"2025-03-20","2025-03-17","SF FuneralFDC0000000FCJY250317","","31.63","","355698.29"
"2025-03-20","2025-03-18","SF FuneralF833912       250318","","63.25","","355761.54"
"2025-03-20","2025-03-18","SF FuneralF1103986      250318","","31.63","","355793.17"
"2025-03-20","2025-03-19","SF FuneralFDC00000008FNX250319","","126.5","","355919.67"
"2025-03-20","2025-03-12","SF FuneralFDC00000005SP8250312","","126.5","","356046.17"
"2025-03-20","2025-03-12","SF FuneralF1127388      250312","","126.5","","356172.67"
"2025-03-20","2025-03-17","SF FuneralF1117939      250317","","126.5","","356299.17"
"2025-03-20","2025-03-19","SF FuneralFDC00000006SPY250319","","126.5","","356425.67"
"2025-03-20","2025-03-17","SF FuneralFDC000000064YD250317","","126.5","","356552.17"
"2025-03-20","2025-03-17","SF FuneralF816474       250317","","126.5","","356678.67"
"2025-03-20","2025-03-17","SF FuneralF1120655      250317","","31.63","","356710.3"
"2025-03-20","2025-03-15","SF FuneralF1021491      250316","","31.63","","356741.93"
"2025-03-20","2025-03-15","SF FuneralF1072856      250316","","31.63","","356773.56"
"2025-03-20","2025-03-20","SF FuneralF987777       250321","","126.5","","356900.06"
"2025-03-20","2025-03-20","SF FuneralF1020456      250320","","126.5","","357026.56"
"2025-03-20","2025-03-20","SF FuneralF1127316      250321","","126.5","","357153.06"
"2025-03-20","2025-03-18","SF FuneralF797055       250318","","31.63","","357184.69"
"2025-03-20","2025-03-18","SF FuneralF810426       250318","","31.63","","357216.32"
"2025-03-20","2025-03-18","SF FuneralF990639       250318","","126.5","","357342.82"
"2025-03-20","2025-03-18","SF FuneralF1121768      250318","","63.25","","357406.07"
"2025-03-20","2025-03-19","SF FuneralF1054817      250319","","126.5","","357532.57"
"2025-03-20","2025-03-20","SF FuneralFDC00000007SPM250320","","126.5","","357659.07"
"2025-03-20","2025-03-20","SF FuneralF828072       250320","","126.5","","357785.57"
"2025-03-20","2025-03-20","SF FuneralF988760       250320","","126.5","","357912.07"
"2025-03-20","2025-03-20","SF FuneralFDC0000000HYHK250323","","126.5","","358038.57"
"2025-03-20","2025-03-20","SF FuneralF1033849      250321","","126.5","","358165.07"
"2025-03-20","2025-03-20","SF FuneralF1110763      250320","","31.63","","358196.7"
"2025-03-20","2025-03-20","SF FuneralF1113935      250320","","126.5","","358323.2"
"2025-03-20","2025-03-20","SF FuneralF1120590      250320","","126.5","","358449.7"
"2025-03-20","2025-03-20","SF FuneralF1133263      250320","","126.5","","358576.2"
"2025-03-20","2025-03-20","SF FuneralFDC00000009F9L250320","","126.5","","358702.7"
"2025-03-20","2025-03-20","SF FuneralFDC00000009VG5250320","","126.5","","358829.2"
"2025-03-20","2025-03-20","SF FuneralF1078865      250320","","47.88","","358877.08"
"2025-03-20","2025-03-20","SF FuneralF1133107      250320","","126.5","","359003.58"
"2025-03-20","2025-03-20","SF FuneralF991574       250320","","126.5","","359130.08"
"2025-03-20","2025-03-20","SF FuneralFDC00000007N8T250320","","126.5","","359256.58"
"2025-03-20","2025-03-20","SF FuneralF1108440      250320","","126.5","","359383.08"
"2025-03-20","2025-03-17","SF FuneralFDC0000000502G250317","","31.63","","359414.71"
"2025-03-20","2025-03-17","SF FuneralFDC0000000F7T2250317","","31.63","","359446.34"
"2025-03-20","2025-03-17","SF FuneralFDC000000067C7250317","","31.63","","359477.97"
"2025-03-20","2025-03-17","SF FuneralF1060944      250317","","31.63","","359509.6"
"2025-03-20","2025-03-17","SF FuneralF1118416      250317","","31.63","","359541.23"
"2025-03-20","2025-03-17","SF FuneralF1130901      250317","","31.63","","359572.86"
"2025-03-20","2025-03-18","SF FuneralFDC00000007WH2250318","","47.88","","359620.74"
"2025-03-20","2025-03-18","SF FuneralF834784       250318","","31.63","","359652.37"
"2025-03-20","2025-03-18","SF FuneralF1021467      250318","","31.63","","359684"
"2025-03-20","2025-03-18","SF FuneralF1073828      250318","","31.63","","359715.63"
"2025-03-20","2025-03-18","SF FuneralF1120226      250318","","31.63","","359747.26"
"2025-03-20","2025-03-18","SF FuneralF1126072      250318","","31.63","","359778.89"
"2025-03-20","2025-03-18","SF FuneralF1131495      250318","","31.63","","359810.52"
"2025-03-20","2025-03-18","SF FuneralF1132785      250318","","31.63","","359842.15"
"2025-03-20","2025-03-18","SF FuneralF1134525      250318","","31.63","","359873.78"
"2025-03-20","2025-03-20","SF FuneralFDC00000005N6M250320","","31.63","","359905.41"
"2025-03-20","2025-03-20","SF FuneralFDC00000006ZNM250320","","31.63","","359937.04"
"2025-03-20","2025-03-20","SF FuneralF819674       250323","","31.63","","359968.67"
"2025-03-20","2025-03-20","SF FuneralF990787       250322","","31.63","","360000.3"
"2025-03-20","2025-03-17","SF FuneralFDC00000008MY8250316","","31.63","","360031.93"
"2025-03-20","2025-03-17","SF FuneralF1052812      250317","","31.63","","360063.56"
"2025-03-20","2025-03-17","SF FuneralF1068000      250317","","31.63","","360095.19"
"2025-03-20","2025-03-18","SF FuneralFDC000000051KX250318","","31.63","","360126.82"
"2025-03-20","2025-03-18","SF FuneralF798846       250318","","31.63","","360158.45"
"2025-03-20","2025-03-18","SF FuneralF799673       250318","","31.63","","360190.08"
"2025-03-20","2025-03-18","SF FuneralF802169       250318","","31.63","","360221.71"
"2025-03-20","2025-03-18","SF FuneralF809823       250318","","31.63","","360253.34"
"2025-03-20","2025-03-18","SF FuneralF822125       250318","","31.63","","360284.97"
"2025-03-20","2025-03-18","SF FuneralF823596       250318","","31.63","","360316.6"
"2025-03-20","2025-03-18","SF FuneralF832888       250318","","31.63","","360348.23"
"2025-03-20","2025-03-18","SF FuneralF834203       250318","","31.63","","360379.86"
"2025-03-20","2025-03-18","SF FuneralF981838       250318","","31.63","","360411.49"
"2025-03-20","2025-03-18","SF FuneralF1020936      250318","","31.63","","360443.12"
"2025-03-20","2025-03-18","SF FuneralF1083692      250318","","31.63","","360474.75"
"2025-03-20","2025-03-18","SF FuneralF1084860      250318","","31.63","","360506.38"
"2025-03-20","2025-03-18","SF FuneralF1110117      250318","","31.63","","360538.01"
"2025-03-20","2025-03-18","SF FuneralF1126086      250318","","31.63","","360569.64"
"2025-03-20","2025-03-18","SF FuneralF1127863      250318","","31.63","","360601.27"
"2025-03-20","2025-03-17","SF FuneralF818028       250317","","31.63","","360632.9"
"2025-03-20","2025-03-20","SF FuneralF1119753      250321","","31.63","","360664.53"
"2025-03-20","2025-03-17","SF FuneralF828566       250317","","31.63","","360696.16"
"2025-03-20","2025-03-18","SF FuneralFDC00000007FBC250318","","31.63","","360727.79"
"2025-03-20","2025-03-18","SF FuneralFDC00000008M07250318","","31.63","","360759.42"
"2025-03-20","2025-03-18","SF FuneralFDC00000008M09250318","","31.63","","360791.05"
"2025-03-20","2025-03-18","SF FuneralF833515       250318","","31.63","","360822.68"
"2025-03-20","2025-03-18","SF FuneralF833824       250318","","31.63","","360854.31"
"2025-03-20","2025-03-18","SF FuneralF843037       250318","","31.63","","360885.94"
"2025-03-20","2025-03-18","SF FuneralF799620       250318","","64.13","","360950.07"
"2025-03-20","2025-03-18","SF FuneralF1073297      250318","","31.63","","360981.7"
"2025-03-20","2025-03-18","SF FuneralF1074647      250318","","31.63","","361013.33"
"2025-03-20","2025-03-18","SF FuneralF1111731      250318","","31.63","","361044.96"
"2025-03-20","2025-03-18","SF FuneralFDC0000000NRQK250318","","31.63","","361076.59"
"2025-03-20","2025-03-18","SF FuneralF1124052      250318","","31.63","","361108.22"
"2025-03-20","2025-03-18","SF FuneralF1127480      250318","","31.63","","361139.85"
"2025-03-20","2025-03-18","SF FuneralF1127528      250318","","31.63","","361171.48"
"2025-03-20","2025-03-18","SF FuneralF1128998      250318","","31.63","","361203.11"
"2025-03-20","2025-03-18","SF FuneralF1131696      250318","","31.63","","361234.74"
"2025-03-20","2025-03-18","SF FuneralF1132209      250318","","31.63","","361266.37"
"2025-03-20","2025-03-18","SF FuneralF1132895      250318","","31.63","","361298"
"2025-03-20","2025-03-18","SF FuneralF1133759      250318","","31.63","","361329.63"
"2025-03-20","2025-03-20","SF FuneralF1073030      250321","","31.63","","361361.26"
"2025-03-20","2025-03-20","SF FuneralF1133251      250321","","31.63","","361392.89"
"2025-03-20","2025-03-20","SF FuneralF988945       250323","","31.63","","361424.52"
"2025-03-20","2025-03-20","SF FuneralF1016768      250320","","31.63","","361456.15"
"2025-03-20","2025-03-18","SF FuneralFDC00000006SSB250318","","31.63","","361487.78"
"2025-03-20","2025-03-18","SF FuneralFDC00000006ST9250318","","31.63","","361519.41"
"2025-03-20","2025-03-18","SF FuneralFDC00000006STJ250318","","31.63","","361551.04"
"2025-03-20","2025-03-18","SF FuneralF801219       250318","","31.63","","361582.67"
"2025-03-20","2025-03-18","SF FuneralF986709       250318","","31.63","","361614.3"
"2025-03-20","2025-03-18","SF FuneralF1066647      250318","","31.63","","361645.93"
"2025-03-20","2025-03-19","SF FuneralF1122926      250319","","31.63","","361677.56"
"2025-03-20","2025-03-20","SF FuneralFDC0000000PK3S250321","","31.63","","361709.19"
"2025-03-20","2025-03-20","SF FuneralF1130338      250321","","31.63","","361740.82"
"2025-03-20","2025-03-20","SF FuneralF1131198      250321","","31.63","","361772.45"
"2025-03-20","2025-03-18","SF FuneralFDC0000000690Q250318","","31.63","","361804.08"
"2025-03-20","2025-03-18","SF FuneralF811275       250318","","31.63","","361835.71"
"2025-03-20","2025-03-18","SF FuneralF819196       250318","","31.63","","361867.34"
"2025-03-20","2025-03-18","SF FuneralF1112349      250318","","31.63","","361898.97"
"2025-03-20","2025-03-20","SF FuneralF1061782      250321","","31.63","","361930.6"
"2025-03-20","2025-03-20","SF FuneralF1079664      250321","","31.63","","361962.23"
"2025-03-20","2025-03-17","SF FuneralF1055321      250317","","126.5","","362088.73"
"2025-03-20","2025-03-17","SF FuneralFDC0000000KDL6250317","","126.5","","362215.23"
"2025-03-20","2025-03-20","SF FuneralFDC00000006NT7250320","","220","","362435.23"
"2025-03-20","2025-03-20","SF FuneralF989011       250322","","126.5","","362561.73"
"2025-03-20","2025-03-20","SF FuneralF1115784      250321","","126.5","","362688.23"
"2025-03-20","2025-03-15","SF FuneralF1131093      250315","","63.25","","362751.48"
"2025-03-20","2025-03-17","SF FuneralFDC00000005XH1250317","","126.5","","362877.98"
"2025-03-20","2025-03-17","SF FuneralF801671       250317","","63.25","","362941.23"
"2025-03-20","2025-03-17","SF FuneralF834868       250317","","126.5","","363067.73"
"2025-03-20","2025-03-17","SF FuneralF844068       250317","","63.25","","363130.98"
"2025-03-20","2025-03-18","SF FuneralF1129149      250318","","63.25","","363194.23"
"2025-03-20","2025-03-18","SF FuneralF1129384      250318","","63.25","","363257.48"
"2025-03-20","2025-03-20","SF FuneralFDC0000000B6T5250320","","126.5","","363383.98"
"2025-03-20","2025-03-20","SF FuneralFDC00000005VN9250320","","126.5","","363510.48"
"2025-03-20","2025-03-20","SF FuneralFDC00000007TDY250320","","126.5","","363636.98"
"2025-03-20","2025-03-20","SF FuneralF991409       250321","","126.5","","363763.48"
"2025-03-20","2025-03-20","SF FuneralF1124453      250320","","126.5","","363889.98"
"2025-03-20","2025-03-20","SF FuneralF1134067      250320","","126.5","","364016.48"
"2025-03-20","2025-03-17","SF FuneralF828005       250317","","126.5","","364142.98"
"2025-03-20","2025-03-20","SF FuneralF1108395      250321","","126.5","","364269.48"
"2025-03-20","2025-03-20","SF FuneralF1132205      250320","","126.5","","364395.98"
"2025-03-20","2025-03-20","SF FuneralF821513       250320","","126.5","","364522.48"
"2025-03-20","2025-03-20","SF FuneralF828444       250320","","126.5","","364648.98"
"2025-03-20","2025-03-20","SF FuneralF1108243      250320","","126.5","","364775.48"
"2025-03-20","2025-03-20","SF FuneralFDC00000007H45250320","","63.25","","364838.73"
"2025-03-20","2025-03-20","SF FuneralFDC00000007H48250320","","63.25","","364901.98"
"2025-03-20","2025-03-20","SF FuneralFDC00000007HSD250320","","126.5","","365028.48"
"2025-03-20","2025-03-20","SF FuneralFDC00000007NCH250320","","126.5","","365154.98"
"2025-03-20","2025-03-20","SF FuneralFDC0000000HP20250322","","126.5","","365281.48"
"2025-03-20","2025-03-20","SF FuneralF1124286      250320","","126.5","","365407.98"
"2025-03-20","2025-03-20","SF FuneralF989666       250322","","126.5","","365534.48"
"2025-03-20","2025-03-20","SF FuneralF1085013      250321","","126.5","","365660.98"
"2025-03-20","2025-03-17","SF FuneralFDC00000006QDH250317","","126.5","","365787.48"
"2025-03-20","2025-03-17","SF FuneralFDC00000006VXW250317","","126.5","","365913.98"
"2025-03-20","2025-03-17","SF FuneralFDC00000008ZBX250317","","126.5","","366040.48"
"2025-03-20","2025-03-20","SF FuneralFDC000000063NN250320","","126.5","","366166.98"
"2025-03-20","2025-03-20","SF FuneralF981763       250323","","126.5","","366293.48"
"2025-03-20","2025-03-20","SF FuneralF987214       250322","","126.5","","366419.98"
"2025-03-20","2025-03-20","SF FuneralF1112338      250321","","126.5","","366546.48"
"2025-03-20","2025-03-20","SF FuneralF1125171      250321","","126.5","","366672.98"
"2025-03-20","2025-03-17","SF FuneralFDC00000008T67250317","","126.5","","366799.48"
"2025-03-20","2025-03-18","SF FuneralF980457       250318","","126.5","","366925.98"
"2025-03-20","2025-03-18","SF FuneralFDC0000000HG11250318","","63.25","","366989.23"
"2025-03-20","2025-03-20","SF FuneralF987085       250322","","126.5","","367115.73"
"2025-03-20","2025-03-20","SF FuneralFDC000000060Q8250320","","126.5","","367242.23"
"2025-03-20","2025-03-20","SF FuneralF987386       250322","","126.5","","367368.73"
"2025-03-20","2025-03-20","SF FuneralF1127997      250320","","126.5","","367495.23"
"2025-03-20","2025-03-12","SF FuneralFDC00000006997250312","","126.5","","367621.73"
"2025-03-20","2025-03-12","SF FuneralFDC00000006998250312","","126.5","","367748.23"
"2025-03-20","2025-03-12","SF FuneralF804754       250312","","126.5","","367874.73"
"2025-03-20","2025-03-17","SF FuneralFDC00000008JTX250317","","126.5","","368001.23"
"2025-03-20","2025-03-17","SF FuneralF831364       250317","","126.5","","368127.73"
"2025-03-20","2025-03-19","SF FuneralF777675       250319","","256.5","","368384.23"
"2025-03-20","2025-03-19","SF FuneralF844383       250319","","126.5","","368510.73"
"2025-03-20","2025-03-19","SF FuneralF1118812      250319","","126.5","","368637.23"
"2025-03-20","2025-03-19","SF FuneralF1129895      250319","","126.5","","368763.73"
"2025-03-20","2025-03-19","SF FuneralF1133752      250319","","126.5","","368890.23"
"2025-03-20","2025-03-20","SF FuneralF805420       250320","","126.5","","369016.73"
"2025-03-20","2025-03-20","SF FuneralF799893       250320","","126.5","","369143.23"
"2025-03-20","2025-03-20","SF FuneralF991497       250323","","126.5","","369269.73"
"2025-03-20","2025-03-17","SF FuneralFDC00000007MJX250317","","126.5","","369396.23"
"2025-03-20","2025-03-17","SF FuneralFDC00000008L4Z250317","","126.5","","369522.73"
"2025-03-20","2025-03-17","SF FuneralF844167       250317","","126.5","","369649.23"
"2025-03-20","2025-03-18","SF FuneralF1124763      250318","","63.25","","369712.48"
"2025-03-20","2025-03-18","SF FuneralF1129043      250318","","63.25","","369775.73"
"2025-03-20","2025-03-20","SF FuneralF989474       250322","","126.5","","369902.23"
"2025-03-20","2025-03-20","SF FuneralF991113       250322","","126.5","","370028.73"
"2025-03-20","2025-03-17","SF FuneralFDC000000070M5250317","","126.5","","370155.23"
"2025-03-20","2025-03-20","SF FuneralF991320       250320","","126.5","","370281.73"
"2025-03-20","2025-03-20","SF FuneralFDC0000000QB6X250321","","126.5","","370408.23"
"2025-03-20","2025-03-19","SF FuneralF989171       250319","","126.5","","370534.73"
"2025-03-20","2025-03-20","SF FuneralFDC00000005YBX250320","","126.5","","370661.23"
"2025-03-20","2025-03-19","SF FuneralFDC0000000819D250319","","256.5","","370917.73"
"2025-03-20","2025-03-19","SF FuneralF805613       250319","","126.5","","371044.23"
"2025-03-20","2025-03-20","SF FuneralFDC00000006PK7250320","","126.5","","371170.73"
"2025-03-20","2025-03-20","SF FuneralFDC00000007CVM250320","","126.5","","371297.23"
"2025-03-20","2025-03-20","SF FuneralFDC000000089G7250320","","126.5","","371423.73"
"2025-03-20","2025-03-20","SF FuneralF993968       250320","","126.5","","371550.23"
"2025-03-20","2025-03-20","SF FuneralF1017688      250320","","126.5","","371676.73"
"2025-03-20","2025-03-20","SF FuneralF1074533      250320","","126.5","","371803.23"
"2025-03-20","2025-03-17","SF FuneralFDC0000000369L250317","","220","","372023.23"
"2025-03-20","2025-03-17","SF FuneralF822940       250317","","126.5","","372149.73"
"2025-03-20","2025-03-17","SF FuneralF823496       250317","","126.5","","372276.23"
"2025-03-20","2025-03-17","SF FuneralF830817       250317","","126.5","","372402.73"
"2025-03-20","2025-03-17","SF FuneralF1128347      250317","","126.5","","372529.23"
"2025-03-20","2025-03-20","SF FuneralF1127833      250320","","126.5","","372655.73"
"2025-03-20","2025-03-17","SF FuneralFDC00000007C14250317","","220","","372875.73"
"2025-03-20","2025-03-20","SF FuneralF986642       250320","","126.5","","373002.23"
"2025-03-20","2025-03-20","SF FuneralF986905       250322","","126.5","","373128.73"
"2025-03-20","2025-03-20","SF FuneralFDC00000006K90250320","","126.5","","373255.23"
"2025-03-20","2025-03-17","SF FuneralF989508       250317","","126.5","","373381.73"
"2025-03-20","2025-03-20","SF FuneralFDC0000000BSQ0250320","","126.5","","373508.23"
"2025-03-20","2025-03-20","SF FuneralF831817       250320","","126.5","","373634.73"
"2025-03-20","2025-03-20","SF FuneralF1113330      250320","","126.5","","373761.23"
"2025-03-20","2025-03-20","SF FuneralF988483       250323","","126.5","","373887.73"
"2025-03-20","2025-03-20","SF FuneralF1132250      250321","","126.5","","374014.23"
"2025-03-20","2025-03-17","SF FuneralF844091       250317","","126.5","","374140.73"
"2025-03-20","2025-03-17","SF FuneralF986985       250317","","63.25","","374203.98"
"2025-03-20","2025-03-17","SF FuneralF1052756      250317","","126.5","","374330.48"
"2025-03-20","2025-03-19","SF FuneralFDC00000005ZWM250319","","126.5","","374456.98"
"2025-03-20","2025-03-19","SF FuneralFDC0000000BXRS250319","","126.5","","374583.48"
"2025-03-20","2025-03-19","SF FuneralF841655       250319","","126.5","","374709.98"
"2025-03-20","2025-03-19","SF FuneralFDC0000000PFXD250319","","126.5","","374836.48"
"2025-03-20","2025-03-17","SF FuneralFDC00000005S2J250317","","126.5","","374962.98"
"2025-03-20","2025-03-17","SF FuneralFDC00000005SJP250317","","126.5","","375089.48"
"2025-03-20","2025-03-17","SF FuneralFDC00000005T1R250317","","126.5","","375215.98"
"2025-03-20","2025-03-17","SF FuneralFDC00000007X2R250317","","126.5","","375342.48"
"2025-03-20","2025-03-17","SF FuneralF814406       250317","","126.5","","375468.98"
"2025-03-20","2025-03-17","SF FuneralFDC0000000C29R250317","","126.5","","375595.48"
"2025-03-20","2025-03-17","SF FuneralF831218       250317","","63.25","","375658.73"
"2025-03-20","2025-03-17","SF FuneralF1054599      250317","","126.5","","375785.23"
"2025-03-20","2025-03-17","SF FuneralF1104207      250317","","126.5","","375911.73"
"2025-03-20","2025-03-20","SF FuneralFDC000000080NR250320","","126.5","","376038.23"
"2025-03-20","2025-03-18","SF FuneralFDC000000072H2250318","","63.25","","376101.48"
"2025-03-20","2025-03-18","SF FuneralF830972       250318","","126.5","","376227.98"
"2025-03-20","2025-03-18","SF FuneralF844728       250318","","31.63","","376259.61"
"2025-03-20","2025-03-18","SF FuneralF1127611      250318","","31.63","","376291.24"
"2025-03-20","2025-03-17","SF FuneralFDC000000063B7250317","","110","","376401.24"
"2025-03-20","2025-03-19","SF FuneralFDC00000002SRP250319","","220","","376621.24"
"2025-03-20","2025-03-19","SF FuneralFDC00000005RNY250319","","126.5","","376747.74"
"2025-03-20","2025-03-19","SF FuneralFDC000000076L1250319","","126.5","","376874.24"
"2025-03-20","2025-03-19","SF FuneralFDC00000007GVT250319","","126.5","","377000.74"
"2025-03-20","2025-03-19","SF FuneralFDC00000007HMX250319","","126.5","","377127.24"
"2025-03-20","2025-03-20","SF FuneralF986771       250320","","126.5","","377253.74"
"2025-03-20","2025-03-17","SF FuneralF1130229      250317","","126.5","","377380.24"
"2025-03-20","2025-03-18","SF FuneralF1058830      250318","","63.25","","377443.49"
"2025-03-20","2025-03-19","SF FuneralFDC00000006GD6250319","","126.5","","377569.99"
"2025-03-20","2025-03-19","SF FuneralF823129       250319","","126.5","","377696.49"
"2025-03-20","2025-03-19","SF FuneralF841842       250319","","126.5","","377822.99"
"2025-03-20","2025-03-20","SF FuneralFDC0000000CHY1250320","","126.5","","377949.49"
"2025-03-20","2025-03-20","SF FuneralF832811       250320","","126.5","","378075.99"
"2025-03-20","2025-03-20","SF FuneralF832953       250320","","126.5","","378202.49"
"2025-03-20","2025-03-19","SF FuneralFDC00000005TSC250319","","126.5","","378328.99"
"2025-03-20","2025-03-19","SF FuneralFDC0000000609P250319","","126.5","","378455.49"
"2025-03-20","2025-03-19","SF FuneralFDC00000006MQV250319","","126.5","","378581.99"
"2025-03-20","2025-03-19","SF FuneralFDC0000000FS50250319","","126.5","","378708.49"
"2025-03-20","2025-03-19","SF FuneralF831689       250319","","126.5","","378834.99"
"2025-03-20","2025-03-19","SF FuneralF1120815      250319","","31.63","","378866.62"
"2025-03-20","2025-03-17","SF FuneralFDC00000006Z6S250317","","126.5","","378993.12"
"2025-03-20","2025-03-17","SF FuneralFDC00000007HS4250317","","126.5","","379119.62"
"2025-03-20","2025-03-17","SF FuneralFDC0000000828D250317","","126.5","","379246.12"
"2025-03-20","2025-03-17","SF FuneralF813539       250317","","126.5","","379372.62"
"2025-03-20","2025-03-17","SF FuneralF814899       250317","","126.5","","379499.12"
"2025-03-20","2025-03-18","SF FuneralF820830       250318","","63.25","","379562.37"
"2025-03-20","2025-03-18","SF FuneralF842064       250318","","63.25","","379625.62"
"2025-03-20","2025-03-18","SF FuneralF1074818      250318","","63.25","","379688.87"
"2025-03-20","2025-03-18","SF FuneralF1084648      250318","","63.25","","379752.12"
"2025-03-20","2025-03-18","SF FuneralF1125287      250318","","63.25","","379815.37"
"2025-03-20","2025-03-19","SF FuneralF1110441      250319","","126.5","","379941.87"
"2025-03-20","2025-03-20","SF FuneralF801667       250320","","126.5","","380068.37"
"2025-03-20","2025-03-20","SF FuneralFDC0000000J13S250322","","126.5","","380194.87"
"2025-03-20","2025-03-20","SF FuneralFDC0000000J141250322","","126.5","","380321.37"
"2025-03-20","2025-03-20","SF FuneralF1068008      250320","","126.5","","380447.87"
"2025-03-20","2025-03-20","SF FuneralF1112419      250320","","126.5","","380574.37"
"2025-03-20","2025-03-12","SF FuneralFDC0000000NBV2250312","","63.25","","380637.62"
"2025-03-20","2025-03-12","SF FuneralF1115107      250312","","63.25","","380700.87"
"2025-03-20","2025-03-17","SF FuneralFDC00000005GM0250317","","126.5","","380827.37"
"2025-03-20","2025-03-17","SF FuneralFDC00000005P76250317","","126.5","","380953.87"
"2025-03-20","2025-03-17","SF FuneralFDC00000005XX1250317","","126.5","","381080.37"
"2025-03-20","2025-03-17","SF FuneralFDC0000000602T250317","","126.5","","381206.87"
"2025-03-20","2025-03-17","SF FuneralFDC00000006T5Y250317","","126.5","","381333.37"
"2025-03-20","2025-03-17","SF FuneralF804915       250317","","126.5","","381459.87"
"2025-03-20","2025-03-17","SF FuneralF819802       250317","","31.63","","381491.5"
"2025-03-20","2025-03-17","SF FuneralF822927       250317","","126.5","","381618"
"2025-03-20","2025-03-17","SF FuneralF829008       250317","","126.5","","381744.5"
"2025-03-20","2025-03-17","SF FuneralF844782       250317","","126.5","","381871"
"2025-03-20","2025-03-17","SF FuneralF990712       250317","","126.5","","381997.5"
"2025-03-20","2025-03-17","SF FuneralF1019192      250317","","126.5","","382124"
"2025-03-20","2025-03-17","SF FuneralF1054861      250317","","126.5","","382250.5"
"2025-03-20","2025-03-17","SF FuneralF1061061      250317","","126.5","","382377"
"2025-03-20","2025-03-17","SF FuneralFDC0000000NC01250317","","63.25","","382440.25"
"2025-03-20","2025-03-17","SF FuneralF1115130      250317","","63.25","","382503.5"
"2025-03-20","2025-03-17","SF FuneralF1129947      250317","","126.5","","382630"
"2025-03-20","2025-03-17","SF FuneralF1130847      250317","","31.63","","382661.63"
"2025-03-20","2025-03-17","SF FuneralF1132080      250317","","126.5","","382788.13"
"2025-03-20","2025-03-17","SF FuneralF1134072      250317","","31.63","","382819.76"
"2025-03-20","2025-03-20","SF FuneralF1050848      250320","","126.5","","382946.26"
"2025-03-20","2025-03-20","SF FuneralFDC0000000QB2S250321","","126.5","","383072.76"
"2025-03-20","2025-03-20","SF FuneralFDC0000000QB2T250321","","126.5","","383199.26"
"2025-03-20","2025-03-20","SF FuneralFDC0000000QB30250321","","126.5","","383325.76"
"2025-03-20","2025-03-20","SF FuneralFDC0000000QB33250321","","126.5","","383452.26"
"2025-03-20","2025-03-20","SF FuneralFDC0000000QB34250321","","126.5","","383578.76"
"2025-03-20","2025-03-20","SF FuneralFDC0000000QB35250321","","126.5","","383705.26"
"2025-03-20","2025-03-17","SF FuneralFDC00000005R60250317","","126.5","","383831.76"
"2025-03-20","2025-03-17","SF FuneralFDC000000063HH250317","","126.5","","383958.26"
"2025-03-20","2025-03-17","SF FuneralF1021159      250317","","126.5","","384084.76"
"2025-03-20","2025-03-17","SF FuneralF1060292      250317","","126.5","","384211.26"
"2025-03-20","2025-03-18","SF FuneralF822295       250318","","63.25","","384274.51"
"2025-03-20","2025-03-19","SF FuneralF1125678      250319","","126.5","","384401.01"
"2025-03-20","2025-03-20","SF FuneralFDC00000005XWD250320","","126.5","","384527.51"
"2025-03-20","2025-03-20","SF FuneralF1066036      250320","","126.5","","384654.01"
"2025-03-20","2025-03-19","SF FuneralF809216       250319","","126.5","","384780.51"
"2025-03-20","2025-03-11","SF FuneralF1115181      250311","","63.25","","384843.76"
"2025-03-20","2025-03-17","SF FuneralF1080152      250317","","126.5","","384970.26"
"2025-03-20","2025-03-17","SF FuneralF1080472      250317","","126.5","","385096.76"
"2025-03-20","2025-03-20","SF FuneralFDC00000008HV1250320","","126.5","","385223.26"
"2025-03-20","2025-03-20","SF FuneralFDC00000008VQQ250320","","126.5","","385349.76"
"2025-03-20","2025-03-12","SF FuneralFDC00000006T6M250312","","126.5","","385476.26"
"2025-03-20","2025-03-17","SF FuneralFDC00000005D9Y250317","","126.5","","385602.76"
"2025-03-20","2025-03-17","SF FuneralF794739       250317","","63.25","","385666.01"
"2025-03-20","2025-03-17","SF FuneralF829484       250317","","126.5","","385792.51"
"2025-03-20","2025-03-17","SF FuneralF1075155      250317","","63.25","","385855.76"
"2025-03-20","2025-03-17","SF FuneralF1115021      250317","","256.5","","386112.26"
"2025-03-20","2025-03-17","SF FuneralF1126179      250317","","126.5","","386238.76"
"2025-03-20","2025-03-18","SF FuneralFDC00000007DFR250318","","126.5","","386365.26"
"2025-03-20","2025-03-19","SF FuneralFDC00000005TXH250319","","126.5","","386491.76"
"2025-03-20","2025-03-19","SF FuneralFDC0000000758K250319","","126.5","","386618.26"
"2025-03-20","2025-03-20","SF FuneralF815293       250320","","126.5","","386744.76"
"2025-03-20","2025-03-20","SF FuneralF840452       250320","","126.5","","386871.26"
"2025-03-20","2025-03-20","SF FuneralF986895       250323","","126.5","","386997.76"
"2025-03-20","2025-03-20","SF FuneralF988943       250322","","126.5","","387124.26"
"2025-03-20","2025-03-20","SF FuneralF1127948      250321","","126.5","","387250.76"
"2025-03-20","2025-03-17","SF FuneralF803071       250317","","126.5","","387377.26"
"2025-03-20","2025-03-17","SF FuneralFDC00000003S1L250317","","55","","387432.26"
"2025-03-20","2025-03-17","SF FuneralFDC00000005ZFF250317","","126.5","","387558.76"
"2025-03-20","2025-03-17","SF FuneralFDC00000005ZGR250317","","126.5","","387685.26"
"2025-03-20","2025-03-17","SF FuneralFDC00000006TT6250317","","126.5","","387811.76"
"2025-03-20","2025-03-17","SF FuneralFDC00000007HBL250317","","126.5","","387938.26"
"2025-03-20","2025-03-17","SF FuneralF811097       250317","","126.5","","388064.76"
"2025-03-20","2025-03-17","SF FuneralF812333       250317","","126.5","","388191.26"
"2025-03-20","2025-03-17","SF FuneralFDC0000000HKWY250317","","126.5","","388317.76"
"2025-03-20","2025-03-17","SF FuneralF1017776      250317","","126.5","","388444.26"
"2025-03-20","2025-03-17","SF FuneralFDC0000000KLNT250317","","126.5","","388570.76"
"2025-03-20","2025-03-17","SF FuneralF1073414      250317","","126.5","","388697.26"
"2025-03-20","2025-03-17","SF FuneralF1080529      250317","","31.63","","388728.89"
"2025-03-20","2025-03-17","SF FuneralF1115128      250317","","126.5","","388855.39"
"2025-03-20","2025-03-17","SF FuneralF1131359      250317","","126.5","","388981.89"
"2025-03-20","2025-03-17","SF FuneralF1133709      250317","","31.63","","389013.52"
"2025-03-20","2025-03-18","SF FuneralF821545       250318","","47.88","","389061.4"
"2025-03-20","2025-03-18","SF FuneralF990255       250318","","31.63","","389093.03"
"2025-03-20","2025-03-18","SF FuneralF1110299      250318","","31.63","","389124.66"
"2025-03-20","2025-03-18","SF FuneralF1122312      250318","","126.5","","389251.16"
"2025-03-20","2025-03-18","SF FuneralF1132378      250318","","31.63","","389282.79"
"2025-03-20","2025-03-19","SF FuneralFDC00000005TJ3250319","","126.5","","389409.29"
"2025-03-20","2025-03-19","SF FuneralFDC00000005WMJ250319","","126.5","","389535.79"
"2025-03-20","2025-03-20","SF FuneralFDC00000002TMW250320","","220","","389755.79"
"2025-03-20","2025-03-20","SF FuneralFDC0000000623F250320","","126.5","","389882.29"
"2025-03-20","2025-03-20","SF FuneralFDC0000000627P250320","","126.5","","390008.79"
"2025-03-20","2025-03-20","SF FuneralFDC00000006BF7250320","","126.5","","390135.29"
"2025-03-20","2025-03-20","SF FuneralFDC00000006T3G250320","","126.5","","390261.79"
"2025-03-20","2025-03-20","SF FuneralFDC00000006T3R250320","","126.5","","390388.29"
"2025-03-20","2025-03-20","SF FuneralFDC00000007K38250320","","126.5","","390514.79"
"2025-03-20","2025-03-20","SF FuneralF810145       250320","","126.5","","390641.29"
"2025-03-20","2025-03-20","SF FuneralF831580       250320","","126.5","","390767.79"
"2025-03-20","2025-03-20","SF FuneralF844722       250320","","126.5","","390894.29"
"2025-03-20","2025-03-20","SF FuneralF847201       250320","","126.5","","391020.79"
"2025-03-20","2025-03-20","SF FuneralF822822       250322","","191.5","","391212.29"
"2025-03-20","2025-03-20","SF FuneralF988516       250322","","126.5","","391338.79"
"2025-03-20","2025-03-20","SF FuneralF991358       250322","","126.5","","391465.29"
"2025-03-20","2025-03-20","SF FuneralF991558       250323","","126.5","","391591.79"
"2025-03-20","2025-03-20","SF FuneralF993809       250321","","31.63","","391623.42"
"2025-03-20","2025-03-20","SF FuneralF993837       250321","","31.63","","391655.05"
"2025-03-20","2025-03-20","SF FuneralF1129095      250320","","126.5","","391781.55"
"2025-03-20","2025-03-19","SF FuneralFDC000000060YG250319","","126.5","","391908.05"
"2025-03-20","2025-03-19","SF FuneralF1061719      250319","","126.5","","392034.55"
"2025-03-20","2025-03-12","SF FuneralFDC00000006197250312","","126.5","","392161.05"
"2025-03-20","2025-03-12","SF FuneralFDC00000006198250312","","126.5","","392287.55"
"2025-03-20","2025-03-15","SF FuneralF817889       250315","","126.5","","392414.05"
"2025-03-20","2025-03-15","SF FuneralF1060968      250316","","31.63","","392445.68"
"2025-03-20","2025-03-15","SF FuneralF1103935      250316","","31.63","","392477.31"
"2025-03-20","2025-03-15","SF FuneralF1132917      250316","","31.63","","392508.94"
"2025-03-20","2025-03-17","SF FuneralFDC00000003591250317","","55","","392563.94"
"2025-03-20","2025-03-17","SF FuneralFDC00000003N3S250317","","220","","392783.94"
"2025-03-20","2025-03-17","SF FuneralFDC00000005PLC250317","","126.5","","392910.44"
"2025-03-20","2025-03-17","SF FuneralFDC00000005QL1250317","","126.5","","393036.94"
"2025-03-20","2025-03-17","SF FuneralFDC00000007GG6250317","","126.5","","393163.44"
"2025-03-20","2025-03-17","SF FuneralFDC00000007GGB250317","","126.5","","393289.94"
"2025-03-20","2025-03-17","SF FuneralFDC00000008097250317","","126.5","","393416.44"
"2025-03-20","2025-03-17","SF FuneralF811108       250317","","126.5","","393542.94"
"2025-03-20","2025-03-17","SF FuneralF827871       250317","","126.5","","393669.44"
"2025-03-20","2025-03-17","SF FuneralF830987       250317","","126.5","","393795.94"
"2025-03-20","2025-03-17","SF FuneralF831193       250317","","126.5","","393922.44"
"2025-03-20","2025-03-17","SF FuneralF834697       250317","","126.5","","394048.94"
"2025-03-20","2025-03-17","SF FuneralF1020562      250317","","126.5","","394175.44"
"2025-03-20","2025-03-17","SF FuneralF1061614      250317","","126.5","","394301.94"
"2025-03-20","2025-03-17","SF FuneralFDC0000000LC7N250317","","126.5","","394428.44"
"2025-03-20","2025-03-17","SF FuneralF1075119      250317","","126.5","","394554.94"
"2025-03-20","2025-03-17","SF FuneralF1085015      250317","","126.5","","394681.44"
"2025-03-20","2025-03-17","SF FuneralF1085065      250317","","126.5","","394807.94"
"2025-03-20","2025-03-17","SF FuneralF1104100      250317","","126.5","","394934.44"
"2025-03-20","2025-03-17","SF FuneralF1104109      250317","","126.5","","395060.94"
"2025-03-20","2025-03-17","SF FuneralF1120125      250317","","126.5","","395187.44"
"2025-03-20","2025-03-18","SF FuneralFDC00000002QF4250318","","55","","395242.44"
"2025-03-20","2025-03-18","SF FuneralFDC00000009383250318","","31.63","","395274.07"
"2025-03-20","2025-03-18","SF FuneralF816158       250318","","63.25","","395337.32"
"2025-03-20","2025-03-18","SF FuneralF842418       250318","","126.5","","395463.82"
"2025-03-20","2025-03-18","SF FuneralF844086       250318","","63.25","","395527.07"
"2025-03-20","2025-03-18","SF FuneralF991967       250318","","63.25","","395590.32"
"2025-03-20","2025-03-18","SF FuneralF1061069      250318","","31.63","","395621.95"
"2025-03-20","2025-03-18","SF FuneralF1078209      250318","","31.63","","395653.58"
"2025-03-20","2025-03-18","SF FuneralF1115031      250318","","31.63","","395685.21"
"2025-03-20","2025-03-18","SF FuneralF1118892      250318","","31.63","","395716.84"
"2025-03-20","2025-03-19","SF FuneralFDC00000006W3Z250319","","126.5","","395843.34"
"2025-03-20","2025-03-19","SF FuneralF834670       250319","","126.5","","395969.84"
"2025-03-20","2025-03-19","SF FuneralF1122596      250319","","126.5","","396096.34"
"2025-03-20","2025-03-19","SF FuneralFDC0000000PSRX250319","","126.5","","396222.84"
"2025-03-20","2025-03-19","SF FuneralFDC0000000PSS5250319","","126.5","","396349.34"
"2025-03-20","2025-03-20","SF FuneralFDC000000060XJ250320","","126.5","","396475.84"
"2025-03-20","2025-03-20","SF FuneralFDC00000006329250320","","126.5","","396602.34"
"2025-03-20","2025-03-20","SF FuneralFDC000000078VX250320","","126.5","","396728.84"
"2025-03-20","2025-03-20","SF FuneralFDC00000007W6P250320","","126.5","","396855.34"
"2025-03-20","2025-03-20","SF FuneralFDC00000008LYF250320","","126.5","","396981.84"
"2025-03-20","2025-03-20","SF FuneralF990280       250322","","126.5","","397108.34"
"2025-03-20","2025-03-20","SF FuneralF990692       250322","","126.5","","397234.84"
"2025-03-20","2025-03-20","SF FuneralF1108868      250321","","126.5","","397361.34"
"2025-03-20","2025-03-20","SF FuneralF1122718      250320","","31.63","","397392.97"
"2025-03-20","2025-03-20","SF FuneralF1132255      250321","","31.63","","397424.6"
"2025-03-20","2025-03-12","SF FuneralF1072726      250312","","126.5","","397551.1"
"2025-03-20","2025-03-17","SF FuneralF1073092      250317","","126.5","","397677.6"
"2025-03-20","2025-03-17","Rev SF FuneralFDC0000000FCJY250317","","-31.63","","397645.97"
"2025-03-20","2025-03-17","Rev SF FuneralFDC00000005YNL250317","","-55","","397590.97"
"2025-03-20","2025-03-17","Rev SF FuneralFDC00000005YW3250317","","-31.63","","397559.34"
"2025-03-20","2025-03-17","Rev SF FuneralFDC00000006SLY250316","","-126.5","","397432.84"
"2025-03-20","2025-03-17","Rev SF FuneralFDC00000006SLZ250316","","-126.5","","397306.34"
"2025-03-20","2025-03-17","Rev SF FuneralFDC0000000K17R250317","","-126.5","","397179.84"
"2025-03-20","2025-03-12","Rev SF FuneralFDC0000000KJYJ250312","","-126.5","","397053.34"
"2025-03-20","2025-03-19","Rev SF FuneralFDC00000006W2Y250319","","-126.5","","396926.84"
"2025-03-20","2025-02-22","Rev SF FuneralFDC0000000KLMP250222","","-126.5","","396800.34"
"2025-03-20","2025-03-17","Rev SF FuneralFDC0000000N2L5250317","","-126.5","","396673.84"
"2025-03-20","2025-03-18","SF FuneralFDC00000008851250318","","31.63","","396705.47"
"2025-03-20","2025-03-17","SF FuneralFDC00000005M4T250317","","63.25","","396768.72"
"2025-03-20","2025-03-18","SF FuneralF1073597      250318","","126.5","","396895.22"
"2025-03-20","2025-03-17","SF FuneralFDC000000070PX250317","","31.63","","396926.85"
"2025-03-20","2025-03-17","SF FuneralF800626       250317","","31.63","","396958.48"
"2025-03-20","2025-03-17","SF FuneralF803226       250317","","31.63","","396990.11"
"2025-03-20","2025-03-17","SF FuneralF987310       250317","","31.63","","397021.74"
"2025-03-20","2025-03-17","SF FuneralFDC0000000J1SX250317","","126.5","","397148.24"
"2025-03-20","2025-03-17","SF FuneralF1068208      250317","","126.5","","397274.74"
"2025-03-20","2025-03-17","SF FuneralF1117412      250317","","31.63","","397306.37"
"2025-03-20","2025-03-17","SF FuneralFDC0000000NPG9250317","","31.63","","397338"
"2025-03-20","2025-03-18","SF FuneralFDC00000005H2H250318","","31.63","","397369.63"
"2025-03-20","2025-03-18","SF FuneralFDC00000005NFK250318","","31.63","","397401.26"
"2025-03-20","2025-03-18","SF FuneralFDC00000007S9L250318","","31.63","","397432.89"
"2025-03-20","2025-03-18","SF FuneralFDC00000007ZH7250318","","31.63","","397464.52"
"2025-03-20","2025-03-18","SF FuneralF831226       250318","","31.63","","397496.15"
"2025-03-20","2025-03-18","SF FuneralF1114433      250318","","31.63","","397527.78"
"2025-03-20","2025-03-20","SF FuneralFDC0000000B3QN250320","","126.5","","397654.28"
"2025-03-20","2025-03-20","SF FuneralF1116001      250320","","126.5","","397780.78"
"2025-03-20","2025-03-11","SF FuneralFDC000000045CF250311","","110","","397890.78"
"2025-03-20","2025-03-12","SF FuneralF829081       250312","","126.5","","398017.28"
"2025-03-20","2025-03-15","SF FuneralFDC00000005XG6250315","","126.5","","398143.78"
"2025-03-20","2025-03-15","SF FuneralF1060491      250316","","126.5","","398270.28"
"2025-03-20","2025-03-17","SF FuneralFDC00000005PZC250317","","220","","398490.28"
"2025-03-20","2025-03-17","SF FuneralFDC00000008TYJ250317","","63.25","","398553.53"
"2025-03-20","2025-03-17","SF FuneralF987096       250317","","63.25","","398616.78"
"2025-03-20","2025-03-17","SF FuneralF1130031      250317","","126.5","","398743.28"
"2025-03-20","2025-03-17","SF FuneralFDC0000000Q7VH250317","","126.5","","398869.78"
"2025-03-20","2025-03-17","SF FuneralF1133144      250317","","63.25","","398933.03"
"2025-03-20","2025-03-18","SF FuneralF1108240      250318","","63.25","","398996.28"
"2025-03-20","2025-03-20","SF FuneralF814884       250320","","63.25","","399059.53"
"2025-03-20","2025-03-20","SF FuneralF981318       250322","","126.5","","399186.03"
"2025-03-20","2025-03-20","SF FuneralF1078544      250321","","126.5","","399312.53"
"2025-03-20","2025-03-20","SF FuneralF1121784      250321","","126.5","","399439.03"
"2025-03-20","2025-03-12","Rev SF FuneralFDC0000000HM0V250312","","-126.5","","399312.53"
"2025-03-20","2025-03-14","SF FuneralF829800       250314","","63.25","","399375.78"
"2025-03-20","2025-03-17","SF FuneralF1020919      250317","","126.5","","399502.28"
"2025-03-20","2025-03-17","SF FuneralF1123966      250317","","126.5","","399628.78"
"2025-03-20","2025-03-18","SF FuneralFDC00000005P4K250318","","31.63","","399660.41"
"2025-03-20","2025-03-18","SF FuneralF822587       250318","","31.63","","399692.04"
"2025-03-20","2025-03-11","SF FuneralFDC0000000BHGP250311","","63.25","","399755.29"
"2025-03-20","2025-03-11","SF FuneralF1120906      250311","","63.25","","399818.54"
"2025-03-20","2025-03-12","SF FuneralFDC000000063DK250312","","126.5","","399945.04"
"2025-03-20","2025-03-12","SF FuneralF1114431      250312","","126.5","","400071.54"
"2025-03-20","2025-03-17","SF FuneralFDC00000007D5W250317","","63.25","","400134.79"
"2025-03-20","2025-03-17","SF FuneralFDC0000000J1SG250317","","126.5","","400261.29"
"2025-03-20","2025-03-17","SF FuneralF1123166      250317","","31.63","","400292.92"
"2025-03-20","2025-03-18","SF FuneralFDC00000006QTN250318","","31.63","","400324.55"
"2025-03-20","2025-03-18","SF FuneralF811790       250318","","31.63","","400356.18"
"2025-03-20","2025-03-18","SF FuneralF818338       250318","","63.25","","400419.43"
"2025-03-20","2025-03-18","SF FuneralF823292       250318","","63.25","","400482.68"
"2025-03-20","2025-03-18","SF FuneralF1066156      250318","","63.25","","400545.93"
"2025-03-20","2025-03-18","SF FuneralF1080246      250318","","31.63","","400577.56"
"2025-03-20","2025-03-18","SF FuneralF1134975      250318","","31.63","","400609.19"
"2025-03-20","2025-03-18","SF FuneralF1135003      250318","","63.25","","400672.44"
"2025-03-20","2025-03-20","SF FuneralFDC00000005ZK4250320","","126.5","","400798.94"
"2025-03-20","2025-03-20","SF FuneralFDC00000005ZKG250320","","126.5","","400925.44"
"2025-03-20","2025-03-20","SF FuneralFDC00000005ZKP250320","","126.5","","401051.94"
"2025-03-20","2025-03-20","SF FuneralF989355       250322","","126.5","","401178.44"
"2025-03-20","2025-03-17","SF FuneralF1021004      250317","","31.63","","401210.07"
"2025-03-20","2025-03-17","SF FuneralF1080551      250317","","126.5","","401336.57"
"2025-03-20","2025-03-18","SF FuneralF798602       250318","","63.25","","401399.82"
"2025-03-20","2025-03-18","SF FuneralF1134581      250318","","63.25","","401463.07"
"2025-03-20","2025-03-20","SF FuneralFDC0000000Q9MV250320","","126.5","","401589.57"
"2025-03-20","2025-03-17","SF FuneralF1132972      250317","","126.5","","401716.07"
"2025-03-20","2025-03-18","SF FuneralF990180       250318","","31.63","","401747.7"
"2025-03-20","2025-03-12","SF FuneralFDC00000005KXY250312","","126.5","","401874.2"
"2025-03-20","2025-03-15","SF FuneralFDC0000000K1G3250315","","126.5","","402000.7"
"2025-03-20","2025-03-15","SF FuneralF1111595      250316","","31.63","","402032.33"
"2025-03-20","2025-03-17","SF FuneralFDC00000006XGF250317","","63.25","","402095.58"
"2025-03-20","2025-03-17","SF FuneralFDC00000007C9V250317","","63.25","","402158.83"
"2025-03-20","2025-03-17","SF FuneralF804146       250317","","126.5","","402285.33"
"2025-03-20","2025-03-17","SF FuneralF1061516      250317","","63.25","","402348.58"
"2025-03-20","2025-03-17","SF FuneralF1072934      250317","","31.63","","402380.21"
"2025-03-20","2025-03-17","SF FuneralF1110362      250317","","31.63","","402411.84"
"2025-03-20","2025-03-17","SF FuneralF1111352      250317","","63.25","","402475.09"
"2025-03-20","2025-03-17","SF FuneralF1124140      250317","","31.63","","402506.72"
"2025-03-20","2025-03-17","SF FuneralF1132453      250317","","31.63","","402538.35"
"2025-03-20","2025-03-18","SF FuneralFDC00000005X2M250318","","31.63","","402569.98"
"2025-03-20","2025-03-18","SF FuneralFDC00000006H1Y250318","","31.63","","402601.61"
"2025-03-20","2025-03-18","SF FuneralFDC00000006Y7S250318","","31.63","","402633.24"
"2025-03-20","2025-03-18","SF FuneralFDC00000007CY2250318","","63.25","","402696.49"
"2025-03-20","2025-03-18","SF FuneralF814235       250318","","63.25","","402759.74"
"2025-03-20","2025-03-18","SF FuneralF830023       250318","","31.63","","402791.37"
"2025-03-20","2025-03-18","SF FuneralF989148       250318","","31.63","","402823"
"2025-03-20","2025-03-18","SF FuneralF1066029      250318","","31.63","","402854.63"
"2025-03-20","2025-03-18","SF FuneralF1126100      250318","","31.63","","402886.26"
"2025-03-20","2025-03-18","SF FuneralF739720       250318","","64.13","","402950.39"
"2025-03-20","2025-03-18","SF FuneralF1132930      250318","","63.25","","403013.64"
"2025-03-20","2025-03-19","SF FuneralFDC00000008J7N250319","","126.5","","403140.14"
"2025-03-20","2025-03-19","SF FuneralF1115979      250319","","126.5","","403266.64"
"2025-03-20","2025-03-20","SF FuneralF987794       250323","","126.5","","403393.14"
"2025-03-20","2025-03-20","SF FuneralF989273       250323","","31.63","","403424.77"
"2025-03-20","2025-03-20","SF FuneralF989543       250322","","126.5","","403551.27"
"2025-03-20","2025-03-17","SF FuneralF833860       250317","","126.5","","403677.77"
"2025-03-20","2025-03-18","SF FuneralFDC00000006CWD250318","","55","","403732.77"
"2025-03-20","2025-03-18","SF FuneralF1127432      250318","","31.63","","403764.4"
"2025-03-20","2025-03-18","SF FuneralF1134611      250318","","63.25","","403827.65"
"2025-03-20","2025-03-15","SF FuneralF1060488      250315","","126.5","","403954.15"
"2025-03-20","2025-03-17","SF FuneralFDC00000005NX7250317","","31.63","","403985.78"
"2025-03-20","2025-03-18","SF FuneralFDC00000002Y4M250318","","55","","404040.78"
"2025-03-20","2025-03-18","SF FuneralFDC000000030DF250318","","55","","404095.78"
"2025-03-20","2025-03-18","SF FuneralF833229       250318","","63.25","","404159.03"
"2025-03-20","2025-03-18","SF FuneralF991505       250318","","63.25","","404222.28"
"2025-03-20","2025-03-18","SF FuneralF813130       250318","","31.63","","404253.91"
"2025-03-20","2025-03-20","SF FuneralF1120154      250320","","126.5","","404380.41"
"2025-03-20","2025-03-18","SF FuneralFDC0000000CY56250318","","31.63","","404412.04"
"2025-03-20","2025-03-18","SF FuneralF993778       250318","","63.25","","404475.29"
"2025-03-20","2025-03-17","SF FuneralFDC0000000KZ2C250317","","31.63","","404506.92"
"2025-03-20","2025-03-17","SF FuneralFDC0000000QC5P250317","","126.5","","404633.42"
"2025-03-20","2025-03-17","SF FuneralF1133191      250317","","126.5","","404759.92"
"2025-03-20","2025-03-14","SF FuneralF1125111      250314","","31.63","","404791.55"
"2025-03-20","2025-03-15","SF FuneralF1084539      250316","","31.63","","404823.18"
"2025-03-20","2025-03-17","SF FuneralFDC00000007PP8250317","","31.63","","404854.81"
"2025-03-20","2025-03-17","SF FuneralF843034       250317","","31.63","","404886.44"
"2025-03-20","2025-03-17","SF FuneralF1017630      250317","","31.63","","404918.07"
"2025-03-20","2025-03-17","SF FuneralF1060055      250317","","31.63","","404949.7"
"2025-03-20","2025-03-18","SF FuneralF815955       250318","","31.63","","404981.33"
"2025-03-20","2025-03-18","SF FuneralF991415       250318","","31.63","","405012.96"
"2025-03-20","2025-03-18","SF FuneralF1033680      250318","","31.63","","405044.59"
"2025-03-20","2025-03-18","SF FuneralF1060838      250318","","31.63","","405076.22"
"2025-03-20","2025-03-18","SF FuneralF1061865      250318","","31.63","","405107.85"
"2025-03-20","2025-03-18","SF FuneralF1062646      250318","","31.63","","405139.48"
"2025-03-20","2025-03-18","SF FuneralF1067990      250318","","31.63","","405171.11"
"2025-03-20","2025-03-18","SF FuneralFDC0000000L215250318","","31.63","","405202.74"
"2025-03-20","2025-03-18","SF FuneralF1079178      250318","","31.63","","405234.37"
"2025-03-20","2025-03-18","SF FuneralF1079259      250318","","31.63","","405266"
"2025-03-20","2025-03-18","SF FuneralF1084842      250318","","31.63","","405297.63"
"2025-03-20","2025-03-18","SF FuneralF1085179      250318","","31.63","","405329.26"
"2025-03-20","2025-03-18","SF FuneralF1116010      250318","","31.63","","405360.89"
"2025-03-20","2025-03-18","SF FuneralF1132381      250318","","31.63","","405392.52"
"2025-03-20","2025-03-18","SF FuneralF1132989      250318","","31.63","","405424.15"
"2025-03-20","2025-03-19","SF FuneralF1124171      250319","","31.63","","405455.78"
"2025-03-20","2025-03-20","SF FuneralF830649       250320","","31.63","","405487.41"
"2025-03-20","2025-03-20","SF FuneralF1125111      250321","","31.63","","405519.04"
"2025-03-20","2025-03-11","SF FuneralF1117876      250311","","63.25","","405582.29"
"2025-03-20","2025-03-12","SF FuneralFDC00000005QG0250312","","126.5","","405708.79"
"2025-03-20","2025-03-17","SF FuneralFDC000000078GS250317","","126.5","","405835.29"
"2025-03-20","2025-03-17","SF FuneralF838867       250317","","63.25","","405898.54"
"2025-03-20","2025-03-17","SF FuneralF981125       250317","","126.5","","406025.04"
"2025-03-20","2025-03-17","SF FuneralFDC0000000KL49250317","","126.5","","406151.54"
"2025-03-20","2025-03-17","SF FuneralF1073867      250317","","126.5","","406278.04"
"2025-03-20","2025-03-17","SF FuneralF1080425      250317","","126.5","","406404.54"
"2025-03-20","2025-03-17","SF FuneralF1125055      250317","","126.5","","406531.04"
"2025-03-20","2025-03-17","SF FuneralF1125068      250317","","126.5","","406657.54"
"2025-03-20","2025-03-17","SF FuneralF1129539      250317","","126.5","","406784.04"
"2025-03-20","2025-03-17","SF FuneralF1132099      250317","","126.5","","406910.54"
"2025-03-20","2025-03-18","SF FuneralFDC00000006MV3250318","","63.25","","406973.79"
"2025-03-20","2025-03-18","SF FuneralFDC00000006PKR250318","","126.5","","407100.29"
"2025-03-20","2025-03-18","SF FuneralFDC00000007LQC250318","","63.25","","407163.54"
"2025-03-20","2025-03-18","SF FuneralF796639       250318","","126.5","","407290.04"
"2025-03-20","2025-03-18","SF FuneralF814319       250318","","63.25","","407353.29"
"2025-03-20","2025-03-18","SF FuneralF815933       250318","","63.25","","407416.54"
"2025-03-20","2025-03-18","SF FuneralF820828       250318","","63.25","","407479.79"
"2025-03-20","2025-03-18","SF FuneralF841866       250318","","63.25","","407543.04"
"2025-03-20","2025-03-18","SF FuneralF981808       250318","","126.5","","407669.54"
"2025-03-20","2025-03-18","SF FuneralF987466       250318","","63.25","","407732.79"
"2025-03-20","2025-03-18","SF FuneralF1073704      250318","","126.5","","407859.29"
"2025-03-20","2025-03-18","SF FuneralF1123402      250318","","63.25","","407922.54"
"2025-03-20","2025-03-18","SF FuneralF1131800      250318","","63.25","","407985.79"
"2025-03-20","2025-03-18","SF FuneralF1132383      250318","","63.25","","408049.04"
"2025-03-20","2025-03-19","SF FuneralFDC00000007JD3250319","","126.5","","408175.54"
"2025-03-20","2025-03-19","SF FuneralF1120890      250319","","126.5","","408302.04"
"2025-03-20","2025-03-20","SF FuneralFDC00000005YCW250320","","126.5","","408428.54"
"2025-03-20","2025-03-20","SF FuneralF981094       250322","","126.5","","408555.04"
"2025-03-20","2025-03-20","SF FuneralF991083       250322","","126.5","","408681.54"
"2025-03-20","2025-03-20","SF FuneralF1073655      250321","","126.5","","408808.04"
"2025-03-20","2025-03-20","SF FuneralF1083762      250321","","126.5","","408934.54"
"2025-03-20","2025-03-20","SF FuneralF1119083      250320","","126.5","","409061.04"
"2025-03-20","2025-03-20","SF FuneralFDC0000000P3JR250321","","126.5","","409187.54"
"2025-03-20","2025-03-20","SF FuneralF815715       250321","","126.5","","409314.04"
"2025-03-20","2025-03-20","SF FuneralF1132258      250321","","126.5","","409440.54"
"2025-03-20","2025-02-11","Rev SF FuneralFDC00000008H47250211","","-31.63","","409408.91"
"2025-03-20","2025-03-11","Rev SF FuneralFDC00000008H47250311","","-31.63","","409377.28"
"2025-03-20","2025-03-18","Rev SF FuneralFDC0000000NRQK250318","","-31.63","","409345.65"
"2025-03-20","2025-03-18","Rev SF FuneralFDC00000008H47250318","","-31.63","","409314.02"
"2025-03-20","2025-03-18","Rev SF FuneralFDC00000006ST9250318","","-31.63","","409282.39"
"2025-03-20","2025-03-04","Rev SF FuneralFDC00000008H47250304","","-31.63","","409250.76"
"2025-03-20","2025-01-28","Rev SF FuneralFDC00000008H47250128","","-31.63","","409219.13"
"2025-03-20","2025-03-18","Rev SF FuneralFDC00000006STJ250318","","-31.63","","409187.5"
"2025-03-20","2025-02-18","Rev SF FuneralFDC00000008H47250218","","-31.63","","409155.87"
"2025-03-20","2025-02-04","Rev SF FuneralFDC00000008H47250204","","-31.63","","409124.24"
"2025-03-20","2025-02-25","Rev SF FuneralFDC00000008H47250225","","-31.63","","409092.61"
"2025-03-20","2025-03-17","Rev SF FuneralFDC00000008T67250317","","-126.5","","408966.11"
"2025-03-20","2025-03-17","Rev SF FuneralFDC00000005T1R250317","","-126.5","","408839.61"
"2025-03-20","2025-03-20","Rev SF FuneralFDC0000000HP20250322","","-126.5","","408713.11"
"2025-03-20","2025-03-20","Rev SF FuneralFDC00000006PK7250320","","-126.5","","408586.61"
"2025-03-20","2025-03-20","Rev SF FuneralFDC00000007NCH250320","","-126.5","","408460.11"
"2025-03-20","2025-03-20","Rev SF FuneralFDC00000008VQQ250320","","-126.5","","408333.61"
"2025-03-20","2025-03-12","Rev SF FuneralFDC00000006997250312","","-126.5","","408207.11"
"2025-03-20","2025-03-20","Rev SF FuneralFDC00000005ZK4250320","","-126.5","","408080.61"
"2025-03-20","2025-03-12","Rev SF FuneralFDC00000006998250312","","-126.5","","407954.11"
"2025-03-20","2025-03-20","Rev SF FuneralFDC00000005ZKG250320","","-126.5","","407827.61"
"2025-03-20","2025-03-12","Rev SF FuneralFDC000000060ZD250312","","-126.5","","407701.11"
"2025-03-20","2025-03-15","Rev SF FuneralFDC0000000NQTZ250316","","-126.5","","407574.61"
"2025-03-20","2025-03-17","Rev SF FuneralFDC00000008TYJ250317","","-63.25","","407511.36"
"2025-03-20","2025-03-17","Rev SF FuneralFDC00000008L4Z250317","","-126.5","","407384.86"
"2025-03-20","2025-03-17","Rev SF FuneralFDC00000005R60250317","","-126.5","","407258.36"
"2025-03-20","2025-03-17","Rev SF FuneralFDC0000000369L250317","","-220","","407038.36"
"2025-03-20","2025-03-19","Rev SF FuneralFDC00000006GD6250319","","-126.5","","406911.86"
"2025-03-20","2025-03-19","Rev SF FuneralFDC00000008J7N250319","","-126.5","","406785.36"
"2025-03-20","2025-03-19","Rev SF FuneralFDC00000007GVT250319","","-126.5","","406658.86"
"2025-03-20","2025-03-15","Rev SF FuneralFDC0000000K1G3250315","","-126.5","","406532.36"
"2025-03-20","2025-03-17","Rev SF FuneralFDC00000005XH1250317","","-126.5","","406405.86"
"2025-03-20","2025-03-15","Rev SF FuneralFDC00000005XG6250315","","-126.5","","406279.36"
"2025-03-20","2025-03-18","SF FuneralF1122862      250318","","31.63","","406310.99"
"2025-03-20","2025-03-18","SF FuneralF1123027      250318","","31.63","","406342.62"
"2025-03-20","2025-03-18","SF FuneralFDC0000000QHS1250318","","31.63","","406374.25"
"2025-03-20","2025-03-18","SF FuneralFDC0000000QHS5250318","","31.63","","406405.88"
"2025-03-20","2025-03-19","SF FuneralF813578       250319","","63.25","","406469.13"
"2025-03-20","2025-03-17","SF FuneralF1125487      250317","","31.63","","406500.76"
"2025-03-20","2025-03-19","SF FuneralFDC000000082T4250319","","126.5","","406627.26"
"2025-03-20","2025-03-19","SF FuneralF810636       250319","","126.5","","406753.76"
"2025-03-20","2025-03-19","SF FuneralF1127570      250319","","126.5","","406880.26"
"2025-03-20","2025-03-11","SF FuneralFDC0000000QFTV250311","","126.5","","407006.76"
"2025-03-20","2025-03-20","SF FuneralF992014       250321","","126.5","","407133.26"
"2025-03-20","2025-03-17","SF FuneralFDC00000006M69250317","","126.5","","407259.76"
"2025-03-20","2025-03-18","SF FuneralFDC000000080CL250318","","126.5","","407386.26"
"2025-03-20","2025-03-18","SF FuneralF810630       250318","","63.25","","407449.51"
"2025-03-20","2025-03-18","SF FuneralF816802       250318","","31.63","","407481.14"
"2025-03-20","2025-03-18","SF FuneralF988913       250318","","31.63","","407512.77"
"2025-03-20","2025-03-18","SF FuneralF1033965      250318","","63.25","","407576.02"
"2025-03-20","2025-03-18","SF FuneralF1068029      250318","","31.63","","407607.65"
"2025-03-20","2025-03-18","SF FuneralF1123395      250318","","63.25","","407670.9"
"2025-03-20","2025-03-18","SF FuneralF1127485      250318","","31.63","","407702.53"
"2025-03-20","2025-03-19","SF FuneralF819111       250319","","31.63","","407734.16"
"2025-03-20","2025-03-20","SF FuneralF1021793      250321","","126.5","","407860.66"
"2025-03-20","2025-03-17","SF FuneralFDC00000007FPS250317","","31.63","","407892.29"
"2025-03-20","2025-03-17","SF FuneralF1129089      250317","","63.25","","407955.54"
"2025-03-20","2025-03-18","SF FuneralF830037       250318","","63.25","","408018.79"
"2025-03-20","2025-03-18","SF FuneralF828946       250318","","63.25","","408082.04"
"2025-03-20","2025-03-18","SF FuneralF989085       250318","","31.63","","408113.67"
"2025-03-20","2025-03-18","SF FuneralF989212       250318","","63.25","","408176.92"
"2025-03-20","2025-03-18","SF FuneralF1054618      250318","","31.63","","408208.55"
"2025-03-20","2025-03-18","SF FuneralF1067978      250318","","31.63","","408240.18"
"2025-03-20","2025-03-18","SF FuneralF1112534      250318","","63.25","","408303.43"
"2025-03-20","2025-03-18","SF FuneralF1118693      250318","","63.25","","408366.68"
"2025-03-20","2025-03-18","SF FuneralF1130346      250318","","31.63","","408398.31"
"2025-03-20","2025-03-20","SF FuneralF1073874      250321","","126.5","","408524.81"
"2025-03-20","2025-03-17","SF FuneralFDC00000002XYZ250316","","55","","408579.81"
"2025-03-20","2025-03-17","SF FuneralF811084       250317","","63.25","","408643.06"
"2025-03-20","2025-03-17","SF FuneralF844339       250317","","31.63","","408674.69"
"2025-03-20","2025-03-17","SF FuneralF791581       250317","","47.88","","408722.57"
"2025-03-20","2025-03-17","SF FuneralF1115192      250317","","126.5","","408849.07"
"2025-03-20","2025-03-18","SF FuneralFDC000000061NF250318","","31.63","","408880.7"
"2025-03-20","2025-03-18","SF FuneralF806032       250318","","31.63","","408912.33"
"2025-03-20","2025-03-18","SF FuneralF809435       250318","","31.63","","408943.96"
"2025-03-20","2025-03-18","SF FuneralF811655       250318","","31.63","","408975.59"
"2025-03-20","2025-03-18","SF FuneralF812669       250318","","63.25","","409038.84"
"2025-03-20","2025-03-18","SF FuneralFDC0000000HQB5250318","","31.63","","409070.47"
"2025-03-20","2025-03-18","SF FuneralF843649       250318","","31.63","","409102.1"
"2025-03-20","2025-03-18","SF FuneralF1061075      250318","","31.63","","409133.73"
"2025-03-20","2025-03-18","SF FuneralF1068023      250318","","31.63","","409165.36"
"2025-03-20","2025-03-18","SF FuneralFDC0000000MCB7250318","","63.25","","409228.61"
"2025-03-20","2025-03-18","SF FuneralF1111329      250318","","31.63","","409260.24"
"2025-03-20","2025-03-18","SF FuneralFDC0000000NDDS250318","","126.5","","409386.74"
"2025-03-20","2025-03-18","SF FuneralF1117702      250318","","31.63","","409418.37"
"2025-03-20","2025-03-18","SF FuneralF1118948      250318","","63.25","","409481.62"
"2025-03-20","2025-03-18","SF FuneralF1120129      250318","","31.63","","409513.25"
"2025-03-20","2025-03-18","SF FuneralF1123172      250318","","31.63","","409544.88"
"2025-03-20","2025-03-18","SF FuneralF1125142      250318","","31.63","","409576.51"
"2025-03-20","2025-03-18","SF FuneralF1131796      250318","","31.63","","409608.14"
"2025-03-20","2025-03-18","SF FuneralF1132997      250318","","126.5","","409734.64"
"2025-03-20","2025-03-18","SF FuneralF1133731      250318","","31.63","","409766.27"
"2025-03-20","2025-03-12","SF FuneralF1017863      250312","","126.5","","409892.77"
"2025-03-21","2025-03-11","SF FuneralFDC00000009W98250311","","126.5","","410019.27"
"2025-03-21","2025-03-11","SF FuneralF1117955      250311","","63.25","","410082.52"
"2025-03-21","2025-03-12","SF FuneralFDC00000007XQQ250312","","126.5","","410209.02"
"2025-03-21","2025-03-13","SF FuneralF831145       250313","","63.25","","410272.27"
"2025-03-21","2025-03-15","SF FuneralF1016646      250316","","63.25","","410335.52"
"2025-03-21","2025-03-15","SF FuneralF1054967      250316","","126.5","","410462.02"
"2025-03-21","2025-03-17","SF FuneralFDC00000006ZGP250316","","126.5","","410588.52"
"2025-03-21","2025-03-17","SF FuneralFDC00000008CSD250317","","126.5","","410715.02"
"2025-03-21","2025-03-17","SF FuneralFDC00000008CSF250317","","126.5","","410841.52"
"2025-03-21","2025-03-17","SF FuneralF802152       250317","","126.5","","410968.02"
"2025-03-21","2025-03-17","SF FuneralF843935       250317","","63.25","","411031.27"
"2025-03-21","2025-03-17","SF FuneralF1052772      250317","","126.5","","411157.77"
"2025-03-21","2025-03-17","SF FuneralF1073360      250317","","126.5","","411284.27"
"2025-03-21","2025-03-17","SF FuneralF1080260      250317","","126.5","","411410.77"
"2025-03-21","2025-03-17","SF FuneralF1116080      250317","","126.5","","411537.27"
"2025-03-21","2025-03-17","SF FuneralF1123976      250317","","63.25","","411600.52"
"2025-03-21","2025-03-17","SF FuneralF1131799      250317","","63.25","","411663.77"
"2025-03-21","2025-03-18","SF FuneralFDC000000076ZR250318","","126.5","","411790.27"
"2025-03-21","2025-03-18","SF FuneralFDC00000008P1H250318","","63.25","","411853.52"
"2025-03-21","2025-03-18","SF FuneralF815053       250318","","63.25","","411916.77"
"2025-03-21","2025-03-18","SF FuneralF821893       250318","","63.25","","411980.02"
"2025-03-21","2025-03-18","SF FuneralF834932       250318","","63.25","","412043.27"
"2025-03-21","2025-03-18","SF FuneralF843810       250318","","63.25","","412106.52"
"2025-03-21","2025-03-18","SF FuneralF981761       250318","","63.25","","412169.77"
"2025-03-21","2025-03-18","SF FuneralF988932       250318","","63.25","","412233.02"
"2025-03-21","2025-03-18","SF FuneralF989374       250318","","63.25","","412296.27"
"2025-03-21","2025-03-18","SF FuneralFDC0000000J0D4250318","","63.25","","412359.52"
"2025-03-21","2025-03-18","SF FuneralFDC0000000JCZG250318","","63.25","","412422.77"
"2025-03-21","2025-03-18","SF FuneralFDC0000000JJ2Y250318","","63.25","","412486.02"
"2025-03-21","2025-03-18","SF FuneralF1079384      250318","","63.25","","412549.27"
"2025-03-21","2025-03-18","SF FuneralF1080328      250318","","63.25","","412612.52"
"2025-03-21","2025-03-18","SF FuneralFDC0000000MK76250318","","63.25","","412675.77"
"2025-03-21","2025-03-18","SF FuneralF1121999      250318","","63.25","","412739.02"
"2025-03-21","2025-03-18","SF FuneralF1130519      250318","","63.25","","412802.27"
"2025-03-21","2025-03-18","SF FuneralF1130748      250318","","63.25","","412865.52"
"2025-03-21","2025-03-18","SF FuneralF1131855      250318","","63.25","","412928.77"
"2025-03-21","2025-03-18","SF FuneralF1133468      250318","","63.25","","412992.02"
"2025-03-21","2025-03-19","SF FuneralFDC00000006FX3250319","","126.5","","413118.52"
"2025-03-21","2025-03-19","SF FuneralFDC00000008H3W250319","","126.5","","413245.02"
"2025-03-21","2025-03-19","SF FuneralF987993       250319","","126.5","","413371.52"
"2025-03-21","2025-03-19","SF FuneralFDC0000000J2QP250319","","126.5","","413498.02"
"2025-03-21","2025-03-19","SF FuneralF1020888      250319","","126.5","","413624.52"
"2025-03-21","2025-03-19","SF FuneralF1112292      250319","","126.5","","413751.02"
"2025-03-21","2025-03-20","SF FuneralFDC000000064JL250320","","126.5","","413877.52"
"2025-03-21","2025-03-20","SF FuneralFDC00000006PPW250320","","126.5","","414004.02"
"2025-03-21","2025-03-20","SF FuneralF809258       250320","","126.5","","414130.52"
"2025-03-21","2025-03-20","SF FuneralF901362       250321","","126.5","","414257.02"
"2025-03-21","2025-03-20","SF FuneralF981688       250323","","126.5","","414383.52"
"2025-03-21","2025-03-20","SF FuneralFDC0000000HSWB250323","","126.5","","414510.02"
"2025-03-21","2025-03-20","SF FuneralF987617       250323","","126.5","","414636.52"
"2025-03-21","2025-03-20","SF FuneralF1054882      250320","","126.5","","414763.02"
"2025-03-21","2025-03-20","SF FuneralF1075083      250321","","126.5","","414889.52"
"2025-03-21","2025-03-20","SF FuneralF1122638      250320","","63.25","","414952.77"
"2025-03-21","2025-03-20","SF FuneralF1124762      250320","","126.5","","415079.27"
"2025-03-21","2025-03-20","SF FuneralFDC0000000PXJV250320","","126.5","","415205.77"
"2025-03-21","2025-03-20","SF FuneralF1129119      250320","","126.5","","415332.27"
"2025-03-21","2025-03-17","SF FuneralFDC00000005RR7250317","","31.63","","415363.9"
"2025-03-21","2025-03-17","SF FuneralFDC00000005RR8250317","","31.63","","415395.53"
"2025-03-21","2025-03-17","SF FuneralFDC000000074Y5250317","","55","","415450.53"
"2025-03-21","2025-03-17","SF FuneralFDC00000009G6R250317","","31.63","","415482.16"
"2025-03-21","2025-03-17","SF FuneralF820769       250317","","31.63","","415513.79"
"2025-03-21","2025-03-17","SF FuneralF827602       250317","","31.63","","415545.42"
"2025-03-21","2025-03-17","SF FuneralF901184       250317","","31.63","","415577.05"
"2025-03-21","2025-03-17","SF FuneralF986655       250317","","31.63","","415608.68"
"2025-03-21","2025-03-17","SF FuneralF990276       250317","","31.63","","415640.31"
"2025-03-21","2025-03-17","SF FuneralF993678       250317","","31.63","","415671.94"
"2025-03-21","2025-03-17","SF FuneralF1016810      250317","","31.63","","415703.57"
"2025-03-21","2025-03-17","SF FuneralFDC0000000KYZ5250317","","31.63","","415735.2"
"2025-03-21","2025-03-17","SF FuneralF1072928      250317","","31.63","","415766.83"
"2025-03-21","2025-03-17","SF FuneralF1073374      250317","","31.63","","415798.46"
"2025-03-21","2025-03-17","SF FuneralF1079348      250317","","31.63","","415830.09"
"2025-03-21","2025-03-17","SF FuneralF1084032      250317","","31.63","","415861.72"
"2025-03-21","2025-03-17","SF FuneralF1102887      250317","","31.63","","415893.35"
"2025-03-21","2025-03-17","SF FuneralFDC0000000ML65250317","","31.63","","415924.98"
"2025-03-21","2025-03-17","SF FuneralF1112394      250317","","31.63","","415956.61"
"2025-03-21","2025-03-17","SF FuneralFDC0000000N7Y7250317","","31.63","","415988.24"
"2025-03-21","2025-03-17","SF FuneralF1115136      250317","","31.63","","416019.87"
"2025-03-21","2025-03-17","SF FuneralF1115957      250317","","31.63","","416051.5"
"2025-03-21","2025-03-17","SF FuneralF1118033      250317","","31.63","","416083.13"
"2025-03-21","2025-03-17","SF FuneralF1129904      250317","","31.63","","416114.76"
"2025-03-21","2025-03-17","SF FuneralF1130649      250317","","31.63","","416146.39"
"2025-03-21","2025-03-17","SF FuneralF1130713      250317","","31.63","","416178.02"
"2025-03-21","2025-03-17","SF FuneralF1132115      250317","","31.63","","416209.65"
"2025-03-21","2025-03-18","SF FuneralFDC00000003BTC250318","","55","","416264.65"
"2025-03-21","2025-03-18","SF FuneralFDC00000003V68250318","","55","","416319.65"
"2025-03-21","2025-03-18","SF FuneralFDC00000005PFJ250318","","31.63","","416351.28"
"2025-03-21","2025-03-18","SF FuneralFDC000000064P9250318","","31.63","","416382.91"
"2025-03-21","2025-03-18","SF FuneralFDC00000007KLD250318","","31.63","","416414.54"
"2025-03-21","2025-03-18","SF FuneralFDC0000000BMW2250318","","31.63","","416446.17"
"2025-03-21","2025-03-18","SF FuneralF833072       250318","","31.63","","416477.8"
"2025-03-21","2025-03-18","SF FuneralF833123       250318","","31.63","","416509.43"
"2025-03-21","2025-03-18","SF FuneralF987244       250318","","31.63","","416541.06"
"2025-03-21","2025-03-18","SF FuneralF989270       250318","","31.63","","416572.69"
"2025-03-21","2025-03-18","SF FuneralF1017666      250318","","31.63","","416604.32"
"2025-03-21","2025-03-18","SF FuneralF1050698      250318","","31.63","","416635.95"
"2025-03-21","2025-03-18","SF FuneralFDC0000000K22X250318","","31.63","","416667.58"
"2025-03-21","2025-03-18","SF FuneralF1073379      250318","","31.63","","416699.21"
"2025-03-21","2025-03-18","SF FuneralF1073746      250318","","31.63","","416730.84"
"2025-03-21","2025-03-18","SF FuneralF1074598      250318","","31.63","","416762.47"
"2025-03-21","2025-03-18","SF FuneralF1118352      250318","","31.63","","416794.1"
"2025-03-21","2025-03-18","SF FuneralF1118420      250318","","31.63","","416825.73"
"2025-03-21","2025-03-18","SF FuneralF1123316      250318","","31.63","","416857.36"
"2025-03-21","2025-03-18","SF FuneralF1123497      250318","","31.63","","416888.99"
"2025-03-21","2025-03-18","SF FuneralF1127719      250318","","31.63","","416920.62"
"2025-03-21","2025-03-18","SF FuneralF1129064      250318","","31.63","","416952.25"
"2025-03-21","2025-03-18","SF FuneralF1129356      250318","","31.63","","416983.88"
"2025-03-21","2025-03-18","SF FuneralF1129417      250318","","31.63","","417015.51"
"2025-03-21","2025-03-18","SF FuneralF1131536      250318","","31.63","","417047.14"
"2025-03-21","2025-03-18","SF FuneralF1118962      250318","","31.63","","417078.77"
"2025-03-21","2025-03-19","SF FuneralF1060919      250319","","31.63","","417110.4"
"2025-03-21","2025-03-19","SF FuneralF1124144      250319","","31.63","","417142.03"
"2025-03-21","2025-03-20","SF FuneralFDC0000000HVXH250322","","31.63","","417173.66"
"2025-03-21","2025-03-20","SF FuneralF1085355      250321","","31.63","","417205.29"
"2025-03-21","2025-03-20","SF FuneralF1111672      250321","","31.63","","417236.92"
"2025-03-21","2025-03-20","SF FuneralF1114116      250321","","31.63","","417268.55"
"2025-03-21","2025-03-11","SF FuneralF1066680      250311","","63.25","","417331.8"
"2025-03-21","2025-03-11","SF FuneralF1117868      250311","","63.25","","417395.05"
"2025-03-21","2025-03-17","SF FuneralFDC00000002QJ5250317","","220","","417615.05"
"2025-03-21","2025-03-17","SF FuneralFDC000000036RN250316","","220","","417835.05"
"2025-03-21","2025-03-17","SF FuneralFDC00000006YP1250317","","126.5","","417961.55"
"2025-03-21","2025-03-17","SF FuneralFDC000000092Y1250317","","63.25","","418024.8"
"2025-03-21","2025-03-17","SF FuneralFDC0000000931H250317","","63.25","","418088.05"
"2025-03-21","2025-03-17","SF FuneralF821755       250317","","126.5","","418214.55"
"2025-03-21","2025-03-17","SF FuneralF822919       250317","","63.25","","418277.8"
"2025-03-21","2025-03-17","SF FuneralF842252       250317","","63.25","","418341.05"
"2025-03-21","2025-03-17","SF FuneralFDC0000000GWQQ250317","","126.5","","418467.55"
"2025-03-21","2025-03-17","SF FuneralF986862       250317","","63.25","","418530.8"
"2025-03-21","2025-03-17","SF FuneralF991450       250317","","126.5","","418657.3"
"2025-03-21","2025-03-17","SF FuneralF1066517      250317","","63.25","","418720.55"
"2025-03-21","2025-03-17","SF FuneralF1067883      250317","","63.25","","418783.8"
"2025-03-21","2025-03-17","SF FuneralF1073564      250317","","126.5","","418910.3"
"2025-03-21","2025-03-17","SF FuneralF1108526      250317","","126.5","","419036.8"
"2025-03-21","2025-03-17","SF FuneralF1114589      250317","","126.5","","419163.3"
"2025-03-21","2025-03-17","SF FuneralF1124749      250317","","126.5","","419289.8"
"2025-03-21","2025-03-17","SF FuneralF1128905      250317","","63.25","","419353.05"
"2025-03-21","2025-03-17","SF FuneralF1128971      250317","","63.25","","419416.3"
"2025-03-21","2025-03-17","SF FuneralFDC0000000Q02V250317","","63.25","","419479.55"
"2025-03-21","2025-03-18","SF FuneralFDC0000000616W250318","","126.5","","419606.05"
"2025-03-21","2025-03-18","SF FuneralFDC000000062B9250318","","63.25","","419669.3"
"2025-03-21","2025-03-18","SF FuneralFDC00000006Y8Q250318","","126.5","","419795.8"
"2025-03-21","2025-03-18","SF FuneralFDC00000007TQD250318","","126.5","","419922.3"
"2025-03-21","2025-03-18","SF FuneralF799997       250318","","63.25","","419985.55"
"2025-03-21","2025-03-18","SF FuneralFDC00000008TK0250318","","126.5","","420112.05"
"2025-03-21","2025-03-18","SF FuneralF817760       250318","","63.25","","420175.3"
"2025-03-21","2025-03-18","SF FuneralF818508       250318","","63.25","","420238.55"
"2025-03-21","2025-03-18","SF FuneralF819579       250318","","126.5","","420365.05"
"2025-03-21","2025-03-18","SF FuneralFDC0000000BJ3M250318","","63.25","","420428.3"
"2025-03-21","2025-03-18","SF FuneralF823908       250318","","126.5","","420554.8"
"2025-03-21","2025-03-18","SF FuneralF828969       250318","","63.25","","420618.05"
"2025-03-21","2025-03-18","SF FuneralF834077       250318","","63.25","","420681.3"
"2025-03-21","2025-03-18","SF FuneralF993963       250318","","63.25","","420744.55"
"2025-03-21","2025-03-18","SF FuneralF1117303      250318","","63.25","","420807.8"
"2025-03-21","2025-03-18","SF FuneralFDC0000000P4SX250318","","95.75","","420903.55"
"2025-03-21","2025-03-18","SF FuneralF1123426      250318","","95.75","","420999.3"
"2025-03-21","2025-03-18","SF FuneralF1124139      250318","","126.5","","421125.8"
"2025-03-21","2025-03-18","SF FuneralFDC0000000PBMD250318","","126.5","","421252.3"
"2025-03-21","2025-03-18","SF FuneralFDC0000000Q1HZ250318","","95.75","","421348.05"
"2025-03-21","2025-03-18","SF FuneralFDC0000000Q9SY250318","","63.25","","421411.3"
"2025-03-21","2025-03-19","SF FuneralFDC00000005ZZG250319","","126.5","","421537.8"
"2025-03-21","2025-03-19","SF FuneralFDC000000087TZ250319","","126.5","","421664.3"
"2025-03-21","2025-03-19","SF FuneralFDC000000087V0250319","","126.5","","421790.8"
"2025-03-21","2025-03-19","SF FuneralF805384       250319","","126.5","","421917.3"
"2025-03-21","2025-03-19","SF FuneralF812302       250319","","126.5","","422043.8"
"2025-03-21","2025-03-19","SF FuneralF847303       250319","","126.5","","422170.3"
"2025-03-21","2025-03-19","SF FuneralFDC0000000K8JJ250319","","126.5","","422296.8"
"2025-03-21","2025-03-19","SF FuneralF1067959      250319","","126.5","","422423.3"
"2025-03-21","2025-03-19","SF FuneralFDC0000000P9YG250319","","126.5","","422549.8"
"2025-03-21","2025-03-19","SF FuneralFDC0000000PSR7250319","","126.5","","422676.3"
"2025-03-21","2025-03-19","SF FuneralFDC0000000PSRF250319","","126.5","","422802.8"
"2025-03-21","2025-03-20","SF FuneralFDC00000005MXN250320","","126.5","","422929.3"
"2025-03-21","2025-03-20","SF FuneralFDC000000060BM250320","","126.5","","423055.8"
"2025-03-21","2025-03-20","SF FuneralFDC00000006Y2D250320","","126.5","","423182.3"
"2025-03-21","2025-03-20","SF FuneralFDC00000007X6J250320","","126.5","","423308.8"
"2025-03-21","2025-03-20","SF FuneralF838770       250320","","126.5","","423435.3"
"2025-03-21","2025-03-20","SF FuneralF1108253      250321","","126.5","","423561.8"
"2025-03-21","2025-03-20","SF FuneralFDC0000000QB77250321","","126.5","","423688.3"
"2025-03-21","2025-03-20","SF FuneralFDC0000000QB7B250321","","126.5","","423814.8"
"2025-03-21","2025-03-15","SF FuneralF1122059      250316","","31.63","","423846.43"
"2025-03-21","2025-03-17","SF FuneralFDC00000004NQM250316","","31.63","","423878.06"
"2025-03-21","2025-03-17","SF FuneralFDC00000004NQP250316","","31.63","","423909.69"
"2025-03-21","2025-03-17","SF FuneralFDC000000071S5250317","","31.63","","423941.32"
"2025-03-21","2025-03-17","SF FuneralF811593       250317","","31.63","","423972.95"
"2025-03-21","2025-03-17","SF FuneralF813361       250317","","31.63","","424004.58"
"2025-03-21","2025-03-17","SF FuneralF802331       250317","","31.63","","424036.21"
"2025-03-21","2025-03-17","SF FuneralF841850       250317","","31.63","","424067.84"
"2025-03-21","2025-03-17","SF FuneralF1073218      250317","","31.63","","424099.47"
"2025-03-21","2025-03-17","SF FuneralF1079340      250317","","31.63","","424131.1"
"2025-03-21","2025-03-17","SF FuneralF1104295      250317","","31.63","","424162.73"
"2025-03-21","2025-03-18","SF FuneralFDC000000073P4250318","","31.63","","424194.36"
"2025-03-21","2025-03-18","SF FuneralF798676       250318","","31.63","","424225.99"
"2025-03-21","2025-03-18","SF FuneralFDC000000088BV250318","","31.63","","424257.62"
"2025-03-21","2025-03-18","SF FuneralF812125       250318","","31.63","","424289.25"
"2025-03-21","2025-03-18","SF FuneralF814180       250318","","31.63","","424320.88"
"2025-03-21","2025-03-18","SF FuneralF814338       250318","","31.63","","424352.51"
"2025-03-21","2025-03-18","SF FuneralF817682       250318","","31.63","","424384.14"
"2025-03-21","2025-03-18","SF FuneralF1020608      250318","","31.63","","424415.77"
"2025-03-21","2025-03-18","SF FuneralF1020683      250318","","31.63","","424447.4"
"2025-03-21","2025-03-18","SF FuneralF1115225      250318","","31.63","","424479.03"
"2025-03-21","2025-03-18","SF FuneralF1132382      250318","","31.63","","424510.66"
"2025-03-21","2025-03-19","SF FuneralFDC0000000MLNC250319","","31.63","","424542.29"
"2025-03-21","2025-03-20","SF FuneralFDC00000005P8B250320","","31.63","","424573.92"
"2025-03-21","2025-03-20","SF FuneralF1079509      250321","","31.63","","424605.55"
"2025-03-21","2025-03-17","SF FuneralFDC00000005GH0250317","","31.63","","424637.18"
"2025-03-21","2025-03-17","SF FuneralF815144       250317","","31.63","","424668.81"
"2025-03-21","2025-03-17","SF FuneralF810327       250317","","31.63","","424700.44"
"2025-03-21","2025-03-17","SF FuneralF830431       250317","","31.63","","424732.07"
"2025-03-21","2025-03-17","SF FuneralF1108848      250317","","31.63","","424763.7"
"2025-03-21","2025-03-17","SF FuneralF1123291      250317","","31.63","","424795.33"
"2025-03-21","2025-03-18","SF FuneralFDC00000005R1B250318","","31.63","","424826.96"
"2025-03-21","2025-03-18","SF FuneralFDC0000000J00M250318","","31.63","","424858.59"
"2025-03-21","2025-03-18","SF FuneralF1072724      250318","","31.63","","424890.22"
"2025-03-21","2025-03-18","SF FuneralF1130616      250318","","31.63","","424921.85"
"2025-03-21","2025-03-20","SF FuneralF805236       250320","","31.63","","424953.48"
"2025-03-21","2025-03-17","SF FuneralF802251       250317","","31.63","","424985.11"
"2025-03-21","2025-03-17","SF FuneralF1132386      250317","","31.63","","425016.74"
"2025-03-21","2025-03-18","SF FuneralFDC00000007DFS250318","","31.63","","425048.37"
"2025-03-21","2025-03-18","SF FuneralF805200       250318","","31.63","","425080"
"2025-03-21","2025-03-18","SF FuneralF830294       250318","","31.63","","425111.63"
"2025-03-21","2025-03-18","SF FuneralF993770       250318","","31.63","","425143.26"
"2025-03-21","2025-03-18","SF FuneralFDC0000000NRVB250318","","31.63","","425174.89"
"2025-03-21","2025-03-18","SF FuneralF1123030      250318","","31.63","","425206.52"
"2025-03-21","2025-03-18","SF FuneralF1127417      250318","","31.63","","425238.15"
"2025-03-21","2025-03-18","SF FuneralF743038       250318","","31.63","","425269.78"
"2025-03-21","2025-03-11","SF FuneralF831283       250311","","126.5","","425396.28"
"2025-03-21","2025-03-11","SF FuneralF1118350      250311","","63.25","","425459.53"
"2025-03-21","2025-03-11","SF FuneralF1127477      250311","","63.25","","425522.78"
"2025-03-21","2025-03-15","SF FuneralF1055127      250316","","126.5","","425649.28"
"2025-03-21","2025-03-17","SF FuneralFDC00000005PMN250317","","126.5","","425775.78"
"2025-03-21","2025-03-17","SF FuneralF820521       250317","","63.25","","425839.03"
"2025-03-21","2025-03-17","SF FuneralF820741       250317","","63.25","","425902.28"
"2025-03-21","2025-03-17","SF FuneralF833744       250316","","126.5","","426028.78"
"2025-03-21","2025-03-17","SF FuneralF833829       250316","","126.5","","426155.28"
"2025-03-21","2025-03-17","SF FuneralF988900       250317","","95.75","","426251.03"
"2025-03-21","2025-03-17","SF FuneralF989102       250317","","63.25","","426314.28"
"2025-03-21","2025-03-17","SF FuneralFDC0000000KFF7250317","","126.5","","426440.78"
"2025-03-21","2025-03-17","SF FuneralFDC0000000LJW6250317","","106.66","","426547.44"
"2025-03-21","2025-03-18","SF FuneralF809291       250318","","63.25","","426610.69"
"2025-03-21","2025-03-18","SF FuneralF810730       250318","","63.25","","426673.94"
"2025-03-21","2025-03-18","SF FuneralF822306       250318","","63.25","","426737.19"
"2025-03-21","2025-03-18","SF FuneralF830472       250318","","63.25","","426800.44"
"2025-03-21","2025-03-18","SF FuneralF842929       250318","","63.25","","426863.69"
"2025-03-21","2025-03-18","SF FuneralF993574       250318","","126.5","","426990.19"
"2025-03-21","2025-03-18","SF FuneralF1103647      250318","","63.25","","427053.44"
"2025-03-21","2025-03-19","SF FuneralFDC00000005RNF250319","","126.5","","427179.94"
"2025-03-21","2025-03-19","SF FuneralF815170       250319","","126.5","","427306.44"
"2025-03-21","2025-03-19","SF FuneralF1083874      250319","","63.25","","427369.69"
"2025-03-21","2025-03-19","SF FuneralFDC0000000QHB4250319","","126.5","","427496.19"
"2025-03-21","2025-03-19","SF FuneralF1134186      250319","","126.5","","427622.69"
"2025-03-21","2025-03-20","SF FuneralFDC0000000HRQH250322","","126.5","","427749.19"
"2025-03-21","2025-03-20","SF FuneralF1118195      250321","","126.5","","427875.69"
"2025-03-21","2025-03-12","SF FuneralFDC0000000J28V250312","","126.5","","428002.19"
"2025-03-21","2025-03-18","SF FuneralF810870       250318","","63.25","","428065.44"
"2025-03-21","2025-03-18","SF FuneralFDC00000007CQV250318","","31.63","","428097.07"
"2025-03-21","2025-03-18","SF FuneralFDC0000000892D250318","","31.63","","428128.7"
"2025-03-21","2025-03-18","SF FuneralF828892       250318","","63.25","","428191.95"
"2025-03-21","2025-03-18","SF FuneralFDC0000000ML7D250318","","31.63","","428223.58"
"2025-03-21","2025-03-18","SF FuneralF1111588      250318","","31.63","","428255.21"
"2025-03-21","2025-03-18","SF FuneralF1118308      250318","","31.63","","428286.84"
"2025-03-21","2025-03-18","SF FuneralF1118348      250318","","31.63","","428318.47"
"2025-03-21","2025-03-18","SF FuneralFDC0000000NN7N250318","","31.63","","428350.1"
"2025-03-21","2025-03-18","SF FuneralF1123132      250318","","31.63","","428381.73"
"2025-03-21","2025-03-18","SF FuneralF1130344      250318","","31.63","","428413.36"
"2025-03-21","2025-03-18","SF FuneralF1132354      250318","","31.63","","428444.99"
"2025-03-21","2025-03-19","SF FuneralF828217       250319","","126.5","","428571.49"
"2025-03-21","2025-03-19","SF FuneralF1059424      250319","","31.63","","428603.12"
"2025-03-21","2025-03-12","SF FuneralFDC00000005PF9250312","","126.5","","428729.62"
"2025-03-21","2025-03-17","SF FuneralF809759       250317","","63.25","","428792.87"
"2025-03-21","2025-03-17","SF FuneralFDC0000000HS6H250317","","31.63","","428824.5"
"2025-03-21","2025-03-17","SF FuneralF1122322      250317","","126.5","","428951"
"2025-03-21","2025-03-17","SF FuneralF1126068      250317","","126.5","","429077.5"
"2025-03-21","2025-03-13","SF FuneralFDC00000005YHY250313","","126.5","","429204"
"2025-03-21","2025-03-17","SF FuneralF842916       250317","","63.25","","429267.25"
"2025-03-21","2025-03-17","SF FuneralF1111602      250317","","126.5","","429393.75"
"2025-03-21","2025-03-18","SF FuneralFDC00000002XZF250318","","110","","429503.75"
"2025-03-21","2025-03-18","SF FuneralFDC00000006WKK250318","","31.63","","429535.38"
"2025-03-21","2025-03-18","SF FuneralFDC000000079QY250318","","31.63","","429567.01"
"2025-03-21","2025-03-18","SF FuneralFDC00000007LMQ250318","","126.5","","429693.51"
"2025-03-21","2025-03-18","SF FuneralF815591       250318","","126.5","","429820.01"
"2025-03-21","2025-03-18","SF FuneralF831106       250318","","31.63","","429851.64"
"2025-03-21","2025-03-18","SF FuneralF1020916      250318","","31.63","","429883.27"
"2025-03-21","2025-03-18","SF FuneralF1060950      250318","","31.63","","429914.9"
"2025-03-21","2025-03-18","SF FuneralF1065982      250318","","31.63","","429946.53"
"2025-03-21","2025-03-18","SF FuneralF1068221      250318","","31.63","","429978.16"
"2025-03-21","2025-03-18","SF FuneralF1108251      250318","","31.63","","430009.79"
"2025-03-21","2025-03-18","SF FuneralF981451       250318","","31.63","","430041.42"
"2025-03-21","2025-03-18","SF FuneralF1132974      250318","","63.25","","430104.67"
"2025-03-21","2025-03-19","SF FuneralFDC00000007K1G250319","","126.5","","430231.17"
"2025-03-21","2025-03-20","SF FuneralF821684       250320","","126.5","","430357.67"
"2025-03-21","2025-03-21","SF FuneralF819108       250321","","126.5","","430484.17"
"2025-03-21","2025-03-21","SF FuneralF842737       250321","","31.63","","430515.8"
"2025-03-21","2025-03-18","SF FuneralFDC0000000Q8H7250318","","31.63","","430547.43"
"2025-03-21","2025-03-19","SF FuneralFDC00000005Z4Z250319","","126.5","","430673.93"
"2025-03-21","2025-03-18","SF FuneralFDC0000000J23L250318","","31.63","","430705.56"
"2025-03-22","2025-03-12","SF FuneralF820113       250312","","225.75","","430931.31"
"2025-03-22","2025-03-12","SF FuneralF1129489      250312","","126.5","","431057.81"
"2025-03-22","2025-03-18","SF FuneralFDC00000006B9G250318","","31.63","","431089.44"
"2025-03-22","2025-03-18","SF FuneralFDC0000000776Q250318","","63.25","","431152.69"
"2025-03-22","2025-03-18","SF FuneralF816327       250318","","63.25","","431215.94"
"2025-03-22","2025-03-18","SF FuneralF993911       250318","","126.5","","431342.44"
"2025-03-22","2025-03-18","SF FuneralF1016973      250318","","31.63","","431374.07"
"2025-03-22","2025-03-18","SF FuneralF1110349      250318","","31.63","","431405.7"
"2025-03-22","2025-03-18","SF FuneralF1112152      250318","","31.63","","431437.33"
"2025-03-22","2025-03-18","SF FuneralF1118994      250318","","63.25","","431500.58"
"2025-03-22","2025-03-18","SF FuneralF1123619      250318","","63.25","","431563.83"
"2025-03-22","2025-03-20","SF FuneralF1016998      250320","","126.5","","431690.33"
"2025-03-22","2025-03-20","SF FuneralF1083745      250320","","126.5","","431816.83"
"2025-03-22","2025-03-20","SF FuneralF1131921      250321","","31.63","","431848.46"
"2025-03-22","2025-03-17","SF FuneralFDC000000070CJ250317","","31.63","","431880.09"
"2025-03-22","2025-03-17","SF FuneralFDC00000007969250316","","126.5","","432006.59"
"2025-03-22","2025-03-17","SF FuneralFDC00000007GXS250317","","31.63","","432038.22"
"2025-03-22","2025-03-17","SF FuneralF987157       250317","","63.25","","432101.47"
"2025-03-22","2025-03-17","SF FuneralF1084895      250317","","126.5","","432227.97"
"2025-03-22","2025-03-19","SF FuneralF819230       250319","","126.5","","432354.47"
"2025-03-22","2025-03-19","SF FuneralF1119016      250319","","95.75","","432450.22"
"2025-03-22","2025-03-12","SF FuneralF822126       250312","","126.5","","432576.72"
"2025-03-22","2025-03-17","SF FuneralF819708       250317","","126.5","","432703.22"
"2025-03-22","2025-03-17","SF FuneralF1060981      250317","","63.25","","432766.47"
"2025-03-22","2025-03-18","SF FuneralF834979       250318","","63.25","","432829.72"
"2025-03-22","2025-03-19","SF FuneralFDC000000073VV250319","","126.5","","432956.22"
"2025-03-22","2025-03-19","SF FuneralF1131023      250319","","126.5","","433082.72"
"2025-03-22","2025-03-20","SF FuneralFDC00000005XTB250320","","126.5","","433209.22"
"2025-03-22","2025-03-12","SF FuneralFDC00000006F0S250312","","126.5","","433335.72"
"2025-03-22","2025-03-17","SF FuneralF1118324      250317","","31.63","","433367.35"
"2025-03-22","2025-03-18","SF FuneralFDC00000008G43250318","","31.63","","433398.98"
"2025-03-22","2025-03-20","SF FuneralF988703       250322","","126.5","","433525.48"
"2025-03-22","2025-03-17","SF FuneralF986911       250317","","31.63","","433557.11"
"2025-03-22","2025-03-18","SF FuneralF1113987      250318","","31.63","","433588.74"
"2025-03-22","2025-03-18","SF FuneralFDC0000000NNP9250318","","31.63","","433620.37"
"2025-03-22","2025-03-20","SF FuneralF1135156      250321","","31.63","","433652"
"2025-03-22","2025-03-22","SF FuneralF1021306      250322","","126.5","","433778.5"
"2025-03-22","2025-03-17","SF FuneralFDC000000074Y0250317","","126.5","","433905"
"2025-03-22","2025-03-17","SF FuneralFDC0000000LT6F250317","","126.5","","434031.5"
"2025-03-22","2025-03-20","SF FuneralF991207       250322","","126.5","","434158"
"2025-03-22","2025-03-20","SF FuneralF1123947      250321","","31.63","","434189.63"
"2025-03-22","2025-03-20","SF FuneralFDC0000000QFBX250320","","126.5","","434316.13"
"2025-03-22","2025-03-22","SF FuneralFDC000000031GC250322","","220","","434536.13"
"2025-03-22","2025-03-22","SF FuneralFDC00000005P75250322","","126.5","","434662.63"
"2025-03-22","2025-03-22","SF FuneralFDC00000005VPZ250321","","31.63","","434694.26"
"2025-03-22","2025-03-22","SF FuneralFDC00000005YDH250321","","126.5","","434820.76"
"2025-03-22","2025-03-22","SF FuneralFDC000000065N4250322","","126.5","","434947.26"
"2025-03-22","2025-03-22","SF FuneralFDC0000000668B250322","","126.5","","435073.76"
"2025-03-22","2025-03-22","SF FuneralFDC00000006PKT250322","","126.5","","435200.26"
"2025-03-22","2025-03-22","SF FuneralFDC00000006T66250322","","126.5","","435326.76"
"2025-03-22","2025-03-22","SF FuneralFDC000000070HM250321","","63.25","","435390.01"
"2025-03-22","2025-03-22","SF FuneralFDC000000073LB250322","","126.5","","435516.51"
"2025-03-22","2025-03-22","SF FuneralFDC000000077ZW250322","","126.5","","435643.01"
"2025-03-22","2025-03-22","SF FuneralFDC00000007HTV250322","","126.5","","435769.51"
"2025-03-22","2025-03-22","SF FuneralFDC00000007JNV250322","","126.5","","435896.01"
"2025-03-22","2025-03-22","SF FuneralFDC00000007JNX250322","","126.5","","436022.51"
"2025-03-22","2025-03-22","SF FuneralFDC00000007XDS250321","","126.5","","436149.01"
"2025-03-22","2025-03-22","SF FuneralFDC000000081YN250322","","126.5","","436275.51"
"2025-03-22","2025-03-22","SF FuneralF798583       250321","","31.63","","436307.14"
"2025-03-22","2025-03-22","SF FuneralF803329       250322","","126.5","","436433.64"
"2025-03-22","2025-03-22","SF FuneralF816117       250322","","126.5","","436560.14"
"2025-03-22","2025-03-22","SF FuneralFDC0000000B410250322","","126.5","","436686.64"
"2025-03-22","2025-03-22","SF FuneralF821177       250322","","126.5","","436813.14"
"2025-03-22","2025-03-22","SF FuneralF831397       250321","","126.5","","436939.64"
"2025-03-22","2025-03-22","SF FuneralF841916       250322","","126.5","","437066.14"
"2025-03-22","2025-03-22","SF FuneralF1020598      250322","","126.5","","437192.64"
"2025-03-22","2025-03-22","SF FuneralF1021848      250322","","126.5","","437319.14"
"2025-03-22","2025-03-22","SF FuneralFDC0000000KQ0M250322","","126.5","","437445.64"
"2025-03-22","2025-03-22","SF FuneralF1085288      250323","","126.5","","437572.14"
"2025-03-22","2025-03-22","SF FuneralF1108592      250322","","126.5","","437698.64"
"2025-03-22","2025-03-22","SF FuneralF1111503      250322","","126.5","","437825.14"
"2025-03-22","2025-03-22","SF FuneralFDC0000000PH6H250322","","126.5","","437951.64"
"2025-03-22","2025-03-20","SF FuneralF991098       250320","","126.5","","438078.14"
"2025-03-22","2025-03-18","SF FuneralF801331       250318","","31.63","","438109.77"
"2025-03-22","2025-03-18","SF FuneralFDC0000000MWP0250318","","63.25","","438173.02"
"2025-03-22","2025-03-18","SF FuneralF1111979      250318","","63.25","","438236.27"
"2025-03-22","2025-03-12","SF FuneralF844032       250312","","126.5","","438362.77"
"2025-03-22","2025-03-17","SF FuneralFDC00000006CXK250317","","126.5","","438489.27"
"2025-03-22","2025-03-17","SF FuneralFDC00000008MKX250317","","31.63","","438520.9"
"2025-03-22","2025-03-17","SF FuneralFDC00000009K4G250317","","126.5","","438647.4"
"2025-03-22","2025-03-18","SF FuneralF800205       250318","","31.63","","438679.03"
"2025-03-22","2025-03-18","SF FuneralF822239       250318","","31.63","","438710.66"
"2025-03-22","2025-03-18","SF FuneralF827810       250318","","63.25","","438773.91"
"2025-03-22","2025-03-18","SF FuneralF1131657      250318","","31.63","","438805.54"
"2025-03-22","2025-03-19","SF FuneralFDC000000063F4250319","","126.5","","438932.04"
"2025-03-22","2025-03-19","SF FuneralF819349       250319","","126.5","","439058.54"
"2025-03-22","2025-03-19","SF FuneralF980991       250319","","126.5","","439185.04"
"2025-03-22","2025-03-20","SF FuneralFDC00000005ZQ2250320","","126.5","","439311.54"
"2025-03-22","2025-03-20","SF FuneralF1110071      250320","","126.5","","439438.04"
"2025-03-22","2025-03-20","SF FuneralF1127416      250321","","63.25","","439501.29"
"2025-03-22","2025-03-22","SF FuneralFDC000000061ML250322","","126.5","","439627.79"
"2025-03-22","2025-03-22","SF FuneralFDC0000000624R250322","","126.5","","439754.29"
"2025-03-22","2025-03-22","SF FuneralFDC000000062V6250322","","126.5","","439880.79"
"2025-03-22","2025-03-22","SF FuneralFDC00000006563250322","","126.5","","440007.29"
"2025-03-22","2025-03-22","SF FuneralFDC00000006QR8250322","","126.5","","440133.79"
"2025-03-22","2025-03-22","SF FuneralFDC00000006QRH250322","","126.5","","440260.29"
"2025-03-22","2025-03-22","SF FuneralFDC00000006QWK250322","","126.5","","440386.79"
"2025-03-22","2025-03-22","SF FuneralFDC00000006SK3250322","","126.5","","440513.29"
"2025-03-22","2025-03-22","SF FuneralFDC00000006T84250322","","126.5","","440639.79"
"2025-03-22","2025-03-22","SF FuneralFDC00000006V2H250322","","126.5","","440766.29"
"2025-03-22","2025-03-22","SF FuneralFDC00000006ZTG250322","","126.5","","440892.79"
"2025-03-22","2025-03-22","SF FuneralFDC000000073YH250322","","126.5","","441019.29"
"2025-03-22","2025-03-22","SF FuneralFDC00000007KBJ250322","","126.5","","441145.79"
"2025-03-22","2025-03-22","SF FuneralFDC00000007L1F250321","","126.5","","441272.29"
"2025-03-22","2025-03-22","SF FuneralFDC00000007M62250321","","126.5","","441398.79"
"2025-03-22","2025-03-22","SF FuneralFDC00000007NYY250322","","126.5","","441525.29"
"2025-03-22","2025-03-22","SF FuneralF801394       250322","","126.5","","441651.79"
"2025-03-22","2025-03-22","SF FuneralFDC00000008GSY250322","","126.5","","441778.29"
"2025-03-22","2025-03-22","SF FuneralFDC00000008H16250321","","126.5","","441904.79"
"2025-03-22","2025-03-22","SF FuneralFDC00000008H22250321","","126.5","","442031.29"
"2025-03-22","2025-03-22","SF FuneralFDC00000008PKS250322","","126.5","","442157.79"
"2025-03-22","2025-03-22","SF FuneralFDC00000008PLF250322","","126.5","","442284.29"
"2025-03-22","2025-03-22","SF FuneralF804893       250321","","126.5","","442410.79"
"2025-03-22","2025-03-22","SF FuneralF812686       250322","","126.5","","442537.29"
"2025-03-22","2025-03-22","SF FuneralF814422       250322","","126.5","","442663.79"
"2025-03-22","2025-03-22","SF FuneralF816104       250322","","126.5","","442790.29"
"2025-03-22","2025-03-22","SF FuneralFDC0000000JHW8250322","","126.5","","442916.79"
"2025-03-22","2025-03-22","SF FuneralF1052763      250323","","126.5","","443043.29"
"2025-03-22","2025-03-22","SF FuneralF1060480      250323","","126.5","","443169.79"
"2025-03-22","2025-03-22","SF FuneralF1074674      250322","","126.5","","443296.29"
"2025-03-22","2025-03-22","SF FuneralF1108630      250322","","126.5","","443422.79"
"2025-03-22","2025-03-22","SF FuneralF1112517      250322","","126.5","","443549.29"
"2025-03-22","2025-03-22","SF FuneralF1113780      250322","","126.5","","443675.79"
"2025-03-22","2025-03-22","SF FuneralF1120141      250322","","126.5","","443802.29"
"2025-03-22","2025-03-22","SF FuneralF1123228      250322","","126.5","","443928.79"
"2025-03-22","2025-03-22","SF FuneralF1130472      250322","","126.5","","444055.29"
"2025-03-22","2025-03-22","SF FuneralF1134853      250322","","126.5","","444181.79"
"2025-03-22","2025-03-22","SF FuneralF1135369      250322","","126.5","","444308.29"
"2025-03-22","2025-03-22","SF FuneralFDC00000007KR2250322","","126.5","","444434.79"
"2025-03-22","2025-03-22","SF FuneralFDC0000000L72K250322","","126.5","","444561.29"
"2025-03-22","2025-03-22","SF FuneralFDC00000002TMK250321","","220","","444781.29"
"2025-03-22","2025-03-22","SF FuneralFDC00000005951250322","","256.5","","445037.79"
"2025-03-22","2025-03-22","SF FuneralFDC00000005M9Q250322","","126.5","","445164.29"
"2025-03-22","2025-03-22","SF FuneralFDC00000005RMS250322","","126.5","","445290.79"
"2025-03-22","2025-03-22","SF FuneralFDC00000005WY0250322","","126.5","","445417.29"
"2025-03-22","2025-03-22","SF FuneralFDC00000005YMX250322","","126.5","","445543.79"
"2025-03-22","2025-03-22","SF FuneralFDC0000000610Y250322","","126.5","","445670.29"
"2025-03-22","2025-03-22","SF FuneralFDC000000061WJ250321","","126.5","","445796.79"
"2025-03-22","2025-03-22","SF FuneralFDC0000000676D250322","","126.5","","445923.29"
"2025-03-22","2025-03-22","SF FuneralFDC00000007BF7250322","","126.5","","446049.79"
"2025-03-22","2025-03-22","SF FuneralFDC00000007K9C250322","","126.5","","446176.29"
"2025-03-22","2025-03-22","SF FuneralF795057       250322","","126.5","","446302.79"
"2025-03-22","2025-03-22","SF FuneralFDC00000007TSB250321","","126.5","","446429.29"
"2025-03-22","2025-03-22","SF FuneralFDC00000007X00250322","","126.5","","446555.79"
"2025-03-22","2025-03-22","SF FuneralFDC00000008L2W250322","","126.5","","446682.29"
"2025-03-22","2025-03-22","SF FuneralF803725       250322","","126.5","","446808.79"
"2025-03-22","2025-03-22","SF FuneralFDC00000008TGS250322","","126.5","","446935.29"
"2025-03-22","2025-03-22","SF FuneralF778535       250322","","126.5","","447061.79"
"2025-03-22","2025-03-22","SF FuneralFDC00000009HXP250322","","126.5","","447188.29"
"2025-03-22","2025-03-22","SF FuneralF822624       250322","","126.5","","447314.79"
"2025-03-22","2025-03-22","SF FuneralF833223       250322","","126.5","","447441.29"
"2025-03-22","2025-03-22","SF FuneralFDC0000000DPHH250322","","126.5","","447567.79"
"2025-03-22","2025-03-22","SF FuneralF992692       250322","","126.5","","447694.29"
"2025-03-22","2025-03-22","SF FuneralFDC0000000K8W4250322","","126.5","","447820.79"
"2025-03-22","2025-03-22","SF FuneralFDC0000000K8W8250322","","126.5","","447947.29"
"2025-03-22","2025-03-22","SF FuneralF1060707      250322","","126.5","","448073.79"
"2025-03-22","2025-03-22","SF FuneralFDC0000000KJN0250322","","126.5","","448200.29"
"2025-03-22","2025-03-22","SF FuneralF1060948      250322","","126.5","","448326.79"
"2025-03-22","2025-03-22","SF FuneralF1066388      250322","","126.5","","448453.29"
"2025-03-22","2025-03-22","SF FuneralFDC0000000KXVC250323","","126.5","","448579.79"
"2025-03-22","2025-03-22","SF FuneralF1072856      250323","","31.63","","448611.42"
"2025-03-22","2025-03-22","SF FuneralF1108380      250322","","126.5","","448737.92"
"2025-03-22","2025-03-22","SF FuneralFDC0000000MJDP250322","","126.5","","448864.42"
"2025-03-22","2025-03-22","SF FuneralF1109891      250322","","126.5","","448990.92"
"2025-03-22","2025-03-22","SF FuneralF1114730      250323","","31.63","","449022.55"
"2025-03-22","2025-03-22","SF FuneralF1117872      250322","","126.5","","449149.05"
"2025-03-22","2025-03-22","SF FuneralF1120805      250322","","126.5","","449275.55"
"2025-03-22","2025-03-22","SF FuneralFDC0000000P8Q8250322","","126.5","","449402.05"
"2025-03-22","2025-03-22","SF FuneralF1124282      250322","","126.5","","449528.55"
"2025-03-22","2025-03-22","SF FuneralF1125995      250322","","126.5","","449655.05"
"2025-03-22","2025-03-22","SF FuneralF1127937      250322","","126.5","","449781.55"
"2025-03-22","2025-03-22","SF FuneralF1131224      250322","","126.5","","449908.05"
"2025-03-22","2025-03-22","SF FuneralF833804       250322","","126.5","","450034.55"
"2025-03-22","2025-03-22","SF FuneralF833892       250322","","126.5","","450161.05"
"2025-03-22","2025-03-22","SF FuneralF841058       250322","","126.5","","450287.55"
"2025-03-22","2025-03-22","SF FuneralF841619       250322","","126.5","","450414.05"
"2025-03-22","2025-03-22","SF FuneralF992898       250322","","126.5","","450540.55"
"2025-03-22","2025-03-22","SF FuneralF993052       250322","","126.5","","450667.05"
"2025-03-22","2025-03-22","SF FuneralF1017674      250322","","126.5","","450793.55"
"2025-03-22","2025-03-22","SF FuneralF1061712      250322","","126.5","","450920.05"
"2025-03-22","2025-03-22","SF FuneralF1062674      250322","","126.5","","451046.55"
"2025-03-22","2025-03-22","SF FuneralFDC0000000KXSZ250322","","126.5","","451173.05"
"2025-03-22","2025-03-22","SF FuneralF1067921      250322","","126.5","","451299.55"
"2025-03-22","2025-03-22","SF FuneralFDC0000000LB4G250322","","126.5","","451426.05"
"2025-03-22","2025-03-22","SF FuneralF1080374      250322","","126.5","","451552.55"
"2025-03-22","2025-03-22","SF FuneralF1084029      250322","","126.5","","451679.05"
"2025-03-22","2025-03-22","SF FuneralF1084376      250323","","126.5","","451805.55"
"2025-03-22","2025-03-22","SF FuneralF1102943      250322","","126.5","","451932.05"
"2025-03-22","2025-03-22","SF FuneralF1103524      250322","","126.5","","452058.55"
"2025-03-22","2025-03-22","SF FuneralF1108092      250322","","126.5","","452185.05"
"2025-03-22","2025-03-22","SF FuneralF1108099      250322","","126.5","","452311.55"
"2025-03-22","2025-03-22","SF FuneralFDC0000000MCXM250322","","126.5","","452438.05"
"2025-03-22","2025-03-22","SF FuneralF1108352      250322","","126.5","","452564.55"
"2025-03-22","2025-03-22","SF FuneralF1108657      250322","","126.5","","452691.05"
"2025-03-22","2025-03-22","SF FuneralFDC0000000MLZ8250323","","126.5","","452817.55"
"2025-03-22","2025-03-22","SF FuneralFDC0000000MQ4Q250322","","126.5","","452944.05"
"2025-03-22","2025-03-22","SF FuneralFDC0000000N928250322","","126.5","","453070.55"
"2025-03-22","2025-03-22","SF FuneralFDC0000000N92F250322","","126.5","","453197.05"
"2025-03-22","2025-03-22","SF FuneralF1114608      250322","","126.5","","453323.55"
"2025-03-22","2025-03-22","SF FuneralFDC0000000N9R4250322","","126.5","","453450.05"
"2025-03-22","2025-03-22","SF FuneralFDC0000000NGN1250323","","126.5","","453576.55"
"2025-03-22","2025-03-22","SF FuneralF1116702      250322","","126.5","","453703.05"
"2025-03-22","2025-03-22","SF FuneralFDC0000000NHLX250322","","126.5","","453829.55"
"2025-03-22","2025-03-22","SF FuneralF1117624      250323","","126.5","","453956.05"
"2025-03-22","2025-03-22","SF FuneralF1118392      250322","","126.5","","454082.55"
"2025-03-22","2025-03-22","SF FuneralF1118400      250322","","126.5","","454209.05"
"2025-03-22","2025-03-22","SF FuneralF1118917      250322","","126.5","","454335.55"
"2025-03-22","2025-03-22","SF FuneralF1118935      250323","","126.5","","454462.05"
"2025-03-22","2025-03-22","SF FuneralF1120218      250322","","126.5","","454588.55"
"2025-03-22","2025-03-22","SF FuneralF1124601      250322","","126.5","","454715.05"
"2025-03-22","2025-03-22","SF FuneralF1125868      250322","","126.5","","454841.55"
"2025-03-22","2025-03-22","SF FuneralF1126267      250322","","126.5","","454968.05"
"2025-03-22","2025-03-22","SF FuneralFDC0000000PR6H250322","","126.5","","455094.55"
"2025-03-22","2025-03-22","SF FuneralF1127702      250322","","126.5","","455221.05"
"2025-03-22","2025-03-22","SF FuneralF1130312      250322","","126.5","","455347.55"
"2025-03-22","2025-03-22","SF FuneralF1130340      250322","","126.5","","455474.05"
"2025-03-22","2025-03-22","SF FuneralFDC00000005K6L250322","","126.5","","455600.55"
"2025-03-22","2025-03-22","SF FuneralFDC00000005XSP250322","","126.5","","455727.05"
"2025-03-22","2025-03-22","SF FuneralFDC00000005YYY250322","","126.5","","455853.55"
"2025-03-22","2025-03-22","SF FuneralFDC00000005Z1Q250322","","126.5","","455980.05"
"2025-03-22","2025-03-22","SF FuneralFDC000000061BF250321","","126.5","","456106.55"
"2025-03-22","2025-03-22","SF FuneralFDC000000061JM250322","","126.5","","456233.05"
"2025-03-22","2025-03-22","SF FuneralFDC000000061V4250322","","126.5","","456359.55"
"2025-03-22","2025-03-22","SF FuneralFDC000000064R8250321","","126.5","","456486.05"
"2025-03-22","2025-03-22","SF FuneralFDC00000006CQ6250322","","126.5","","456612.55"
"2025-03-22","2025-03-22","SF FuneralFDC00000006DJV250322","","126.5","","456739.05"
"2025-03-22","2025-03-22","SF FuneralFDC00000006SC8250322","","126.5","","456865.55"
"2025-03-22","2025-03-22","SF FuneralFDC00000006Z5Z250321","","126.5","","456992.05"
"2025-03-22","2025-03-22","SF FuneralFDC000000071N5250321","","126.5","","457118.55"
"2025-03-22","2025-03-22","SF FuneralFDC000000074ZC250322","","126.5","","457245.05"
"2025-03-22","2025-03-22","SF FuneralFDC0000000757K250322","","126.5","","457371.55"
"2025-03-22","2025-03-22","SF FuneralFDC0000000757M250322","","126.5","","457498.05"
"2025-03-22","2025-03-22","SF FuneralFDC0000000770G250322","","126.5","","457624.55"
"2025-03-22","2025-03-22","SF FuneralFDC00000007937250322","","126.5","","457751.05"
"2025-03-22","2025-03-22","SF FuneralFDC00000007CWZ250322","","126.5","","457877.55"
"2025-03-22","2025-03-22","SF FuneralFDC00000007CX0250322","","126.5","","458004.05"
"2025-03-22","2025-03-22","SF FuneralFDC00000007D4Y250322","","126.5","","458130.55"
"2025-03-22","2025-03-22","SF FuneralFDC00000007F8P250322","","126.5","","458257.05"
"2025-03-22","2025-03-22","SF FuneralFDC00000007RJK250322","","126.5","","458383.55"
"2025-03-22","2025-03-22","SF FuneralFDC00000007TZQ250322","","126.5","","458510.05"
"2025-03-22","2025-03-22","SF FuneralFDC00000007TZX250322","","126.5","","458636.55"
"2025-03-22","2025-03-22","SF FuneralFDC000000080YV250322","","126.5","","458763.05"
"2025-03-22","2025-03-22","SF FuneralFDC0000000818Z250321","","220","","458983.05"
"2025-03-22","2025-03-22","SF FuneralFDC000000081RY250322","","126.5","","459109.55"
"2025-03-22","2025-03-22","SF FuneralFDC000000081Y8250322","","126.5","","459236.05"
"2025-03-22","2025-03-22","SF FuneralF797656       250322","","126.5","","459362.55"
"2025-03-22","2025-03-22","SF FuneralFDC000000084Y7250322","","126.5","","459489.05"
"2025-03-22","2025-03-22","SF FuneralFDC00000008FPT250322","","126.5","","459615.55"
"2025-03-22","2025-03-22","SF FuneralF801335       250322","","126.5","","459742.05"
"2025-03-22","2025-03-22","SF FuneralF801555       250322","","191.5","","459933.55"
"2025-03-22","2025-03-22","SF FuneralF801935       250322","","126.5","","460060.05"
"2025-03-22","2025-03-22","SF FuneralF801952       250322","","126.5","","460186.55"
"2025-03-22","2025-03-22","SF FuneralFDC00000008JXM250322","","126.5","","460313.05"
"2025-03-22","2025-03-22","SF FuneralF803703       250322","","126.5","","460439.55"
"2025-03-22","2025-03-22","SF FuneralF808887       250322","","126.5","","460566.05"
"2025-03-22","2025-03-22","SF FuneralF811136       250322","","126.5","","460692.55"
"2025-03-22","2025-03-22","SF FuneralF811284       250322","","126.5","","460819.05"
"2025-03-22","2025-03-22","SF FuneralF815298       250322","","126.5","","460945.55"
"2025-03-22","2025-03-22","SF FuneralF818302       250322","","126.5","","461072.05"
"2025-03-22","2025-03-22","SF FuneralF818521       250322","","126.5","","461198.55"
"2025-03-22","2025-03-22","SF FuneralF823331       250322","","126.5","","461325.05"
"2025-03-22","2025-03-22","SF FuneralFDC0000000D3F5250321","","126.5","","461451.55"
"2025-03-22","2025-03-22","SF FuneralF840648       250322","","126.5","","461578.05"
"2025-03-22","2025-03-22","SF FuneralF842306       250322","","126.5","","461704.55"
"2025-03-22","2025-03-22","SF FuneralF842700       250322","","126.5","","461831.05"
"2025-03-22","2025-03-22","SF FuneralF842893       250322","","126.5","","461957.55"
"2025-03-22","2025-03-22","SF FuneralFDC0000000J80P250322","","126.5","","462084.05"
"2025-03-22","2025-03-22","SF FuneralF993347       250322","","126.5","","462210.55"
"2025-03-22","2025-03-22","SF FuneralF1017656      250322","","126.5","","462337.05"
"2025-03-22","2025-03-22","SF FuneralF1017658      250322","","126.5","","462463.55"
"2025-03-22","2025-03-22","SF FuneralF1022169      250322","","126.5","","462590.05"
"2025-03-22","2025-03-22","SF FuneralF1033800      250322","","126.5","","462716.55"
"2025-03-22","2025-03-22","SF FuneralFDC0000000K3JW250322","","191.5","","462908.05"
"2025-03-22","2025-03-22","SF FuneralF1054937      250322","","126.5","","463034.55"
"2025-03-22","2025-03-22","SF FuneralFDC0000000KDK6250322","","126.5","","463161.05"
"2025-03-22","2025-03-22","SF FuneralF1065816      250322","","126.5","","463287.55"
"2025-03-22","2025-03-22","SF FuneralF1066675      250322","","126.5","","463414.05"
"2025-03-22","2025-03-22","SF FuneralF1068091      250322","","126.5","","463540.55"
"2025-03-22","2025-03-22","SF FuneralF1073861      250322","","126.5","","463667.05"
"2025-03-22","2025-03-22","SF FuneralF1074989      250322","","126.5","","463793.55"
"2025-03-22","2025-03-22","SF FuneralF1084969      250322","","126.5","","463920.05"
"2025-03-22","2025-03-22","SF FuneralF1108533      250322","","126.5","","464046.55"
"2025-03-22","2025-03-22","SF FuneralF1113321      250322","","126.5","","464173.05"
"2025-03-22","2025-03-22","SF FuneralF1118065      250322","","126.5","","464299.55"
"2025-03-22","2025-03-22","SF FuneralF1120184      250322","","126.5","","464426.05"
"2025-03-22","2025-03-22","SF FuneralF1124390      250322","","126.5","","464552.55"
"2025-03-22","2025-03-22","SF FuneralFDC0000000P9RQ250322","","126.5","","464679.05"
"2025-03-22","2025-03-22","SF FuneralF1128333      250322","","126.5","","464805.55"
"2025-03-22","2025-03-22","SF FuneralFDC0000000Q22L250322","","126.5","","464932.05"
"2025-03-22","2025-03-22","SF FuneralF1130837      250322","","191.5","","465123.55"
"2025-03-22","2025-03-18","SF FuneralF834882       250318","","31.63","","465155.18"
"2025-03-22","2025-03-18","SF FuneralF989177       250318","","31.63","","465186.81"
"2025-03-22","2025-03-18","SF FuneralF1104234      250318","","31.63","","465218.44"
"2025-03-22","2025-03-22","SF FuneralFDC000000034HX250322","","220","","465438.44"
"2025-03-22","2025-03-22","SF FuneralFDC0000000382P250321","","220","","465658.44"
"2025-03-22","2025-03-22","SF FuneralFDC0000000387Y250321","","220","","465878.44"
"2025-03-22","2025-03-22","SF FuneralFDC00000005R26250322","","126.5","","466004.94"
"2025-03-22","2025-03-22","SF FuneralFDC00000005RZ8250321","","126.5","","466131.44"
"2025-03-22","2025-03-22","SF FuneralFDC00000005S4B250322","","126.5","","466257.94"
"2025-03-22","2025-03-22","SF FuneralFDC00000005SB0250322","","126.5","","466384.44"
"2025-03-22","2025-03-22","SF FuneralFDC00000005X4T250322","","126.5","","466510.94"
"2025-03-22","2025-03-22","SF FuneralFDC00000005Y9L250322","","126.5","","466637.44"
"2025-03-22","2025-03-22","SF FuneralFDC00000005YBL250321","","126.5","","466763.94"
"2025-03-22","2025-03-22","SF FuneralFDC00000005ZQ7250322","","126.5","","466890.44"
"2025-03-22","2025-03-22","SF FuneralFDC00000005ZVB250322","","126.5","","467016.94"
"2025-03-22","2025-03-22","SF FuneralFDC00000005ZVF250322","","126.5","","467143.44"
"2025-03-22","2025-03-22","SF FuneralFDC000000060JT250322","","126.5","","467269.94"
"2025-03-22","2025-03-22","SF FuneralFDC000000060LY250322","","126.5","","467396.44"
"2025-03-22","2025-03-22","SF FuneralFDC000000060NF250322","","126.5","","467522.94"
"2025-03-22","2025-03-22","SF FuneralFDC000000060Q0250322","","126.5","","467649.44"
"2025-03-22","2025-03-22","SF FuneralFDC0000000612K250322","","126.5","","467775.94"
"2025-03-22","2025-03-22","SF FuneralFDC000000063MY250322","","126.5","","467902.44"
"2025-03-22","2025-03-22","SF FuneralFDC000000064HB250322","","126.5","","468028.94"
"2025-03-22","2025-03-22","SF FuneralFDC00000006539250322","","126.5","","468155.44"
"2025-03-22","2025-03-22","SF FuneralFDC000000066C5250322","","126.5","","468281.94"
"2025-03-22","2025-03-22","SF FuneralFDC00000006BCV250322","","126.5","","468408.44"
"2025-03-22","2025-03-22","SF FuneralFDC00000006CZP250322","","126.5","","468534.94"
"2025-03-22","2025-03-22","SF FuneralFDC00000006JZM250322","","126.5","","468661.44"
"2025-03-22","2025-03-22","SF FuneralFDC00000006MPK250322","","126.5","","468787.94"
"2025-03-22","2025-03-22","SF FuneralFDC00000006MQC250322","","126.5","","468914.44"
"2025-03-22","2025-03-22","SF FuneralFDC00000006SS8250322","","126.5","","469040.94"
"2025-03-22","2025-03-22","SF FuneralFDC00000006SVG250322","","126.5","","469167.44"
"2025-03-22","2025-03-22","SF FuneralFDC00000006V08250322","","126.5","","469293.94"
"2025-03-22","2025-03-22","SF FuneralFDC00000006VRQ250322","","126.5","","469420.44"
"2025-03-22","2025-03-22","SF FuneralFDC00000006ZR6250322","","126.5","","469546.94"
"2025-03-22","2025-03-22","SF FuneralFDC00000007JRW250322","","126.5","","469673.44"
"2025-03-22","2025-03-22","SF FuneralFDC00000007MH6250322","","126.5","","469799.94"
"2025-03-22","2025-03-22","SF FuneralFDC00000007N1T250322","","126.5","","469926.44"
"2025-03-22","2025-03-22","SF FuneralFDC00000007N30250322","","191.5","","470117.94"
"2025-03-22","2025-03-22","SF FuneralFDC0000000837V250322","","126.5","","470244.44"
"2025-03-22","2025-03-22","SF FuneralFDC000000085FC250322","","126.5","","470370.94"
"2025-03-22","2025-03-22","SF FuneralFDC000000086GN250322","","126.5","","470497.44"
"2025-03-22","2025-03-22","SF FuneralFDC00000008FRT250321","","126.5","","470623.94"
"2025-03-22","2025-03-22","SF FuneralFDC00000008G22250322","","126.5","","470750.44"
"2025-03-22","2025-03-22","SF FuneralFDC00000008GNM250322","","126.5","","470876.94"
"2025-03-22","2025-03-22","SF FuneralFDC00000008HLZ250322","","126.5","","471003.44"
"2025-03-22","2025-03-22","SF FuneralF801823       250322","","126.5","","471129.94"
"2025-03-22","2025-03-22","SF FuneralFDC00000008LJ9250322","","126.5","","471256.44"
"2025-03-22","2025-03-22","SF FuneralF805495       250322","","126.5","","471382.94"
"2025-03-22","2025-03-22","SF FuneralF805637       250322","","126.5","","471509.44"
"2025-03-22","2025-03-22","SF FuneralF808564       250322","","126.5","","471635.94"
"2025-03-22","2025-03-22","SF FuneralFDC000000092ZZ250322","","126.5","","471762.44"
"2025-03-22","2025-03-22","SF FuneralF809750       250322","","126.5","","471888.94"
"2025-03-22","2025-03-22","SF FuneralF809969       250322","","126.5","","472015.44"
"2025-03-22","2025-03-22","SF FuneralF811774       250322","","126.5","","472141.94"
"2025-03-22","2025-03-22","SF FuneralF812459       250322","","126.5","","472268.44"
"2025-03-22","2025-03-22","SF FuneralF813946       250322","","126.5","","472394.94"
"2025-03-22","2025-03-22","SF FuneralFDC00000009NWR250322","","126.5","","472521.44"
"2025-03-22","2025-03-22","SF FuneralFDC00000009R9J250322","","126.5","","472647.94"
"2025-03-22","2025-03-22","SF FuneralF817024       250322","","126.5","","472774.44"
"2025-03-22","2025-03-22","SF FuneralF817547       250322","","126.5","","472900.94"
"2025-03-22","2025-03-22","SF FuneralF817608       250322","","126.5","","473027.44"
"2025-03-22","2025-03-22","SF FuneralF819429       250322","","126.5","","473153.94"
"2025-03-22","2025-03-22","SF FuneralF819611       250322","","126.5","","473280.44"
"2025-03-22","2025-03-22","SF FuneralFDC0000000B6F9250322","","126.5","","473406.94"
"2025-03-22","2025-03-22","SF FuneralF820021       250322","","126.5","","473533.44"
"2025-03-22","2025-03-22","SF FuneralF822044       250322","","126.5","","473659.94"
"2025-03-22","2025-03-22","SF FuneralFDC0000000BFNN250322","","126.5","","473786.44"
"2025-03-22","2025-03-22","SF FuneralF819634       250322","","126.5","","473912.94"
"2025-03-22","2025-03-22","SF FuneralFDC0000000BHFW250322","","126.5","","474039.44"
"2025-03-22","2025-03-22","SF FuneralF823287       250322","","126.5","","474165.94"
"2025-03-22","2025-03-22","SF FuneralF823652       250322","","126.5","","474292.44"
"2025-03-22","2025-03-22","SF FuneralF1130777      250322","","126.5","","474418.94"
"2025-03-22","2025-03-22","SF FuneralFDC0000000Q46H250322","","126.5","","474545.44"
"2025-03-22","2025-03-22","SF FuneralF1131539      250322","","126.5","","474671.94"
"2025-03-22","2025-03-22","SF FuneralF1133208      250322","","126.5","","474798.44"
"2025-03-22","2025-03-22","SF FuneralF1133233      250322","","126.5","","474924.94"
"2025-03-22","2025-03-22","SF FuneralF1134734      250322","","126.5","","475051.44"
"2025-03-22","2025-03-22","SF FuneralFDC0000000QLG8250322","","126.5","","475177.94"
"2025-03-22","2025-03-22","SF FuneralFDC0000000QLJM250322","","126.5","","475304.44"
"2025-03-22","2025-03-17","SF FuneralF1060883      250317","","126.5","","475430.94"
"2025-03-22","2025-03-18","SF FuneralF1073139      250318","","63.25","","475494.19"
"2025-03-22","2025-03-18","SF FuneralF1128929      250318","","63.25","","475557.44"
"2025-03-22","2025-03-20","SF FuneralF981027       250321","","126.5","","475683.94"
"2025-03-22","2025-03-20","SF FuneralF1073750      250321","","126.5","","475810.44"
"2025-03-22","2025-03-22","SF FuneralF814303       250321","","31.63","","475842.07"
"2025-03-22","2025-03-22","SF FuneralFDC0000000B37Y250321","","31.63","","475873.7"
"2025-03-22","2025-03-22","SF FuneralF831922       250321","","31.63","","475905.33"
"2025-03-22","2025-03-22","SF FuneralFDC0000000D307250321","","31.63","","475936.96"
"2025-03-22","2025-03-22","SF FuneralF841714       250321","","31.63","","475968.59"
"2025-03-22","2025-03-22","SF FuneralFDC0000000KH3D250323","","31.63","","476000.22"
"2025-03-22","2025-03-22","SF FuneralFDC00000005LRG250322","","220","","476220.22"
"2025-03-22","2025-03-22","SF FuneralFDC00000005N68250322","","126.5","","476346.72"
"2025-03-22","2025-03-22","SF FuneralFDC00000005P39250322","","126.5","","476473.22"
"2025-03-22","2025-03-22","SF FuneralFDC00000005PKJ250322","","126.5","","476599.72"
"2025-03-22","2025-03-22","SF FuneralF1074728      250323","","126.5","","476726.22"
"2025-03-22","2025-03-22","SF FuneralF1078466      250322","","126.5","","476852.72"
"2025-03-22","2025-03-22","SF FuneralF1078643      250322","","126.5","","476979.22"
"2025-03-22","2025-03-18","SF FuneralFDC00000005P72250318","","63.25","","477042.47"
"2025-03-22","2025-03-18","SF FuneralF1078543      250318","","63.25","","477105.72"
"2025-03-22","2025-03-18","SF FuneralF1078560      250318","","63.25","","477168.97"
"2025-03-22","2025-03-20","SF FuneralFDC00000007K3D250320","","126.5","","477295.47"
"2025-03-22","2025-03-22","SF FuneralFDC00000002Q5G250322","","220","","477515.47"
"2025-03-22","2025-03-22","SF FuneralFDC00000004CPY250322","","220","","477735.47"
"2025-03-22","2025-03-22","SF FuneralFDC00000005ZP0250322","","126.5","","477861.97"
"2025-03-22","2025-03-22","SF FuneralFDC000000063Z0250322","","126.5","","477988.47"
"2025-03-22","2025-03-22","SF FuneralFDC0000000642B250322","","126.5","","478114.97"
"2025-03-22","2025-03-22","SF FuneralFDC00000006TZS250322","","126.5","","478241.47"
"2025-03-22","2025-03-22","SF FuneralFDC0000000628F250321","","31.63","","478273.1"
"2025-03-22","2025-03-22","SF FuneralFDC00000006XF8250322","","126.5","","478399.6"
"2025-03-22","2025-03-22","SF FuneralFDC00000007MWY250322","","126.5","","478526.1"
"2025-03-22","2025-03-22","SF FuneralFDC00000007TDT250322","","126.5","","478652.6"
"2025-03-22","2025-03-22","SF FuneralFDC00000008TWD250322","","126.5","","478779.1"
"2025-03-22","2025-03-22","SF FuneralF807999       250322","","126.5","","478905.6"
"2025-03-22","2025-03-22","SF FuneralF818868       250322","","126.5","","479032.1"
"2025-03-22","2025-03-22","SF FuneralF820022       250322","","126.5","","479158.6"
"2025-03-22","2025-03-22","SF FuneralF823397       250322","","126.5","","479285.1"
"2025-03-22","2025-03-22","SF FuneralF833055       250322","","126.5","","479411.6"
"2025-03-22","2025-03-22","SF FuneralFDC0000000D90L250322","","126.5","","479538.1"
"2025-03-22","2025-03-22","SF FuneralF1054957      250322","","126.5","","479664.6"
"2025-03-22","2025-03-22","SF FuneralF1084288      250322","","31.63","","479696.23"
"2025-03-22","2025-03-22","SF FuneralF1102955      250323","","126.5","","479822.73"
"2025-03-22","2025-03-22","SF FuneralF1115048      250322","","126.5","","479949.23"
"2025-03-22","2025-03-22","SF FuneralFDC0000000NYC4250322","","126.5","","480075.73"
"2025-03-22","2025-03-22","SF FuneralF1130544      250323","","126.5","","480202.23"
"2025-03-22","2025-03-22","SF FuneralFDC0000000Q29G250323","","126.5","","480328.73"
"2025-03-22","2025-03-22","SF FuneralFDC0000000QBPM250322","","256.5","","480585.23"
"2025-03-22","2025-03-22","SF FuneralF1135108      250322","","126.5","","480711.73"
"2025-03-22","2025-03-17","SF FuneralFDC00000006Q80250317","","31.63","","480743.36"
"2025-03-22","2025-03-17","SF FuneralF1133108      250317","","126.5","","480869.86"
"2025-03-22","2025-03-18","SF FuneralF831001       250318","","63.25","","480933.11"
"2025-03-22","2025-03-18","SF FuneralF1078281      250318","","63.25","","480996.36"
"2025-03-22","2025-03-18","SF FuneralF1122750      250318","","31.63","","481027.99"
"2025-03-22","2025-03-19","SF FuneralFDC0000000828X250319","","126.5","","481154.49"
"2025-03-22","2025-03-22","SF FuneralFDC000000063D4250322","","126.5","","481280.99"
"2025-03-22","2025-03-17","Rev SF FuneralFDC0000000KYZ5250317","","-31.63","","481249.36"
"2025-03-22","2025-03-18","Rev SF FuneralFDC00000005PFJ250318","","-31.63","","481217.73"
"2025-03-22","2025-03-17","Rev SF FuneralFDC0000000J1SX250317","","-126.5","","481091.23"
"2025-03-22","2025-03-19","Rev SF FuneralFDC00000008H3W250319","","-126.5","","480964.73"
"2025-03-22","2025-03-19","Rev SF FuneralFDC000000087TZ250319","","-126.5","","480838.23"
"2025-03-22","2025-03-19","Rev SF FuneralFDC000000087V0250319","","-126.5","","480711.73"
"2025-03-22","2025-03-18","Rev SF FuneralFDC0000000MK76250318","","-63.25","","480648.48"
"2025-03-22","2025-03-18","Rev SF FuneralFDC000000076ZR250318","","-126.5","","480521.98"
"2025-03-22","2025-03-17","Rev SF FuneralFDC00000008JTX250317","","-126.5","","480395.48"
"2025-03-22","2025-03-17","Rev SF FuneralFDC0000000KFF7250317","","-126.5","","480268.98"
"2025-03-22","2025-03-20","Rev SF FuneralFDC00000006NT7250320","","-220","","480048.98"
"2025-03-22","2025-03-12","Rev SF FuneralFDC0000000J28V250312","","-126.5","","479922.48"
"2025-03-22","2025-03-20","Rev SF FuneralFDC00000007CVM250320","","-126.5","","479795.98"
"2025-03-22","2025-03-20","Rev SF FuneralFDC000000060BM250320","","-126.5","","479669.48"
"2025-03-22","2025-03-11","Rev SF FuneralFDC00000007YZB250311","","-31.63","","479637.85"
"2025-03-22","2025-03-18","Rev SF FuneralFDC0000000NNP9250318","","-31.63","","479606.22"
"2025-03-22","2025-03-18","Rev SF FuneralFDC00000007YZB250318","","-31.63","","479574.59"
"2025-03-22","2025-03-20","Rev SF FuneralFDC00000005P8B250320","","-31.63","","479542.96"
"2025-03-22","2025-02-22","Rev SF FuneralFDC000000069RG250222","","-126.5","","479416.46"
"2025-03-22","2025-03-12","Rev SF FuneralFDC0000000PVD2250312","","-126.5","","479289.96"
"2025-03-22","2025-03-17","Rev SF FuneralFDC00000008CSD250317","","-126.5","","479163.46"
"2025-03-22","2025-03-17","Rev SF FuneralFDC00000008CSF250317","","-126.5","","479036.96"
"2025-03-22","2025-03-17","Rev SF FuneralFDC0000000Q7VH250317","","-126.5","","478910.46"
"2025-03-22","2025-03-17","Rev SF FuneralFDC0000000GWQQ250317","","-126.5","","478783.96"
"2025-03-22","2025-03-18","Rev SF FuneralFDC0000000BJ3M250318","","-63.25","","478720.71"
"2025-03-22","2025-03-20","Rev SF FuneralFDC0000000PXJV250320","","-126.5","","478594.21"
"2025-03-22","2025-03-20","Rev SF FuneralFDC0000000HRQH250322","","-126.5","","478467.71"
"2025-03-22","2025-03-22","Rev SF FuneralFDC00000006MQC250322","","-126.5","","478341.21"
"2025-03-22","2025-03-22","Rev SF FuneralFDC00000008FRT250321","","-126.5","","478214.71"
"2025-03-22","2025-03-17","SF FuneralFDC000000061DH250317","","126.5","","478341.21"
"2025-03-22","2025-03-17","SF FuneralF1116789      250317","","63.25","","478404.46"
"2025-03-22","2025-03-18","SF FuneralF822427       250318","","31.63","","478436.09"
"2025-03-22","2025-03-18","SF FuneralF992943       250318","","63.25","","478499.34"
"2025-03-22","2025-03-18","SF FuneralF1060963      250318","","63.25","","478562.59"
"2025-03-22","2025-03-18","SF FuneralF1078491      250318","","63.25","","478625.84"
"2025-03-22","2025-03-18","SF FuneralF1102942      250318","","31.63","","478657.47"
"2025-03-22","2025-03-18","SF FuneralFDC0000000ML5T250318","","63.25","","478720.72"
"2025-03-22","2025-03-18","SF FuneralF1127395      250318","","63.25","","478783.97"
"2025-03-22","2025-03-18","SF FuneralF1128976      250318","","63.25","","478847.22"
"2025-03-22","2025-03-19","SF FuneralF840927       250319","","63.25","","478910.47"
"2025-03-22","2025-03-19","SF FuneralF842872       250319","","31.63","","478942.1"
"2025-03-22","2025-03-19","SF FuneralF844042       250319","","31.63","","478973.73"
"2025-03-22","2025-03-19","SF FuneralFDC0000000PSR9250319","","126.5","","479100.23"
"2025-03-22","2025-03-20","SF FuneralFDC000000078FQ250320","","126.5","","479226.73"
"2025-03-22","2025-03-20","SF FuneralFDC0000000807N250320","","126.5","","479353.23"
"2025-03-22","2025-03-20","SF FuneralFDC0000000HYF4250322","","126.5","","479479.73"
"2025-03-22","2025-03-20","SF FuneralF990295       250322","","63.25","","479542.98"
"2025-03-22","2025-03-20","SF FuneralFDC0000000J2Y1250322","","31.63","","479574.61"
"2025-03-22","2025-03-20","SF FuneralF1068059      250321","","126.5","","479701.11"
"2025-03-22","2025-03-22","SF FuneralFDC00000003BYY250322","","220","","479921.11"
"2025-03-22","2025-03-22","SF FuneralFDC00000005FXR250322","","63.25","","479984.36"
"2025-03-22","2025-03-22","SF FuneralFDC000000060BP250322","","126.5","","480110.86"
"2025-03-22","2025-03-22","SF FuneralFDC000000062VN250322","","126.5","","480237.36"
"2025-03-22","2025-03-22","SF FuneralFDC0000000637Y250322","","126.5","","480363.86"
"2025-03-22","2025-03-22","SF FuneralFDC00000006H2X250322","","126.5","","480490.36"
"2025-03-22","2025-03-22","SF FuneralFDC00000006H8M250322","","126.5","","480616.86"
"2025-03-22","2025-03-22","SF FuneralFDC00000006T7F250322","","126.5","","480743.36"
"2025-03-22","2025-03-22","SF FuneralFDC00000007CWY250322","","126.5","","480869.86"
"2025-03-22","2025-03-22","SF FuneralFDC000000080LJ250321","","126.5","","480996.36"
"2025-03-22","2025-03-22","SF FuneralFDC000000081SC250322","","126.5","","481122.86"
"2025-03-22","2025-03-22","SF FuneralFDC000000085TB250322","","126.5","","481249.36"
"2025-03-22","2025-03-22","SF FuneralF822623       250322","","126.5","","481375.86"
"2025-03-22","2025-03-22","SF FuneralFDC0000000D8C4250321","","126.5","","481502.36"
"2025-03-22","2025-03-22","SF FuneralF841829       250322","","126.5","","481628.86"
"2025-03-22","2025-03-22","SF FuneralF1110552      250322","","126.5","","481755.36"
"2025-03-22","2025-03-22","SF FuneralF1115901      250322","","126.5","","481881.86"
"2025-03-22","2025-03-22","SF FuneralF1115905      250322","","126.5","","482008.36"
"2025-03-22","2025-03-20","SF FuneralF981215       250322","","126.5","","482134.86"
"2025-03-22","2025-03-20","SF FuneralFDC0000000J4YX250323","","126.5","","482261.36"
"2025-03-22","2025-03-22","SF FuneralFDC00000006T7D250322","","126.5","","482387.86"
"2025-03-22","2025-03-22","SF FuneralFDC00000006Z4M250322","","126.5","","482514.36"
"2025-03-22","2025-03-22","SF FuneralFDC00000006Z4R250322","","126.5","","482640.86"
"2025-03-22","2025-03-22","SF FuneralFDC00000007TZN250322","","126.5","","482767.36"
"2025-03-22","2025-03-22","SF FuneralFDC000000089HJ250322","","126.5","","482893.86"
"2025-03-22","2025-03-22","SF FuneralF801333       250322","","126.5","","483020.36"
"2025-03-22","2025-03-22","SF FuneralFDC00000008HJY250322","","126.5","","483146.86"
"2025-03-22","2025-03-22","SF FuneralF778086       250322","","191.5","","483338.36"
"2025-03-22","2025-03-22","SF FuneralFDC0000000LNMK250322","","126.5","","483464.86"
"2025-03-22","2025-03-22","SF FuneralF1080376      250322","","126.5","","483591.36"
"2025-03-22","2025-03-22","SF FuneralF1083938      250322","","126.5","","483717.86"
"2025-03-22","2025-03-22","SF FuneralF1085063      250322","","126.5","","483844.36"
"2025-03-22","2025-03-22","SF FuneralF1107999      250322","","126.5","","483970.86"
"2025-03-22","2025-03-22","SF FuneralF1108104      250322","","126.5","","484097.36"
"2025-03-22","2025-03-22","SF FuneralF1108154      250323","","126.5","","484223.86"
"2025-03-22","2025-03-22","SF FuneralFDC0000000MGMY250322","","126.5","","484350.36"
"2025-03-22","2025-03-22","SF FuneralF1123070      250323","","126.5","","484476.86"
"2025-03-22","2025-03-22","SF FuneralF1112430      250322","","126.5","","484603.36"
"2025-03-22","2025-03-22","Rev SF FuneralFDC00000007CX0250322","","-126.5","","484476.86"
"2025-03-22","2025-03-22","Rev SF FuneralFDC00000007F8P250322","","-126.5","","484350.36"
"2025-03-22","2025-03-22","Rev SF FuneralFDC0000000J80P250322","","-126.5","","484223.86"
"2025-03-22","2025-03-22","Rev SF FuneralFDC0000000D8C4250321","","-126.5","","484097.36"
"2025-03-22","2025-03-22","Rev SF FuneralFDC00000006T7F250322","","-126.5","","483970.86"
"2025-03-22","2025-03-22","Rev SF FuneralFDC00000007TZN250322","","-126.5","","483844.36"
"2025-03-22","2025-03-22","Rev SF FuneralFDC00000007TZQ250322","","-126.5","","483717.86"
"2025-03-22","2025-03-22","Rev SF FuneralFDC00000007D4Y250322","","-126.5","","483591.36"
"2025-03-22","2025-03-22","Rev SF FuneralFDC00000005FXR250322","","-63.25","","483528.11"
"2025-03-22","2025-03-22","Rev SF FuneralFDC0000000757K250322","","-126.5","","483401.61"
"2025-03-22","2025-03-22","Rev SF FuneralFDC0000000757M250322","","-126.5","","483275.11"
"2025-03-22","2025-03-22","Rev SF FuneralFDC00000005S4B250322","","-126.5","","483148.61"
"2025-03-22","2025-03-22","Rev SF FuneralFDC00000005SB0250322","","-126.5","","483022.11"
"2025-03-22","2025-03-22","Rev SF FuneralFDC00000006T7D250322","","-126.5","","482895.61"
"2025-03-22","2025-03-22","Rev SF FuneralFDC00000005YBL250321","","-126.5","","482769.11"
"2025-03-22","2025-03-22","Rev SF FuneralFDC00000007CWY250322","","-126.5","","482642.61"
"2025-03-22","2025-03-22","Rev SF FuneralFDC00000006BCV250322","","-126.5","","482516.11"
"2025-03-22","2025-03-22","Rev SF FuneralFDC0000000LB4G250322","","-126.5","","482389.61"
"2025-03-22","2025-03-18","Rev SF FuneralFDC00000005XGZ250318","","-126.5","","482263.11"
"2025-03-22","2025-03-22","Rev SF FuneralFDC0000000BHFW250322","","-126.5","","482136.61"
"2025-03-22","2025-03-22","Rev SF FuneralFDC0000000NGN1250323","","-126.5","","482010.11"
"2025-03-22","2025-03-22","Rev SF FuneralFDC0000000MLZ8250323","","-126.5","","481883.61"
"2025-03-22","2025-03-22","Rev SF FuneralFDC00000007CWZ250322","","-126.5","","481757.11"
"2025-03-22","2025-03-20","Rev SF FuneralFDC0000000J4YX250323","","-126.5","","481630.61"
"2025-03-22","2025-03-20","Rev SF FuneralFDC0000000QFBX250320","","-126.5","","481504.11"
"2025-03-22","2025-03-20","Rev SF FuneralFDC0000000807N250320","","-126.5","","481377.61"
"2025-03-22","2025-03-14","Rev SF FuneralFDC0000000B37Y250314","","-31.63","","481345.98"
"2025-03-22","2025-03-18","SF FuneralFDC0000000HN9N250318","","31.63","","481377.61"
"2025-03-22","2025-03-20","SF FuneralF1079205      250321","","126.5","","481504.11"
"2025-03-22","2025-03-22","SF FuneralFDC000000063FL250322","","126.5","","481630.61"
"2025-03-22","2025-03-22","SF FuneralFDC00000006H3V250322","","126.5","","481757.11"
"2025-03-22","2025-03-22","SF FuneralFDC00000008337250322","","126.5","","481883.61"
"2025-03-22","2025-03-22","SF FuneralF802341       250322","","126.5","","482010.11"
"2025-03-22","2025-03-22","SF FuneralF816124       250322","","126.5","","482136.61"
"2025-03-22","2025-03-22","SF FuneralF842128       250322","","126.5","","482263.11"
"2025-03-22","2025-03-22","SF FuneralF1052177      250322","","126.5","","482389.61"
"2025-03-22","2025-03-22","SF FuneralF1054490      250322","","126.5","","482516.11"
"2025-03-22","2025-03-22","SF FuneralF1066408      250322","","126.5","","482642.61"
"2025-03-22","2025-03-22","SF FuneralF1080489      250322","","126.5","","482769.11"
"2025-03-22","2025-03-22","SF FuneralF1113796      250323","","126.5","","482895.61"
"2025-03-22","2025-03-22","SF FuneralF1116728      250322","","126.5","","483022.11"
"2025-03-22","2025-03-22","SF FuneralFDC0000000NQZN250322","","126.5","","483148.61"
"2025-03-22","2025-03-22","SF FuneralF1120935      250322","","126.5","","483275.11"
"2025-03-22","2025-03-22","SF FuneralF1127435      250322","","126.5","","483401.61"
"2025-03-22","2025-03-16","SF FuneralF819229       250316","","31.63","","483433.24"
"2025-03-22","2025-03-22","SF FuneralF1119009      250322","","126.5","","483559.74"
"2025-03-22","2025-03-18","SF FuneralFDC0000000788B250318","","31.63","","483591.37"
"2025-03-22","2025-03-18","SF FuneralF1074952      250318","","126.5","","483717.87"
"2025-03-22","2025-03-18","SF FuneralF820999       250318","","31.63","","483749.5"
"2025-03-22","2025-03-22","SF FuneralFDC00000006208250322","","220","","483969.5"
"2025-03-22","2025-03-22","SF FuneralF1078520      250322","","126.5","","484096"
"2025-03-22","2025-03-22","SF FuneralF1120188      250322","","256.5","","484352.5"
"2025-03-22","2025-03-22","SF FuneralF1120609      250322","","126.5","","484479"
"2025-03-22","2025-03-17","SF FuneralFDC0000000FNVP250317","","126.5","","484605.5"
"2025-03-22","2025-03-22","SF FuneralFDC0000000691X250322","","126.5","","484732"
"2025-03-22","2025-03-22","SF FuneralFDC00000006WH3250322","","126.5","","484858.5"
"2025-03-22","2025-03-22","SF FuneralF786544       250322","","126.5","","484985"
"2025-03-22","2025-03-22","SF FuneralFDC0000000826X250322","","126.5","","485111.5"
"2025-03-22","2025-03-22","SF FuneralF831176       250322","","126.5","","485238"
"2025-03-22","2025-03-17","Rev SF FuneralFDC0000000HKWY250317","","-126.5","","485111.5"
"2025-03-22","2025-03-18","SF FuneralFDC0000000N7JJ250318","","63.25","","485174.75"
