"Txn date","Effective","Description","Truncated card number","Amount","Charges","Balance"
"2025-02-12","2025-02-10","SF FuneralFDC00000006X3B250209","","126.5","","137359.79"
"2025-02-12","2025-02-04","SF FuneralFDC00000007F8K250204","","63.25","","137423.04"
"2025-02-12","2025-02-08","SF FuneralF1072684      250208","","31.63","","137454.67"
"2025-02-12","2025-02-11","SF FuneralFDC000000051KX250211","","31.63","","137486.3"
"2025-02-12","2025-02-08","SF FuneralFDC00000009MWX250208","","63.25","","137549.55"
"2025-02-12","2025-02-10","SF FuneralFDC00000005XG9250210","","31.63","","137581.18"
"2025-02-12","2025-02-11","SF FuneralF980415       250211","","31.63","","137612.81"
"2025-02-12","2025-02-08","SF FuneralFDC00000005XNC250208","","31.63","","137644.44"
"2025-02-12","2025-02-08","SF FuneralF1127843      250208","","31.63","","137676.07"
"2025-02-12","2025-02-08","SF FuneralF1130776      250208","","31.63","","137707.7"
"2025-02-12","2025-02-10","SF FuneralFDC00000006876250210","","126.5","","137834.2"
"2025-02-12","2025-02-10","SF FuneralFDC000000080YP250209","","63.25","","137897.45"
"2025-02-12","2025-02-10","SF FuneralF1072930      250210","","31.63","","137929.08"
"2025-02-12","2025-02-10","SF FuneralF1123098      250210","","31.63","","137960.71"
"2025-02-12","2025-02-11","SF FuneralFDC00000006MXW250211","","63.25","","138023.96"
"2025-02-12","2025-02-11","SF FuneralF833557       250211","","63.25","","138087.21"
"2025-02-12","2025-02-11","SF FuneralF1080249      250211","","31.63","","138118.84"
"2025-02-12","2025-02-10","SF FuneralF834627       250209","","31.63","","138150.47"
"2025-02-12","2025-02-10","SF FuneralFDC0000000M9K6250210","","63.25","","138213.72"
"2025-02-12","2025-02-12","SF FuneralFDC00000005JGX250212","","126.5","","138340.22"
"2025-02-12","2025-02-12","SF FuneralFDC000000061FJ250212","","126.5","","138466.72"
"2025-02-12","2025-02-12","SF FuneralFDC000000061FK250212","","126.5","","138593.22"
"2025-02-12","2025-02-12","SF FuneralFDC00000006LX0250212","","126.5","","138719.72"
"2025-02-12","2025-02-12","SF FuneralFDC00000006YNY250212","","126.5","","138846.22"
"2025-02-12","2025-02-12","SF FuneralFDC000000089MZ250212","","126.5","","138972.72"
"2025-02-12","2025-02-12","SF FuneralF803533       250212","","126.5","","139099.22"
"2025-02-12","2025-02-12","SF FuneralF808125       250212","","126.5","","139225.72"
"2025-02-12","2025-02-12","SF FuneralF822014       250212","","126.5","","139352.22"
"2025-02-12","2025-02-12","SF FuneralF794742       250212","","126.5","","139478.72"
"2025-02-12","2025-02-12","SF FuneralF830097       250212","","126.5","","139605.22"
"2025-02-12","2025-02-12","SF FuneralFDC0000000CNBM250212","","126.5","","139731.72"
"2025-02-12","2025-02-12","SF FuneralF1050832      250212","","126.5","","139858.22"
"2025-02-12","2025-02-12","SF FuneralF1116979      250212","","126.5","","139984.72"
"2025-02-12","2025-02-12","SF FuneralF1123465      250212","","126.5","","140111.22"
"2025-02-12","2025-02-12","SF FuneralFDC0000000PL6G250212","","126.5","","140237.72"
"2025-02-12","2025-02-12","SF FuneralFDC0000000PL6M250212","","126.5","","140364.22"
"2025-02-12","2025-02-12","SF FuneralF1130480      250212","","126.5","","140490.72"
"2025-02-12","2025-02-12","SF FuneralFDC00000005K1B250212","","126.5","","140617.22"
"2025-02-12","2025-02-12","SF FuneralFDC00000005K9B250212","","126.5","","140743.72"
"2025-02-12","2025-02-12","SF FuneralFDC00000005N53250212","","126.5","","140870.22"
"2025-02-12","2025-02-12","SF FuneralFDC0000000635T250212","","126.5","","140996.72"
"2025-02-12","2025-02-12","SF FuneralFDC0000000645D250212","","126.5","","141123.22"
"2025-02-12","2025-02-12","SF FuneralFDC00000007M3B250212","","126.5","","141249.72"
"2025-02-12","2025-02-12","SF FuneralFDC00000007MDX250212","","126.5","","141376.22"
"2025-02-12","2025-02-12","SF FuneralFDC00000007MDY250212","","126.5","","141502.72"
"2025-02-12","2025-02-12","SF FuneralFDC00000007N3L250212","","126.5","","141629.22"
"2025-02-12","2025-02-12","SF FuneralF808156       250212","","126.5","","141755.72"
"2025-02-12","2025-02-12","SF FuneralF810891       250212","","126.5","","141882.22"
"2025-02-12","2025-02-12","SF FuneralF819057       250212","","126.5","","142008.72"
"2025-02-12","2025-02-12","SF FuneralF821224       250212","","126.5","","142135.22"
"2025-02-12","2025-02-12","SF FuneralF829893       250212","","126.5","","142261.72"
"2025-02-12","2025-02-12","SF FuneralF1017041      250212","","126.5","","142388.22"
"2025-02-12","2025-02-11","SF FuneralF1054998      250211","","63.25","","142451.47"
"2025-02-12","2025-02-12","SF FuneralFDC00000005HS0250212","","126.5","","142577.97"
"2025-02-12","2025-02-12","SF FuneralFDC00000005LH2250212","","126.5","","142704.47"
"2025-02-12","2025-02-12","SF FuneralFDC00000005LN8250212","","191.5","","142895.97"
"2025-02-12","2025-02-12","SF FuneralFDC00000005LQK250212","","126.5","","143022.47"
"2025-02-12","2025-02-12","SF FuneralFDC00000005LYY250212","","126.5","","143148.97"
"2025-02-12","2025-02-12","SF FuneralFDC00000005QPS250212","","126.5","","143275.47"
"2025-02-12","2025-02-12","SF FuneralFDC00000006S1V250212","","126.5","","143401.97"
"2025-02-12","2025-02-12","SF FuneralFDC00000006TNT250212","","126.5","","143528.47"
"2025-02-12","2025-02-12","SF FuneralF800591       250212","","126.5","","143654.97"
"2025-02-12","2025-02-12","SF FuneralFDC00000008Q6Q250212","","126.5","","143781.47"
"2025-02-12","2025-02-12","SF FuneralF818343       250212","","126.5","","143907.97"
"2025-02-12","2025-02-12","SF FuneralF820222       250212","","126.5","","144034.47"
"2025-02-12","2025-02-12","SF FuneralF989253       250212","","126.5","","144160.97"
"2025-02-12","2025-02-12","SF FuneralF989251       250212","","126.5","","144287.47"
"2025-02-12","2025-02-12","SF FuneralF989834       250212","","126.5","","144413.97"
"2025-02-12","2025-02-12","SF FuneralF990460       250212","","126.5","","144540.47"
"2025-02-12","2025-02-12","SF FuneralFDC0000000J28D250212","","126.5","","144666.97"
"2025-02-12","2025-02-12","SF FuneralF1016830      250212","","126.5","","144793.47"
"2025-02-12","2025-02-12","SF FuneralF1020450      250212","","126.5","","144919.97"
"2025-02-12","2025-02-12","SF FuneralF1054697      250212","","126.5","","145046.47"
"2025-02-12","2025-02-12","SF FuneralF1073408      250212","","126.5","","145172.97"
"2025-02-12","2025-02-12","SF FuneralF1080305      250212","","126.5","","145299.47"
"2025-02-12","2025-02-12","SF FuneralFDC0000000NFB5250212","","126.5","","145425.97"
"2025-02-12","2025-02-12","SF FuneralF1124154      250212","","126.5","","145552.47"
"2025-02-12","2025-02-12","SF FuneralFDC0000000P9J0250212","","126.5","","145678.97"
"2025-02-12","2025-02-12","SF FuneralFDC0000000P9J5250212","","126.5","","145805.47"
"2025-02-12","2025-02-12","SF FuneralFDC0000000PL6F250212","","126.5","","145931.97"
"2025-02-12","2025-02-12","SF FuneralF1129277      250212","","126.5","","146058.47"
"2025-02-12","2025-02-12","SF FuneralFDC0000000PZXJ250212","","126.5","","146184.97"
"2025-02-12","2025-02-12","SF FuneralFDC000000037DQ250212","","220","","146404.97"
"2025-02-12","2025-02-12","SF FuneralFDC00000005M50250212","","126.5","","146531.47"
"2025-02-12","2025-02-12","SF FuneralFDC00000005Z5K250212","","126.5","","146657.97"
"2025-02-12","2025-02-12","SF FuneralFDC00000006ND7250212","","126.5","","146784.47"
"2025-02-12","2025-02-12","SF FuneralFDC00000006S1F250212","","126.5","","146910.97"
"2025-02-12","2025-02-12","SF FuneralFDC00000006Y42250212","","126.5","","147037.47"
"2025-02-12","2025-02-12","SF FuneralFDC00000007XCB250212","","126.5","","147163.97"
"2025-02-12","2025-02-12","SF FuneralF786101       250212","","126.5","","147290.47"
"2025-02-12","2025-02-12","SF FuneralF814043       250212","","126.5","","147416.97"
"2025-02-12","2025-02-12","SF FuneralFDC0000000B1VV250212","","126.5","","147543.47"
"2025-02-12","2025-02-12","SF FuneralFDC0000000BG87250212","","126.5","","147669.97"
"2025-02-12","2025-02-12","SF FuneralF1079283      250212","","126.5","","147796.47"
"2025-02-12","2025-02-12","SF FuneralFDC0000000LLW8250212","","126.5","","147922.97"
"2025-02-12","2025-02-12","SF FuneralF1083739      250212","","126.5","","148049.47"
"2025-02-12","2025-02-12","SF FuneralF1124999      250212","","126.5","","148175.97"
"2025-02-12","2025-02-11","SF FuneralFDC000000061NF250211","","31.63","","148207.6"
"2025-02-12","2025-02-08","SF FuneralF1074785      250208","","31.63","","148239.23"
"2025-02-12","2025-02-12","SF FuneralFDC0000000618X250212","","126.5","","148365.73"
"2025-02-12","2025-02-12","SF FuneralFDC0000000619C250212","","126.5","","148492.23"
"2025-02-12","2025-02-12","SF FuneralFDC000000082HL250212","","126.5","","148618.73"
"2025-02-12","2025-02-12","SF FuneralFDC0000000JJ24250212","","126.5","","148745.23"
"2025-02-12","2025-02-12","SF FuneralF1103802      250212","","126.5","","148871.73"
"2025-02-12","2025-02-12","SF FuneralF1129285      250212","","126.5","","148998.23"
"2025-02-12","2025-02-12","SF FuneralFDC00000005HNS250212","","126.5","","149124.73"
"2025-02-12","2025-02-12","SF FuneralFDC00000005HTM250212","","126.5","","149251.23"
"2025-02-12","2025-02-12","SF FuneralFDC00000005KYY250212","","126.5","","149377.73"
"2025-02-12","2025-02-12","SF FuneralFDC00000005Q8W250212","","126.5","","149504.23"
"2025-02-12","2025-02-12","SF FuneralFDC00000005ZJ4250212","","126.5","","149630.73"
"2025-02-12","2025-02-12","SF FuneralFDC00000007YXC250212","","126.5","","149757.23"
"2025-02-12","2025-02-12","SF FuneralF797631       250212","","126.5","","149883.73"
"2025-02-12","2025-02-12","SF FuneralFDC00000008K4Q250212","","126.5","","150010.23"
"2025-02-12","2025-02-12","SF FuneralF1103752      250212","","126.5","","150136.73"
"2025-02-12","2025-02-12","SF FuneralFDC0000000N9YT250212","","126.5","","150263.23"
"2025-02-12","2025-02-12","SF FuneralF1118937      250212","","126.5","","150389.73"
"2025-02-12","2025-02-12","SF FuneralFDC0000000PBZ3250212","","126.5","","150516.23"
"2025-02-12","2025-02-11","SF FuneralF815108       250211","","63.25","","150579.48"
"2025-02-12","2025-02-11","SF FuneralF1116012      250211","","126.5","","150705.98"
"2025-02-12","2025-02-12","SF FuneralFDC00000005HWH250212","","126.5","","150832.48"
"2025-02-12","2025-02-12","SF FuneralFDC00000005J17250212","","126.5","","150958.98"
"2025-02-12","2025-02-12","SF FuneralFDC00000005M5H250212","","220","","151178.98"
"2025-02-12","2025-02-12","SF FuneralFDC00000005N3Y250212","","126.5","","151305.48"
"2025-02-12","2025-02-12","SF FuneralFDC00000005P1G250212","","126.5","","151431.98"
"2025-02-12","2025-02-12","SF FuneralFDC00000005V14250212","","126.5","","151558.48"
"2025-02-12","2025-02-12","SF FuneralF795038       250212","","126.5","","151684.98"
"2025-02-12","2025-02-12","SF FuneralF819111       250212","","31.63","","151716.61"
"2025-02-12","2025-02-12","SF FuneralF1060977      250212","","126.5","","151843.11"
"2025-02-12","2025-02-12","SF FuneralF1080364      250212","","126.5","","151969.61"
"2025-02-12","2025-02-12","SF FuneralF1103739      250212","","126.5","","152096.11"
"2025-02-12","2025-02-10","Rev SF FuneralFDC00000005XG9250210","","-31.63","","152064.48"
"2025-02-12","2025-02-10","Rev SF FuneralFDC00000008JY9250210","","-63.25","","152001.23"
"2025-02-12","2025-01-24","Rev SF FuneralFDC0000000B6FR250128","","-126.5","","151874.73"
"2025-02-12","2025-02-10","Rev SF FuneralFDC00000008JYB250210","","-63.25","","151811.48"
"2025-02-12","2025-02-03","SF FuneralFDC00000006NPV250202","","110","","151921.48"
"2025-02-12","2025-02-10","SF FuneralF834044       250210","","31.63","","151953.11"
"2025-02-12","2025-02-10","SF FuneralF1084856      250210","","31.63","","151984.74"
"2025-02-12","2025-02-12","SF FuneralFDC00000005QG0250212","","126.5","","152111.24"
"2025-02-12","2025-02-12","SF FuneralFDC00000005Z74250212","","126.5","","152237.74"
"2025-02-12","2025-02-12","SF FuneralF810506       250212","","126.5","","152364.24"
"2025-02-12","2025-02-12","SF FuneralF830116       250212","","126.5","","152490.74"
"2025-02-12","2025-02-12","SF FuneralF1120754      250212","","31.63","","152522.37"
"2025-02-12","2025-02-10","SF FuneralFDC000000042HH250209","","55","","152577.37"
"2025-02-12","2025-02-10","SF FuneralFDC00000005LX1250209","","63.25","","152640.62"
"2025-02-12","2025-02-10","SF FuneralFDC00000006XRW250209","","63.25","","152703.87"
"2025-02-12","2025-02-12","SF FuneralF804754       250212","","126.5","","152830.37"
"2025-02-12","2025-02-12","SF FuneralF1114717      250212","","126.5","","152956.87"
"2025-02-12","2025-02-12","SF FuneralF796065       250212","","126.5","","153083.37"
"2025-02-12","2025-02-12","SF FuneralF1126093      250212","","126.5","","153209.87"
"2025-02-12","2025-02-07","SF FuneralF1085052      250207","","63.25","","153273.12"
"2025-02-12","2025-02-12","SF FuneralFDC000000060PJ250212","","126.5","","153399.62"
"2025-02-12","2025-02-12","SF FuneralFDC00000006PPH250212","","126.5","","153526.12"
"2025-02-12","2025-02-12","SF FuneralFDC00000006VDK250212","","126.5","","153652.62"
"2025-02-12","2025-02-12","SF FuneralF811783       250212","","126.5","","153779.12"
"2025-02-12","2025-02-12","SF FuneralF844044       250212","","31.63","","153810.75"
"2025-02-12","2025-02-12","SF FuneralF1079563      250212","","126.5","","153937.25"
"2025-02-12","2025-02-12","SF FuneralF1079724      250212","","126.5","","154063.75"
"2025-02-12","2025-02-12","SF FuneralF1074876      250212","","126.5","","154190.25"
"2025-02-12","2025-02-12","SF FuneralFDC0000000KKBT250212","","95.75","","154286"
"2025-02-12","2025-02-08","SF FuneralF1129917      250209","","31.63","","154317.63"
"2025-02-12","2025-02-11","SF FuneralFDC000000061YD250211","","31.63","","154349.26"
"2025-02-12","2025-02-12","SF FuneralFDC00000008NF0250212","","126.5","","154475.76"
"2025-02-12","2025-02-04","SF FuneralF1074627      250204","","126.5","","154602.26"
"2025-02-12","2025-02-08","SF FuneralF784736       250208","","31.63","","154633.89"
"2025-02-12","2025-02-08","SF FuneralF1108038      250208","","126.5","","154760.39"
"2025-02-12","2025-02-10","SF FuneralFDC00000005RZQ250210","","31.63","","154792.02"
"2025-02-12","2025-02-10","SF FuneralFDC00000009G6B250209","","31.63","","154823.65"
"2025-02-12","2025-02-10","SF FuneralFDC00000009XWR250209","","31.63","","154855.28"
"2025-02-12","2025-02-10","SF FuneralF832990       250209","","31.63","","154886.91"
"2025-02-12","2025-02-11","SF FuneralF828353       250211","","126.5","","155013.41"
"2025-02-12","2025-02-11","SF FuneralF993633       250211","","31.63","","155045.04"
"2025-02-12","2025-02-11","SF FuneralF1130942      250211","","31.63","","155076.67"
"2025-02-12","2025-02-12","SF FuneralF831727       250212","","126.5","","155203.17"
"2025-02-12","2025-02-12","SF FuneralFDC0000000KJYJ250212","","126.5","","155329.67"
"2025-02-12","2025-02-12","SF FuneralF1083800      250212","","126.5","","155456.17"
"2025-02-12","2025-02-12","SF FuneralF1123156      250212","","126.5","","155582.67"
"2025-02-12","2025-02-12","SF FuneralF793566       250212","","126.5","","155709.17"
"2025-02-12","2025-02-12","Rev SF FuneralFDC00000006YNY250212","","-126.5","","155582.67"
"2025-02-12","2025-02-12","Rev SF FuneralFDC0000000CNBM250212","","-126.5","","155456.17"
"2025-02-12","2025-02-03","Rev SF FuneralFDC0000000NQ7P250203","","-126.5","","155329.67"
"2025-02-12","2025-02-12","Rev SF FuneralFDC0000000P9J5250212","","-126.5","","155203.17"
"2025-02-12","2025-02-12","Rev SF FuneralFDC00000005K9B250212","","-126.5","","155076.67"
"2025-02-12","2025-02-12","Rev SF FuneralFDC000000061FJ250212","","-126.5","","154950.17"
"2025-02-12","2025-02-12","Rev SF FuneralFDC000000061FK250212","","-126.5","","154823.67"
"2025-02-12","2025-02-12","Rev SF FuneralFDC00000005Z74250212","","-126.5","","154697.17"
"2025-02-12","2025-02-12","Rev SF FuneralFDC0000000P9J0250212","","-126.5","","154570.67"
"2025-02-12","2025-02-01","Rev SF FuneralFDC0000000PHJK250201","","-126.5","","154444.17"
"2025-02-12","2024-12-31","Rev SF FuneralFDC0000000PHJK250101","","-126.5","","154317.67"
"2025-02-12","2024-12-11","Rev SF FuneralF1119775      241228","","-126.5","","154191.17"
"2025-02-12","2025-01-24","Rev SF FuneralF1119775      250128","","-126.5","","154064.67"
"2025-02-12","2025-02-03","SF FuneralFDC00000006MWP250202","","63.25","","154127.92"
"2025-02-12","2025-02-12","SF FuneralFDC00000007Z8Z250212","","126.5","","154254.42"
"2025-02-12","2025-02-12","SF FuneralF990573       250212","","126.5","","154380.92"
"2025-02-12","2025-02-12","SF FuneralF1123300      250212","","126.5","","154507.42"
"2025-02-12","2025-02-08","SF FuneralFDC0000000JY24250209","","31.63","","154539.05"
"2025-02-12","2025-02-10","SF FuneralFDC00000005NKJ250210","","31.63","","154570.68"
"2025-02-13","2025-02-11","SF FuneralFDC00000007LG1250211","","31.63","","154602.31"
"2025-02-13","2025-02-11","SF FuneralF818153       250211","","31.63","","154633.94"
"2025-02-13","2025-02-11","SF FuneralF1125777      250211","","31.63","","154665.57"
"2025-02-13","2025-02-10","SF FuneralFDC00000004CSK250210","","55","","154720.57"
"2025-02-13","2025-02-10","SF FuneralFDC00000004CSL250210","","55","","154775.57"
"2025-02-13","2025-02-10","SF FuneralFDC00000005LWP250209","","31.63","","154807.2"
"2025-02-13","2025-02-10","SF FuneralF812202       250210","","31.63","","154838.83"
"2025-02-13","2025-02-10","SF FuneralF820956       250209","","31.63","","154870.46"
"2025-02-13","2025-02-10","SF FuneralFDC0000000CWBD250209","","31.63","","154902.09"
"2025-02-13","2025-02-04","SF FuneralFDC00000007VX8250204","","126.5","","155028.59"
"2025-02-13","2025-02-07","SF FuneralF981670       250207","","31.63","","155060.22"
"2025-02-13","2025-02-07","SF FuneralF989273       250209","","31.63","","155091.85"
"2025-02-13","2025-02-08","SF FuneralF994082       250209","","126.5","","155218.35"
"2025-02-13","2025-02-08","SF FuneralFDC0000000JW2F250209","","126.5","","155344.85"
"2025-02-13","2025-02-08","SF FuneralF1021571      250209","","126.5","","155471.35"
"2025-02-13","2025-02-08","SF FuneralF1054722      250209","","63.25","","155534.6"
"2025-02-13","2025-02-08","SF FuneralF1122295      250209","","31.63","","155566.23"
"2025-02-13","2025-02-10","SF FuneralFDC00000005LS9250210","","31.63","","155597.86"
"2025-02-13","2025-02-10","SF FuneralFDC00000005RW6250209","","220","","155817.86"
"2025-02-13","2025-02-10","SF FuneralFDC00000005YNL250210","","55","","155872.86"
"2025-02-13","2025-02-10","SF FuneralFDC00000005YW3250210","","31.63","","155904.49"
"2025-02-13","2025-02-10","SF FuneralFDC00000007BGG250209","","31.63","","155936.12"
"2025-02-13","2025-02-10","SF FuneralFDC000000087G6250209","","31.63","","155967.75"
"2025-02-13","2025-02-10","SF FuneralF805304       250209","","126.5","","156094.25"
"2025-02-13","2025-02-10","SF FuneralF744001       250209","","220","","156314.25"
"2025-02-13","2025-02-10","SF FuneralF819012       250210","","31.63","","156345.88"
"2025-02-13","2025-02-10","SF FuneralF1073374      250210","","31.63","","156377.51"
"2025-02-13","2025-02-10","SF FuneralF1118416      250210","","31.63","","156409.14"
"2025-02-13","2025-02-11","SF FuneralFDC00000005V84250211","","126.5","","156535.64"
"2025-02-13","2025-02-11","SF FuneralFDC00000005YYS250211","","31.63","","156567.27"
"2025-02-13","2025-02-11","SF FuneralF1016763      250211","","126.5","","156693.77"
"2025-02-13","2025-02-11","SF FuneralF1129391      250211","","126.5","","156820.27"
"2025-02-13","2025-02-12","SF FuneralFDC00000003L9L250212","","220","","157040.27"
"2025-02-13","2025-02-12","SF FuneralFDC00000006F0S250212","","126.5","","157166.77"
"2025-02-13","2025-02-12","SF FuneralFDC00000008LN1250212","","126.5","","157293.27"
"2025-02-13","2025-02-12","SF FuneralF814078       250212","","126.5","","157419.77"
"2025-02-13","2025-02-12","SF FuneralF986909       250212","","126.5","","157546.27"
"2025-02-13","2025-02-12","SF FuneralF1111478      250212","","126.5","","157672.77"
"2025-02-13","2025-02-12","SF FuneralF1120683      250212","","126.5","","157799.27"
"2025-02-13","2025-02-10","SF FuneralF1068281      250210","","63.25","","157862.52"
"2025-02-13","2025-02-07","SF FuneralFDC00000005HJM250207","","31.63","","157894.15"
"2025-02-13","2025-02-07","SF FuneralFDC0000000D307250207","","31.63","","157925.78"
"2025-02-13","2025-02-08","SF FuneralFDC0000000JVCB250209","","31.63","","157957.41"
"2025-02-13","2025-02-08","SF FuneralFDC0000000PZBG250209","","31.63","","157989.04"
"2025-02-13","2025-02-08","SF FuneralFDC0000000PZBK250209","","31.63","","158020.67"
"2025-02-13","2025-02-08","SF FuneralFDC0000000PZBL250209","","31.63","","158052.3"
"2025-02-13","2025-02-08","SF FuneralFDC0000000PZBM250209","","31.63","","158083.93"
"2025-02-13","2025-02-10","SF FuneralF814448       250209","","31.63","","158115.56"
"2025-02-13","2025-02-10","SF FuneralF820012       250210","","31.63","","158147.19"
"2025-02-13","2025-02-10","SF FuneralF834650       250209","","31.63","","158178.82"
"2025-02-13","2025-02-10","SF FuneralF1060055      250210","","31.63","","158210.45"
"2025-02-13","2025-02-10","SF FuneralF1079351      250210","","31.63","","158242.08"
"2025-02-13","2025-02-10","SF FuneralF1122727      250210","","31.63","","158273.71"
"2025-02-13","2025-02-11","SF FuneralF816581       250211","","31.63","","158305.34"
"2025-02-13","2025-02-12","SF FuneralF1124138      250212","","31.63","","158336.97"
"2025-02-13","2025-02-08","SF FuneralF1114548      250209","","126.5","","158463.47"
"2025-02-13","2025-02-08","SF FuneralF1129104      250208","","126.5","","158589.97"
"2025-02-13","2025-02-10","SF FuneralFDC00000005H2M250210","","126.5","","158716.47"
"2025-02-13","2025-02-10","SF FuneralFDC00000006V67250210","","126.5","","158842.97"
"2025-02-13","2025-02-10","SF FuneralF834835       250209","","126.5","","158969.47"
"2025-02-13","2025-02-10","SF FuneralFDC0000000K9LB250210","","126.5","","159095.97"
"2025-02-13","2025-02-11","SF FuneralFDC00000005K44250211","","126.5","","159222.47"
"2025-02-13","2025-02-12","SF FuneralFDC00000005KSW250212","","126.5","","159348.97"
"2025-02-13","2025-02-12","SF FuneralF809457       250212","","126.5","","159475.47"
"2025-02-13","2025-02-12","SF FuneralFDC00000009KTH250212","","126.5","","159601.97"
"2025-02-13","2025-02-12","SF FuneralFDC0000000JGPN250212","","126.5","","159728.47"
"2025-02-13","2025-02-12","SF FuneralF1111918      250212","","126.5","","159854.97"
"2025-02-13","2025-02-07","SF FuneralF988945       250209","","31.63","","159886.6"
"2025-02-13","2025-02-10","SF FuneralFDC00000005N4P250210","","31.63","","159918.23"
"2025-02-13","2025-02-10","SF FuneralFDC000000067C7250210","","31.63","","159949.86"
"2025-02-13","2025-02-10","SF FuneralF797906       250210","","31.63","","159981.49"
"2025-02-13","2025-02-10","SF FuneralFDC00000008MY8250209","","31.63","","160013.12"
"2025-02-13","2025-02-10","SF FuneralF811324       250210","","112.88","","160126"
"2025-02-13","2025-02-10","SF FuneralF1108567      250210","","31.63","","160157.63"
"2025-02-13","2025-02-10","SF FuneralF1130901      250210","","31.63","","160189.26"
"2025-02-13","2025-02-13","SF FuneralFDC00000005N6M250213","","31.63","","160220.89"
"2025-02-13","2025-02-12","SF FuneralFDC000000068N0250212","","126.5","","160347.39"
"2025-02-13","2025-02-13","SF FuneralFDC0000000NWZ1250213","","126.5","","160473.89"
"2025-02-13","2025-02-13","SF FuneralFDC00000006D10250213","","126.5","","160600.39"
"2025-02-13","2025-02-13","SF FuneralF1110797      250213","","126.5","","160726.89"
"2025-02-13","2025-02-08","SF FuneralFDC0000000Q35V250209","","126.5","","160853.39"
"2025-02-13","2025-02-10","SF FuneralF819950       250210","","63.25","","160916.64"
"2025-02-13","2025-02-12","SF FuneralFDC00000005JFX250212","","126.5","","161043.14"
"2025-02-13","2025-02-12","SF FuneralF804444       250212","","126.5","","161169.64"
"2025-02-13","2025-02-12","SF FuneralF829751       250212","","126.5","","161296.14"
"2025-02-13","2025-02-12","SF FuneralF991384       250212","","126.5","","161422.64"
"2025-02-13","2025-02-13","SF FuneralFDC000000066ZC250213","","126.5","","161549.14"
"2025-02-13","2025-02-13","SF FuneralFDC00000006DDG250213","","126.5","","161675.64"
"2025-02-13","2025-02-12","SF FuneralF1072844      250212","","126.5","","161802.14"
"2025-02-13","2025-02-08","SF FuneralFDC00000007VKH250208","","31.63","","161833.77"
"2025-02-13","2025-02-10","SF FuneralF818028       250210","","31.63","","161865.4"
"2025-02-13","2025-02-10","SF FuneralF988318       250210","","31.63","","161897.03"
"2025-02-13","2025-02-10","SF FuneralF1068000      250210","","31.63","","161928.66"
"2025-02-13","2025-02-11","SF FuneralF809823       250211","","31.63","","161960.29"
"2025-02-13","2025-02-11","SF FuneralF823596       250211","","31.63","","161991.92"
"2025-02-13","2025-02-10","SF FuneralFDC00000009958250210","","31.63","","162023.55"
"2025-02-13","2025-02-10","SF FuneralF1117412      250210","","31.63","","162055.18"
"2025-02-13","2025-02-11","SF FuneralF799620       250211","","64.13","","162119.31"
"2025-02-13","2025-02-08","SF FuneralF1103935      250209","","31.63","","162150.94"
"2025-02-13","2025-02-10","SF FuneralFDC00000003591250210","","55","","162205.94"
"2025-02-13","2025-02-10","SF FuneralF1066274      250210","","31.63","","162237.57"
"2025-02-13","2025-02-11","SF FuneralF1115031      250211","","31.63","","162269.2"
"2025-02-13","2025-02-12","SF FuneralFDC0000000681T250212","","126.5","","162395.7"
"2025-02-13","2025-02-12","SF FuneralFDC00000007GSK250212","","126.5","","162522.2"
"2025-02-13","2025-02-12","SF FuneralFDC00000007GSM250212","","126.5","","162648.7"
"2025-02-13","2025-02-12","SF FuneralF986676       250212","","126.5","","162775.2"
"2025-02-13","2025-02-12","SF FuneralF987846       250212","","126.5","","162901.7"
"2025-02-13","2025-02-13","SF FuneralFDC000000066TQ250213","","63.5","","162965.2"
"2025-02-13","2025-02-08","SF FuneralF1021491      250209","","31.63","","162996.83"
"2025-02-13","2025-02-08","SF FuneralF1072856      250209","","31.63","","163028.46"
"2025-02-13","2025-02-10","SF FuneralFDC00000005YV6250210","","63.25","","163091.71"
"2025-02-13","2025-02-10","SF FuneralFDC00000008JTC250210","","321.5","","163413.21"
"2025-02-13","2025-02-10","SF FuneralF819802       250210","","31.63","","163444.84"
"2025-02-13","2025-02-10","SF FuneralF1120655      250210","","31.63","","163476.47"
"2025-02-13","2025-02-10","SF FuneralF1130847      250210","","31.63","","163508.1"
"2025-02-13","2025-02-11","SF FuneralF810426       250211","","31.63","","163539.73"
"2025-02-13","2025-02-11","SF FuneralF1130344      250211","","31.63","","163571.36"
"2025-02-13","2025-02-12","SF FuneralF843979       250212","","126.5","","163697.86"
"2025-02-13","2025-02-10","SF FuneralFDC00000003S1L250210","","55","","163752.86"
"2025-02-13","2025-02-10","SF FuneralFDC00000005Z3L250210","","31.63","","163784.49"
"2025-02-13","2025-02-11","SF FuneralF797213       250211","","31.63","","163816.12"
"2025-02-13","2025-02-04","Rev SF FuneralFDC00000008C95250204","","-31.63","","163784.49"
"2025-02-13","2025-02-10","Rev SF FuneralFDC00000005YNL250210","","-55","","163729.49"
"2025-02-13","2025-02-10","Rev SF FuneralFDC00000005YW3250210","","-31.63","","163697.86"
"2025-02-13","2025-01-28","Rev SF FuneralFDC00000008C95250128","","-31.63","","163666.23"
"2025-02-13","2025-02-07","Rev SF FuneralFDC00000005HJM250207","","-31.63","","163634.6"
"2025-02-13","2025-01-24","Rev SF FuneralFDC0000000L35F250127","","-126.5","","163508.1"
"2025-02-13","2025-02-10","Rev SF FuneralFDC0000000HZN0250210","","-63.25","","163444.85"
"2025-02-13","2025-02-12","Rev SF FuneralFDC0000000KJYJ250212","","-126.5","","163318.35"
"2025-02-13","2025-02-10","Rev SF FuneralFDC00000005RW6250209","","-220","","163098.35"
"2025-02-13","2025-02-12","Rev SF FuneralFDC00000008LN1250212","","-126.5","","162971.85"
"2025-02-13","2025-02-12","Rev SF FuneralFDC00000009KTH250212","","-126.5","","162845.35"
"2025-02-13","2025-02-07","SF FuneralF830001       250207","","63.25","","162908.6"
"2025-02-13","2025-02-07","SF FuneralF990295       250208","","63.25","","162971.85"
"2025-02-13","2025-02-10","SF FuneralF805875       250209","","63.25","","163035.1"
"2025-02-13","2025-02-10","SF FuneralF830084       250210","","63.25","","163098.35"
"2025-02-13","2025-02-11","SF FuneralFDC000000069HF250211","","126.5","","163224.85"
"2025-02-13","2025-02-11","SF FuneralF805648       250211","","31.63","","163256.48"
"2025-02-13","2025-02-11","SF FuneralFDC0000000CQMV250211","","63.25","","163319.73"
"2025-02-13","2025-02-11","SF FuneralF993719       250211","","31.63","","163351.36"
"2025-02-13","2025-02-11","SF FuneralF1114433      250211","","31.63","","163382.99"
"2025-02-13","2025-02-12","SF FuneralFDC00000005V08250212","","126.5","","163509.49"
"2025-02-13","2025-02-12","SF FuneralFDC00000006VBW250212","","126.5","","163635.99"
"2025-02-13","2025-02-12","SF FuneralF802076       250212","","126.5","","163762.49"
"2025-02-13","2025-02-12","SF FuneralF818175       250212","","126.5","","163888.99"
"2025-02-13","2025-02-12","SF FuneralF1016869      250212","","126.5","","164015.49"
"2025-02-13","2025-02-12","SF FuneralF1103755      250212","","126.5","","164141.99"
"2025-02-13","2025-02-12","SF FuneralF1123121      250212","","126.5","","164268.49"
"2025-02-13","2025-02-12","SF FuneralF1123405      250212","","126.5","","164394.99"
"2025-02-13","2025-02-12","SF FuneralF1111304      250212","","126.5","","164521.49"
"2025-02-13","2025-02-10","SF FuneralFDC00000006XFK250210","","31.63","","164553.12"
"2025-02-13","2025-02-10","SF FuneralF1021004      250210","","31.63","","164584.75"
"2025-02-13","2025-02-12","SF FuneralF833902       250212","","126.5","","164711.25"
"2025-02-13","2025-02-11","SF FuneralF1016936      250211","","63.25","","164774.5"
"2025-02-13","2025-02-08","SF FuneralF1111595      250209","","31.63","","164806.13"
"2025-02-13","2025-02-10","SF FuneralFDC000000072K8250210","","63.25","","164869.38"
"2025-02-13","2025-02-10","SF FuneralF810250       250210","","31.63","","164901.01"
"2025-02-13","2025-02-10","SF FuneralF816565       250210","","31.63","","164932.64"
"2025-02-13","2025-02-10","SF FuneralF1072934      250210","","31.63","","164964.27"
"2025-02-13","2025-02-10","SF FuneralF1115020      250210","","63.25","","165027.52"
"2025-02-13","2025-02-10","SF FuneralF1124140      250210","","31.63","","165059.15"
"2025-02-13","2025-02-10","SF FuneralF1130649      250210","","31.63","","165090.78"
"2025-02-13","2025-02-11","SF FuneralFDC00000003D2J250211","","110","","165200.78"
"2025-02-13","2025-02-11","SF FuneralFDC00000007ZH7250211","","31.63","","165232.41"
"2025-02-13","2025-02-11","SF FuneralFDC00000008JVD250211","","31.63","","165264.04"
"2025-02-13","2025-02-11","SF FuneralF1111675      250211","","31.63","","165295.67"
"2025-02-13","2025-02-11","SF FuneralF1111742      250211","","31.63","","165327.3"
"2025-02-13","2025-02-11","SF FuneralFDC0000000ND1R250211","","31.63","","165358.93"
"2025-02-13","2025-02-11","SF FuneralFDC0000000NT58250211","","31.63","","165390.56"
"2025-02-13","2025-02-12","SF FuneralF981257       250212","","126.5","","165517.06"
"2025-02-13","2025-02-12","SF FuneralFDC0000000LG2D250212","","31.63","","165548.69"
"2025-02-13","2025-02-12","SF FuneralF1078566      250212","","31.63","","165580.32"
"2025-02-13","2025-02-11","SF FuneralF809796       250211","","63.25","","165643.57"
"2025-02-13","2025-02-07","SF FuneralF815237       250207","","63.25","","165706.82"
"2025-02-13","2025-02-08","SF FuneralF1128055      250209","","31.63","","165738.45"
"2025-02-13","2025-02-04","SF FuneralF823520       250204","","63.25","","165801.7"
"2025-02-13","2025-02-10","SF FuneralF1111332      250210","","31.63","","165833.33"
"2025-02-13","2025-02-10","SF FuneralF1125487      250210","","31.63","","165864.96"
"2025-02-13","2025-02-11","SF FuneralF815443       250211","","63.25","","165928.21"
"2025-02-13","2025-02-04","SF FuneralF1017847      250204","","63.25","","165991.46"
"2025-02-13","2025-02-07","SF FuneralF834529       250207","","126.5","","166117.96"
"2025-02-13","2025-02-10","SF FuneralFDC0000000376D250210","","55","","166172.96"
"2025-02-13","2025-02-10","SF FuneralFDC000000070PX250210","","31.63","","166204.59"
"2025-02-13","2025-02-10","SF FuneralFDC00000007H6K250210","","31.63","","166236.22"
"2025-02-13","2025-02-10","SF FuneralF800626       250210","","31.63","","166267.85"
"2025-02-13","2025-02-10","SF FuneralFDC0000000918Q250210","","47.88","","166315.73"
"2025-02-13","2025-02-10","SF FuneralF830266       250210","","31.63","","166347.36"
"2025-02-13","2025-02-10","SF FuneralF843034       250210","","31.63","","166378.99"
"2025-02-13","2025-02-10","SF FuneralF990991       250210","","63.25","","166442.24"
"2025-02-13","2025-02-10","SF FuneralF1020942      250210","","63.25","","166505.49"
"2025-02-13","2025-02-10","SF FuneralF1117477      250210","","31.63","","166537.12"
"2025-02-13","2025-02-10","SF FuneralF1108848      250210","","31.63","","166568.75"
"2025-02-13","2025-02-10","SF FuneralF1131037      250210","","31.63","","166600.38"
"2025-02-13","2025-02-11","SF FuneralFDC00000005H2H250211","","31.63","","166632.01"
"2025-02-13","2025-02-11","SF FuneralFDC00000005R1B250211","","31.63","","166663.64"
"2025-02-13","2025-02-11","SF FuneralFDC00000006H1Y250211","","31.63","","166695.27"
"2025-02-13","2025-02-11","SF FuneralFDC00000006Q68250211","","31.63","","166726.9"
"2025-02-13","2025-02-11","SF FuneralFDC00000007ZD3250211","","31.63","","166758.53"
"2025-02-13","2025-02-11","SF FuneralFDC000000088BV250211","","31.63","","166790.16"
"2025-02-13","2025-02-11","SF FuneralF814338       250211","","31.63","","166821.79"
"2025-02-13","2025-02-11","SF FuneralF815955       250211","","31.63","","166853.42"
"2025-02-13","2025-02-11","SF FuneralF831704       250211","","31.63","","166885.05"
"2025-02-13","2025-02-11","SF FuneralFDC0000000FQV0250211","","63.25","","166948.3"
"2025-02-13","2025-02-11","SF FuneralF1016929      250211","","63.25","","167011.55"
"2025-02-13","2025-02-11","SF FuneralFDC0000000K09P250211","","65","","167076.55"
"2025-02-13","2025-02-11","SF FuneralF1084842      250211","","31.63","","167108.18"
"2025-02-13","2025-02-12","SF FuneralFDC00000005W7K250212","","126.5","","167234.68"
"2025-02-13","2025-02-12","SF FuneralFDC00000005X31250212","","126.5","","167361.18"
"2025-02-13","2025-02-12","SF FuneralFDC00000007FWM250212","","126.5","","167487.68"
"2025-02-13","2025-02-12","SF FuneralFDC00000009H1J250212","","126.5","","167614.18"
"2025-02-13","2025-02-12","SF FuneralF1122926      250212","","31.63","","167645.81"
"2025-02-13","2025-02-12","SF FuneralF1124171      250212","","31.63","","167677.44"
"2025-02-13","2025-02-11","Rev SF FuneralFDC00000003D2J250211","","-110","","167567.44"
"2025-02-13","2025-02-08","Rev SF FuneralFDC0000000Q35V250209","","-126.5","","167440.94"
"2025-02-13","2025-02-08","Rev SF FuneralFDC0000000MNF7250208","","-31.63","","167409.31"
"2025-02-13","2025-02-01","Rev SF FuneralFDC0000000MNF7250201","","-31.63","","167377.68"
"2025-02-13","2025-01-25","Rev SF FuneralFDC0000000MNF7250125","","-31.63","","167346.05"
"2025-02-13","2025-01-11","Rev SF FuneralFDC0000000MNF7250111","","-31.63","","167314.42"
"2025-02-13","2025-01-04","Rev SF FuneralFDC0000000MNF7250104","","-31.63","","167282.79"
"2025-02-13","2025-02-12","Rev SF FuneralFDC0000000LG2D250212","","-31.63","","167251.16"
"2025-02-13","2025-02-12","Rev SF FuneralFDC00000009H1J250212","","-126.5","","167124.66"
"2025-02-13","2025-02-12","Rev SF FuneralFDC00000005V08250212","","-126.5","","166998.16"
"2025-02-13","2024-12-23","Rev SF FuneralF792924       241225","","-126.5","","166871.66"
"2025-02-13","2025-01-31","Rev SF FuneralFDC0000000H6N1250201","","-126.5","","166745.16"
"2025-02-13","2025-02-12","SF FuneralFDC00000006RPD250212","","126.5","","166871.66"
"2025-02-13","2025-02-10","SF FuneralFDC0000000KZ2C250210","","31.63","","166903.29"
"2025-02-13","2025-02-10","SF FuneralFDC0000000NNDF250210","","31.63","","166934.92"
"2025-02-13","2025-02-10","SF FuneralF1127535      250210","","63.25","","166998.17"
"2025-02-13","2025-02-11","SF FuneralF803854       250211","","63.25","","167061.42"
"2025-02-13","2025-02-11","SF FuneralF843011       250211","","63.25","","167124.67"
"2025-02-13","2025-02-11","SF FuneralF1085053      250211","","63.25","","167187.92"
"2025-02-13","2025-02-13","SF FuneralF1078865      250213","","47.88","","167235.8"
"2025-02-13","2025-02-11","SF FuneralFDC00000002Y4M250211","","55","","167290.8"
"2025-02-13","2025-02-11","SF FuneralF988913       250211","","31.63","","167322.43"
"2025-02-13","2025-02-11","SF FuneralF1068029      250211","","31.63","","167354.06"
"2025-02-13","2025-02-11","SF FuneralF1119033      250211","","63.25","","167417.31"
"2025-02-13","2025-02-12","SF FuneralF823042       250212","","126.5","","167543.81"
"2025-02-13","2025-02-11","SF FuneralF1118809      250211","","31.63","","167575.44"
"2025-02-13","2025-02-11","SF FuneralF1118848      250211","","31.63","","167607.07"
"2025-02-13","2025-02-11","SF FuneralF1131796      250211","","31.63","","167638.7"
"2025-02-13","2025-02-08","SF FuneralF1114730      250209","","31.63","","167670.33"
"2025-02-13","2025-02-12","SF FuneralFDC00000005J2J250212","","126.5","","167796.83"
"2025-02-13","2025-02-12","SF FuneralFDC00000005PJ7250212","","126.5","","167923.33"
"2025-02-13","2025-02-12","SF FuneralFDC000000073DD250212","","126.5","","168049.83"
"2025-02-13","2025-02-12","SF FuneralFDC00000008X5B250212","","31.63","","168081.46"
"2025-02-13","2025-02-12","SF FuneralF990178       250212","","126.5","","168207.96"
"2025-02-13","2025-02-12","SF FuneralF1118427      250212","","126.5","","168334.46"
"2025-02-13","2025-02-12","SF FuneralFDC0000000NXBY250212","","126.5","","168460.96"
"2025-02-13","2025-02-12","SF FuneralF1131516      250212","","126.5","","168587.46"
"2025-02-13","2025-02-10","SF FuneralF829978       250210","","63.25","","168650.71"
"2025-02-13","2025-02-10","SF FuneralF834614       250210","","31.63","","168682.34"
"2025-02-13","2025-02-10","SF FuneralF844339       250210","","31.63","","168713.97"
"2025-02-13","2025-02-10","SF FuneralF987492       250210","","31.63","","168745.6"
"2025-02-13","2025-02-10","SF FuneralF791581       250210","","47.88","","168793.48"
"2025-02-13","2025-02-10","SF FuneralF1100809      250210","","31.63","","168825.11"
"2025-02-13","2025-02-10","SF FuneralF1102815      250210","","31.63","","168856.74"
"2025-02-13","2025-02-10","SF FuneralF1102914      250210","","31.63","","168888.37"
"2025-02-13","2025-02-10","SF FuneralF1113735      250210","","31.63","","168920"
"2025-02-13","2025-02-10","SF FuneralF1068032      250210","","63.25","","168983.25"
"2025-02-13","2025-02-10","SF FuneralF1128205      250210","","31.63","","169014.88"
"2025-02-13","2025-02-11","SF FuneralF796739       250211","","31.63","","169046.51"
"2025-02-13","2025-02-11","SF FuneralF822587       250211","","31.63","","169078.14"
"2025-02-13","2025-02-13","SF FuneralF1122718      250213","","31.63","","169109.77"
"2025-02-14","2025-02-10","SF FuneralFDC00000006BK1250210","","31.63","","169141.4"
"2025-02-14","2025-02-10","SF FuneralFDC00000006Y3J250210","","126.5","","169267.9"
"2025-02-14","2025-02-10","SF FuneralFDC00000006Y3M250210","","126.5","","169394.4"
"2025-02-14","2025-02-10","SF FuneralFDC000000070CJ250210","","31.63","","169426.03"
"2025-02-14","2025-02-10","SF FuneralFDC00000007GXS250210","","31.63","","169457.66"
"2025-02-14","2025-02-10","SF FuneralFDC00000008KX0250210","","31.63","","169489.29"
"2025-02-14","2025-02-10","SF FuneralF809870       250210","","63.25","","169552.54"
"2025-02-14","2025-02-10","SF FuneralF844112       250209","","126.5","","169679.04"
"2025-02-14","2025-02-13","SF FuneralF1110763      250213","","31.63","","169710.67"
"2025-02-14","2025-02-12","SF FuneralFDC000000035K0250212","","220","","169930.67"
"2025-02-14","2025-02-12","SF FuneralFDC00000003DJF250212","","220","","170150.67"
"2025-02-14","2025-02-12","SF FuneralFDC00000005CQB250212","","126.5","","170277.17"
"2025-02-14","2025-02-12","SF FuneralFDC00000005FBM250212","","126.5","","170403.67"
"2025-02-14","2025-02-12","SF FuneralFDC00000005HW1250212","","126.5","","170530.17"
"2025-02-14","2025-02-12","SF FuneralFDC00000005J0Y250212","","126.5","","170656.67"
"2025-02-14","2025-02-12","SF FuneralFDC00000005K8S250212","","220","","170876.67"
"2025-02-14","2025-02-12","SF FuneralFDC00000005K8Y250212","","220","","171096.67"
"2025-02-14","2025-02-12","SF FuneralFDC00000005K93250212","","220","","171316.67"
"2025-02-14","2025-02-12","SF FuneralFDC00000005KBC250212","","220","","171536.67"
"2025-02-14","2025-02-12","SF FuneralFDC00000005NP1250212","","126.5","","171663.17"
"2025-02-14","2025-02-12","SF FuneralFDC00000005QRT250212","","126.5","","171789.67"
"2025-02-14","2025-02-12","SF FuneralFDC00000005SND250212","","126.5","","171916.17"
"2025-02-14","2025-02-12","SF FuneralFDC00000005V4Z250212","","31.63","","171947.8"
"2025-02-14","2025-02-12","SF FuneralFDC000000065TC250212","","126.5","","172074.3"
"2025-02-14","2025-02-12","SF FuneralFDC00000006RXM250212","","126.5","","172200.8"
"2025-02-14","2025-02-12","SF FuneralFDC000000071DT250212","","126.5","","172327.3"
"2025-02-14","2025-02-12","SF FuneralFDC00000007DS2250212","","126.5","","172453.8"
"2025-02-14","2025-02-12","SF FuneralFDC000000089VR250212","","126.5","","172580.3"
"2025-02-14","2025-02-12","SF FuneralF804247       250212","","126.5","","172706.8"
"2025-02-14","2025-02-12","SF FuneralF810177       250212","","126.5","","172833.3"
"2025-02-14","2025-02-12","SF FuneralF834337       250212","","126.5","","172959.8"
"2025-02-14","2025-02-12","SF FuneralF838848       250212","","126.5","","173086.3"
"2025-02-14","2025-02-12","SF FuneralF840471       250212","","126.5","","173212.8"
"2025-02-14","2025-02-12","SF FuneralFDC0000000GFXY250212","","126.5","","173339.3"
"2025-02-14","2025-02-12","SF FuneralFDC0000000GP6C250212","","126.5","","173465.8"
"2025-02-14","2025-02-12","SF FuneralF987264       250212","","126.5","","173592.3"
"2025-02-14","2025-02-12","SF FuneralF993793       250212","","126.5","","173718.8"
"2025-02-14","2025-02-12","SF FuneralFDC0000000JKSD250212","","126.5","","173845.3"
"2025-02-14","2025-02-12","SF FuneralFDC0000000K87M250212","","126.5","","173971.8"
"2025-02-14","2025-02-12","SF FuneralF1055205      250212","","126.5","","174098.3"
"2025-02-14","2025-02-12","SF FuneralF1078398      250212","","126.5","","174224.8"
"2025-02-14","2025-02-12","SF FuneralF1108338      250212","","126.5","","174351.3"
"2025-02-14","2025-02-12","SF FuneralF1110735      250212","","126.5","","174477.8"
"2025-02-14","2025-02-12","SF FuneralF1111308      250212","","126.5","","174604.3"
"2025-02-14","2025-02-12","SF FuneralF1118528      250212","","126.5","","174730.8"
"2025-02-14","2025-02-12","SF FuneralF785760       250212","","126.5","","174857.3"
"2025-02-14","2025-02-12","SF FuneralFDC0000000P675250212","","126.5","","174983.8"
"2025-02-14","2025-02-12","SF FuneralF1125161      250212","","126.5","","175110.3"
"2025-02-14","2025-02-12","SF FuneralFDC0000000PN4S250212","","126.5","","175236.8"
"2025-02-14","2025-02-12","SF FuneralFDC0000000PNDP250212","","126.5","","175363.3"
"2025-02-14","2025-02-12","SF FuneralFDC0000000PVCY250212","","126.5","","175489.8"
"2025-02-14","2025-02-12","SF FuneralF1130465      250212","","126.5","","175616.3"
"2025-02-14","2025-02-11","SF FuneralF814465       250211","","31.63","","175647.93"
"2025-02-14","2025-02-11","SF FuneralF830046       250211","","63.25","","175711.18"
"2025-02-14","2025-02-11","SF FuneralF830094       250211","","63.25","","175774.43"
"2025-02-14","2025-02-11","SF FuneralFDC0000000KFFJ250211","","31.63","","175806.06"
"2025-02-14","2025-02-11","SF FuneralF1112152      250211","","31.63","","175837.69"
"2025-02-14","2025-02-11","SF FuneralF1114513      250211","","31.63","","175869.32"
"2025-02-14","2025-02-11","SF FuneralF1115080      250211","","63.25","","175932.57"
"2025-02-14","2025-02-11","SF FuneralF1130277      250211","","31.63","","175964.2"
"2025-02-14","2025-02-11","SF FuneralF1103986      250211","","31.63","","175995.83"
"2025-02-14","2025-02-10","SF FuneralF1102887      250210","","31.63","","176027.46"
"2025-02-14","2025-02-10","SF FuneralF1118957      250210","","31.63","","176059.09"
"2025-02-14","2025-02-11","SF FuneralFDC00000003BTC250211","","55","","176114.09"
"2025-02-14","2025-02-11","SF FuneralFDC000000079S6250211","","31.63","","176145.72"
"2025-02-14","2025-02-11","SF FuneralFDC00000008365250211","","31.63","","176177.35"
"2025-02-14","2025-02-11","SF FuneralF821837       250211","","47.88","","176225.23"
"2025-02-14","2025-02-11","SF FuneralFDC0000000K22X250211","","31.63","","176256.86"
"2025-02-14","2025-02-11","SF FuneralFDC0000000L0TL250211","","31.63","","176288.49"
"2025-02-14","2025-02-11","SF FuneralF1110634      250211","","31.63","","176320.12"
"2025-02-14","2025-02-11","SF FuneralFDC0000000N526250211","","31.63","","176351.75"
"2025-02-14","2025-02-11","SF FuneralF1118865      250211","","31.63","","176383.38"
"2025-02-14","2025-02-11","SF FuneralF1123316      250211","","31.63","","176415.01"
"2025-02-14","2025-02-11","SF FuneralF1129356      250211","","31.63","","176446.64"
"2025-02-14","2025-02-11","SF FuneralF1131536      250211","","31.63","","176478.27"
"2025-02-14","2025-02-12","SF FuneralF800771       250212","","31.63","","176509.9"
"2025-02-14","2025-02-12","SF FuneralF823094       250212","","31.63","","176541.53"
"2025-02-14","2025-02-12","SF FuneralF1060919      250212","","31.63","","176573.16"
"2025-02-14","2025-02-13","SF FuneralFDC00000006ZNM250213","","31.63","","176604.79"
"2025-02-14","2025-02-05","SF FuneralFDC000000060TF250205","","126.5","","176731.29"
"2025-02-14","2025-02-08","SF FuneralF1079578      250209","","126.5","","176857.79"
"2025-02-14","2025-02-10","SF FuneralFDC00000005NR4250210","","31.63","","176889.42"
"2025-02-14","2025-02-10","SF FuneralFDC00000005NT1250210","","31.63","","176921.05"
"2025-02-14","2025-02-10","SF FuneralFDC00000005RR7250210","","31.63","","176952.68"
"2025-02-14","2025-02-10","SF FuneralFDC00000005RR8250210","","31.63","","176984.31"
"2025-02-14","2025-02-10","SF FuneralFDC000000074Y5250210","","55","","177039.31"
"2025-02-14","2025-02-10","SF FuneralF796603       250210","","126.5","","177165.81"
"2025-02-14","2025-02-10","SF FuneralF802251       250210","","31.63","","177197.44"
"2025-02-14","2025-02-10","SF FuneralF804198       250210","","63.25","","177260.69"
"2025-02-14","2025-02-10","SF FuneralF815135       250210","","31.63","","177292.32"
"2025-02-14","2025-02-10","SF FuneralF827602       250210","","31.63","","177323.95"
"2025-02-14","2025-02-10","SF FuneralF834680       250209","","126.5","","177450.45"
"2025-02-14","2025-02-10","SF FuneralF841850       250210","","31.63","","177482.08"
"2025-02-14","2025-02-10","SF FuneralF901184       250210","","31.63","","177513.71"
"2025-02-14","2025-02-10","SF FuneralF986655       250210","","31.63","","177545.34"
"2025-02-14","2025-02-10","SF FuneralF990276       250210","","31.63","","177576.97"
"2025-02-14","2025-02-10","SF FuneralF1016810      250210","","31.63","","177608.6"
"2025-02-14","2025-02-10","SF FuneralF1020751      250210","","126.5","","177735.1"
"2025-02-14","2025-02-10","SF FuneralF1059832      250210","","63.25","","177798.35"
"2025-02-14","2025-02-10","SF FuneralF1060914      250210","","63.25","","177861.6"
"2025-02-14","2025-02-10","SF FuneralFDC0000000KYZ5250210","","31.63","","177893.23"
"2025-02-14","2025-02-10","SF FuneralF1072928      250210","","31.63","","177924.86"
"2025-02-14","2025-02-10","SF FuneralF1073049      250210","","31.63","","177956.49"
"2025-02-14","2025-02-10","SF FuneralF1073147      250210","","31.63","","177988.12"
"2025-02-14","2025-02-10","SF FuneralF1084032      250210","","31.63","","178019.75"
"2025-02-14","2025-02-10","SF FuneralFDC0000000ML65250210","","31.63","","178051.38"
"2025-02-14","2025-02-10","SF FuneralF1112394      250210","","31.63","","178083.01"
"2025-02-14","2025-02-10","SF FuneralF1113769      250210","","63.25","","178146.26"
"2025-02-14","2025-02-10","SF FuneralFDC0000000N7Y7250210","","31.63","","178177.89"
"2025-02-14","2025-02-10","SF FuneralF1115136      250210","","31.63","","178209.52"
"2025-02-14","2025-02-10","SF FuneralF1118324      250210","","31.63","","178241.15"
"2025-02-14","2025-02-10","SF FuneralF1125923      250210","","31.63","","178272.78"
"2025-02-14","2025-02-11","SF FuneralFDC00000007KLD250211","","31.63","","178304.41"
"2025-02-14","2025-02-11","SF FuneralFDC00000008BSS250211","","63.25","","178367.66"
"2025-02-14","2025-02-11","SF FuneralFDC00000008KHZ250211","","126.5","","178494.16"
"2025-02-14","2025-02-11","SF FuneralFDC000000094YF250211","","126.5","","178620.66"
"2025-02-14","2025-02-11","SF FuneralF827707       250211","","31.63","","178652.29"
"2025-02-14","2025-02-11","SF FuneralFDC0000000BMW2250211","","31.63","","178683.92"
"2025-02-14","2025-02-11","SF FuneralF987241       250211","","31.63","","178715.55"
"2025-02-14","2025-02-11","SF FuneralFDC0000000J00M250211","","31.63","","178747.18"
"2025-02-14","2025-02-11","SF FuneralF1125003      250211","","31.63","","178778.81"
"2025-02-14","2025-02-11","SF FuneralF1130060      250211","","63.25","","178842.06"
"2025-02-14","2025-02-12","SF FuneralFDC00000005J51250212","","126.5","","178968.56"
"2025-02-14","2025-02-12","SF FuneralFDC00000005SG7250212","","126.5","","179095.06"
"2025-02-14","2025-02-12","SF FuneralFDC00000005X2Z250212","","126.5","","179221.56"
"2025-02-14","2025-02-12","SF FuneralFDC00000005X9N250212","","126.5","","179348.06"
"2025-02-14","2025-02-12","SF FuneralFDC000000064KN250212","","126.5","","179474.56"
"2025-02-14","2025-02-12","SF FuneralFDC00000006MF5250212","","126.5","","179601.06"
"2025-02-14","2025-02-12","SF FuneralFDC000000070JJ250212","","126.5","","179727.56"
"2025-02-14","2025-02-12","SF FuneralFDC00000007CFW250212","","126.5","","179854.06"
"2025-02-14","2025-02-12","SF FuneralFDC0000000811C250212","","126.5","","179980.56"
"2025-02-14","2025-02-12","SF FuneralFDC000000083R0250212","","126.5","","180107.06"
"2025-02-14","2025-02-12","SF FuneralF818243       250212","","126.5","","180233.56"
"2025-02-14","2025-02-12","SF FuneralFDC0000000BLKQ250212","","126.5","","180360.06"
"2025-02-14","2025-02-12","SF FuneralF823905       250212","","126.5","","180486.56"
"2025-02-14","2025-02-12","SF FuneralF834612       250212","","126.5","","180613.06"
"2025-02-14","2025-02-12","SF FuneralF843496       250212","","126.5","","180739.56"
"2025-02-14","2025-02-12","SF FuneralF843863       250212","","126.5","","180866.06"
"2025-02-14","2025-02-12","SF FuneralF989024       250212","","126.5","","180992.56"
"2025-02-14","2025-02-12","SF FuneralF989562       250212","","126.5","","181119.06"
"2025-02-14","2025-02-12","SF FuneralF1111368      250212","","126.5","","181245.56"
"2025-02-14","2025-02-12","SF FuneralF1118896      250212","","126.5","","181372.06"
"2025-02-14","2025-02-12","SF FuneralF1119793      250212","","126.5","","181498.56"
"2025-02-14","2025-02-12","SF FuneralF1127610      250212","","126.5","","181625.06"
"2025-02-14","2025-02-12","SF FuneralF1127865      250212","","126.5","","181751.56"
"2025-02-14","2025-02-12","SF FuneralF1130810      250212","","126.5","","181878.06"
"2025-02-14","2025-02-12","SF FuneralF1130826      250212","","126.5","","182004.56"
"2025-02-14","2025-02-13","SF FuneralF987254       250213","","126.5","","182131.06"
"2025-02-14","2025-02-10","SF FuneralF834043       250210","","63.25","","182194.31"
"2025-02-14","2025-02-10","SF FuneralF1110330      250210","","63.25","","182257.56"
"2025-02-14","2025-02-10","SF FuneralF1112102      250210","","63.25","","182320.81"
"2025-02-14","2025-02-10","SF FuneralF1113968      250210","","63.25","","182384.06"
"2025-02-14","2025-02-10","SF FuneralF1127699      250210","","63.25","","182447.31"
"2025-02-14","2025-02-11","SF FuneralF1131019      250211","","63.25","","182510.56"
"2025-02-14","2025-02-12","SF FuneralF814535       250212","","126.5","","182637.06"
"2025-02-14","2025-02-04","SF FuneralF1118312      250204","","63.25","","182700.31"
"2025-02-14","2025-02-10","SF FuneralFDC00000006TRY250210","","63.25","","182763.56"
"2025-02-14","2025-02-10","SF FuneralFDC00000007R5Z250210","","63.25","","182826.81"
"2025-02-14","2025-02-10","SF FuneralF821865       250210","","63.25","","182890.06"
"2025-02-14","2025-02-10","SF FuneralF989371       250210","","63.25","","182953.31"
"2025-02-14","2025-02-10","SF FuneralF1060760      250210","","63.25","","183016.56"
"2025-02-14","2025-02-11","SF FuneralF808312       250211","","63.25","","183079.81"
"2025-02-14","2025-02-11","SF FuneralF990777       250211","","63.25","","183143.06"
"2025-02-14","2025-02-11","SF FuneralF1079157      250211","","63.25","","183206.31"
"2025-02-14","2025-02-12","SF FuneralFDC00000006S9F250212","","126.5","","183332.81"
"2025-02-14","2025-02-12","SF FuneralFDC00000007N5P250212","","126.5","","183459.31"
"2025-02-14","2025-02-12","SF FuneralF810959       250212","","126.5","","183585.81"
"2025-02-14","2025-02-07","SF FuneralFDC00000008GY4250207","","31.63","","183617.44"
"2025-02-14","2025-02-07","SF FuneralFDC0000000H5YY250209","","31.63","","183649.07"
"2025-02-14","2025-02-07","SF FuneralF819674       250209","","31.63","","183680.7"
"2025-02-14","2025-02-07","SF FuneralF1125111      250207","","31.63","","183712.33"
"2025-02-14","2025-02-10","SF FuneralFDC00000004NQM250209","","31.63","","183743.96"
"2025-02-14","2025-02-10","SF FuneralFDC00000004NQP250209","","31.63","","183775.59"
"2025-02-14","2025-02-10","SF FuneralFDC00000005GH0250210","","31.63","","183807.22"
"2025-02-14","2025-02-10","SF FuneralFDC00000007PP8250210","","31.63","","183838.85"
"2025-02-14","2025-02-10","SF FuneralFDC00000007WVJ250210","","31.63","","183870.48"
"2025-02-14","2025-02-10","SF FuneralF811593       250210","","31.63","","183902.11"
"2025-02-14","2025-02-10","SF FuneralF813361       250210","","31.63","","183933.74"
"2025-02-14","2025-02-10","SF FuneralF815144       250210","","31.63","","183965.37"
"2025-02-14","2025-02-10","SF FuneralF822865       250210","","31.63","","183997"
"2025-02-14","2025-02-10","SF FuneralF830431       250210","","31.63","","184028.63"
"2025-02-14","2025-02-10","SF FuneralFDC0000000FVPD250210","","31.63","","184060.26"
"2025-02-14","2025-02-10","SF FuneralF986911       250210","","31.63","","184091.89"
"2025-02-14","2025-02-10","SF FuneralF993678       250210","","31.63","","184123.52"
"2025-02-14","2025-02-10","SF FuneralF1115957      250210","","31.63","","184155.15"
"2025-02-14","2025-02-10","SF FuneralF1125116      250210","","31.63","","184186.78"
"2025-02-14","2025-02-10","SF FuneralF1128005      250210","","31.63","","184218.41"
"2025-02-14","2025-02-11","SF FuneralFDC00000005P3L250211","","31.63","","184250.04"
"2025-02-14","2025-02-11","SF FuneralFDC00000007DFS250211","","31.63","","184281.67"
"2025-02-14","2025-02-11","SF FuneralFDC00000008CVJ250211","","31.63","","184313.3"
"2025-02-14","2025-02-11","SF FuneralF814063       250211","","31.63","","184344.93"
"2025-02-14","2025-02-11","SF FuneralF814180       250211","","31.63","","184376.56"
"2025-02-14","2025-02-11","SF FuneralFDC0000000BT1S250211","","31.63","","184408.19"
"2025-02-14","2025-02-11","SF FuneralF830294       250211","","31.63","","184439.82"
"2025-02-14","2025-02-11","SF FuneralF1066227      250211","","31.63","","184471.45"
"2025-02-14","2025-02-11","SF FuneralF1102910      250211","","31.63","","184503.08"
"2025-02-14","2025-02-11","SF FuneralF1110079      250211","","31.63","","184534.71"
"2025-02-14","2025-02-11","SF FuneralF1118352      250211","","31.63","","184566.34"
"2025-02-14","2025-02-11","SF FuneralF1123129      250211","","31.63","","184597.97"
"2025-02-14","2025-02-11","SF FuneralF1126262      250211","","31.63","","184629.6"
"2025-02-14","2025-02-11","SF FuneralF1127688      250211","","31.63","","184661.23"
"2025-02-14","2025-02-11","SF FuneralF1128820      250211","","31.63","","184692.86"
"2025-02-14","2025-02-12","SF FuneralF1124144      250212","","31.63","","184724.49"
"2025-02-14","2025-02-13","SF FuneralFDC00000005P8B250213","","31.63","","184756.12"
"2025-02-14","2025-02-13","SF FuneralF805236       250213","","31.63","","184787.75"
"2025-02-14","2025-02-12","SF FuneralF833958       250212","","126.5","","184914.25"
"2025-02-14","2025-02-12","SF FuneralF1021175      250212","","126.5","","185040.75"
"2025-02-14","2025-02-12","SF FuneralF1059424      250212","","31.63","","185072.38"
"2025-02-14","2025-02-11","SF FuneralF797055       250211","","31.63","","185104.01"
"2025-02-14","2025-02-11","SF FuneralF829557       250211","","31.63","","185135.64"
"2025-02-14","2025-02-11","SF FuneralF1080165      250211","","31.63","","185167.27"
"2025-02-14","2025-02-11","SF FuneralFDC0000000ML7D250211","","31.63","","185198.9"
"2025-02-14","2025-02-11","SF FuneralFDC0000000NN7N250211","","31.63","","185230.53"
"2025-02-14","2025-02-11","SF FuneralF1120129      250211","","31.63","","185262.16"
"2025-02-14","2025-02-11","SF FuneralF1123132      250211","","31.63","","185293.79"
"2025-02-14","2025-02-10","SF FuneralFDC0000000HS6H250210","","31.63","","185325.42"
"2025-02-14","2025-02-10","SF FuneralF1111402      250210","","63.25","","185388.67"
"2025-02-14","2025-02-10","SF FuneralF1125114      250210","","31.63","","185420.3"
"2025-02-14","2025-02-11","SF FuneralF811275       250211","","31.63","","185451.93"
"2025-02-14","2025-02-11","SF FuneralF1074647      250211","","31.63","","185483.56"
"2025-02-14","2025-02-11","SF FuneralF1078493      250211","","31.63","","185515.19"
"2025-02-14","2025-02-14","SF FuneralF1079509      250214","","31.63","","185546.82"
"2025-02-14","2025-02-11","SF FuneralF830076       250211","","63.25","","185610.07"
"2025-02-14","2025-02-11","SF FuneralFDC0000000N2L7250211","","63.25","","185673.32"
"2025-02-14","2025-02-11","SF FuneralF1119864      250211","","63.25","","185736.57"
"2025-02-14","2025-02-12","SF FuneralFDC000000043BV250212","","220","","185956.57"
"2025-02-14","2025-02-12","SF FuneralFDC00000005J58250212","","126.5","","186083.07"
"2025-02-14","2025-02-12","SF FuneralFDC00000005JSW250212","","126.5","","186209.57"
"2025-02-14","2025-02-12","SF FuneralFDC00000005K68250212","","126.5","","186336.07"
"2025-02-14","2025-02-12","SF FuneralFDC00000005K70250212","","126.5","","186462.57"
"2025-02-14","2025-02-12","SF FuneralFDC00000005L04250212","","126.5","","186589.07"
"2025-02-14","2025-02-12","SF FuneralFDC00000005L3N250212","","126.5","","186715.57"
"2025-02-14","2025-02-12","SF FuneralFDC00000005N4G250212","","126.5","","186842.07"
"2025-02-14","2025-02-12","SF FuneralFDC00000006B6K250212","","126.5","","186968.57"
"2025-02-14","2025-02-12","SF FuneralFDC00000006W3P250212","","126.5","","187095.07"
"2025-02-14","2025-02-12","SF FuneralFDC00000006WDQ250212","","126.5","","187221.57"
"2025-02-14","2025-02-12","SF FuneralF795840       250212","","126.5","","187348.07"
"2025-02-14","2025-02-12","SF FuneralF818309       250212","","126.5","","187474.57"
"2025-02-14","2025-02-12","SF FuneralF814384       250212","","126.5","","187601.07"
"2025-02-14","2025-02-12","SF FuneralF819726       250212","","126.5","","187727.57"
"2025-02-14","2025-02-12","SF FuneralF980316       250212","","126.5","","187854.07"
"2025-02-14","2025-02-12","SF FuneralF980974       250212","","126.5","","187980.57"
"2025-02-14","2025-02-12","SF FuneralF986903       250212","","126.5","","188107.07"
"2025-02-14","2025-02-12","SF FuneralF1017413      250212","","126.5","","188233.57"
"2025-02-14","2025-02-12","SF FuneralFDC0000000JJX5250212","","126.5","","188360.07"
"2025-02-14","2025-02-12","SF FuneralF1021083      250212","","126.5","","188486.57"
"2025-02-14","2025-02-12","SF FuneralFDC0000000JZPH250212","","126.5","","188613.07"
"2025-02-14","2025-02-12","SF FuneralF1073395      250212","","126.5","","188739.57"
"2025-02-14","2025-02-12","SF FuneralFDC0000000LDKT250212","","126.5","","188866.07"
"2025-02-14","2025-02-12","SF FuneralF1079728      250212","","126.5","","188992.57"
"2025-02-14","2025-02-12","SF FuneralFDC0000000M8PV250212","","126.5","","189119.07"
"2025-02-14","2025-02-12","SF FuneralFDC0000000NBPX250212","","126.5","","189245.57"
"2025-02-14","2025-02-12","SF FuneralFDC0000000P45S250212","","126.5","","189372.07"
"2025-02-14","2025-02-12","SF FuneralFDC0000000P5F4250212","","126.5","","189498.57"
"2025-02-14","2025-02-12","SF FuneralF1126296      250212","","126.5","","189625.07"
"2025-02-14","2025-02-11","SF FuneralF1112459      250211","","63.25","","189688.32"
"2025-02-14","2025-02-11","SF FuneralF1114553      250211","","63.25","","189751.57"
"2025-02-14","2025-02-11","SF FuneralF1084860      250211","","31.63","","189783.2"
"2025-02-14","2025-02-11","SF FuneralF1112298      250211","","31.63","","189814.83"
"2025-02-14","2025-02-11","SF FuneralF1112349      250211","","31.63","","189846.46"
"2025-02-14","2025-02-14","SF FuneralF1114116      250214","","31.63","","189878.09"
"2025-02-14","2025-02-14","SF FuneralF1121971      250214","","31.63","","189909.72"
"2025-02-14","2025-02-14","SF FuneralFDC0000000PK3S250214","","31.63","","189941.35"
"2025-02-14","2025-02-10","SF FuneralF1123291      250210","","31.63","","189972.98"
"2025-02-14","2025-02-11","SF FuneralFDC00000006FKH250211","","63.25","","190036.23"
"2025-02-14","2025-02-11","SF FuneralF1068200      250211","","63.25","","190099.48"
"2025-02-14","2025-02-12","SF FuneralFDC00000005J99250212","","126.5","","190225.98"
"2025-02-14","2025-02-12","SF FuneralFDC00000005JCW250212","","126.5","","190352.48"
"2025-02-14","2025-02-12","SF FuneralFDC00000005KFX250212","","126.5","","190478.98"
"2025-02-14","2025-02-12","SF FuneralFDC00000005MBM250212","","126.5","","190605.48"
"2025-02-14","2025-02-12","SF FuneralFDC00000005V13250212","","126.5","","190731.98"
"2025-02-14","2025-02-12","SF FuneralFDC00000005XGH250212","","126.5","","190858.48"
"2025-02-14","2025-02-12","SF FuneralFDC00000006V5J250212","","126.5","","190984.98"
"2025-02-14","2025-02-12","SF FuneralFDC00000006V6Y250212","","213.31","","191198.29"
"2025-02-14","2025-02-12","SF FuneralFDC00000006V75250212","","213.31","","191411.6"
"2025-02-14","2025-02-12","SF FuneralFDC00000006X80250212","","126.5","","191538.1"
"2025-02-14","2025-02-12","SF FuneralFDC00000007DLY250212","","126.5","","191664.6"
"2025-02-14","2025-02-12","SF FuneralFDC00000007DMG250212","","126.5","","191791.1"
"2025-02-14","2025-02-12","SF FuneralFDC00000007X62250212","","126.5","","191917.6"
"2025-02-14","2025-02-12","SF FuneralF796179       250212","","126.5","","192044.1"
"2025-02-14","2025-02-12","SF FuneralFDC00000007Y3K250212","","126.5","","192170.6"
"2025-02-14","2025-02-12","SF FuneralF796282       250212","","126.5","","192297.1"
"2025-02-14","2025-02-12","SF FuneralF796547       250212","","126.5","","192423.6"
"2025-02-14","2025-02-12","SF FuneralF796728       250212","","126.5","","192550.1"
"2025-02-14","2025-02-12","SF FuneralFDC00000008B89250212","","126.5","","192676.6"
"2025-02-14","2025-02-12","SF FuneralF800589       250212","","126.5","","192803.1"
"2025-02-14","2025-02-12","SF FuneralF816324       250212","","126.5","","192929.6"
"2025-02-14","2025-02-12","SF FuneralF817919       250212","","126.5","","193056.1"
"2025-02-14","2025-02-12","SF FuneralF819113       250212","","126.5","","193182.6"
"2025-02-14","2025-02-12","SF FuneralF822846       250212","","126.5","","193309.1"
"2025-02-14","2025-02-12","SF FuneralFDC0000000BSLC250212","","126.5","","193435.6"
"2025-02-14","2025-02-12","SF FuneralF829959       250212","","126.5","","193562.1"
"2025-02-14","2025-02-12","SF FuneralFDC0000000CWP7250212","","126.5","","193688.6"
"2025-02-14","2025-02-12","SF FuneralFDC0000000FLWY250212","","126.5","","193815.1"
"2025-02-14","2025-02-12","SF FuneralFDC0000000G606250212","","126.5","","193941.6"
"2025-02-14","2025-02-12","SF FuneralF986746       250212","","126.5","","194068.1"
"2025-02-14","2025-02-12","SF FuneralFDC0000000HQH2250212","","126.5","","194194.6"
"2025-02-14","2025-02-12","SF FuneralF990043       250212","","126.5","","194321.1"
"2025-02-14","2025-02-12","SF FuneralF990679       250212","","126.5","","194447.6"
"2025-02-14","2025-02-12","SF FuneralF1061869      250212","","126.5","","194574.1"
"2025-02-14","2025-02-12","SF FuneralF1074772      250212","","126.5","","194700.6"
"2025-02-14","2025-02-12","SF FuneralF1103840      250212","","126.5","","194827.1"
"2025-02-14","2025-02-12","SF FuneralF1111777      250212","","126.5","","194953.6"
"2025-02-14","2025-02-12","SF FuneralFDC0000000N9DG250212","","126.5","","195080.1"
"2025-02-14","2025-02-12","SF FuneralF1122738      250212","","126.5","","195206.6"
"2025-02-14","2025-02-12","SF FuneralFDC0000000P3M1250212","","126.5","","195333.1"
"2025-02-14","2025-02-12","SF FuneralF1127761      250212","","126.5","","195459.6"
"2025-02-14","2025-02-12","SF FuneralF1130682      250212","","126.5","","195586.1"
"2025-02-14","2025-02-11","SF FuneralF822823       250211","","63.25","","195649.35"
"2025-02-14","2025-02-11","SF FuneralF992479       250211","","63.25","","195712.6"
"2025-02-14","2025-02-11","SF FuneralF1052710      250211","","63.25","","195775.85"
"2025-02-14","2025-02-11","SF FuneralF1078509      250211","","63.25","","195839.1"
"2025-02-14","2025-02-11","SF FuneralF1080397      250211","","63.25","","195902.35"
"2025-02-14","2025-02-11","SF FuneralF1131005      250211","","63.25","","195965.6"
"2025-02-14","2025-02-12","SF FuneralFDC00000005DWW250212","","126.5","","196092.1"
"2025-02-14","2025-02-12","SF FuneralFDC00000005GH3250212","","126.5","","196218.6"
"2025-02-14","2025-02-12","SF FuneralFDC00000006CP2250212","","126.5","","196345.1"
"2025-02-14","2025-02-12","SF FuneralFDC00000006XBS250212","","126.5","","196471.6"
"2025-02-14","2025-02-12","SF FuneralFDC000000070WX250212","","126.5","","196598.1"
"2025-02-14","2025-02-12","SF FuneralFDC0000000710G250212","","126.5","","196724.6"
"2025-02-14","2025-02-12","SF FuneralFDC000000072GH250212","","126.5","","196851.1"
"2025-02-14","2025-02-12","SF FuneralFDC00000007XKK250212","","126.5","","196977.6"
"2025-02-14","2025-02-12","SF FuneralFDC00000008C7N250212","","126.5","","197104.1"
"2025-02-14","2025-02-12","SF FuneralF801016       250212","","126.5","","197230.6"
"2025-02-14","2025-02-12","SF FuneralFDC00000008KSM250212","","126.5","","197357.1"
"2025-02-14","2025-02-12","SF FuneralF814106       250212","","126.5","","197483.6"
"2025-02-14","2025-02-12","SF FuneralF822351       250212","","126.5","","197610.1"
"2025-02-14","2025-02-12","SF FuneralF822590       250212","","126.5","","197736.6"
"2025-02-14","2025-02-12","SF FuneralF830412       250212","","126.5","","197863.1"
"2025-02-14","2025-02-12","SF FuneralF1083626      250212","","126.5","","197989.6"
"2025-02-14","2025-02-12","SF FuneralFDC0000000P741250212","","126.5","","198116.1"
"2025-02-14","2025-02-12","SF FuneralF1125185      250212","","126.5","","198242.6"
"2025-02-14","2025-02-10","SF FuneralFDC00000007F71250210","","63.25","","198305.85"
"2025-02-14","2025-02-14","SF FuneralF1127827      250214","","126.5","","198432.35"
"2025-02-14","2025-02-07","SF FuneralF1110676      250207","","126.5","","198558.85"
"2025-02-14","2025-02-11","SF FuneralF993898       250211","","63.25","","198622.1"
"2025-02-14","2025-02-11","SF FuneralF1073735      250211","","63.25","","198685.35"
"2025-02-14","2025-02-12","SF FuneralFDC00000005HQ9250212","","126.5","","198811.85"
"2025-02-14","2025-02-12","SF FuneralFDC00000005HWT250212","","126.5","","198938.35"
"2025-02-14","2025-02-12","SF FuneralFDC00000005HXT250212","","126.5","","199064.85"
"2025-02-14","2025-02-12","SF FuneralFDC00000005J20250212","","126.5","","199191.35"
"2025-02-14","2025-02-12","SF FuneralFDC00000005LWL250212","","126.5","","199317.85"
"2025-02-14","2025-02-12","SF FuneralFDC00000005N1Q250212","","126.5","","199444.35"
"2025-02-14","2025-02-12","SF FuneralFDC00000005N90250212","","126.5","","199570.85"
"2025-02-14","2025-02-12","SF FuneralFDC00000005NJY250212","","126.5","","199697.35"
"2025-02-14","2025-02-12","SF FuneralFDC00000005PMC250212","","126.5","","199823.85"
"2025-02-14","2025-02-12","SF FuneralFDC00000005SZ7250212","","126.5","","199950.35"
"2025-02-14","2025-02-12","SF FuneralFDC00000006Q2Z250212","","126.5","","200076.85"
"2025-02-14","2025-02-12","SF FuneralFDC00000006RKW250212","","126.5","","200203.35"
"2025-02-14","2025-02-12","SF FuneralFDC00000006YQ3250212","","126.5","","200329.85"
"2025-02-14","2025-02-12","SF FuneralFDC00000006ZBD250212","","126.5","","200456.35"
"2025-02-14","2025-02-12","SF FuneralF804578       250212","","126.5","","200582.85"
"2025-02-14","2025-02-12","SF FuneralF830765       250212","","126.5","","200709.35"
"2025-02-14","2025-02-12","SF FuneralF833726       250212","","126.5","","200835.85"
"2025-02-14","2025-02-12","SF FuneralF833864       250212","","126.5","","200962.35"
"2025-02-14","2025-02-12","SF FuneralF833875       250212","","126.5","","201088.85"
"2025-02-14","2025-02-12","SF FuneralF834066       250212","","126.5","","201215.35"
"2025-02-14","2025-02-12","SF FuneralFDC0000000D000250212","","126.5","","201341.85"
"2025-02-14","2025-02-12","SF FuneralFDC0000000D71H250212","","126.5","","201468.35"
"2025-02-14","2025-02-12","SF FuneralFDC0000000FGXN250212","","126.5","","201594.85"
"2025-02-14","2025-02-12","SF FuneralF843697       250212","","126.5","","201721.35"
"2025-02-14","2025-02-12","SF FuneralF989556       250212","","126.5","","201847.85"
"2025-02-14","2025-02-12","SF FuneralF989730       250212","","126.5","","201974.35"
"2025-02-14","2025-02-12","SF FuneralFDC0000000JGBQ250212","","126.5","","202100.85"
"2025-02-14","2025-02-12","SF FuneralF1050716      250212","","126.5","","202227.35"
"2025-02-14","2025-02-12","SF FuneralF1060763      250212","","126.5","","202353.85"
"2025-02-14","2025-02-12","SF FuneralFDC0000000KK01250212","","126.5","","202480.35"
"2025-02-14","2025-02-12","SF FuneralF1061034      250212","","126.5","","202606.85"
"2025-02-14","2025-02-12","SF FuneralF1080153      250212","","126.5","","202733.35"
"2025-02-14","2025-02-12","SF FuneralF1083948      250212","","126.5","","202859.85"
"2025-02-14","2025-02-12","SF FuneralF1084280      250212","","126.5","","202986.35"
"2025-02-14","2025-02-12","SF FuneralF1112131      250212","","126.5","","203112.85"
"2025-02-14","2025-02-12","SF FuneralFDC0000000NJPY250212","","126.5","","203239.35"
"2025-02-14","2025-02-12","SF FuneralFDC0000000NPGH250212","","126.5","","203365.85"
"2025-02-14","2025-02-12","SF FuneralFDC0000000PVD2250212","","126.5","","203492.35"
"2025-02-14","2025-02-14","SF FuneralFDC00000007Y4Y250214","","126.5","","203618.85"
"2025-02-14","2025-02-11","SF FuneralF1060636      250211","","63.25","","203682.1"
"2025-02-14","2025-02-11","SF FuneralF1060859      250211","","63.25","","203745.35"
"2025-02-14","2025-02-12","SF FuneralFDC00000002Q7T250212","","220","","203965.35"
"2025-02-14","2025-02-12","SF FuneralFDC00000003D4T250212","","220","","204185.35"
"2025-02-14","2025-02-12","SF FuneralFDC000000043BX250212","","220","","204405.35"
"2025-02-14","2025-02-12","SF FuneralFDC00000005V62250212","","126.5","","204531.85"
"2025-02-14","2025-02-12","SF FuneralFDC00000006WVW250212","","126.5","","204658.35"
"2025-02-14","2025-02-12","SF FuneralFDC00000006WY6250212","","126.5","","204784.85"
"2025-02-14","2025-02-12","SF FuneralFDC0000000757W250212","","126.5","","204911.35"
"2025-02-14","2025-02-12","SF FuneralFDC00000007CK1250212","","126.5","","205037.85"
"2025-02-14","2025-02-12","SF FuneralFDC00000007PTD250212","","220","","205257.85"
"2025-02-14","2025-02-12","SF FuneralFDC00000008BPL250212","","126.5","","205384.35"
"2025-02-14","2025-02-12","SF FuneralF804219       250212","","126.5","","205510.85"
"2025-02-14","2025-02-12","SF FuneralF804309       250212","","126.5","","205637.35"
"2025-02-14","2025-02-12","SF FuneralFDC0000000953Q250212","","126.5","","205763.85"
"2025-02-14","2025-02-12","SF FuneralF814199       250212","","126.5","","205890.35"
"2025-02-14","2025-02-12","SF FuneralF833921       250212","","126.5","","206016.85"
"2025-02-14","2025-02-12","SF FuneralF833976       250212","","126.5","","206143.35"
"2025-02-14","2025-02-12","SF FuneralF981839       250212","","126.5","","206269.85"
"2025-02-14","2025-02-12","SF FuneralFDC0000000HJLD250212","","126.5","","206396.35"
"2025-02-14","2025-02-12","SF FuneralFDC0000000JHR3250212","","126.5","","206522.85"
"2025-02-14","2025-02-12","SF FuneralF1017310      250212","","126.5","","206649.35"
"2025-02-14","2025-02-12","SF FuneralF1060695      250212","","126.5","","206775.85"
"2025-02-14","2025-02-12","SF FuneralF1072754      250212","","126.5","","206902.35"
"2025-02-14","2025-02-12","SF FuneralFDC0000000L73H250212","","126.5","","207028.85"
"2025-02-14","2025-02-12","SF FuneralF1103776      250212","","126.5","","207155.35"
"2025-02-14","2025-02-12","SF FuneralFDC0000000MRJY250212","","126.5","","207281.85"
"2025-02-14","2025-02-12","SF FuneralF1111667      250212","","126.5","","207408.35"
"2025-02-14","2025-02-12","SF FuneralF1118661      250212","","126.5","","207534.85"
"2025-02-14","2025-02-12","SF FuneralFDC0000000NPPS250212","","191.5","","207726.35"
"2025-02-14","2025-02-12","SF FuneralFDC0000000PLW4250212","","126.5","","207852.85"
"2025-02-14","2025-02-12","SF FuneralFDC0000000PLW7250212","","126.5","","207979.35"
"2025-02-14","2025-02-12","SF FuneralF1128701      250212","","126.5","","208105.85"
"2025-02-14","2025-02-14","SF FuneralF1060738      250214","","126.5","","208232.35"
"2025-02-14","2025-02-11","SF FuneralF822630       250211","","63.25","","208295.6"
"2025-02-14","2025-02-11","SF FuneralF827697       250211","","126.5","","208422.1"
"2025-02-14","2025-02-11","SF FuneralF1103863      250211","","126.5","","208548.6"
"2025-02-14","2025-02-12","SF FuneralFDC00000005L52250212","","126.5","","208675.1"
"2025-02-14","2025-02-12","SF FuneralFDC00000005L5D250212","","126.5","","208801.6"
"2025-02-14","2025-02-12","SF FuneralFDC00000005MD5250212","","126.5","","208928.1"
"2025-02-14","2025-02-12","SF FuneralFDC00000005Q9D250212","","126.5","","209054.6"
"2025-02-14","2025-02-12","SF FuneralFDC00000005QYJ250212","","126.5","","209181.1"
"2025-02-14","2025-02-12","SF FuneralFDC00000005ZC3250212","","126.5","","209307.6"
"2025-02-14","2025-02-12","SF FuneralFDC00000006L8X250212","","126.5","","209434.1"
"2025-02-14","2025-02-12","SF FuneralF787671       250212","","126.5","","209560.6"
"2025-02-14","2025-02-12","SF FuneralF810985       250212","","126.5","","209687.1"
"2025-02-14","2025-02-12","SF FuneralFDC0000000DRNV250212","","126.5","","209813.6"
"2025-02-14","2025-02-12","SF FuneralF1110805      250212","","126.5","","209940.1"
"2025-02-14","2025-02-12","SF FuneralF1118006      250212","","126.5","","210066.6"
"2025-02-14","2025-02-10","SF FuneralFDC00000005LNS250209","","126.5","","210193.1"
"2025-02-14","2025-02-10","SF FuneralFDC0000000659X250210","","63.25","","210256.35"
"2025-02-14","2025-02-14","SF FuneralFDC00000006ZGX250214","","126.5","","210382.85"
"2025-02-14","2025-02-14","SF FuneralFDC000000087GP250214","","126.5","","210509.35"
"2025-02-14","2025-02-14","SF FuneralFDC000000089XM250214","","126.5","","210635.85"
"2025-02-14","2025-02-11","SF FuneralF1020917      250211","","63.25","","210699.1"
"2025-02-14","2025-02-11","SF FuneralF1079188      250211","","63.25","","210762.35"
"2025-02-14","2025-02-12","SF FuneralF844079       250212","","126.5","","210888.85"
"2025-02-14","2025-02-12","SF FuneralFDC0000000JG7T250212","","126.5","","211015.35"
"2025-02-14","2025-02-12","SF FuneralFDC0000000L3TB250212","","126.5","","211141.85"
"2025-02-14","2025-02-10","SF FuneralF989002       250210","","63.25","","211205.1"
"2025-02-14","2025-02-10","SF FuneralF1111946      250210","","126.5","","211331.6"
"2025-02-14","2025-02-10","SF FuneralF1118237      250210","","126.5","","211458.1"
"2025-02-14","2025-02-10","SF FuneralF1125170      250210","","126.5","","211584.6"
"2025-02-14","2025-02-10","SF FuneralF1052354      250210","","63.25","","211647.85"
"2025-02-14","2025-02-11","SF FuneralF1119681      250211","","63.25","","211711.1"
"2025-02-14","2025-02-11","SF FuneralFDC00000007WH2250211","","47.88","","211758.98"
"2025-02-14","2025-02-11","SF FuneralF798846       250211","","31.63","","211790.61"
"2025-02-14","2025-02-11","SF FuneralFDC000000086B2250211","","31.63","","211822.24"
"2025-02-14","2025-02-10","SF FuneralF1052812      250210","","31.63","","211853.87"
"2025-02-14","2025-02-10","SF FuneralF1060944      250210","","31.63","","211885.5"
"2025-02-14","2025-02-10","SF FuneralF1129452      250210","","31.63","","211917.13"
"2025-02-14","2025-02-11","SF FuneralFDC0000000690Q250211","","31.63","","211948.76"
"2025-02-14","2025-02-11","SF FuneralF819196       250211","","31.63","","211980.39"
"2025-02-14","2025-02-11","SF FuneralF843037       250211","","31.63","","212012.02"
"2025-02-14","2025-02-11","SF FuneralF1079331      250211","","31.63","","212043.65"
"2025-02-14","2025-02-11","SF FuneralF1083692      250211","","31.63","","212075.28"
"2025-02-14","2025-02-11","SF FuneralF1110117      250211","","31.63","","212106.91"
"2025-02-14","2025-02-12","SF FuneralF1110314      250212","","31.63","","212138.54"
"2025-02-14","2025-02-13","SF FuneralF1109029      250213","","31.63","","212170.17"
"2025-02-14","2025-02-14","SF FuneralF1125111      250214","","31.63","","212201.8"
"2025-02-14","2025-02-10","SF FuneralF1074954      250210","","31.63","","212233.43"
"2025-02-14","2025-02-10","SF FuneralF1079348      250210","","31.63","","212265.06"
"2025-02-14","2025-02-14","SF FuneralF814064       250214","","31.63","","212296.69"
"2025-02-14","2025-02-14","SF FuneralF814303       250214","","31.63","","212328.32"
"2025-02-14","2025-02-14","SF FuneralF817655       250214","","31.63","","212359.95"
"2025-02-14","2025-02-14","SF FuneralF1022106      250214","","31.63","","212391.58"
"2025-02-14","2025-02-14","SF FuneralFDC0000000JXK7250214","","31.63","","212423.21"
"2025-02-14","2025-02-14","SF FuneralF840580       250214","","31.63","","212454.84"
"2025-02-14","2025-02-14","SF FuneralF844636       250214","","31.63","","212486.47"
"2025-02-14","2025-02-14","SF FuneralFDC0000000KLCD250214","","31.63","","212518.1"
"2025-02-14","2025-02-14","SF FuneralF1061613      250214","","31.63","","212549.73"
"2025-02-14","2025-02-14","SF FuneralFDC0000000L3MT250214","","31.63","","212581.36"
"2025-02-14","2025-02-11","SF FuneralF827761       250211","","31.63","","212612.99"
"2025-02-14","2025-02-11","SF FuneralF1124052      250211","","31.63","","212644.62"
"2025-02-14","2025-02-11","SF FuneralF1127528      250211","","31.63","","212676.25"
"2025-02-14","2025-02-11","SF FuneralFDC00000007S9L250211","","31.63","","212707.88"
"2025-02-14","2025-02-11","SF FuneralF802169       250211","","31.63","","212739.51"
"2025-02-14","2025-02-11","SF FuneralFDC00000008M07250211","","31.63","","212771.14"
"2025-02-14","2025-02-11","SF FuneralF989177       250211","","31.63","","212802.77"
"2025-02-14","2025-02-11","SF FuneralFDC0000000L215250211","","31.63","","212834.4"
"2025-02-14","2025-02-11","SF FuneralF1073297      250211","","31.63","","212866.03"
"2025-02-14","2025-02-11","SF FuneralF1111731      250211","","31.63","","212897.66"
"2025-02-14","2025-02-11","SF FuneralFDC0000000NRQK250211","","31.63","","212929.29"
"2025-02-14","2025-02-11","SF FuneralF1126072      250211","","31.63","","212960.92"
"2025-02-14","2025-02-11","SF FuneralF1127863      250211","","31.63","","212992.55"
"2025-02-14","2025-02-11","SF FuneralF1131622      250211","","31.63","","213024.18"
"2025-02-14","2025-02-11","SF FuneralF1131696      250211","","31.63","","213055.81"
"2025-02-14","2025-02-13","SF FuneralF1016768      250213","","31.63","","213087.44"
"2025-02-14","2025-02-14","SF FuneralF900608       250214","","31.63","","213119.07"
"2025-02-14","2025-02-14","SF FuneralFDC0000000HVXH250215","","31.63","","213150.7"
"2025-02-14","2025-02-14","SF FuneralF990787       250215","","31.63","","213182.33"
"2025-02-14","2025-02-11","SF FuneralF841421       250211","","31.63","","213213.96"
"2025-02-14","2025-02-11","SF FuneralF981838       250211","","31.63","","213245.59"
"2025-02-14","2025-02-11","SF FuneralF993770       250211","","31.63","","213277.22"
"2025-02-14","2025-02-11","SF FuneralF1021467      250211","","31.63","","213308.85"
"2025-02-14","2025-02-11","SF FuneralF1120226      250211","","31.63","","213340.48"
"2025-02-14","2025-02-11","SF FuneralF1124780      250211","","31.63","","213372.11"
"2025-02-14","2025-02-11","SF FuneralF1129409      250211","","31.63","","213403.74"
"2025-02-14","2025-02-11","SF FuneralF799673       250211","","31.63","","213435.37"
"2025-02-14","2025-02-11","SF FuneralF1127480      250211","","31.63","","213467"
"2025-02-14","2025-02-11","SF FuneralF1131484      250211","","31.63","","213498.63"
"2025-02-14","2025-02-11","SF FuneralFDC00000007FBC250211","","31.63","","213530.26"
"2025-02-14","2025-02-11","SF FuneralFDC00000008M09250211","","31.63","","213561.89"
"2025-02-14","2025-02-11","SF FuneralF822125       250211","","31.63","","213593.52"
"2025-02-14","2025-02-11","SF FuneralF827812       250211","","31.63","","213625.15"
"2025-02-14","2025-02-11","SF FuneralF832888       250211","","31.63","","213656.78"
"2025-02-14","2025-02-11","SF FuneralF833515       250211","","31.63","","213688.41"
"2025-02-14","2025-02-11","SF FuneralF833824       250211","","31.63","","213720.04"
"2025-02-14","2025-02-11","SF FuneralF834784       250211","","31.63","","213751.67"
"2025-02-14","2025-02-11","SF FuneralF900687       250211","","31.63","","213783.3"
"2025-02-14","2025-02-11","SF FuneralF986709       250211","","31.63","","213814.93"
"2025-02-14","2025-02-11","SF FuneralF1126086      250211","","31.63","","213846.56"
"2025-02-14","2025-02-11","SF FuneralF1128998      250211","","31.63","","213878.19"
"2025-02-14","2025-02-14","SF FuneralF1079664      250214","","31.63","","213909.82"
"2025-02-14","2025-02-14","SF FuneralF1079691      250214","","31.63","","213941.45"
"2025-02-14","2025-02-08","SF FuneralF1050764      250209","","126.5","","214067.95"
"2025-02-14","2025-02-08","SF FuneralFDC0000000K1KY250209","","126.5","","214194.45"
"2025-02-14","2025-02-11","SF FuneralFDC00000007NHV250211","","63.25","","214257.7"
"2025-02-14","2025-02-11","SF FuneralF811733       250211","","31.63","","214289.33"
"2025-02-14","2025-02-11","SF FuneralF828867       250211","","31.63","","214320.96"
"2025-02-14","2025-02-11","SF FuneralF844728       250211","","31.63","","214352.59"
"2025-02-14","2025-02-11","SF FuneralF1059394      250211","","63.25","","214415.84"
"2025-02-14","2025-02-11","SF FuneralF1111540      250211","","63.25","","214479.09"
"2025-02-14","2025-02-11","SF FuneralF1111588      250211","","31.63","","214510.72"
"2025-02-14","2025-02-11","SF FuneralFDC0000000N8HR250211","","63.25","","214573.97"
"2025-02-14","2025-02-11","SF FuneralF1118308      250211","","31.63","","214605.6"
"2025-02-14","2025-02-11","SF FuneralF1119889      250211","","31.63","","214637.23"
"2025-02-14","2025-02-11","SF FuneralF1124111      250211","","63.25","","214700.48"
"2025-02-14","2025-02-11","SF FuneralF1129444      250211","","126.5","","214826.98"
"2025-02-14","2025-02-12","SF FuneralFDC00000005HWG250212","","126.5","","214953.48"
"2025-02-14","2025-02-12","SF FuneralFDC00000005HZD250212","","126.5","","215079.98"
"2025-02-14","2025-02-12","SF FuneralFDC00000005K24250212","","126.5","","215206.48"
"2025-02-14","2025-02-12","SF FuneralFDC00000005LJ6250212","","126.5","","215332.98"
"2025-02-14","2025-02-12","SF FuneralFDC00000006314250212","","126.5","","215459.48"
"2025-02-14","2025-02-12","SF FuneralFDC0000000652G250212","","126.5","","215585.98"
"2025-02-14","2025-02-12","SF FuneralFDC00000006LX7250212","","126.5","","215712.48"
"2025-02-14","2025-02-12","SF FuneralFDC00000006RZV250212","","126.5","","215838.98"
"2025-02-14","2025-02-12","SF FuneralFDC00000006SL4250212","","126.5","","215965.48"
"2025-02-14","2025-02-12","SF FuneralFDC00000006XVB250212","","126.5","","216091.98"
"2025-02-14","2025-02-12","SF FuneralFDC00000007D6T250212","","126.5","","216218.48"
"2025-02-14","2025-02-12","SF FuneralFDC00000007DP5250212","","126.5","","216344.98"
"2025-02-14","2025-02-12","SF FuneralF794542       250212","","126.5","","216471.48"
"2025-02-14","2025-02-12","SF FuneralF796013       250212","","126.5","","216597.98"
"2025-02-14","2025-02-12","SF FuneralFDC00000007Y1F250212","","126.5","","216724.48"
"2025-02-14","2025-02-12","SF FuneralFDC00000007Y3H250212","","126.5","","216850.98"
"2025-02-14","2025-02-12","SF FuneralFDC00000008BVN250212","","126.5","","216977.48"
"2025-02-14","2025-02-12","SF FuneralFDC00000008N3V250212","","126.5","","217103.98"
"2025-02-14","2025-02-12","SF FuneralF805210       250212","","126.5","","217230.48"
"2025-02-14","2025-02-12","SF FuneralF805929       250212","","126.5","","217356.98"
"2025-02-14","2025-02-12","SF FuneralFDC000000095B4250212","","126.5","","217483.48"
"2025-02-14","2025-02-12","SF FuneralF810689       250212","","126.5","","217609.98"
"2025-02-14","2025-02-12","SF FuneralF811172       250212","","126.5","","217736.48"
"2025-02-14","2025-02-12","SF FuneralF813364       250212","","126.5","","217862.98"
"2025-02-14","2025-02-12","SF FuneralF819285       250212","","126.5","","217989.48"
"2025-02-14","2025-02-12","SF FuneralF828835       250212","","126.5","","218115.98"
"2025-02-14","2025-02-12","SF FuneralF831904       250212","","126.5","","218242.48"
"2025-02-14","2025-02-12","SF FuneralF834047       250212","","126.5","","218368.98"
"2025-02-14","2025-02-12","SF FuneralF844667       250212","","126.5","","218495.48"
"2025-02-14","2025-02-12","SF FuneralFDC0000000HQB8250212","","126.5","","218621.98"
"2025-02-14","2025-02-12","SF FuneralF989967       250212","","126.5","","218748.48"
"2025-02-14","2025-02-12","SF FuneralF993528       250212","","126.5","","218874.98"
"2025-02-14","2025-02-12","SF FuneralF1017070      250212","","126.5","","219001.48"
"2025-02-14","2025-02-12","SF FuneralF1021345      250212","","126.5","","219127.98"
"2025-02-14","2025-02-12","SF FuneralF1054626      250212","","126.5","","219254.48"
"2025-02-14","2025-02-12","SF FuneralF1060602      250212","","126.5","","219380.98"
"2025-02-14","2025-02-12","SF FuneralF1060646      250212","","126.5","","219507.48"
"2025-02-14","2025-02-12","SF FuneralF1079269      250212","","31.63","","219539.11"
"2025-02-14","2025-02-12","SF FuneralF1103933      250212","","126.5","","219665.61"
"2025-02-14","2025-02-12","SF FuneralF1113569      250212","","126.5","","219792.11"
"2025-02-14","2025-02-12","SF FuneralF1115044      250212","","126.5","","219918.61"
"2025-02-14","2025-02-12","SF FuneralF1120815      250212","","31.63","","219950.24"
"2025-02-14","2025-02-12","SF FuneralF1127392      250212","","126.5","","220076.74"
"2025-02-14","2025-02-10","SF FuneralF1113793      250210","","126.5","","220203.24"
"2025-02-14","2025-02-10","SF FuneralFDC00000008MKX250210","","31.63","","220234.87"
"2025-02-14","2025-02-10","SF FuneralF822549       250210","","31.63","","220266.5"
"2025-02-14","2025-02-10","SF FuneralF1123277      250210","","31.63","","220298.13"
"2025-02-14","2025-02-11","SF FuneralFDC00000002QF4250211","","55","","220353.13"
"2025-02-14","2025-02-11","SF FuneralF794834       250211","","63.25","","220416.38"
"2025-02-14","2025-02-11","SF FuneralFDC00000009383250211","","31.63","","220448.01"
"2025-02-14","2025-02-11","SF FuneralF1078209      250211","","31.63","","220479.64"
"2025-02-14","2025-02-11","SF FuneralF1118892      250211","","31.63","","220511.27"
"2025-02-14","2025-02-11","SF FuneralF1127985      250211","","63.25","","220574.52"
"2025-02-14","2025-02-11","SF FuneralF1131657      250211","","31.63","","220606.15"
"2025-02-14","2025-02-12","SF FuneralFDC00000002XF4250212","","220","","220826.15"
"2025-02-14","2025-02-12","SF FuneralFDC00000005HT6250212","","126.5","","220952.65"
"2025-02-14","2025-02-12","SF FuneralFDC00000005LR0250212","","126.5","","221079.15"
"2025-02-14","2025-02-12","SF FuneralFDC00000005MZF250212","","126.5","","221205.65"
"2025-02-14","2025-02-12","SF FuneralFDC00000005NF1250212","","126.5","","221332.15"
"2025-02-14","2025-02-12","SF FuneralFDC00000005NTQ250212","","126.5","","221458.65"
"2025-02-14","2025-02-12","SF FuneralFDC00000005P8H250212","","126.5","","221585.15"
"2025-02-14","2025-02-12","SF FuneralFDC00000005X1L250212","","126.5","","221711.65"
"2025-02-14","2025-02-12","SF FuneralFDC00000005XR4250212","","126.5","","221838.15"
"2025-02-14","2025-02-12","SF FuneralFDC000000061PQ250212","","126.5","","221964.65"
"2025-02-14","2025-02-12","SF FuneralFDC000000061Q0250212","","126.5","","222091.15"
"2025-02-14","2025-02-12","SF FuneralFDC00000006F20250212","","126.5","","222217.65"
"2025-02-14","2025-02-12","SF FuneralFDC00000006GLM250212","","126.5","","222344.15"
"2025-02-14","2025-02-12","SF FuneralFDC00000006J8D250212","","126.5","","222470.65"
"2025-02-14","2025-02-12","SF FuneralFDC00000006J8J250212","","126.5","","222597.15"
"2025-02-14","2025-02-12","SF FuneralFDC00000006MTT250212","","126.5","","222723.65"
"2025-02-14","2025-02-12","SF FuneralFDC00000006RJW250212","","126.5","","222850.15"
"2025-02-14","2025-02-12","SF FuneralFDC00000006T4Z250212","","126.5","","222976.65"
"2025-02-14","2025-02-12","SF FuneralFDC00000006TH7250212","","126.5","","223103.15"
"2025-02-14","2025-02-12","SF FuneralFDC00000006V7G250212","","126.5","","223229.65"
"2025-02-14","2025-02-12","SF FuneralFDC00000007619250212","","126.5","","223356.15"
"2025-02-14","2025-02-12","SF FuneralFDC0000000780W250212","","126.5","","223482.65"
"2025-02-14","2025-02-12","SF FuneralFDC00000007G4Y250212","","126.5","","223609.15"
"2025-02-14","2025-02-12","SF FuneralFDC00000007H6L250212","","126.5","","223735.65"
"2025-02-14","2025-02-12","SF FuneralFDC000000080KX250212","","126.5","","223862.15"
"2025-02-14","2025-02-12","SF FuneralF800305       250212","","126.5","","223988.65"
"2025-02-14","2025-02-12","SF FuneralFDC00000008BBJ250212","","126.5","","224115.15"
"2025-02-14","2025-02-12","SF FuneralF802120       250212","","126.5","","224241.65"
"2025-02-14","2025-02-12","SF FuneralF805178       250212","","126.5","","224368.15"
"2025-02-14","2025-02-12","SF FuneralF807947       250212","","126.5","","224494.65"
"2025-02-14","2025-02-12","SF FuneralF808813       250212","","126.5","","224621.15"
"2025-02-14","2025-02-12","SF FuneralFDC000000096B5250212","","126.5","","224747.65"
"2025-02-14","2025-02-12","SF FuneralF779197       250212","","126.5","","224874.15"
"2025-02-14","2025-02-12","SF FuneralF816313       250212","","126.5","","225000.65"
"2025-02-14","2025-02-12","SF FuneralF819633       250212","","126.5","","225127.15"
"2025-02-14","2025-02-12","SF FuneralF822019       250212","","126.5","","225253.65"
"2025-02-14","2025-02-12","SF FuneralF822999       250212","","126.5","","225380.15"
"2025-02-14","2025-02-12","SF FuneralF830295       250212","","126.5","","225506.65"
"2025-02-14","2025-02-12","SF FuneralF830596       250212","","126.5","","225633.15"
"2025-02-14","2025-02-12","SF FuneralF830974       250212","","126.5","","225759.65"
"2025-02-14","2025-02-12","SF FuneralF831339       250212","","126.5","","225886.15"
"2025-02-14","2025-02-12","SF FuneralFDC0000000CWP5250212","","126.5","","226012.65"
"2025-02-14","2025-02-12","SF FuneralF834453       250212","","126.5","","226139.15"
"2025-02-14","2025-02-12","SF FuneralFDC0000000D2LH250212","","126.5","","226265.65"
"2025-02-14","2025-02-12","SF FuneralF843652       250212","","126.5","","226392.15"
"2025-02-14","2025-02-12","SF FuneralF844427       250212","","126.5","","226518.65"
"2025-02-14","2025-02-12","SF FuneralFDC0000000HM0V250212","","126.5","","226645.15"
"2025-02-14","2025-02-12","SF FuneralF988381       250212","","126.5","","226771.65"
"2025-02-14","2025-02-12","SF FuneralF1052140      250212","","126.5","","226898.15"
"2025-02-14","2025-02-12","SF FuneralF775909       250212","","191.5","","227089.65"
"2025-02-14","2025-02-12","SF FuneralFDC0000000LKQM250212","","126.5","","227216.15"
"2025-02-14","2025-02-12","SF FuneralFDC0000000MZNV250212","","126.5","","227342.65"
"2025-02-14","2025-02-12","SF FuneralF1120307      250212","","126.5","","227469.15"
"2025-02-14","2025-02-12","SF FuneralF1123596      250212","","126.5","","227595.65"
"2025-02-14","2025-02-12","SF FuneralF1124035      250212","","126.5","","227722.15"
"2025-02-14","2025-02-12","SF FuneralFDC0000000Q166250212","","126.5","","227848.65"
"2025-02-14","2025-02-12","SF FuneralFDC0000000Q168250212","","126.5","","227975.15"
"2025-02-14","2025-02-12","SF FuneralFDC0000000Q16C250212","","126.5","","228101.65"
"2025-02-14","2025-02-12","SF FuneralFDC0000000349Q250212","","220","","228321.65"
"2025-02-14","2025-02-12","SF FuneralF840696       250212","","126.5","","228448.15"
"2025-02-14","2025-02-12","SF FuneralF1033584      250212","","126.5","","228574.65"
"2025-02-14","2025-02-12","SF FuneralF1079367      250212","","126.5","","228701.15"
"2025-02-14","2025-02-12","SF FuneralF1114763      250212","","126.5","","228827.65"
"2025-02-14","2025-02-12","SF FuneralF1114796      250212","","126.5","","228954.15"
"2025-02-14","2025-02-13","SF FuneralFDC00000007D5Y250213","","126.5","","229080.65"
"2025-02-14","2025-02-14","SF FuneralF1131921      250214","","31.63","","229112.28"
"2025-02-14","2025-02-08","SF FuneralF1084288      250208","","31.63","","229143.91"
"2025-02-14","2025-02-10","SF FuneralFDC000000077L1250210","","63.25","","229207.16"
"2025-02-14","2025-02-10","SF FuneralFDC000000077LG250210","","110","","229317.16"
"2025-02-14","2025-02-10","SF FuneralFDC00000007R6J250210","","63.25","","229380.41"
"2025-02-14","2025-02-10","SF FuneralF1080529      250210","","31.63","","229412.04"
"2025-02-14","2025-02-10","SF FuneralFDC0000000MXS0250210","","63.25","","229475.29"
"2025-02-14","2025-02-10","SF FuneralF1124114      250210","","31.63","","229506.92"
"2025-02-14","2025-02-11","SF FuneralFDC00000006WKK250211","","31.63","","229538.55"
"2025-02-14","2025-02-11","SF FuneralFDC00000007CPB250211","","31.63","","229570.18"
"2025-02-14","2025-02-11","SF FuneralFDC00000008851250211","","31.63","","229601.81"
"2025-02-14","2025-02-11","SF FuneralF821545       250211","","47.88","","229649.69"
"2025-02-14","2025-02-11","SF FuneralF981653       250211","","63.25","","229712.94"
"2025-02-14","2025-02-11","SF FuneralF990255       250211","","31.63","","229744.57"
"2025-02-14","2025-02-11","SF FuneralF1060950      250211","","31.63","","229776.2"
"2025-02-14","2025-02-11","SF FuneralF1080286      250211","","31.63","","229807.83"
"2025-02-14","2025-02-11","SF FuneralF1114485      250211","","63.25","","229871.08"
"2025-02-14","2025-02-11","SF FuneralF1115105      250211","","31.63","","229902.71"
"2025-02-14","2025-02-11","SF FuneralF1122598      250211","","63.25","","229965.96"
"2025-02-14","2025-02-12","SF FuneralFDC000000031P9250212","","220","","230185.96"
"2025-02-14","2025-02-12","SF FuneralFDC00000005HSY250212","","126.5","","230312.46"
"2025-02-14","2025-02-12","SF FuneralFDC00000005J86250212","","126.5","","230438.96"
"2025-02-14","2025-02-12","SF FuneralFDC00000005J87250212","","126.5","","230565.46"
"2025-02-14","2025-02-12","SF FuneralFDC00000005JKG250212","","126.5","","230691.96"
"2025-02-14","2025-02-12","SF FuneralFDC00000005K6N250212","","126.5","","230818.46"
"2025-02-14","2025-02-12","SF FuneralFDC00000005KSH250212","","126.5","","230944.96"
"2025-02-14","2025-02-12","SF FuneralFDC00000005M1V250212","","126.5","","231071.46"
"2025-02-14","2025-02-12","SF FuneralFDC00000005MM8250212","","126.5","","231197.96"
"2025-02-14","2025-02-12","SF FuneralFDC00000005NZ7250212","","126.5","","231324.46"
"2025-02-14","2025-02-12","SF FuneralFDC00000005NZC250212","","126.5","","231450.96"
"2025-02-14","2025-02-12","SF FuneralFDC00000005TKX250212","","126.5","","231577.46"
"2025-02-14","2025-02-12","SF FuneralFDC00000005XR7250212","","126.5","","231703.96"
"2025-02-14","2025-02-12","SF FuneralFDC0000000615G250212","","126.5","","231830.46"
"2025-02-14","2025-02-12","SF FuneralFDC00000006BQ5250212","","126.5","","231956.96"
"2025-02-14","2025-02-12","SF FuneralFDC00000006L2B250212","","278.31","","232235.27"
"2025-02-14","2025-02-12","SF FuneralFDC00000006RDP250212","","126.5","","232361.77"
"2025-02-14","2025-02-12","SF FuneralFDC00000006W87250212","","126.5","","232488.27"
"2025-02-14","2025-02-12","SF FuneralFDC00000006WZJ250212","","126.5","","232614.77"
"2025-02-14","2025-02-12","SF FuneralFDC00000006ZDR250212","","126.5","","232741.27"
"2025-02-14","2025-02-12","SF FuneralFDC00000007HJD250212","","126.5","","232867.77"
"2025-02-14","2025-02-12","SF FuneralFDC00000007RCC250212","","126.5","","232994.27"
"2025-02-14","2025-02-12","SF FuneralFDC00000007ZRC250212","","126.5","","233120.77"
"2025-02-14","2025-02-12","SF FuneralFDC000000080CD250212","","126.5","","233247.27"
"2025-02-14","2025-02-12","SF FuneralF811281       250212","","126.5","","233373.77"
"2025-02-14","2025-02-12","SF FuneralF812983       250212","","126.5","","233500.27"
"2025-02-14","2025-02-12","SF FuneralF815267       250212","","126.5","","233626.77"
"2025-02-14","2025-02-12","SF FuneralF823270       250212","","126.5","","233753.27"
"2025-02-14","2025-02-12","SF FuneralFDC0000000BMHJ250212","","126.5","","233879.77"
"2025-02-14","2025-02-12","SF FuneralF829988       250212","","126.5","","234006.27"
"2025-02-14","2025-02-12","SF FuneralF833884       250212","","126.5","","234132.77"
"2025-02-14","2025-02-12","SF FuneralF843692       250212","","126.5","","234259.27"
"2025-02-14","2025-02-12","SF FuneralF990482       250212","","126.5","","234385.77"
"2025-02-14","2025-02-12","SF FuneralF1016906      250212","","126.5","","234512.27"
"2025-02-14","2025-02-12","SF FuneralF1016930      250212","","126.5","","234638.77"
"2025-02-14","2025-02-12","SF FuneralF1050816      250212","","126.5","","234765.27"
"2025-02-14","2025-02-12","SF FuneralF1050855      250212","","126.5","","234891.77"
"2025-02-14","2025-02-12","SF FuneralFDC0000000KGGJ250212","","126.5","","235018.27"
"2025-02-14","2025-02-12","SF FuneralF1116720      250212","","126.5","","235144.77"
"2025-02-14","2025-02-12","SF FuneralFDC0000000NPJ2250212","","126.5","","235271.27"
"2025-02-14","2025-02-12","SF FuneralF1118630      250212","","126.5","","235397.77"
"2025-02-14","2025-02-12","SF FuneralFDC0000000NPQ0250212","","126.5","","235524.27"
"2025-02-14","2025-02-14","SF FuneralFDC00000005M42250214","","220","","235744.27"
"2025-02-14","2025-02-14","SF FuneralFDC0000000628F250214","","31.63","","235775.9"
"2025-02-14","2025-02-14","SF FuneralFDC00000006P6D250214","","31.63","","235807.53"
"2025-02-14","2025-02-14","SF FuneralF993809       250214","","31.63","","235839.16"
"2025-02-14","2025-02-14","SF FuneralF993837       250214","","31.63","","235870.79"
"2025-02-14","2025-02-14","SF FuneralF1118340      250214","","63.25","","235934.04"
"2025-02-14","2025-02-14","SF FuneralF1128672      250214","","31.63","","235965.67"
"2025-02-14","2025-02-14","SF FuneralF829800       250214","","63.25","","236028.92"
"2025-02-14","2025-02-14","SF FuneralF803505       250214","","31.63","","236060.55"
"2025-02-14","2025-02-12","SF FuneralF1110730      250212","","126.5","","236187.05"
"2025-02-14","2025-01-30","Rev SF FuneralFDC00000003L0S250130","","-220","","235967.05"
"2025-02-14","2025-02-10","Rev SF FuneralFDC0000000KYZ5250210","","-31.63","","235935.42"
"2025-02-14","2025-02-11","Rev SF FuneralFDC000000079S6250211","","-31.63","","235903.79"
"2025-02-14","2025-02-12","Rev SF FuneralFDC0000000MRJY250212","","-126.5","","235777.29"
"2025-02-14","2025-02-12","Rev SF FuneralFDC0000000N9DG250212","","-126.5","","235650.79"
"2025-02-14","2025-02-12","Rev SF FuneralFDC0000000NBPX250212","","-126.5","","235524.29"
"2025-02-14","2025-01-22","Rev SF FuneralFDC0000000N2FJ250122","","-126.5","","235397.79"
"2025-02-14","2025-02-05","Rev SF FuneralFDC000000060TF250205","","-126.5","","235271.29"
"2025-02-14","2025-02-12","Rev SF FuneralFDC00000006VBW250212","","-126.5","","235144.79"
"2025-02-14","2025-02-12","Rev SF FuneralFDC00000006VDK250212","","-126.5","","235018.29"
"2025-02-14","2025-02-12","Rev SF FuneralFDC00000008BPL250212","","-126.5","","234891.79"
"2025-02-14","2025-02-10","Rev SF FuneralFDC00000007R5Z250210","","-63.25","","234828.54"
"2025-02-14","2025-02-12","Rev SF FuneralFDC000000043BV250212","","-220","","234608.54"
"2025-02-14","2025-02-12","Rev SF FuneralFDC00000008KSM250212","","-126.5","","234482.04"
"2025-02-14","2025-01-24","Rev SF FuneralFDC0000000PRPK250124","","-126.5","","234355.54"
"2025-02-14","2025-02-12","Rev SF FuneralFDC0000000P5F4250212","","-126.5","","234229.04"
"2025-02-14","2025-02-12","Rev SF FuneralFDC00000003D4T250212","","-220","","234009.04"
"2025-02-14","2025-02-12","Rev SF FuneralFDC000000070JJ250212","","-126.5","","233882.54"
"2025-02-14","2025-02-12","Rev SF FuneralFDC00000007FWM250212","","-126.5","","233756.04"
"2025-02-14","2025-02-12","Rev SF FuneralFDC00000006Q2Z250212","","-126.5","","233629.54"
"2025-02-14","2025-02-10","SF FuneralFDC00000006Q80250210","","31.63","","233661.17"
"2025-02-14","2025-02-11","SF FuneralF800205       250211","","31.63","","233692.8"
"2025-02-14","2025-02-11","SF FuneralFDC00000007333250211","","63.25","","233756.05"
"2025-02-14","2025-02-11","SF FuneralF990253       250211","","63.25","","233819.3"
"2025-02-14","2025-02-11","SF FuneralF991428       250211","","63.25","","233882.55"
"2025-02-14","2025-02-11","SF FuneralF1122765      250211","","63.25","","233945.8"
"2025-02-14","2025-02-11","SF FuneralF1124156      250211","","63.25","","234009.05"
"2025-02-14","2025-02-12","SF FuneralFDC00000005N1S250212","","126.5","","234135.55"
"2025-02-14","2025-02-12","SF FuneralFDC00000005SN0250212","","126.5","","234262.05"
"2025-02-14","2025-02-12","SF FuneralF820742       250212","","126.5","","234388.55"
"2025-02-14","2025-02-10","SF FuneralF1073425      250210","","31.63","","234420.18"
"2025-02-14","2025-02-10","SF FuneralF1123166      250210","","31.63","","234451.81"
"2025-02-14","2025-02-11","SF FuneralF831226       250211","","31.63","","234483.44"
"2025-02-14","2025-02-11","SF FuneralF841781       250211","","31.63","","234515.07"
"2025-02-14","2025-02-11","SF FuneralF992519       250211","","31.63","","234546.7"
"2025-02-14","2025-02-11","SF FuneralFDC0000000ND1S250211","","31.63","","234578.33"
"2025-02-14","2025-02-14","SF FuneralF841714       250214","","31.63","","234609.96"
"2025-02-14","2025-02-14","SF FuneralFDC0000000J2Y1250215","","31.63","","234641.59"
"2025-02-14","2025-02-11","SF FuneralF1054618      250211","","31.63","","234673.22"
"2025-02-14","2025-02-11","SF FuneralF1113963      250211","","31.63","","234704.85"
"2025-02-14","2025-02-11","SF FuneralFDC00000003V68250211","","55","","234759.85"
"2025-02-14","2025-02-11","SF FuneralFDC00000005NFK250211","","31.63","","234791.48"
"2025-02-14","2025-02-11","SF FuneralF819158       250211","","31.63","","234823.11"
"2025-02-14","2025-02-11","SF FuneralF989270       250211","","31.63","","234854.74"
"2025-02-14","2025-02-11","SF FuneralF990591       250211","","31.63","","234886.37"
"2025-02-14","2025-02-11","SF FuneralF1118338      250211","","31.63","","234918"
"2025-02-14","2025-02-11","SF FuneralFDC0000000NTBQ250211","","31.63","","234949.63"
"2025-02-14","2025-02-11","SF FuneralF1120133      250211","","31.63","","234981.26"
"2025-02-14","2025-02-11","SF FuneralF1127482      250211","","31.63","","235012.89"
"2025-02-14","2025-02-12","SF FuneralF989692       250212","","126.5","","235139.39"
"2025-02-14","2025-02-14","SF FuneralF1131924      250214","","31.63","","235171.02"
"2025-02-14","2024-12-27","Rev SF FuneralFDC000000032B1241227","","-220","","234951.02"
"2025-02-14","2024-11-27","Rev SF FuneralFDC000000032B1241127","","-220","","234731.02"
"2025-02-14","2025-01-27","Rev SF FuneralFDC000000032B1250127","","-220","","234511.02"
"2025-02-14","2024-07-27","Rev SF FuneralFDC000000032B1240727","","-220","","234291.02"
"2025-02-14","2024-06-27","Rev SF FuneralFDC000000032B1240627","","-220","","234071.02"
"2025-02-14","2024-10-28","Rev SF FuneralFDC000000032B1241027","","-220","","233851.02"
"2025-02-14","2025-02-06","SF FuneralFDC000000063DX250206","","126.5","","233977.52"
"2025-02-14","2025-02-11","SF FuneralFDC00000006042250211","","63.25","","234040.77"
"2025-02-14","2025-02-11","SF FuneralFDC0000000HX1F250211","","63.25","","234104.02"
"2025-02-14","2025-02-11","SF FuneralF1074872      250211","","63.25","","234167.27"
"2025-02-14","2025-02-12","SF FuneralFDC00000008T6X250212","","126.5","","234293.77"
"2025-02-14","2025-02-10","SF FuneralF830092       250210","","126.5","","234420.27"
"2025-02-14","2025-02-10","SF FuneralF843842       250210","","63.25","","234483.52"
"2025-02-14","2025-02-11","SF FuneralF990180       250211","","31.63","","234515.15"
"2025-02-14","2025-02-11","SF FuneralF1065770      250211","","63.25","","234578.4"
"2025-02-14","2025-02-11","SF FuneralF1065831      250211","","63.25","","234641.65"
"2025-02-14","2025-02-12","SF FuneralF844032       250212","","126.5","","234768.15"
"2025-02-14","2025-02-11","SF FuneralF811790       250211","","31.63","","234799.78"
"2025-02-14","2025-02-11","SF FuneralF830023       250211","","31.63","","234831.41"
"2025-02-14","2025-02-11","SF FuneralF989148       250211","","31.63","","234863.04"
"2025-02-14","2025-02-11","SF FuneralF991480       250211","","31.63","","234894.67"
"2025-02-14","2025-02-11","SF FuneralF1067990      250211","","31.63","","234926.3"
"2025-02-14","2025-02-11","SF FuneralF1079178      250211","","31.63","","234957.93"
"2025-02-14","2025-02-11","SF FuneralF1079259      250211","","31.63","","234989.56"
"2025-02-14","2025-02-11","SF FuneralFDC0000000N8G1250211","","31.63","","235021.19"
"2025-02-14","2025-02-14","SF FuneralFDC00000006B8Q250214","","31.63","","235052.82"
"2025-02-14","2025-02-14","SF FuneralFDC00000006B9H250214","","31.63","","235084.45"
"2025-02-14","2025-02-08","SF FuneralF1116780      250208","","63.25","","235147.7"
"2025-02-14","2025-02-10","SF FuneralF813447       250210","","63.25","","235210.95"
"2025-02-14","2025-02-11","SF FuneralFDC00000005GGL250211","","63.25","","235274.2"
"2025-02-14","2025-02-11","SF FuneralFDC00000008BNG250211","","126.5","","235400.7"
"2025-02-14","2025-02-11","SF FuneralF830100       250211","","63.25","","235463.95"
"2025-02-14","2025-02-11","SF FuneralF830783       250211","","63.25","","235527.2"
"2025-02-14","2025-02-11","SF FuneralF1068058      250211","","63.25","","235590.45"
"2025-02-14","2025-02-11","SF FuneralF1123396      250211","","63.25","","235653.7"
"2025-02-14","2025-02-11","SF FuneralF1129094      250211","","63.25","","235716.95"
"2025-02-14","2025-02-12","SF FuneralFDC00000005KF0250212","","126.5","","235843.45"
"2025-02-14","2025-02-12","SF FuneralF814918       250212","","126.5","","235969.95"
"2025-02-14","2025-02-12","SF FuneralF834372       250212","","126.5","","236096.45"
"2025-02-14","2025-02-12","SF FuneralF1079086      250212","","126.5","","236222.95"
"2025-02-14","2025-02-12","SF FuneralF1104188      250212","","126.5","","236349.45"
"2025-02-14","2025-02-11","SF FuneralFDC00000006CWD250211","","55","","236404.45"
"2025-02-14","2025-02-11","SF FuneralF989085       250211","","31.63","","236436.08"
"2025-02-14","2025-02-12","SF FuneralFDC00000009LXN250212","","126.5","","236562.58"
"2025-02-14","2025-02-11","SF FuneralF820981       250211","","63.25","","236625.83"
"2025-02-14","2025-02-10","SF FuneralFDC00000005NWL250210","","31.63","","236657.46"
"2025-02-14","2025-02-10","SF FuneralFDC00000005NX7250210","","31.63","","236689.09"
"2025-02-14","2025-02-11","SF FuneralFDC000000030DF250211","","55","","236744.09"
"2025-02-14","2025-02-11","SF FuneralFDC00000006X91250211","","31.63","","236775.72"
"2025-02-14","2025-02-11","SF FuneralF1052659      250211","","31.63","","236807.35"
"2025-02-14","2025-02-11","SF FuneralF1110073      250211","","63.25","","236870.6"
"2025-02-14","2025-02-14","SF FuneralFDC000000070CD250214","","31.63","","236902.23"
"2025-02-14","2025-02-14","SF FuneralF1112474      250214","","63.25","","236965.48"
"2025-02-14","2025-02-10","SF FuneralFDC0000000831X250209","","63.25","","237028.73"
"2025-02-14","2025-02-10","SF FuneralFDC0000000832F250209","","63.25","","237091.98"
"2025-02-14","2025-02-10","SF FuneralF808988       250210","","31.63","","237123.61"
"2025-02-14","2025-02-10","SF FuneralF991385       250210","","31.63","","237155.24"
"2025-02-14","2025-02-10","SF FuneralF1113979      250210","","63.25","","237218.49"
"2025-02-14","2025-02-11","SF FuneralFDC00000005N64250211","","63.25","","237281.74"
"2025-02-14","2025-02-11","SF FuneralFDC00000005X2M250211","","31.63","","237313.37"
"2025-02-14","2025-02-11","SF FuneralFDC000000064RZ250211","","63.25","","237376.62"
"2025-02-14","2025-02-11","SF FuneralFDC000000073P4250211","","31.63","","237408.25"
"2025-02-14","2025-02-11","SF FuneralF811437       250211","","63.25","","237471.5"
"2025-02-14","2025-02-11","SF FuneralF812125       250211","","31.63","","237503.13"
"2025-02-14","2025-02-11","SF FuneralF813552       250211","","31.63","","237534.76"
"2025-02-14","2025-02-11","SF FuneralF820929       250211","","31.63","","237566.39"
"2025-02-14","2025-02-11","SF FuneralF988005       250211","","31.63","","237598.02"
"2025-02-14","2025-02-11","SF FuneralF991415       250211","","31.63","","237629.65"
"2025-02-14","2025-02-11","SF FuneralF1020608      250211","","31.63","","237661.28"
"2025-02-14","2025-02-11","SF FuneralF1033680      250211","","31.63","","237692.91"
"2025-02-14","2025-02-11","SF FuneralF1052117      250211","","63.25","","237756.16"
"2025-02-14","2025-02-11","SF FuneralF1060838      250211","","31.63","","237787.79"
"2025-02-14","2025-02-11","SF FuneralF1061865      250211","","31.63","","237819.42"
"2025-02-14","2025-02-11","SF FuneralF1062646      250211","","31.63","","237851.05"
"2025-02-14","2025-02-11","SF FuneralF1067947      250211","","63.25","","237914.3"
"2025-02-14","2025-02-11","SF FuneralFDC0000000LK43250211","","31.63","","237945.93"
"2025-02-14","2025-02-11","SF FuneralFDC0000000LVMD250211","","31.63","","237977.56"
"2025-02-14","2025-02-11","SF FuneralF1113987      250211","","31.63","","238009.19"
"2025-02-14","2025-02-11","SF FuneralF1116010      250211","","31.63","","238040.82"
"2025-02-14","2025-02-11","SF FuneralF1118471      250211","","31.63","","238072.45"
"2025-02-14","2025-02-11","SF FuneralF1120149      250211","","63.25","","238135.7"
"2025-02-14","2025-02-11","SF FuneralF1120220      250211","","63.25","","238198.95"
"2025-02-14","2025-02-11","SF FuneralF1129417      250211","","31.63","","238230.58"
"2025-02-14","2025-02-12","SF FuneralFDC00000005PXB250212","","126.5","","238357.08"
"2025-02-14","2025-02-12","SF FuneralFDC000000060ZD250212","","126.5","","238483.58"
"2025-02-14","2025-02-12","SF FuneralFDC00000007SPS250212","","63.25","","238546.83"
"2025-02-14","2025-02-12","SF FuneralFDC000000082MV250212","","126.5","","238673.33"
"2025-02-14","2025-02-12","SF FuneralFDC00000008BF0250212","","126.5","","238799.83"
"2025-02-14","2025-02-12","SF FuneralF810249       250212","","126.5","","238926.33"
"2025-02-14","2025-02-12","SF FuneralF822156       250212","","126.5","","239052.83"
"2025-02-14","2025-02-12","SF FuneralF1017477      250212","","126.5","","239179.33"
"2025-02-14","2025-02-12","SF FuneralF1052436      250212","","126.5","","239305.83"
"2025-02-14","2025-02-12","SF FuneralF1073356      250212","","126.5","","239432.33"
"2025-02-14","2025-02-12","SF FuneralF1119711      250212","","126.5","","239558.83"
"2025-02-14","2025-02-13","SF FuneralFDC00000007QNC250213","","126.5","","239685.33"
"2025-02-14","2025-02-14","SF FuneralF811119       250214","","31.63","","239716.96"
"2025-02-14","2025-02-14","SF FuneralF834570       250214","","31.63","","239748.59"
"2025-02-14","2024-12-11","Rev SF FuneralF989096       241227","","-126.5","","239622.09"
"2025-02-14","2025-02-12","Rev SF FuneralFDC00000005L52250212","","-126.5","","239495.59"
"2025-02-14","2025-02-12","Rev SF FuneralFDC00000005L3N250212","","-126.5","","239369.09"
"2025-02-14","2025-02-12","Rev SF FuneralFDC00000005XGH250212","","-126.5","","239242.59"
"2025-02-14","2025-02-12","Rev SF FuneralFDC0000000P45S250212","","-126.5","","239116.09"
"2025-02-14","2025-02-12","Rev SF FuneralFDC0000000HQH2250212","","-126.5","","238989.59"
"2025-02-14","2025-02-12","Rev SF FuneralFDC00000005N1S250212","","-126.5","","238863.09"
"2025-02-14","2025-02-12","Rev SF FuneralFDC0000000JGBQ250212","","-126.5","","238736.59"
"2025-02-14","2025-02-12","Rev SF FuneralFDC00000005QYJ250212","","-126.5","","238610.09"
"2025-02-14","2025-02-12","Rev SF FuneralFDC0000000DRNV250212","","-126.5","","238483.59"
"2025-02-14","2025-02-12","Rev SF FuneralFDC00000005SN0250212","","-126.5","","238357.09"
"2025-02-14","2025-02-12","Rev SF FuneralFDC0000000CWP7250212","","-126.5","","238230.59"
"2025-02-14","2025-02-12","Rev SF FuneralFDC00000008BF0250212","","-126.5","","238104.09"
"2025-02-14","2025-02-12","Rev SF FuneralFDC00000006V6Y250212","","-213.31","","237890.78"
"2025-02-14","2024-12-11","Rev SF FuneralF1125297      241228","","-126.5","","237764.28"
"2025-02-14","2025-02-11","Rev SF FuneralFDC00000005N64250211","","-63.25","","237701.03"
"2025-02-14","2025-02-12","Rev SF FuneralFDC00000005HXT250212","","-126.5","","237574.53"
"2025-02-14","2025-02-12","Rev SF FuneralFDC00000005K68250212","","-126.5","","237448.03"
"2025-02-14","2025-02-12","Rev SF FuneralFDC00000007CFW250212","","-126.5","","237321.53"
"2025-02-14","2025-02-12","Rev SF FuneralFDC0000000D000250212","","-126.5","","237195.03"
"2025-02-14","2025-02-12","Rev SF FuneralFDC0000000FLWY250212","","-126.5","","237068.53"
"2025-02-14","2025-02-12","Rev SF FuneralFDC0000000G606250212","","-126.5","","236942.03"
"2025-02-14","2025-01-24","Rev SF FuneralF989096       250127","","-126.5","","236815.53"
"2025-02-14","2025-01-24","Rev SF FuneralF1125297      250128","","-126.5","","236689.03"
"2025-02-14","2025-02-10","Rev SF FuneralFDC00000005NT1250210","","-31.63","","236657.4"
"2025-02-14","2025-02-14","Rev SF FuneralFDC00000006B9H250214","","-31.63","","236625.77"
"2025-02-14","2025-02-14","Rev SF FuneralFDC00000006B8Q250214","","-31.63","","236594.14"
"2025-02-14","2025-02-11","Rev SF FuneralFDC0000000NRVB250211","","-31.63","","236562.51"
"2025-02-14","2025-01-31","Rev SF FuneralFDC00000006B8Q250131","","-31.63","","236530.88"
"2025-02-14","2025-01-31","Rev SF FuneralFDC00000006B9H250131","","-31.63","","236499.25"
"2025-02-14","2025-02-14","Rev SF FuneralFDC0000000PK3S250214","","-31.63","","236467.62"
"2025-02-14","2025-02-14","Rev SF FuneralFDC0000000KLCD250214","","-31.63","","236435.99"
"2025-02-14","2025-02-14","Rev SF FuneralFDC0000000L3MT250214","","-31.63","","236404.36"
"2025-02-14","2025-02-11","SF FuneralFDC00000008C4Y250211","","63.25","","236467.61"
"2025-02-14","2025-02-11","SF FuneralF809435       250211","","31.63","","236499.24"
"2025-02-14","2025-02-11","SF FuneralFDC00000009H46250211","","31.63","","236530.87"
"2025-02-14","2025-02-11","SF FuneralF986694       250211","","31.63","","236562.5"
"2025-02-14","2025-02-11","SF FuneralF987161       250211","","63.25","","236625.75"
"2025-02-14","2025-02-11","SF FuneralFDC0000000J23L250211","","31.63","","236657.38"
"2025-02-14","2025-02-11","SF FuneralF1022115      250211","","31.63","","236689.01"
"2025-02-14","2025-02-11","SF FuneralF843649       250211","","31.63","","236720.64"
"2025-02-14","2025-02-11","SF FuneralF1061075      250211","","31.63","","236752.27"
"2025-02-14","2025-02-11","SF FuneralF1068023      250211","","31.63","","236783.9"
"2025-02-14","2025-02-11","SF FuneralF1111329      250211","","31.63","","236815.53"
"2025-02-14","2025-02-11","SF FuneralF1111658      250211","","63.25","","236878.78"
"2025-02-14","2025-02-11","SF FuneralF1117702      250211","","31.63","","236910.41"
"2025-02-14","2025-02-11","SF FuneralF820999       250211","","31.63","","236942.04"
"2025-02-14","2025-02-11","SF FuneralF1123172      250211","","31.63","","236973.67"
"2025-02-14","2025-02-11","SF FuneralF1125142      250211","","31.63","","237005.3"
"2025-02-14","2025-02-11","SF FuneralF990319       250211","","160.75","","237166.05"
"2025-02-14","2025-02-11","SF FuneralF1130345      250211","","31.63","","237197.68"
"2025-02-14","2025-02-13","SF FuneralF1117678      250213","","126.5","","237324.18"
"2025-02-14","2025-02-12","SF FuneralFDC00000003WRN250212","","220","","237544.18"
"2025-02-14","2025-02-12","SF FuneralFDC0000000BF0Y250212","","126.5","","237670.68"
"2025-02-14","2025-02-12","SF FuneralFDC0000000FR7L250212","","126.5","","237797.18"
"2025-02-14","2025-02-12","SF FuneralF1020960      250212","","63.25","","237860.43"
"2025-02-14","2025-02-12","SF FuneralF1022075      250212","","126.5","","237986.93"
"2025-02-14","2025-02-12","SF FuneralF1072688      250212","","126.5","","238113.43"
"2025-02-14","2025-02-12","SF FuneralFDC0000000NC64250212","","126.5","","238239.93"
"2025-02-14","2025-02-12","SF FuneralF1127671      250212","","126.5","","238366.43"
"2025-02-14","2025-02-12","SF FuneralF1129247      250212","","126.5","","238492.93"
"2025-02-14","2025-02-12","SF FuneralF1129256      250212","","126.5","","238619.43"
"2025-02-14","2025-02-10","SF FuneralFDC0000000CSY7250210","","31.63","","238651.06"
"2025-02-14","2025-02-10","SF FuneralFDC00000007FPS250210","","31.63","","238682.69"
"2025-02-14","2025-02-10","SF FuneralFDC00000007M33250210","","126.5","","238809.19"
"2025-02-14","2025-02-11","SF FuneralFDC00000005P4K250211","","31.63","","238840.82"
"2025-02-14","2025-02-11","SF FuneralF1068068      250211","","63.25","","238904.07"
"2025-02-14","2025-02-11","SF FuneralF1129047      250211","","63.25","","238967.32"
"2025-02-14","2025-02-11","SF FuneralF1130346      250211","","31.63","","238998.95"
"2025-02-14","2025-02-12","SF FuneralFDC00000005P9M250212","","126.5","","239125.45"
"2025-02-14","2025-02-12","SF FuneralFDC00000009R3K250212","","126.5","","239251.95"
"2025-02-14","2025-02-12","SF FuneralF1124778      250212","","126.5","","239378.45"
"2025-02-14","2025-02-09","SF FuneralF803603       250209","","126.5","","239504.95"
"2025-02-14","2025-02-09","SF FuneralF804360       250209","","126.5","","239631.45"
"2025-02-14","2025-02-09","SF FuneralF804555       250209","","126.5","","239757.95"
"2025-02-14","2025-02-14","SF FuneralF990378       250214","","31.63","","239789.58"
"2025-02-14","2024-12-11","Rev SF FuneralF1118958      241228","","-126.5","","239663.08"
"2025-02-14","2025-01-24","Rev SF FuneralF1118958      250128","","-126.5","","239536.58"
"2025-02-15","2025-02-08","SF FuneralFDC0000000P3KC250209","","126.5","","239663.08"
"2025-02-15","2025-02-14","SF FuneralFDC00000005VPZ250214","","31.63","","239694.71"
"2025-02-15","2025-02-14","SF FuneralF798583       250214","","31.63","","239726.34"
"2025-02-15","2025-02-12","SF FuneralFDC00000005L1J250212","","126.5","","239852.84"
"2025-02-15","2025-02-12","SF FuneralFDC00000005N7C250212","","126.5","","239979.34"
"2025-02-15","2025-02-12","SF FuneralFDC000000075Y5250212","","126.5","","240105.84"
"2025-02-15","2025-02-12","SF FuneralFDC00000007JJ1250212","","126.5","","240232.34"
"2025-02-15","2025-02-12","SF FuneralFDC00000007ZRT250212","","126.5","","240358.84"
"2025-02-15","2025-02-12","SF FuneralF810325       250212","","126.5","","240485.34"
"2025-02-15","2025-02-12","SF FuneralF1126239      250212","","126.5","","240611.84"
"2025-02-15","2025-02-12","SF FuneralF1129357      250212","","126.5","","240738.34"
"2025-02-15","2025-02-12","SF FuneralF1129408      250212","","126.5","","240864.84"
"2025-02-15","2025-02-12","SF FuneralF1129968      250212","","126.5","","240991.34"
"2025-02-15","2025-02-12","SF FuneralF1131000      250212","","126.5","","241117.84"
"2025-02-15","2025-02-10","SF FuneralF834709       250210","","63.25","","241181.09"
"2025-02-15","2025-02-11","SF FuneralFDC00000005P6R250211","","63.25","","241244.34"
"2025-02-15","2025-02-11","SF FuneralFDC00000006B9G250211","","31.63","","241275.97"
"2025-02-15","2025-02-11","SF FuneralF832776       250211","","63.25","","241339.22"
"2025-02-15","2025-02-11","SF FuneralF1016973      250211","","31.63","","241370.85"
"2025-02-15","2025-02-11","SF FuneralF1020439      250211","","63.25","","241434.1"
"2025-02-15","2025-02-11","SF FuneralF1022184      250211","","31.63","","241465.73"
"2025-02-15","2025-02-11","SF FuneralF1110349      250211","","31.63","","241497.36"
"2025-02-15","2025-02-11","SF FuneralF1122862      250211","","31.63","","241528.99"
"2025-02-15","2025-02-11","SF FuneralF1123027      250211","","31.63","","241560.62"
"2025-02-15","2025-02-07","SF FuneralF991908       250207","","126.5","","241687.12"
"2025-02-15","2025-02-10","SF FuneralFDC00000006N0H250210","","126.5","","241813.62"
"2025-02-15","2025-02-10","SF FuneralF804824       250209","","126.5","","241940.12"
"2025-02-15","2025-02-10","SF FuneralF832096       250209","","31.63","","241971.75"
"2025-02-15","2025-02-10","SF FuneralF1103857      250210","","31.63","","242003.38"
"2025-02-15","2025-02-11","SF FuneralFDC000000067FT250211","","63.25","","242066.63"
"2025-02-15","2025-02-11","SF FuneralFDC00000006Y7S250211","","31.63","","242098.26"
"2025-02-15","2025-02-11","SF FuneralFDC00000009CP1250211","","95.75","","242194.01"
"2025-02-15","2025-02-11","SF FuneralF813480       250211","","63.25","","242257.26"
"2025-02-15","2025-02-11","SF FuneralF833123       250211","","31.63","","242288.89"
"2025-02-15","2025-02-11","SF FuneralFDC0000000CWJT250211","","63.25","","242352.14"
"2025-02-15","2025-02-11","SF FuneralF987244       250211","","31.63","","242383.77"
"2025-02-15","2025-02-11","SF FuneralF1017666      250211","","31.63","","242415.4"
"2025-02-15","2025-02-11","SF FuneralF1021955      250211","","63.25","","242478.65"
"2025-02-15","2025-02-11","SF FuneralF1050698      250211","","31.63","","242510.28"
"2025-02-15","2025-02-11","SF FuneralF1068027      250211","","31.63","","242541.91"
"2025-02-15","2025-02-11","SF FuneralF1072724      250211","","31.63","","242573.54"
"2025-02-15","2025-02-11","SF FuneralF1072850      250211","","63.25","","242636.79"
"2025-02-15","2025-02-11","SF FuneralFDC0000000L20G250211","","126.5","","242763.29"
"2025-02-15","2025-02-11","SF FuneralF1073209      250211","","126.5","","242889.79"
"2025-02-15","2025-02-11","SF FuneralF1073379      250211","","31.63","","242921.42"
"2025-02-15","2025-02-11","SF FuneralF1073746      250211","","31.63","","242953.05"
"2025-02-15","2025-02-11","SF FuneralF1074598      250211","","31.63","","242984.68"
"2025-02-15","2025-02-11","SF FuneralF1078528      250211","","63.25","","243047.93"
"2025-02-15","2025-02-11","SF FuneralF1080351      250211","","63.25","","243111.18"
"2025-02-15","2025-02-11","SF FuneralF1083711      250211","","63.25","","243174.43"
"2025-02-15","2025-02-11","SF FuneralF1113741      250211","","31.63","","243206.06"
"2025-02-15","2025-02-11","SF FuneralF1124768      250211","","63.25","","243269.31"
"2025-02-15","2025-02-11","SF FuneralFDC0000000PJX8250211","","31.63","","243300.94"
"2025-02-15","2025-02-11","SF FuneralF1127919      250211","","63.25","","243364.19"
"2025-02-15","2025-02-11","SF FuneralF1131798      250211","","31.63","","243395.82"
"2025-02-15","2025-02-12","SF FuneralFDC00000003MLH250212","","220","","243615.82"
"2025-02-15","2025-02-12","SF FuneralFDC00000006VYC250212","","126.5","","243742.32"
"2025-02-15","2025-02-12","SF FuneralFDC00000006VZG250212","","126.5","","243868.82"
"2025-02-15","2025-02-12","SF FuneralFDC0000000718V250212","","126.5","","243995.32"
"2025-02-15","2025-02-12","SF FuneralFDC00000007H16250212","","126.5","","244121.82"
"2025-02-15","2025-02-12","SF FuneralFDC00000007KNK250212","","126.5","","244248.32"
"2025-02-15","2025-02-12","SF FuneralF818782       250212","","126.5","","244374.82"
"2025-02-15","2025-02-12","SF FuneralF822974       250212","","126.5","","244501.32"
"2025-02-15","2025-02-12","SF FuneralF830628       250212","","126.5","","244627.82"
"2025-02-15","2025-02-12","SF FuneralF844482       250212","","126.5","","244754.32"
"2025-02-15","2025-02-12","SF FuneralF989765       250212","","126.5","","244880.82"
"2025-02-15","2025-02-12","SF FuneralFDC0000000J3WX250212","","126.5","","245007.32"
"2025-02-15","2025-02-12","SF FuneralF1052331      250212","","126.5","","245133.82"
"2025-02-15","2025-02-12","SF FuneralFDC0000000LM22250212","","126.5","","245260.32"
"2025-02-15","2025-02-12","SF FuneralF1111327      250212","","126.5","","245386.82"
"2025-02-15","2025-02-12","SF FuneralF1128076      250212","","63.25","","245450.07"
"2025-02-15","2025-02-12","SF FuneralF1131004      250212","","126.5","","245576.57"
"2025-02-15","2025-02-13","SF FuneralFDC00000005MHW250213","","126.5","","245703.07"
"2025-02-15","2025-02-13","SF FuneralF987792       250213","","126.5","","245829.57"
"2025-02-15","2025-02-13","SF FuneralF1111341      250213","","126.5","","245956.07"
"2025-02-15","2025-02-14","SF FuneralF847452       250214","","31.63","","245987.7"
"2025-02-15","2025-02-14","SF FuneralF1126287      250214","","31.63","","246019.33"
"2025-02-15","2025-02-10","SF FuneralFDC000000034JS250210","","110","","246129.33"
"2025-02-15","2025-02-12","SF FuneralFDC00000007G41250212","","126.5","","246255.83"
"2025-02-15","2025-02-12","SF FuneralFDC00000007ZR6250212","","126.5","","246382.33"
"2025-02-15","2025-02-10","SF FuneralFDC000000069C5250210","","31.63","","246413.96"
"2025-02-15","2025-02-10","SF FuneralF810327       250210","","31.63","","246445.59"
"2025-02-15","2025-02-10","SF FuneralF1079340      250210","","31.63","","246477.22"
"2025-02-15","2025-02-11","SF FuneralFDC000000064P9250211","","31.63","","246508.85"
"2025-02-15","2025-02-11","SF FuneralFDC00000008G43250211","","31.63","","246540.48"
"2025-02-15","2025-02-11","SF FuneralF805200       250211","","31.63","","246572.11"
"2025-02-15","2025-02-11","SF FuneralF817682       250211","","31.63","","246603.74"
"2025-02-15","2025-02-11","SF FuneralFDC0000000CWFK250211","","31.63","","246635.37"
"2025-02-15","2025-02-11","SF FuneralF1020683      250211","","31.63","","246667"
"2025-02-15","2025-02-11","SF FuneralF1115225      250211","","31.63","","246698.63"
"2025-02-15","2025-02-11","SF FuneralF1123030      250211","","31.63","","246730.26"
"2025-02-15","2025-02-11","SF FuneralF1130616      250211","","31.63","","246761.89"
"2025-02-15","2025-02-12","SF FuneralF844042       250212","","31.63","","246793.52"
"2025-02-15","2025-02-12","SF FuneralF1129376      250212","","31.63","","246825.15"
"2025-02-15","2025-02-14","SF FuneralF813030       250214","","31.63","","246856.78"
"2025-02-15","2025-02-08","SF FuneralFDC0000000752S250208","","63.25","","246920.03"
"2025-02-15","2025-02-10","SF FuneralFDC000000037KM250210","","220","","247140.03"
"2025-02-15","2025-02-10","SF FuneralF803601       250209","","126.5","","247266.53"
"2025-02-15","2025-02-10","SF FuneralF804527       250209","","126.5","","247393.03"
"2025-02-15","2025-02-11","SF FuneralF1083636      250211","","63.25","","247456.28"
"2025-02-15","2025-02-11","SF FuneralF1085191      250211","","63.25","","247519.53"
"2025-02-15","2025-02-11","SF FuneralF1127561      250211","","63.25","","247582.78"
"2025-02-15","2025-02-12","SF FuneralF833962       250212","","126.5","","247709.28"
"2025-02-15","2025-02-12","SF FuneralF844243       250212","","126.5","","247835.78"
"2025-02-15","2025-02-12","SF FuneralF1104171      250212","","191.5","","248027.28"
"2025-02-15","2025-02-12","SF FuneralF1126155      250212","","126.5","","248153.78"
"2025-02-15","2025-02-11","SF FuneralF821871       250211","","63.25","","248217.03"
"2025-02-15","2025-02-11","SF FuneralF993377       250211","","63.25","","248280.28"
"2025-02-15","2025-02-11","SF FuneralF1073187      250211","","126.5","","248406.78"
"2025-02-15","2025-02-11","SF FuneralF1118010      250211","","63.25","","248470.03"
"2025-02-15","2025-02-12","SF FuneralFDC000000035CW250212","","220","","248690.03"
"2025-02-15","2025-02-12","SF FuneralFDC00000005RQ7250212","","126.5","","248816.53"
"2025-02-15","2025-02-12","SF FuneralFDC00000005VF8250212","","126.5","","248943.03"
"2025-02-15","2025-02-12","SF FuneralF800330       250212","","126.5","","249069.53"
"2025-02-15","2025-02-12","SF FuneralF810293       250212","","126.5","","249196.03"
"2025-02-15","2025-02-12","SF FuneralF810930       250212","","126.5","","249322.53"
"2025-02-15","2025-02-12","SF FuneralF818481       250212","","126.5","","249449.03"
"2025-02-15","2025-02-12","SF FuneralF819141       250212","","126.5","","249575.53"
"2025-02-15","2025-02-12","SF FuneralFDC0000000B3G4250212","","126.5","","249702.03"
"2025-02-15","2025-02-12","SF FuneralF844153       250212","","126.5","","249828.53"
"2025-02-15","2025-02-12","SF FuneralF844166       250212","","126.5","","249955.03"
"2025-02-15","2025-02-12","SF FuneralF981146       250212","","126.5","","250081.53"
"2025-02-15","2025-02-12","SF FuneralF986932       250212","","126.5","","250208.03"
"2025-02-15","2025-02-12","SF FuneralFDC0000000L1WJ250212","","126.5","","250334.53"
"2025-02-15","2025-02-12","SF FuneralF1073393      250212","","126.5","","250461.03"
"2025-02-15","2025-02-12","SF FuneralF1111673      250212","","126.5","","250587.53"
"2025-02-15","2025-02-12","SF FuneralF1115094      250212","","126.5","","250714.03"
"2025-02-15","2025-02-12","SF FuneralF1118580      250212","","126.5","","250840.53"
"2025-02-15","2025-02-12","SF FuneralF1120144      250212","","126.5","","250967.03"
"2025-02-15","2025-02-12","SF FuneralF1124339      250212","","126.5","","251093.53"
"2025-02-15","2025-02-12","SF FuneralFDC0000000PN9W250212","","126.5","","251220.03"
"2025-02-15","2025-02-12","SF FuneralFDC0000000PN9Y250212","","126.5","","251346.53"
"2025-02-15","2025-02-12","SF FuneralF1129228      250212","","126.5","","251473.03"
"2025-02-15","2025-02-12","SF FuneralF823992       250212","","126.5","","251599.53"
"2025-02-15","2025-02-12","SF FuneralF1129504      250212","","126.5","","251726.03"
"2025-02-15","2025-02-13","SF FuneralFDC0000000J05W250213","","126.5","","251852.53"
"2025-02-15","2025-02-13","SF FuneralF810417       250213","","126.5","","251979.03"
"2025-02-15","2025-02-10","SF FuneralFDC0000000F7T2250210","","31.63","","252010.66"
"2025-02-15","2025-02-11","SF FuneralF813326       250211","","31.63","","252042.29"
"2025-02-15","2025-02-11","SF FuneralF833890       250211","","31.63","","252073.92"
"2025-02-15","2025-02-11","SF FuneralF834882       250211","","31.63","","252105.55"
"2025-02-15","2025-02-11","SF FuneralF1104234      250211","","31.63","","252137.18"
"2025-02-15","2025-02-15","SF FuneralF814211       250215","","31.63","","252168.81"
"2025-02-15","2025-02-15","SF FuneralF832932       250215","","31.63","","252200.44"
"2025-02-15","2025-02-15","SF FuneralF1084539      250216","","31.63","","252232.07"
"2025-02-15","2025-02-15","SF FuneralF1120593      250216","","31.63","","252263.7"
"2025-02-15","2025-02-15","SF FuneralFDC0000000PZBG250216","","31.63","","252295.33"
"2025-02-15","2025-02-08","SF FuneralF1127847      250209","","63.25","","252358.58"
"2025-02-15","2025-02-10","SF FuneralF1118370      250210","","63.25","","252421.83"
"2025-02-15","2025-02-11","SF FuneralF822981       250211","","126.5","","252548.33"
"2025-02-15","2025-02-12","SF FuneralFDC00000007J4Y250212","","126.5","","252674.83"
"2025-02-15","2025-02-12","SF FuneralFDC000000080C0250212","","126.5","","252801.33"
"2025-02-15","2025-02-12","SF FuneralF801084       250212","","126.5","","252927.83"
"2025-02-15","2025-02-12","SF FuneralF810150       250212","","126.5","","253054.33"
"2025-02-15","2025-02-12","SF FuneralF819514       250212","","126.5","","253180.83"
"2025-02-15","2025-02-12","SF FuneralF834564       250212","","126.5","","253307.33"
"2025-02-15","2025-02-12","SF FuneralF981800       250212","","126.5","","253433.83"
"2025-02-15","2025-02-12","SF FuneralF1072854      250212","","126.5","","253560.33"
"2025-02-15","2025-02-12","SF FuneralF1072855      250212","","126.5","","253686.83"
"2025-02-15","2025-02-12","SF FuneralF1073647      250212","","126.5","","253813.33"
"2025-02-15","2025-02-12","SF FuneralF1114926      250212","","126.5","","253939.83"
"2025-02-15","2025-02-12","SF FuneralFDC0000000NFGD250212","","126.5","","254066.33"
"2025-02-15","2025-02-12","SF FuneralF1118624      250212","","126.5","","254192.83"
"2025-02-15","2025-02-12","SF FuneralF1118720      250212","","126.5","","254319.33"
"2025-02-15","2025-02-12","SF FuneralF1123492      250212","","126.5","","254445.83"
"2025-02-15","2025-02-12","SF FuneralFDC0000000PQNK250212","","63.25","","254509.08"
"2025-02-15","2025-02-12","SF FuneralF1131883      250212","","63.25","","254572.33"
"2025-02-15","2025-02-15","SF FuneralFDC00000006LTK250215","","63.25","","254635.58"
"2025-02-15","2025-02-15","SF FuneralF1074580      250215","","63.25","","254698.83"
"2025-02-15","2025-02-15","SF FuneralFDC0000000NJMN250215","","126.5","","254825.33"
"2025-02-15","2025-02-15","SF FuneralFDC0000000NJMQ250215","","126.5","","254951.83"
"2025-02-15","2025-02-11","SF FuneralFDC00000007CQV250211","","31.63","","254983.46"
"2025-02-15","2025-02-11","SF FuneralF1110796      250211","","31.63","","255015.09"
"2025-02-15","2025-02-11","SF FuneralF1118348      250211","","31.63","","255046.72"
"2025-02-15","2025-02-11","SF FuneralF1130991      250211","","31.63","","255078.35"
"2025-02-15","2025-02-13","SF FuneralF1079631      250213","","31.63","","255109.98"
"2025-02-15","2025-02-10","SF FuneralF1020672      250210","","31.63","","255141.61"
"2025-02-15","2025-02-14","SF FuneralFDC00000009V7T250214","","126.5","","255268.11"
"2025-02-15","2025-02-15","SF FuneralFDC00000005N9V250215","","126.5","","255394.61"
"2025-02-15","2025-02-15","SF FuneralF830878       250215","","126.5","","255521.11"
"2025-02-15","2025-02-15","SF FuneralF1052175      250215","","126.5","","255647.61"
"2025-02-15","2025-02-15","SF FuneralF1079334      250215","","126.5","","255774.11"
"2025-02-15","2025-02-15","SF FuneralF1114423      250215","","63.25","","255837.36"
"2025-02-15","2025-02-15","SF FuneralF1129339      250215","","126.5","","255963.86"
"2025-02-15","2025-02-12","SF FuneralF822682       250212","","126.5","","256090.36"
"2025-02-15","2025-02-12","SF FuneralF847342       250212","","126.5","","256216.86"
"2025-02-15","2025-02-12","SF FuneralF1073273      250212","","126.5","","256343.36"
"2025-02-15","2025-02-12","SF FuneralF1073206      250212","","126.5","","256469.86"
"2025-02-15","2025-02-12","SF FuneralFDC0000000N9R0250212","","126.5","","256596.36"
"2025-02-15","2025-02-12","SF FuneralF1124445      250212","","126.5","","256722.86"
"2025-02-15","2025-02-12","SF FuneralF1127388      250212","","126.5","","256849.36"
"2025-02-15","2025-02-12","SF FuneralF1130339      250212","","126.5","","256975.86"
"2025-02-15","2025-02-15","SF FuneralFDC00000006CDN250215","","126.5","","257102.36"
"2025-02-15","2025-02-15","SF FuneralF1020853      250216","","126.5","","257228.86"
"2025-02-15","2025-02-15","SF FuneralFDC0000000KDQ3250215","","126.5","","257355.36"
"2025-02-15","2025-02-15","SF FuneralF1072856      250216","","31.63","","257386.99"
"2025-02-15","2025-02-15","SF FuneralF1052578      250215","","126.5","","257513.49"
"2025-02-15","2025-02-15","SF FuneralFDC0000000NLY9250215","","31.63","","257545.12"
"2025-02-15","2025-02-15","SF FuneralF1129917      250216","","31.63","","257576.75"
"2025-02-15","2025-02-11","SF FuneralFDC00000007GVV250211","","63.25","","257640"
"2025-02-15","2025-02-11","SF FuneralF1103565      250211","","63.25","","257703.25"
"2025-02-15","2025-02-12","SF FuneralFDC00000005JLK250212","","126.5","","257829.75"
"2025-02-15","2025-02-12","SF FuneralF804321       250212","","126.5","","257956.25"
"2025-02-15","2025-02-12","SF FuneralF989808       250212","","126.5","","258082.75"
"2025-02-15","2025-02-12","SF FuneralF1021776      250212","","126.5","","258209.25"
"2025-02-15","2025-02-12","SF FuneralF1115117      250212","","126.5","","258335.75"
"2025-02-15","2025-02-15","SF FuneralF810290       250215","","126.5","","258462.25"
"2025-02-15","2025-02-15","SF FuneralF1020601      250215","","31.63","","258493.88"
"2025-02-15","2025-02-15","SF FuneralF1084288      250215","","31.63","","258525.51"
"2025-02-15","2025-02-15","SF FuneralF1125662      250215","","31.63","","258557.14"
"2025-02-15","2025-02-15","SF FuneralF1117993      250215","","31.63","","258588.77"
"2025-02-15","2025-02-15","SF FuneralFDC00000002RFQ250215","","220","","258808.77"
"2025-02-15","2025-02-15","SF FuneralF1103935      250216","","31.63","","258840.4"
"2025-02-15","2025-02-11","SF FuneralF822239       250211","","31.63","","258872.03"
"2025-02-15","2025-02-11","SF FuneralF1067978      250211","","31.63","","258903.66"
"2025-02-15","2025-02-11","SF FuneralF1122750      250211","","31.63","","258935.29"
"2025-02-15","2025-02-11","SF FuneralFDC0000000PZNV250211","","63.25","","258998.54"
"2025-02-15","2025-02-12","SF FuneralFDC00000005N3T250212","","126.5","","259125.04"
"2025-02-15","2025-02-12","SF FuneralFDC00000006197250212","","126.5","","259251.54"
"2025-02-15","2025-02-12","SF FuneralFDC00000006198250212","","126.5","","259378.04"
"2025-02-15","2025-02-12","SF FuneralF795824       250212","","126.5","","259504.54"
"2025-02-15","2025-02-12","SF FuneralF810622       250212","","126.5","","259631.04"
"2025-02-15","2025-02-12","SF FuneralF843690       250212","","126.5","","259757.54"
"2025-02-15","2025-02-12","SF FuneralF1073420      250212","","126.5","","259884.04"
"2025-02-15","2025-02-14","SF FuneralF1126874      250214","","31.63","","259915.67"
"2025-02-15","2025-02-11","Rev SF FuneralFDC00000008365250211","","-31.63","","259884.04"
"2025-02-15","2025-02-11","Rev SF FuneralFDC0000000N8G1250211","","-31.63","","259852.41"
"2025-02-15","2025-02-11","Rev SF FuneralFDC0000000L20G250211","","-126.5","","259725.91"
"2025-02-15","2025-02-12","Rev SF FuneralFDC0000000NFGD250212","","-126.5","","259599.41"
"2025-02-15","2025-02-12","Rev SF FuneralFDC00000005PXB250212","","-126.5","","259472.91"
"2025-02-15","2025-02-12","Rev SF FuneralFDC0000000718V250212","","-126.5","","259346.41"
"2025-02-15","2025-02-12","Rev SF FuneralFDC0000000LM22250212","","-126.5","","259219.91"
"2025-02-15","2025-02-11","Rev SF FuneralFDC0000000FQV0250211","","-63.25","","259156.66"
"2025-02-15","2025-01-13","Rev SF FuneralFDC00000005QYJ250112","","-126.5","","259030.16"
"2025-02-15","2025-01-23","Rev SF FuneralFDC000000062RH250123","","-126.5","","258903.66"
"2025-02-15","2025-02-12","Rev SF FuneralFDC0000000B3G4250212","","-126.5","","258777.16"
"2025-02-15","2025-02-10","Rev SF FuneralFDC00000007F71250210","","-63.25","","258713.91"
"2025-02-15","2025-02-12","Rev SF FuneralFDC00000007J4Y250212","","-126.5","","258587.41"
"2025-02-15","2025-02-11","Rev SF FuneralF1111658      250211","","-63.25","","258524.16"
"2025-02-15","2025-02-11","SF FuneralF833072       250211","","31.63","","258555.79"
"2025-02-15","2025-02-11","SF FuneralF990246       250211","","63.25","","258619.04"
"2025-02-15","2025-02-11","SF FuneralF1117422      250211","","31.63","","258650.67"
"2025-02-15","2025-02-12","SF FuneralFDC00000006VJZ250212","","126.5","","258777.17"
"2025-02-15","2025-02-12","SF FuneralF1114789      250212","","126.5","","258903.67"
"2025-02-15","2025-02-12","SF FuneralF1119686      250212","","126.5","","259030.17"
"2025-02-15","2025-02-12","SF FuneralF1128325      250212","","126.5","","259156.67"
"2025-02-15","2025-02-12","SF FuneralFDC0000000PY4R250212","","126.5","","259283.17"
"2025-02-15","2025-02-12","SF FuneralFDC0000000PY4W250212","","126.5","","259409.67"
"2025-02-15","2025-02-12","SF FuneralFDC0000000PY4X250212","","126.5","","259536.17"
"2025-02-15","2025-02-14","SF FuneralF819674       250216","","31.63","","259567.8"
"2025-02-15","2025-02-14","SF FuneralF1130369      250214","","31.63","","259599.43"
"2025-02-15","2025-02-15","SF FuneralF775997       250215","","191.5","","259790.93"
"2025-02-15","2025-02-15","SF FuneralFDC0000000LNR4250216","","31.63","","259822.56"
"2025-02-15","2025-02-15","SF FuneralF1123126      250215","","31.63","","259854.19"
"2025-02-15","2025-02-07","SF FuneralF818322       250207","","63.25","","259917.44"
"2025-02-15","2025-01-25","Rev SF FuneralFDC0000000752S250125","","-63.25","","259854.19"
"2025-02-15","2025-02-08","Rev SF FuneralFDC0000000752S250208","","-63.25","","259790.94"
"2025-02-15","2024-12-28","Rev SF FuneralFDC0000000752S241228","","-63.25","","259727.69"
"2025-02-15","2025-01-11","Rev SF FuneralFDC0000000752S250111","","-63.25","","259664.44"
"2025-02-15","2025-02-10","Rev SF FuneralFDC00000006N0H250210","","-126.5","","259537.94"
"2025-02-15","2025-02-15","Rev SF FuneralFDC00000005N9V250215","","-126.5","","259411.44"
"2025-02-15","2025-02-10","SF FuneralFDC0000000NL09250210","","31.63","","259443.07"
"2025-02-15","2025-02-12","SF FuneralF814898       250212","","126.5","","259569.57"
"2025-02-15","2025-02-12","SF FuneralFDC00000005NXL250212","","126.5","","259696.07"
"2025-02-15","2025-02-12","SF FuneralF1127551      250212","","126.5","","259822.57"
"2025-02-15","2025-02-11","SF FuneralFDC0000000788B250211","","31.63","","259854.2"
"2025-02-15","2025-02-11","SF FuneralF1052200      250211","","31.63","","259885.83"
"2025-02-15","2025-02-15","SF FuneralF1017154      250216","","126.5","","260012.33"
"2025-02-15","2025-02-15","SF FuneralF1102798      250216","","126.5","","260138.83"
"2025-02-15","2025-02-12","SF FuneralFDC00000005N5C250212","","126.5","","260265.33"
"2025-02-15","2025-02-12","SF FuneralF844787       250212","","126.5","","260391.83"
"2025-02-15","2025-02-12","SF FuneralF1118902      250212","","126.5","","260518.33"
"2025-02-16","2025-02-14","SF FuneralFDC00000008NYM250214","","31.63","","260549.96"
"2025-02-16","2025-02-14","SF FuneralF1072884      250214","","31.63","","260581.59"
"2025-02-16","2025-02-14","SF FuneralFDC0000000N3BG250214","","31.63","","260613.22"
"2025-02-16","2025-02-12","SF FuneralFDC00000005MZZ250212","","126.5","","260739.72"
"2025-02-16","2025-02-12","SF FuneralF822126       250212","","126.5","","260866.22"
"2025-02-16","2025-02-12","SF FuneralF989548       250212","","126.5","","260992.72"
"2025-02-16","2025-02-12","SF FuneralFDC0000000K8XN250212","","126.5","","261119.22"
"2025-02-16","2025-02-12","SF FuneralF1072779      250212","","126.5","","261245.72"
"2025-02-16","2025-02-12","SF FuneralF1102951      250212","","126.5","","261372.22"
"2025-02-16","2025-02-15","SF FuneralFDC0000000NCRN250215","","63.25","","261435.47"
"2025-02-16","2025-02-10","SF FuneralFDC00000005WTC250210","","55","","261490.47"
"2025-02-16","2025-02-10","SF FuneralF829866       250209","","126.5","","261616.97"
"2025-02-16","2025-02-11","SF FuneralFDC0000000HZS6250211","","63.25","","261680.22"
"2025-02-16","2025-02-11","SF FuneralF1050833      250211","","31.63","","261711.85"
"2025-02-16","2025-02-12","SF FuneralF815877       250212","","126.5","","261838.35"
"2025-02-16","2025-02-12","SF FuneralFDC0000000G985250212","","126.5","","261964.85"
"2025-02-16","2025-02-14","SF FuneralF981670       250214","","31.63","","261996.48"
"2025-02-16","2025-02-10","SF FuneralF802331       250210","","31.63","","262028.11"
"2025-02-16","2025-02-11","SF FuneralFDC0000000JHBW250211","","31.63","","262059.74"
"2025-02-16","2025-02-11","SF FuneralFDC0000000595N250211","","31.62","","262091.36"
"2025-02-16","2025-02-12","SF FuneralF802401       250212","","63.25","","262154.61"
"2025-02-16","2025-02-12","SF FuneralF990133       250212","","126.5","","262281.11"
"2025-02-16","2025-02-12","SF FuneralF1117363      250212","","126.5","","262407.61"
"2025-02-16","2025-02-12","SF FuneralFDC000000075BD250212","","126.5","","262534.11"
"2025-02-16","2025-02-13","SF FuneralF1123949      250213","","31.63","","262565.74"
"2025-02-16","2025-02-11","SF FuneralF1102938      250211","","31.63","","262597.37"
"2025-02-16","2025-02-12","SF FuneralF822745       250212","","126.5","","262723.87"
"2025-02-16","2025-02-14","SF FuneralF1123029      250214","","126.5","","262850.37"
"2025-02-17","2025-02-12","SF FuneralF1119760      250212","","126.5","","262976.87"
"2025-02-17","2025-02-12","SF FuneralF1129489      250212","","126.5","","263103.37"
"2025-02-17","2025-02-17","SF FuneralF1117939      250217","","126.5","","263229.87"
"2025-02-17","2025-02-17","SF FuneralFDC00000005H8J250216","","31.63","","263261.5"
"2025-02-17","2025-02-17","SF FuneralFDC00000007FPS250217","","31.63","","263293.13"
"2025-02-17","2025-02-17","SF FuneralF823244       250217","","126.5","","263419.63"
"2025-02-17","2025-02-12","SF FuneralF990706       250212","","63.25","","263482.88"
"2025-02-17","2025-02-12","SF FuneralF1017085      250212","","63.25","","263546.13"
"2025-02-17","2025-02-12","SF FuneralFDC0000000M2N1250212","","63.25","","263609.38"
"2025-02-17","2025-02-14","SF FuneralFDC00000006PSF250214","","31.63","","263641.01"
"2025-02-17","2025-02-14","SF FuneralF822267       250214","","31.63","","263672.64"
"2025-02-17","2025-02-14","SF FuneralFDC0000000L8B0250214","","31.63","","263704.27"
"2025-02-17","2025-02-14","SF FuneralF1120280      250214","","31.63","","263735.9"
"2025-02-17","2025-02-11","SF FuneralF811655       250211","","31.63","","263767.53"
"2025-02-17","2025-02-14","SF FuneralFDC00000005TX1250214","","31.63","","263799.16"
"2025-02-17","2025-02-14","SF FuneralFDC00000006NFW250214","","31.63","","263830.79"
"2025-02-17","2025-02-14","SF FuneralF779346       250214","","31.63","","263862.42"
"2025-02-17","2025-02-14","SF FuneralFDC0000000L8NN250214","","31.63","","263894.05"
"2025-02-17","2025-02-17","SF FuneralFDC00000005GM0250217","","126.5","","264020.55"
"2025-02-17","2025-02-17","SF FuneralFDC00000005XM4250217","","126.5","","264147.05"
"2025-02-17","2025-02-17","SF FuneralFDC0000000723H250217","","126.5","","264273.55"
"2025-02-17","2025-02-17","SF FuneralFDC000000089G2250216","","31.63","","264305.18"
"2025-02-17","2025-02-17","SF FuneralF809759       250217","","63.25","","264368.43"
"2025-02-17","2025-02-17","SF FuneralF844510       250215","","126.5","","264494.93"
"2025-02-17","2025-02-17","SF FuneralF1079709      250217","","126.5","","264621.43"
"2025-02-17","2025-02-17","SF FuneralFDC0000000LMGS250217","","126.5","","264747.93"
"2025-02-17","2025-02-17","SF FuneralFDC0000000MR2H250217","","31.63","","264779.56"
"2025-02-17","2025-02-17","SF FuneralF1113735      250217","","31.63","","264811.19"
"2025-02-17","2025-02-17","SF FuneralFDC00000005LWP250216","","31.63","","264842.82"
"2025-02-17","2025-02-17","SF FuneralFDC00000005LYM250217","","220","","265062.82"
"2025-02-17","2025-02-17","SF FuneralFDC00000005Q9X250217","","126.5","","265189.32"
"2025-02-17","2025-02-17","SF FuneralFDC000000069CL250217","","31.63","","265220.95"
"2025-02-17","2025-02-17","SF FuneralFDC00000008KX0250217","","31.63","","265252.58"
"2025-02-17","2025-02-17","SF FuneralF993861       250217","","126.5","","265379.08"
"2025-02-17","2025-02-17","SF FuneralF1115794      250217","","31.63","","265410.71"
"2025-02-17","2025-02-14","SF FuneralFDC00000007G54250214","","31.63","","265442.34"
"2025-02-17","2025-02-14","SF FuneralF805319       250214","","31.63","","265473.97"
"2025-02-17","2025-02-14","SF FuneralF821927       250214","","31.63","","265505.6"
"2025-02-17","2025-02-14","SF FuneralFDC0000000HX7W250214","","31.63","","265537.23"
"2025-02-17","2025-02-14","SF FuneralF994001       250214","","31.63","","265568.86"
"2025-02-17","2025-02-14","SF FuneralF1126869      250214","","31.63","","265600.49"
"2025-02-17","2025-02-14","SF FuneralF814074       250214","","31.63","","265632.12"
"2025-02-17","2025-02-14","SF FuneralF842737       250214","","31.63","","265663.75"
"2025-02-17","2025-02-14","SF FuneralF1104255      250214","","31.63","","265695.38"
"2025-02-17","2025-02-17","SF FuneralFDC00000005NX7250217","","31.63","","265727.01"
"2025-02-17","2025-02-17","SF FuneralFDC00000006GNR250217","","31.63","","265758.64"
"2025-02-17","2025-02-17","SF FuneralFDC00000006XFM250217","","31.63","","265790.27"
"2025-02-17","2025-02-17","SF FuneralF823862       250217","","63.25","","265853.52"
"2025-02-17","2025-02-17","SF FuneralFDC0000000BV0W250217","","63.25","","265916.77"
"2025-02-17","2025-02-17","SF FuneralF1022279      250217","","126.5","","266043.27"
"2025-02-17","2025-02-17","SF FuneralF1073862      250217","","31.63","","266074.9"
"2025-02-17","2025-02-17","SF FuneralF1112136      250217","","31.63","","266106.53"
"2025-02-17","2025-02-17","SF FuneralFDC0000000N81T250217","","126.5","","266233.03"
"2025-02-17","2025-02-12","SF FuneralFDC00000005MMM250212","","126.5","","266359.53"
"2025-02-17","2025-02-13","SF FuneralF1085168      250213","","31.63","","266391.16"
"2025-02-17","2025-02-13","SF FuneralF1108113      250213","","31.63","","266422.79"
"2025-02-17","2025-02-14","SF FuneralFDC00000005PXF250214","","31.63","","266454.42"
"2025-02-17","2025-02-14","SF FuneralFDC00000005QCT250214","","31.63","","266486.05"
"2025-02-17","2025-02-14","SF FuneralFDC00000005V4S250214","","31.63","","266517.68"
"2025-02-17","2025-02-14","SF FuneralFDC000000069RZ250214","","31.63","","266549.31"
"2025-02-17","2025-02-14","SF FuneralFDC00000006FQ9250214","","31.63","","266580.94"
"2025-02-17","2025-02-14","SF FuneralFDC00000007MW5250214","","31.63","","266612.57"
"2025-02-17","2025-02-14","SF FuneralFDC00000007Q48250214","","31.63","","266644.2"
"2025-02-17","2025-02-14","SF FuneralFDC00000007WBL250214","","31.63","","266675.83"
"2025-02-17","2025-02-14","SF FuneralFDC00000007WJL250214","","31.63","","266707.46"
"2025-02-17","2025-02-14","SF FuneralF795812       250214","","31.63","","266739.09"
"2025-02-17","2025-02-14","SF FuneralFDC000000086Y9250214","","31.63","","266770.72"
"2025-02-17","2025-02-14","SF FuneralF790399       250214","","47.88","","266818.6"
"2025-02-17","2025-02-14","SF FuneralF815340       250214","","31.63","","266850.23"
"2025-02-17","2025-02-14","SF FuneralF815510       250214","","31.63","","266881.86"
"2025-02-17","2025-02-14","SF FuneralF817463       250214","","31.63","","266913.49"
"2025-02-17","2025-02-14","SF FuneralFDC0000000B37Y250214","","31.63","","266945.12"
"2025-02-17","2025-02-14","SF FuneralF819497       250214","","31.63","","266976.75"
"2025-02-17","2025-02-14","SF FuneralF823750       250214","","31.63","","267008.38"
"2025-02-17","2025-02-14","SF FuneralF829118       250214","","31.63","","267040.01"
"2025-02-17","2025-02-14","SF FuneralF830931       250214","","31.63","","267071.64"
"2025-02-17","2025-02-14","SF FuneralF832185       250214","","31.63","","267103.27"
"2025-02-17","2025-02-14","SF FuneralF832777       250214","","31.63","","267134.9"
"2025-02-17","2025-02-14","SF FuneralF843596       250214","","31.63","","267166.53"
"2025-02-17","2025-02-14","SF FuneralFDC0000000FQWF250214","","31.63","","267198.16"
"2025-02-17","2025-02-14","SF FuneralFDC0000000HBD0250214","","31.63","","267229.79"
"2025-02-17","2025-02-14","SF FuneralF774474       250214","","156.28","","267386.07"
"2025-02-17","2025-02-14","SF FuneralF986934       250214","","31.63","","267417.7"
"2025-02-17","2025-02-14","SF FuneralFDC0000000HXHK250214","","47.88","","267465.58"
"2025-02-17","2025-02-14","SF FuneralFDC0000000J2XM250216","","31.63","","267497.21"
"2025-02-17","2025-02-14","SF FuneralF992752       250214","","31.63","","267528.84"
"2025-02-17","2025-02-14","SF FuneralF993205       250214","","31.63","","267560.47"
"2025-02-17","2025-02-14","SF FuneralF1052348      250214","","31.63","","267592.1"
"2025-02-17","2025-02-14","SF FuneralF1068145      250214","","31.63","","267623.73"
"2025-02-17","2025-02-14","SF FuneralFDC0000000LMH8250214","","31.63","","267655.36"
"2025-02-17","2025-02-14","SF FuneralF1080183      250214","","31.63","","267686.99"
"2025-02-17","2025-02-14","SF FuneralF1084400      250214","","31.63","","267718.62"
"2025-02-17","2025-02-14","SF FuneralF1085355      250214","","31.63","","267750.25"
"2025-02-17","2025-02-14","SF FuneralF1111672      250214","","31.63","","267781.88"
"2025-02-17","2025-02-14","SF FuneralFDC0000000NNGY250214","","31.63","","267813.51"
"2025-02-17","2025-02-14","SF FuneralF1119753      250214","","31.63","","267845.14"
"2025-02-17","2025-02-14","SF FuneralF1120399      250214","","31.63","","267876.77"
"2025-02-17","2025-02-14","SF FuneralF1122752      250214","","31.63","","267908.4"
"2025-02-17","2025-02-14","SF FuneralF1123008      250214","","31.63","","267940.03"
"2025-02-17","2025-02-14","SF FuneralF1123947      250214","","31.63","","267971.66"
"2025-02-17","2025-02-14","SF FuneralF1127351      250214","","31.63","","268003.29"
"2025-02-17","2025-02-14","SF FuneralF1130338      250214","","31.63","","268034.92"
"2025-02-17","2025-02-14","SF FuneralF1130684      250214","","31.63","","268066.55"
"2025-02-17","2025-02-15","SF FuneralFDC00000006HHY250215","","31.63","","268098.18"
"2025-02-17","2025-02-15","SF FuneralF1060024      250215","","31.63","","268129.81"
"2025-02-17","2025-02-17","SF FuneralFDC000000086PW250216","","31.63","","268161.44"
"2025-02-17","2025-02-17","SF FuneralFDC000000086PX250216","","31.63","","268193.07"
"2025-02-17","2025-02-17","SF FuneralF816565       250217","","31.63","","268224.7"
"2025-02-17","2025-02-17","SF FuneralF843935       250217","","63.25","","268287.95"
"2025-02-17","2025-02-17","SF FuneralF1017111      250217","","31.63","","268319.58"
"2025-02-17","2025-02-17","SF FuneralF1108567      250217","","31.63","","268351.21"
"2025-02-17","2025-02-17","SF FuneralF1131037      250217","","31.63","","268382.84"
"2025-02-17","2025-02-14","SF FuneralFDC0000000HYW8250214","","63.25","","268446.09"
"2025-02-17","2025-02-17","SF FuneralFDC00000005NYD250217","","63.25","","268509.34"
"2025-02-17","2025-02-17","SF FuneralFDC00000005S2J250217","","126.5","","268635.84"
"2025-02-17","2025-02-17","SF FuneralFDC00000005SZ4250217","","63.25","","268699.09"
"2025-02-17","2025-02-17","SF FuneralFDC00000006HWC250217","","126.5","","268825.59"
"2025-02-17","2025-02-17","SF FuneralFDC00000006R9T250217","","126.5","","268952.09"
"2025-02-17","2025-02-17","SF FuneralFDC00000006T5D250217","","126.5","","269078.59"
"2025-02-17","2025-02-17","SF FuneralFDC000000072B6250217","","63.25","","269141.84"
"2025-02-17","2025-02-17","SF FuneralFDC00000008CSD250217","","126.5","","269268.34"
"2025-02-17","2025-02-17","SF FuneralFDC00000008CSF250217","","126.5","","269394.84"
"2025-02-17","2025-02-17","SF FuneralF822308       250217","","63.25","","269458.09"
"2025-02-17","2025-02-17","SF FuneralF1123976      250217","","63.25","","269521.34"
"2025-02-17","2025-02-17","SF FuneralF1126179      250217","","126.5","","269647.84"
"2025-02-17","2025-02-14","SF FuneralFDC00000006R81250214","","31.63","","269679.47"
"2025-02-17","2025-02-14","SF FuneralF819053       250214","","31.63","","269711.1"
"2025-02-17","2025-02-14","SF FuneralF993478       250214","","31.63","","269742.73"
"2025-02-17","2025-02-14","SF FuneralFDC0000000JFC4250214","","31.63","","269774.36"
"2025-02-17","2025-02-14","SF FuneralF1033620      250214","","31.63","","269805.99"
"2025-02-17","2025-02-14","SF FuneralF1065649      250214","","31.63","","269837.62"
"2025-02-17","2025-02-14","SF FuneralF1073030      250214","","31.63","","269869.25"
"2025-02-17","2025-02-14","SF FuneralF1078056      250214","","31.63","","269900.88"
"2025-02-17","2025-02-14","SF FuneralF1078457      250214","","31.63","","269932.51"
"2025-02-17","2025-02-14","SF FuneralF1104196      250214","","31.63","","269964.14"
"2025-02-17","2025-02-14","SF FuneralF1104243      250214","","31.63","","269995.77"
"2025-02-17","2025-02-14","SF FuneralF1115119      250214","","31.63","","270027.4"
"2025-02-17","2025-02-15","SF FuneralFDC00000007G0S250215","","31.63","","270059.03"
"2025-02-17","2025-02-17","SF FuneralFDC000000071S5250217","","31.63","","270090.66"
"2025-02-17","2025-02-17","SF FuneralFDC00000007BGG250216","","31.63","","270122.29"
"2025-02-17","2025-02-17","SF FuneralFDC00000007GS9250217","","31.63","","270153.92"
"2025-02-17","2025-02-17","SF FuneralF804126       250217","","31.63","","270185.55"
"2025-02-17","2025-02-17","SF FuneralF811593       250217","","31.63","","270217.18"
"2025-02-17","2025-02-17","SF FuneralF828566       250217","","31.63","","270248.81"
"2025-02-17","2025-02-17","SF FuneralF831617       250217","","31.63","","270280.44"
"2025-02-17","2025-02-17","SF FuneralF987310       250217","","31.63","","270312.07"
"2025-02-17","2025-02-17","SF FuneralF1118181      250217","","31.63","","270343.7"
"2025-02-17","2025-02-17","SF FuneralF1129402      250217","","31.63","","270375.33"
"2025-02-17","2025-02-17","SF FuneralF1132115      250217","","31.63","","270406.96"
"2025-02-17","2025-02-14","SF FuneralFDC00000006ZP5250214","","31.63","","270438.59"
"2025-02-17","2025-02-17","SF FuneralFDC0000000786G250216","","126.5","","270565.09"
"2025-02-17","2025-02-17","SF FuneralFDC00000007C14250217","","220","","270785.09"
"2025-02-17","2025-02-17","SF FuneralF820521       250217","","63.25","","270848.34"
"2025-02-17","2025-02-17","SF FuneralF822919       250217","","63.25","","270911.59"
"2025-02-17","2025-02-17","SF FuneralF834868       250217","","126.5","","271038.09"
"2025-02-17","2025-02-17","SF FuneralF898925       250215","","126.5","","271164.59"
"2025-02-17","2025-02-17","SF FuneralF989508       250217","","126.5","","271291.09"
"2025-02-17","2025-02-17","SF FuneralF1108797      250217","","63.25","","271354.34"
"2025-02-17","2025-02-17","SF FuneralFDC0000000NBRB250217","","63.25","","271417.59"
"2025-02-17","2025-02-17","SF FuneralF1115970      250217","","126.5","","271544.09"
"2025-02-17","2025-02-17","SF FuneralF1119058      250217","","63.25","","271607.34"
"2025-02-17","2025-02-17","SF FuneralFDC0000000PDM3250217","","126.5","","271733.84"
"2025-02-17","2025-01-31","Rev SF FuneralFDC00000008NYM250131","","-31.63","","271702.21"
"2025-02-17","2025-02-07","Rev SF FuneralFDC00000008NYM250207","","-31.63","","271670.58"
"2025-02-17","2025-02-10","Rev SF FuneralFDC00000005WTC250210","","-55","","271615.58"
"2025-02-17","2025-02-10","Rev SF FuneralFDC00000007H6K250210","","-31.63","","271583.95"
"2025-02-17","2025-02-15","Rev SF FuneralFDC0000000LNR4250216","","-31.63","","271552.32"
"2025-02-17","2025-02-12","Rev SF FuneralFDC0000000G985250212","","-126.5","","271425.82"
"2025-02-17","2025-02-12","Rev SF FuneralFDC00000006V5J250212","","-126.5","","271299.32"
"2025-02-17","2025-02-12","Rev SF FuneralFDC00000005VF8250212","","-126.5","","271172.82"
"2025-02-17","2025-02-12","Rev SF FuneralFDC0000000PN9W250212","","-126.5","","271046.32"
"2025-02-17","2025-02-12","Rev SF FuneralFDC00000007N3L250212","","-126.5","","270919.82"
"2025-02-17","2025-02-11","Rev SF FuneralFDC0000000HZS6250211","","-63.25","","270856.57"
"2025-02-17","2025-02-12","Rev SF FuneralFDC0000000PN9Y250212","","-126.5","","270730.07"
"2025-02-17","2025-02-12","Rev SF FuneralFDC00000006VYC250212","","-126.5","","270603.57"
"2025-02-17","2025-02-12","Rev SF FuneralFDC0000000PVD2250212","","-126.5","","270477.07"
"2025-02-17","2025-02-10","Rev SF FuneralFDC000000037KM250210","","-220","","270257.07"
"2025-02-17","2025-02-12","Rev SF FuneralFDC00000006X80250212","","-126.5","","270130.57"
"2025-02-17","2025-02-12","Rev SF FuneralFDC000000060ZD250212","","-126.5","","270004.07"
"2025-02-17","2025-02-12","Rev SF FuneralFDC0000000K8XN250212","","-126.5","","269877.57"
"2025-02-17","2025-02-12","Rev SF FuneralFDC00000006VZG250212","","-126.5","","269751.07"
"2025-02-17","2024-12-23","Rev SF FuneralFDC0000000JFXT241226","","-126.5","","269624.57"
"2025-02-17","2025-01-24","Rev SF FuneralFDC00000006N35250124","","-126.5","","269498.07"
"2025-02-17","2025-01-24","Rev SF FuneralFDC0000000NBCB250127","","-126.5","","269371.57"
"2025-02-17","2025-02-12","Rev SF FuneralFDC0000000BLKQ250212","","-126.5","","269245.07"
"2025-02-17","2025-02-12","Rev SF FuneralFDC0000000P3M1250212","","-126.5","","269118.57"
"2025-02-17","2025-02-15","Rev SF FuneralFDC0000000NCRN250215","","-63.25","","269055.32"
"2025-02-17","2024-12-27","Rev SF FuneralFDC00000008NYM241227","","-31.63","","269023.69"
"2025-02-17","2025-02-10","Rev SF FuneralFDC000000069C5250210","","-31.63","","268992.06"
"2025-02-17","2025-01-03","Rev SF FuneralFDC00000008NYM250103","","-31.63","","268960.43"
"2025-02-17","2025-01-24","Rev SF FuneralFDC00000008NYM250124","","-31.63","","268928.8"
"2025-02-17","2025-01-10","Rev SF FuneralFDC00000008NYM250110","","-31.63","","268897.17"
"2025-02-17","2025-01-17","Rev SF FuneralFDC00000008NYM250117","","-31.63","","268865.54"
"2025-02-17","2024-12-20","Rev SF FuneralFDC00000008NYM241220","","-31.63","","268833.91"
"2025-02-17","2025-02-14","Rev SF FuneralFDC0000000JXK7250214","","-31.63","","268802.28"
"2025-02-17","2025-02-14","Rev SF FuneralFDC00000008NYM250214","","-31.63","","268770.65"
"2025-02-17","2025-02-14","Rev SF FuneralFDC0000000NNGY250214","","-31.63","","268739.02"
"2025-02-17","2025-01-24","Rev SF FuneralF1060855      250127","","-126.5","","268612.52"
"2025-02-17","2025-02-12","SF FuneralF842872       250212","","31.63","","268644.15"
"2025-02-17","2025-02-12","SF FuneralF1061004      250212","","63.25","","268707.4"
"2025-02-17","2025-02-12","SF FuneralF1073806      250212","","126.5","","268833.9"
"2025-02-17","2025-02-14","SF FuneralF1118332      250214","","63.25","","268897.15"
"2025-02-17","2025-02-14","SF FuneralF1130222      250214","","31.63","","268928.78"
"2025-02-17","2025-02-14","SF FuneralF1130754      250214","","31.63","","268960.41"
"2025-02-17","2025-02-14","SF FuneralF1131039      250214","","63.25","","269023.66"
"2025-02-17","2025-02-17","SF FuneralFDC0000000502G250217","","31.63","","269055.29"
"2025-02-17","2025-02-17","SF FuneralFDC00000009958250217","","31.63","","269086.92"
"2025-02-17","2025-02-17","SF FuneralFDC00000009HK1250217","","63.25","","269150.17"
"2025-02-17","2025-02-17","SF FuneralF841707       250217","","126.5","","269276.67"
"2025-02-17","2025-02-12","SF FuneralF1115002      250212","","126.5","","269403.17"
"2025-02-17","2025-02-17","SF FuneralFDC00000009K4G250217","","126.5","","269529.67"
"2025-02-17","2025-02-11","SF FuneralF1127719      250211","","31.63","","269561.3"
"2025-02-17","2025-02-12","SF FuneralFDC00000005N7Y250212","","126.5","","269687.8"
"2025-02-17","2025-02-12","SF FuneralFDC00000005N85250212","","126.5","","269814.3"
"2025-02-17","2025-02-13","SF FuneralF776616       250213","","126.5","","269940.8"
"2025-02-17","2025-02-15","SF FuneralFDC00000005M7N250215","","220","","270160.8"
"2025-02-17","2025-02-15","SF FuneralF1017512      250216","","31.63","","270192.43"
"2025-02-17","2025-02-17","SF FuneralF1128347      250217","","126.5","","270318.93"
"2025-02-17","2025-02-17","SF FuneralF1128062      250217","","31.63","","270350.56"
"2025-02-17","2025-02-12","SF FuneralF823847       250212","","126.5","","270477.06"
"2025-02-17","2025-02-14","SF FuneralF843757       250214","","31.63","","270508.69"
"2025-02-17","2025-02-14","SF FuneralF1127614      250214","","31.63","","270540.32"
"2025-02-17","2025-02-17","SF FuneralFDC00000005W1P250217","","126.5","","270666.82"
"2025-02-17","2025-02-12","SF FuneralFDC00000005N61250212","","126.5","","270793.32"
"2025-02-17","2025-02-11","SF FuneralF1103795      250211","","31.63","","270824.95"
"2025-02-17","2025-02-12","SF FuneralFDC00000005XL6250212","","191.5","","271016.45"
"2025-02-17","2025-02-12","SF FuneralF840538       250212","","126.5","","271142.95"
"2025-02-17","2025-02-12","SF FuneralF1129502      250212","","126.5","","271269.45"
"2025-02-17","2025-02-14","SF FuneralF834544       250214","","31.63","","271301.08"
"2025-02-17","2025-02-14","SF FuneralF1033704      250214","","31.63","","271332.71"
"2025-02-17","2025-02-14","SF FuneralF1061782      250214","","31.63","","271364.34"
"2025-02-17","2025-02-15","SF FuneralF1016990      250215","","126.5","","271490.84"
"2025-02-17","2025-02-17","SF FuneralF1108526      250217","","126.5","","271617.34"
"2025-02-17","2025-02-17","SF FuneralF1124411      250217","","31.63","","271648.97"
"2025-02-17","2025-02-03","Rev SF FuneralFDC0000000NR4T250203","","-126.5","","271522.47"
"2025-02-17","2025-02-17","Rev SF FuneralFDC00000008CSF250217","","-126.5","","271395.97"
"2025-02-17","2025-02-12","Rev SF FuneralFDC0000000P741250212","","-126.5","","271269.47"
"2025-02-17","2025-02-17","Rev SF FuneralFDC00000006R9T250217","","-126.5","","271142.97"
"2025-02-17","2025-02-17","Rev SF FuneralFDC00000006HWC250217","","-126.5","","271016.47"
"2025-02-17","2025-02-17","Rev SF FuneralFDC00000009HK1250217","","-63.25","","270953.22"
"2025-02-17","2025-01-24","Rev SF FuneralFDC0000000NPGV250128","","-126.5","","270826.72"
"2025-02-17","2025-02-17","Rev SF FuneralFDC00000008CSD250217","","-126.5","","270700.22"
"2025-02-17","2025-02-12","Rev SF FuneralFDC00000005N7Y250212","","-126.5","","270573.72"
"2025-02-17","2025-02-12","Rev SF FuneralFDC00000005N85250212","","-126.5","","270447.22"
"2025-02-17","2025-02-14","Rev SF FuneralFDC00000007MW5250214","","-31.63","","270415.59"
"2025-02-17","2025-02-14","Rev SF FuneralFDC0000000B37Y250214","","-31.63","","270383.96"
"2025-02-17","2025-02-14","Rev SF FuneralFDC000000069RZ250214","","-31.63","","270352.33"
"2025-02-17","2025-02-14","Rev SF FuneralFDC00000007WBL250214","","-31.63","","270320.7"
"2025-02-17","2025-02-15","SF FuneralF1119754      250216","","126.5","","270447.2"
"2025-02-17","2025-02-17","SF FuneralFDC0000000FNVP250217","","126.5","","270573.7"
"2025-02-17","2025-02-17","SF FuneralF813616       250217","","126.5","","270700.2"
"2025-02-17","2025-02-12","SF FuneralF1017863      250212","","126.5","","270826.7"
"2025-02-17","2025-02-17","SF FuneralF1122650      250217","","126.5","","270953.2"
