"Txn date","Effective","Description","Truncated card number","Amount","Charges","Balance"
"2025-02-18","2025-02-17","SF FuneralFDC00000005Z06250217","","31.63","","270984.83"
"2025-02-18","2025-02-17","SF FuneralFDC00000005Z12250217","","31.63","","271016.46"
"2025-02-18","2025-02-17","SF FuneralFDC00000005Z25250217","","31.63","","271048.09"
"2025-02-18","2025-02-17","SF FuneralFDC00000009DX3250216","","31.63","","271079.72"
"2025-02-18","2025-02-17","SF FuneralFDC0000000N2L5250217","","126.5","","271206.22"
"2025-02-18","2025-02-17","SF FuneralF1127967      250217","","126.5","","271332.72"
"2025-02-18","2025-02-11","SF FuneralF992268       250211","","63.25","","271395.97"
"2025-02-18","2025-02-11","SF FuneralF1120411      250211","","63.25","","271459.22"
"2025-02-18","2025-02-13","SF FuneralF1111321      250213","","126.5","","271585.72"
"2025-02-18","2025-02-14","SF FuneralF1079321      250214","","63.25","","271648.97"
"2025-02-18","2025-02-14","SF FuneralF1123167      250214","","31.63","","271680.6"
"2025-02-18","2025-02-14","SF FuneralF1129945      250214","","31.63","","271712.23"
"2025-02-18","2025-02-12","SF FuneralF1073149      250212","","126.5","","271838.73"
"2025-02-18","2025-02-18","SF FuneralFDC00000005SDS250218","","126.5","","271965.23"
"2025-02-18","2025-02-18","SF FuneralF1103986      250218","","31.63","","271996.86"
"2025-02-18","2025-02-13","SF FuneralFDC0000000CZ73250213","","126.5","","272123.36"
"2025-02-18","2025-02-13","SF FuneralFDC0000000MKTG250213","","126.5","","272249.86"
"2025-02-18","2025-02-14","SF FuneralF844157       250214","","126.5","","272376.36"
"2025-02-18","2025-02-15","SF FuneralFDC0000000KHNV250215","","126.5","","272502.86"
"2025-02-18","2025-02-17","SF FuneralFDC000000036RN250216","","220","","272722.86"
"2025-02-18","2025-02-12","SF FuneralFDC00000005KR5250212","","126.5","","272849.36"
"2025-02-18","2025-02-12","SF FuneralFDC00000005M38250212","","126.5","","272975.86"
"2025-02-18","2025-02-12","SF FuneralFDC00000005V3N250212","","126.5","","273102.36"
"2025-02-18","2025-02-12","SF FuneralFDC00000005WPK250212","","126.5","","273228.86"
"2025-02-18","2025-02-12","SF FuneralFDC00000006TQ1250212","","126.5","","273355.36"
"2025-02-18","2025-02-12","SF FuneralFDC00000007DLP250212","","126.5","","273481.86"
"2025-02-18","2025-02-12","SF FuneralFDC00000007FWD250212","","126.5","","273608.36"
"2025-02-18","2025-02-12","SF FuneralFDC00000008B3L250212","","126.5","","273734.86"
"2025-02-18","2025-02-12","SF FuneralFDC000000095NR250212","","126.5","","273861.36"
"2025-02-18","2025-02-12","SF FuneralF818773       250212","","126.5","","273987.86"
"2025-02-18","2025-02-12","SF FuneralF822321       250212","","126.5","","274114.36"
"2025-02-18","2025-02-12","SF FuneralF830843       250212","","126.5","","274240.86"
"2025-02-18","2025-02-12","SF FuneralF1060675      250212","","126.5","","274367.36"
"2025-02-18","2025-02-12","SF FuneralF1072851      250212","","126.5","","274493.86"
"2025-02-18","2025-02-12","SF FuneralFDC0000000M71B250212","","126.5","","274620.36"
"2025-02-18","2025-02-12","SF FuneralF1111364      250212","","126.5","","274746.86"
"2025-02-18","2025-02-12","SF FuneralFDC0000000NBN5250212","","126.5","","274873.36"
"2025-02-18","2025-02-12","SF FuneralFDC0000000PNVF250212","","126.5","","274999.86"
"2025-02-18","2025-02-12","SF FuneralF1127493      250212","","31.63","","275031.49"
"2025-02-18","2025-02-12","SF FuneralF1129225      250212","","126.5","","275157.99"
"2025-02-18","2025-02-12","SF FuneralFDC0000000PZSD250212","","126.5","","275284.49"
"2025-02-18","2025-02-12","SF FuneralF1129969      250212","","126.5","","275410.99"
"2025-02-18","2025-02-13","SF FuneralF830649       250213","","31.63","","275442.62"
"2025-02-18","2025-02-14","SF FuneralFDC00000005GY1250214","","31.63","","275474.25"
"2025-02-18","2025-02-14","SF FuneralF819116       250214","","63.25","","275537.5"
"2025-02-18","2025-02-14","SF FuneralF834186       250214","","126.5","","275664"
"2025-02-18","2025-02-14","SF FuneralF785787       250214","","63.25","","275727.25"
"2025-02-18","2025-02-14","SF FuneralF1073818      250214","","31.63","","275758.88"
"2025-02-18","2025-02-14","SF FuneralF1054780      250214","","31.63","","275790.51"
"2025-02-18","2025-02-15","SF FuneralFDC0000000B7LZ250215","","126.5","","275917.01"
"2025-02-18","2025-02-15","SF FuneralF1054925      250216","","31.63","","275948.64"
"2025-02-18","2025-02-15","SF FuneralFDC0000000N01R250216","","126.5","","276075.14"
"2025-02-18","2025-02-17","SF FuneralFDC00000006B73250217","","126.5","","276201.64"
"2025-02-18","2025-02-17","SF FuneralFDC000000070Z5250216","","31.63","","276233.27"
"2025-02-18","2025-02-17","SF FuneralFDC00000007VKQ250217","","126.5","","276359.77"
"2025-02-18","2025-02-17","SF FuneralFDC000000080Y5250217","","126.5","","276486.27"
"2025-02-18","2025-02-17","SF FuneralF1052798      250217","","31.63","","276517.9"
"2025-02-18","2025-02-17","SF FuneralF1102870      250217","","63.25","","276581.15"
"2025-02-18","2025-02-17","SF FuneralF1103857      250217","","31.63","","276612.78"
"2025-02-18","2025-02-17","SF FuneralFDC0000000NPG9250217","","31.63","","276644.41"
"2025-02-18","2025-02-12","SF FuneralF801567       250212","","126.5","","276770.91"
"2025-02-18","2025-02-12","SF FuneralF1016865      250212","","126.5","","276897.41"
"2025-02-18","2025-02-12","SF FuneralF1079666      250212","","126.5","","277023.91"
"2025-02-18","2025-02-12","SF FuneralF1129410      250212","","126.5","","277150.41"
"2025-02-18","2025-02-14","SF FuneralF981788       250214","","31.63","","277182.04"
"2025-02-18","2025-02-15","SF FuneralFDC0000000740L250215","","126.5","","277308.54"
"2025-02-18","2025-02-17","SF FuneralF815135       250217","","31.63","","277340.17"
"2025-02-18","2025-02-17","SF FuneralF819708       250217","","126.5","","277466.67"
"2025-02-18","2025-02-12","SF FuneralF822678       250212","","126.5","","277593.17"
"2025-02-18","2025-02-12","SF FuneralFDC0000000N6RG250212","","126.5","","277719.67"
"2025-02-18","2025-02-17","SF FuneralFDC00000005PJH250217","","126.5","","277846.17"
"2025-02-18","2025-02-18","SF FuneralFDC00000002WZ9250218","","110","","277956.17"
"2025-02-18","2025-02-18","SF FuneralFDC00000005XGZ250218","","126.5","","278082.67"
"2025-02-18","2025-02-18","SF FuneralFDC00000007DFR250218","","126.5","","278209.17"
"2025-02-18","2025-02-18","SF FuneralFDC00000007LQC250218","","63.25","","278272.42"
"2025-02-18","2025-02-18","SF FuneralF1129384      250218","","63.25","","278335.67"
"2025-02-18","2025-02-18","SF FuneralF1125077      250218","","63.25","","278398.92"
"2025-02-18","2025-02-12","SF FuneralFDC0000000NPJ0250212","","126.5","","278525.42"
"2025-02-18","2025-02-17","SF FuneralF844068       250217","","63.25","","278588.67"
"2025-02-18","2025-02-18","SF FuneralFDC00000007J6D250218","","63.25","","278651.92"
"2025-02-18","2025-02-18","SF FuneralF817293       250218","","31.63","","278683.55"
"2025-02-18","2025-02-18","SF FuneralF834203       250218","","31.63","","278715.18"
"2025-02-18","2025-02-18","SF FuneralF981808       250218","","126.5","","278841.68"
"2025-02-18","2025-02-18","SF FuneralF1068027      250218","","31.63","","278873.31"
"2025-02-18","2025-02-18","SF FuneralFDC0000000NL0D250218","","63.25","","278936.56"
"2025-02-18","2025-02-18","SF FuneralFDC0000000PFVZ250218","","126.5","","279063.06"
"2025-02-18","2025-02-15","SF FuneralFDC00000005KXR250215","","31.63","","279094.69"
"2025-02-18","2025-02-18","SF FuneralFDC0000000455X250218","","55","","279149.69"
"2025-02-18","2025-02-18","SF FuneralFDC00000005NFK250218","","31.63","","279181.32"
"2025-02-18","2025-02-18","SF FuneralFDC00000005P3L250218","","31.63","","279212.95"
"2025-02-18","2025-02-18","SF FuneralFDC00000005P3Q250218","","31.63","","279244.58"
"2025-02-18","2025-02-18","SF FuneralFDC00000007DFS250218","","31.63","","279276.21"
"2025-02-18","2025-02-18","SF FuneralFDC00000007X30250218","","31.63","","279307.84"
"2025-02-18","2025-02-18","SF FuneralFDC00000007X31250218","","31.63","","279339.47"
"2025-02-18","2025-02-18","SF FuneralFDC00000007YH4250218","","31.63","","279371.1"
"2025-02-18","2025-02-18","SF FuneralFDC00000007YZB250218","","31.63","","279402.73"
"2025-02-18","2025-02-18","SF FuneralFDC00000008H47250218","","31.63","","279434.36"
"2025-02-18","2025-02-18","SF FuneralF811401       250218","","31.63","","279465.99"
"2025-02-18","2025-02-18","SF FuneralF811790       250218","","31.63","","279497.62"
"2025-02-18","2025-02-18","SF FuneralF814338       250218","","31.63","","279529.25"
"2025-02-18","2025-02-18","SF FuneralF830294       250218","","31.63","","279560.88"
"2025-02-18","2025-02-18","SF FuneralFDC0000000HK7D250218","","31.63","","279592.51"
"2025-02-18","2025-02-18","SF FuneralF987244       250218","","31.63","","279624.14"
"2025-02-18","2025-02-18","SF FuneralFDC0000000HXY2250218","","31.63","","279655.77"
"2025-02-18","2025-02-18","SF FuneralF989177       250218","","31.63","","279687.4"
"2025-02-18","2025-02-18","SF FuneralF992519       250218","","31.63","","279719.03"
"2025-02-18","2025-02-18","SF FuneralFDC0000000L0TL250218","","31.63","","279750.66"
"2025-02-18","2025-02-18","SF FuneralFDC0000000L0TM250218","","31.63","","279782.29"
"2025-02-18","2025-02-18","SF FuneralF1080246      250218","","31.63","","279813.92"
"2025-02-18","2025-02-18","SF FuneralF1085179      250218","","31.63","","279845.55"
"2025-02-18","2025-02-18","SF FuneralF1112035      250218","","31.63","","279877.18"
"2025-02-18","2025-02-18","SF FuneralF1112298      250218","","31.63","","279908.81"
"2025-02-18","2025-02-18","SF FuneralF1113741      250218","","31.63","","279940.44"
"2025-02-18","2025-02-18","SF FuneralF1118335      250218","","31.63","","279972.07"
"2025-02-18","2025-02-18","SF FuneralF1124780      250218","","31.63","","280003.7"
"2025-02-18","2025-02-18","SF FuneralF1129409      250218","","31.63","","280035.33"
"2025-02-18","2025-02-18","SF FuneralF1130942      250218","","31.63","","280066.96"
"2025-02-18","2025-02-18","SF FuneralF1131798      250218","","31.63","","280098.59"
"2025-02-18","2025-02-18","SF FuneralF1132366      250218","","31.63","","280130.22"
"2025-02-18","2025-02-18","SF FuneralFDC00000007G81250218","","63.25","","280193.47"
"2025-02-18","2025-02-18","SF FuneralF1123027      250218","","31.63","","280225.1"
"2025-02-18","2025-02-18","SF FuneralF1125777      250218","","31.63","","280256.73"
"2025-02-18","2025-02-14","SF FuneralF1124033      250214","","126.5","","280383.23"
"2025-02-18","2025-02-13","SF FuneralFDC00000005KKZ250213","","126.5","","280509.73"
"2025-02-18","2025-02-13","SF FuneralFDC00000005L51250213","","126.5","","280636.23"
"2025-02-18","2025-02-18","SF FuneralFDC00000006L9F250218","","31.63","","280667.86"
"2025-02-18","2025-02-18","SF FuneralFDC00000006P6H250218","","126.5","","280794.36"
"2025-02-18","2025-02-18","SF FuneralFDC0000000HQB5250218","","31.63","","280825.99"
"2025-02-18","2025-02-18","SF FuneralF1080165      250218","","31.63","","280857.62"
"2025-02-18","2025-02-18","SF FuneralFDC0000000ML7D250218","","31.63","","280889.25"
"2025-02-18","2025-02-18","SF FuneralF1110796      250218","","31.63","","280920.88"
"2025-02-18","2025-02-18","SF FuneralFDC0000000NDDS250218","","126.5","","281047.38"
"2025-02-18","2025-02-18","SF FuneralF1118348      250218","","31.63","","281079.01"
"2025-02-18","2025-02-18","SF FuneralF1121768      250218","","63.25","","281142.26"
"2025-02-18","2025-02-18","SF FuneralF1130345      250218","","31.63","","281173.89"
"2025-02-18","2025-02-12","SF FuneralFDC00000005VNK250212","","126.5","","281300.39"
"2025-02-18","2025-02-12","SF FuneralF989757       250212","","126.5","","281426.89"
"2025-02-18","2025-02-12","SF FuneralFDC0000000KBFK250212","","126.5","","281553.39"
"2025-02-18","2025-02-12","SF FuneralF1120385      250212","","126.5","","281679.89"
"2025-02-18","2025-02-12","SF FuneralFDC00000005MJS250212","","126.5","","281806.39"
"2025-02-18","2025-02-12","SF FuneralFDC00000005NC4250212","","126.5","","281932.89"
"2025-02-18","2025-02-17","SF FuneralF822549       250217","","31.63","","281964.52"
"2025-02-18","2025-02-17","SF FuneralFDC0000000N82W250217","","126.5","","282091.02"
"2025-02-18","2025-02-18","SF FuneralFDC00000005DH3250218","","110","","282201.02"
"2025-02-18","2025-02-18","SF FuneralFDC00000007HDM250218","","126.5","","282327.52"
"2025-02-18","2025-02-18","SF FuneralF804091       250218","","31.63","","282359.15"
"2025-02-18","2025-02-18","SF FuneralF753764       250218","","126.5","","282485.65"
"2025-02-18","2025-02-18","SF FuneralF796739       250218","","31.63","","282517.28"
"2025-02-18","2025-02-18","SF FuneralF840779       250218","","126.5","","282643.78"
"2025-02-18","2025-02-18","SF FuneralF901250       250218","","63.25","","282707.03"
"2025-02-18","2025-02-18","SF FuneralF990180       250218","","31.63","","282738.66"
"2025-02-18","2025-02-18","SF FuneralF1061069      250218","","31.63","","282770.29"
"2025-02-18","2025-02-18","SF FuneralF1111603      250218","","31.63","","282801.92"
"2025-02-18","2025-02-12","SF FuneralFDC00000005PM9250212","","126.5","","282928.42"
"2025-02-18","2025-02-12","SF FuneralF816803       250212","","126.5","","283054.92"
"2025-02-18","2025-02-12","SF FuneralF843956       250212","","126.5","","283181.42"
"2025-02-18","2025-02-18","SF FuneralFDC000000061YD250218","","31.63","","283213.05"
"2025-02-18","2025-02-18","SF FuneralFDC000000079QY250218","","31.63","","283244.68"
"2025-02-18","2025-02-18","SF FuneralFDC00000007CJF250218","","63.25","","283307.93"
"2025-02-18","2025-02-18","SF FuneralF802375       250218","","31.63","","283339.56"
"2025-02-18","2025-02-18","SF FuneralF990232       250218","","31.63","","283371.19"
"2025-02-18","2025-02-18","SF FuneralF1020916      250218","","31.63","","283402.82"
"2025-02-18","2025-02-18","SF FuneralFDC0000000KQ5F250218","","31.63","","283434.45"
"2025-02-18","2025-02-18","SF FuneralF1065982      250218","","31.63","","283466.08"
"2025-02-18","2025-02-18","SF FuneralF1068029      250218","","31.63","","283497.71"
"2025-02-18","2025-02-18","SF FuneralF1073137      250218","","63.25","","283560.96"
"2025-02-18","2025-02-18","SF FuneralF1074649      250218","","31.63","","283592.59"
"2025-02-18","2025-02-18","SF FuneralF981451       250218","","31.63","","283624.22"
"2025-02-18","2025-02-18","SF FuneralF1115104      250218","","63.25","","283687.47"
"2025-02-18","2025-02-18","SF FuneralF1127485      250218","","31.63","","283719.1"
"2025-02-18","2025-02-18","SF FuneralF1129103      250218","","31.63","","283750.73"
"2025-02-18","2025-02-18","SF FuneralF1131768      250218","","126.5","","283877.23"
"2025-02-18","2025-02-18","SF FuneralF1132314      250218","","31.63","","283908.86"
"2025-02-18","2025-02-12","Rev SF FuneralFDC00000006TQ1250212","","-126.5","","283782.36"
"2025-02-18","2025-02-12","Rev SF FuneralFDC0000000PZSD250212","","-126.5","","283655.86"
"2025-02-18","2025-02-12","SF FuneralFDC000000064R7250212","","126.5","","283782.36"
"2025-02-18","2025-02-17","SF FuneralFDC00000005F1K250217","","31.63","","283813.99"
"2025-02-18","2025-02-17","SF FuneralFDC00000007D5W250217","","63.25","","283877.24"
"2025-02-18","2025-02-18","SF FuneralF814431       250218","","31.63","","283908.87"
"2025-02-18","2025-02-12","Rev SF FuneralFDC0000000HM0V250212","","-126.5","","283782.37"
"2025-02-18","2025-02-11","SF FuneralFDC00000006YDC250211","","126.5","","283908.87"
"2025-02-18","2025-02-12","SF FuneralFDC00000007NND250212","","126.5","","284035.37"
"2025-02-18","2025-02-13","SF FuneralFDC00000006Z37250213","","126.5","","284161.87"
"2025-02-18","2025-02-15","SF FuneralFDC000000071GW250215","","126.5","","284288.37"
"2025-02-18","2025-02-18","SF FuneralF843810       250218","","63.25","","284351.62"
"2025-02-18","2025-02-18","SF FuneralFDC0000000ND1R250218","","31.63","","284383.25"
"2025-02-18","2025-02-18","SF FuneralFDC0000000ND1S250218","","31.63","","284414.88"
"2025-02-18","2025-02-18","SF FuneralF1123497      250218","","31.63","","284446.51"
"2025-02-18","2025-02-14","SF FuneralF812499       250214","","63.25","","284509.76"
"2025-02-18","2025-02-14","SF FuneralFDC000000034WF250214","","220","","284729.76"
"2025-02-18","2025-02-14","SF FuneralFDC0000000K7CQ250214","","31.63","","284761.39"
"2025-02-18","2025-02-15","SF FuneralF1127722      250215","","126.5","","284887.89"
"2025-02-18","2025-02-17","SF FuneralFDC000000067RJ250217","","126.5","","285014.39"
"2025-02-18","2025-02-17","SF FuneralF1073094      250217","","126.5","","285140.89"
"2025-02-18","2025-02-17","Rev SF FuneralFDC0000000N2L5250217","","-126.5","","285014.39"
"2025-02-18","2025-02-18","SF FuneralF797213       250218","","31.63","","285046.02"
"2025-02-18","2025-02-17","SF FuneralFDC000000075NF250217","","126.5","","285172.52"
"2025-02-18","2025-02-15","SF FuneralFDC0000000KH3D250216","","31.63","","285204.15"
"2025-02-18","2025-02-15","SF FuneralF1126000      250215","","126.5","","285330.65"
"2025-02-18","2025-02-17","SF FuneralFDC00000005XK1250217","","220","","285550.65"
"2025-02-18","2025-02-17","SF FuneralF844580       250215","","126.5","","285677.15"
"2025-02-18","2025-02-17","SF FuneralF1118978      250217","","126.5","","285803.65"
"2025-02-18","2025-02-18","SF FuneralFDC00000007J73250218","","63.25","","285866.9"
"2025-02-18","2025-02-18","SF FuneralFDC0000000HG11250218","","63.25","","285930.15"
"2025-02-18","2025-02-14","Rev SF FuneralFDC0000000JFC4250214","","-31.63","","285898.52"
"2025-02-18","2025-02-12","Rev SF FuneralFDC0000000PLW4250212","","-126.5","","285772.02"
"2025-02-18","2025-02-15","Rev SF FuneralFDC000000071GW250215","","-126.5","","285645.52"
"2025-02-18","2025-02-12","Rev SF FuneralFDC0000000PLW7250212","","-126.5","","285519.02"
"2025-02-18","2025-01-24","Rev SF FuneralFDC000000070D4250128","","-126.5","","285392.52"
"2025-02-18","2025-01-22","Rev SF FuneralFDC00000008FKB250122","","-126.5","","285266.02"
"2025-02-18","2025-02-14","Rev SF FuneralFDC000000034WF250214","","-220","","285046.02"
"2025-02-18","2025-02-04","Rev SF FuneralFDC00000007VX8250204","","-126.5","","284919.52"
"2025-02-18","2025-02-12","Rev SF FuneralFDC00000007CK1250212","","-126.5","","284793.02"
"2025-02-18","2025-02-17","SF FuneralFDC00000005P76250217","","126.5","","284919.52"
"2025-02-18","2025-02-17","SF FuneralF1073199      250217","","126.5","","285046.02"
"2025-02-18","2025-02-18","SF FuneralF844086       250218","","63.25","","285109.27"
"2025-02-18","2025-02-18","SF FuneralF811655       250218","","31.63","","285140.9"
"2025-02-18","2025-02-18","SF FuneralFDC0000000L7RR250218","","126.5","","285267.4"
"2025-02-19","2025-02-12","SF FuneralFDC0000000600K250212","","126.5","","285393.9"
"2025-02-19","2025-02-12","SF FuneralFDC00000006011250212","","126.5","","285520.4"
"2025-02-19","2025-02-17","SF FuneralF1083929      250217","","63.25","","285583.65"
"2025-02-19","2025-02-10","SF FuneralF1114627      250210","","63.25","","285646.9"
"2025-02-19","2025-02-13","SF FuneralF1104032      250213","","126.5","","285773.4"
"2025-02-19","2025-02-14","SF FuneralF843724       250214","","63.25","","285836.65"
"2025-02-19","2025-02-15","SF FuneralFDC00000005XG6250215","","126.5","","285963.15"
"2025-02-19","2025-02-15","SF FuneralFDC00000005XNC250215","","31.63","","285994.78"
"2025-02-19","2025-02-15","SF FuneralFDC00000007HT4250215","","126.5","","286121.28"
"2025-02-19","2025-02-15","SF FuneralF776812       250215","","386.5","","286507.78"
"2025-02-19","2025-02-15","SF FuneralFDC0000000L9GB250215","","126.5","","286634.28"
"2025-02-19","2025-02-15","SF FuneralF1074829      250215","","126.5","","286760.78"
"2025-02-19","2025-02-15","SF FuneralF1118414      250216","","31.63","","286792.41"
"2025-02-19","2025-02-15","SF FuneralF1127843      250215","","31.63","","286824.04"
"2025-02-19","2025-02-15","SF FuneralF1130776      250215","","31.63","","286855.67"
"2025-02-19","2025-02-17","SF FuneralFDC00000002R4Q250217","","220","","287075.67"
"2025-02-19","2025-02-17","SF FuneralFDC00000005RR7250217","","31.63","","287107.3"
"2025-02-19","2025-02-17","SF FuneralFDC000000063HH250217","","126.5","","287233.8"
"2025-02-19","2025-02-17","SF FuneralFDC00000006M8H250216","","126.5","","287360.3"
"2025-02-19","2025-02-17","SF FuneralFDC00000006SLY250216","","126.5","","287486.8"
"2025-02-19","2025-02-17","SF FuneralFDC00000006SLZ250216","","126.5","","287613.3"
"2025-02-19","2025-02-17","SF FuneralF805529       250217","","126.5","","287739.8"
"2025-02-19","2025-02-17","SF FuneralF841739       250216","","126.5","","287866.3"
"2025-02-19","2025-02-17","SF FuneralF1080152      250217","","126.5","","287992.8"
"2025-02-19","2025-02-17","SF FuneralF1123098      250217","","31.63","","288024.43"
"2025-02-19","2025-02-17","SF FuneralF1129452      250217","","31.63","","288056.06"
"2025-02-19","2025-02-18","SF FuneralFDC0000000JHBW250218","","31.63","","288087.69"
"2025-02-19","2025-02-18","SF FuneralF1068212      250218","","31.63","","288119.32"
"2025-02-19","2025-02-18","SF FuneralF1080249      250218","","31.63","","288150.95"
"2025-02-19","2025-02-18","SF FuneralFDC0000000P3GS250218","","126.5","","288277.45"
"2025-02-19","2025-02-18","SF FuneralF1130870      250218","","31.63","","288309.08"
"2025-02-19","2025-02-11","SF FuneralF831283       250211","","126.5","","288435.58"
"2025-02-19","2025-02-12","SF FuneralFDC00000008FDG250212","","126.5","","288562.08"
"2025-02-19","2025-02-15","SF FuneralFDC00000005MWG250215","","31.63","","288593.71"
"2025-02-19","2025-02-15","SF FuneralF1072684      250215","","31.63","","288625.34"
"2025-02-19","2025-02-17","SF FuneralFDC0000000NYB2250217","","126.5","","288751.84"
"2025-02-19","2025-02-17","SF FuneralF834627       250216","","31.63","","288783.47"
"2025-02-19","2025-02-17","SF FuneralFDC0000000KYZ5250217","","31.63","","288815.1"
"2025-02-19","2025-02-19","SF FuneralF1127493      250219","","31.63","","288846.73"
"2025-02-19","2025-02-19","SF FuneralF844044       250219","","31.63","","288878.36"
"2025-02-19","2025-02-19","SF FuneralFDC00000005XY8250219","","126.5","","289004.86"
"2025-02-19","2025-02-19","SF FuneralFDC00000005Y44250219","","126.5","","289131.36"
"2025-02-19","2025-02-19","SF FuneralFDC00000006FX3250219","","126.5","","289257.86"
"2025-02-19","2025-02-19","SF FuneralFDC00000006W2Y250219","","126.5","","289384.36"
"2025-02-19","2025-02-19","SF FuneralFDC00000006W30250219","","126.5","","289510.86"
"2025-02-19","2025-02-19","SF FuneralF1072876      250219","","126.5","","289637.36"
"2025-02-19","2025-02-19","SF FuneralF1124159      250219","","63.25","","289700.61"
"2025-02-19","2025-02-19","SF FuneralF1131023      250219","","126.5","","289827.11"
"2025-02-19","2025-02-19","SF FuneralFDC00000002SRP250219","","220","","290047.11"
"2025-02-19","2025-02-19","SF FuneralFDC000000061SG250219","","126.5","","290173.61"
"2025-02-19","2025-02-19","SF FuneralFDC0000000PX2H250219","","126.5","","290300.11"
"2025-02-19","2025-02-12","SF FuneralFDC00000005WQ1250212","","126.5","","290426.61"
"2025-02-19","2025-02-18","SF FuneralF1073801      250218","","31.63","","290458.24"
"2025-02-19","2025-02-19","SF FuneralFDC0000000873B250219","","126.5","","290584.74"
"2025-02-19","2025-02-19","SF FuneralFDC00000008H3W250219","","126.5","","290711.24"
"2025-02-19","2025-02-19","SF FuneralFDC0000000HC6L250219","","126.5","","290837.74"
"2025-02-19","2025-02-19","SF FuneralFDC0000000PNDR250219","","126.5","","290964.24"
"2025-02-19","2025-02-15","SF FuneralF1074785      250215","","31.63","","290995.87"
"2025-02-19","2025-02-15","SF FuneralF1104075      250215","","126.5","","291122.37"
"2025-02-19","2025-02-15","SF FuneralF1127442      250215","","126.5","","291248.87"
"2025-02-19","2025-02-14","SF FuneralF823416       250214","","126.5","","291375.37"
"2025-02-19","2025-02-19","SF FuneralFDC00000008X5B250219","","31.63","","291407"
"2025-02-19","2025-02-19","SF FuneralF1127570      250219","","126.5","","291533.5"
"2025-02-19","2025-02-17","SF FuneralF1066274      250217","","31.63","","291565.13"
"2025-02-19","2025-02-18","SF FuneralF1078281      250218","","63.25","","291628.38"
"2025-02-19","2025-02-19","SF FuneralFDC00000005Q2Z250219","","63.25","","291691.63"
"2025-02-19","2025-02-19","SF FuneralFDC00000005R1F250219","","63.25","","291754.88"
"2025-02-19","2025-02-19","SF FuneralFDC00000006JJK250219","","63.25","","291818.13"
"2025-02-19","2025-02-19","SF FuneralFDC0000000KQN5250219","","126.5","","291944.63"
"2025-02-19","2025-02-14","Rev SF FuneralFDC0000000K7CQ250214","","-31.63","","291913"
"2025-02-19","2025-02-15","Rev SF FuneralFDC0000000KH3D250216","","-31.63","","291881.37"
"2025-02-19","2025-02-15","Rev SF FuneralFDC00000007HT4250215","","-126.5","","291754.87"
"2025-02-19","2025-02-17","Rev SF FuneralFDC00000006SLY250216","","-126.5","","291628.37"
"2025-02-19","2025-02-17","Rev SF FuneralFDC00000006SLZ250216","","-126.5","","291501.87"
"2025-02-19","2025-02-15","Rev SF FuneralFDC0000000L9GB250215","","-126.5","","291375.37"
"2025-02-19","2025-02-10","SF FuneralF990195       250210","","126.5","","291501.87"
"2025-02-19","2025-02-12","SF FuneralFDC00000005PK5250212","","126.5","","291628.37"
"2025-02-19","2025-02-12","SF FuneralFDC00000005TL4250212","","126.5","","291754.87"
"2025-02-19","2025-02-13","SF FuneralF830489       250213","","126.5","","291881.37"
"2025-02-19","2025-02-15","SF FuneralF784736       250215","","31.63","","291913"
"2025-02-19","2025-02-15","SF FuneralF1017419      250216","","63.25","","291976.25"
"2025-02-19","2025-02-15","SF FuneralF1079004      250216","","31.63","","292007.88"
"2025-02-19","2025-02-17","SF FuneralFDC00000006SV7250216","","31.63","","292039.51"
"2025-02-19","2025-02-17","SF FuneralFDC00000009G6B250216","","31.63","","292071.14"
"2025-02-19","2025-02-18","SF FuneralFDC00000005YYS250218","","31.63","","292102.77"
"2025-02-19","2025-02-18","SF FuneralF1072724      250218","","31.63","","292134.4"
"2025-02-19","2025-02-17","SF FuneralFDC0000000649N250217","","126.5","","292260.9"
"2025-02-19","2025-02-17","SF FuneralF900413       250215","","126.5","","292387.4"
"2025-02-19","2025-02-17","SF FuneralFDC0000000J1SG250217","","126.5","","292513.9"
"2025-02-19","2025-02-19","SF FuneralF1127823      250219","","126.5","","292640.4"
"2025-02-19","2025-02-12","SF FuneralF1118744      250212","","126.5","","292766.9"
"2025-02-19","2025-02-17","SF FuneralFDC00000008ZBX250217","","126.5","","292893.4"
"2025-02-19","2025-02-17","SF FuneralF1130859      250217","","126.5","","293019.9"
"2025-02-19","2025-02-18","SF FuneralF1127480      250218","","31.63","","293051.53"
"2025-02-19","2025-02-19","SF FuneralF1115979      250219","","126.5","","293178.03"
"2025-02-19","2024-07-22","Rev SF FuneralFDC00000007K8Z240722","","-126.5","","293051.53"
"2025-02-19","2025-02-12","SF FuneralF800675       250212","","126.5","","293178.03"
"2025-02-19","2025-02-17","SF FuneralFDC00000005NT1250217","","31.63","","293209.66"
"2025-02-19","2025-02-17","SF FuneralFDC00000005RZQ250217","","31.63","","293241.29"
"2025-02-19","2025-02-17","SF FuneralFDC00000009XWR250216","","31.63","","293272.92"
"2025-02-19","2025-02-17","SF FuneralFDC0000000C26W250217","","126.5","","293399.42"
"2025-02-19","2025-02-17","SF FuneralF831186       250217","","126.5","","293525.92"
"2025-02-19","2025-02-17","SF FuneralF1115983      250217","","126.5","","293652.42"
"2025-02-19","2025-02-18","SF FuneralF798846       250218","","31.63","","293684.05"
"2025-02-19","2025-02-19","SF FuneralF990934       250219","","126.5","","293810.55"
"2025-02-19","2025-02-01","Rev SF FuneralFDC0000000PRPP250201","","-126.5","","293684.05"
"2025-02-19","2024-12-11","Rev SF FuneralF1108476      241227","","-126.5","","293557.55"
"2025-02-19","2024-08-31","Rev SF FuneralF1110542      240901","","-126.5","","293431.05"
"2025-02-19","2025-02-19","Rev SF FuneralFDC00000008H3W250219","","-126.5","","293304.55"
"2025-02-19","2025-02-04","Rev SF FuneralFDC0000000N7MN250204","","-31.63","","293272.92"
"2025-02-19","2025-02-17","Rev SF FuneralFDC0000000KYZ5250217","","-31.63","","293241.29"
"2025-02-19","2025-02-15","SF FuneralF1111639      250216","","126.5","","293367.79"
"2025-02-19","2025-02-12","SF FuneralFDC00000006X2W250212","","126.5","","293494.29"
"2025-02-19","2025-02-15","SF FuneralFDC0000000JY24250216","","31.63","","293525.92"
"2025-02-19","2025-02-15","SF FuneralF1115201      250216","","126.5","","293652.42"
"2025-02-19","2025-02-17","SF FuneralFDC000000042HH250216","","55","","293707.42"
"2025-02-19","2025-02-17","SF FuneralFDC00000005NKJ250217","","31.63","","293739.05"
"2025-02-19","2025-02-17","SF FuneralFDC00000007CPH250217","","126.5","","293865.55"
"2025-02-19","2025-02-17","SF FuneralF1017423      250217","","126.5","","293992.05"
"2025-02-19","2025-02-17","SF FuneralFDC00000002XYZ250216","","55","","294047.05"
"2025-02-19","2025-02-17","SF FuneralF844135       250217","","126.5","","294173.55"
"2025-02-19","2025-02-17","SF FuneralF900440       250217","","126.5","","294300.05"
"2025-02-20","2025-02-18","SF FuneralFDC00000007LG1250218","","31.63","","294331.68"
"2025-02-20","2025-02-18","SF FuneralF797821       250218","","63.25","","294394.93"
"2025-02-20","2025-02-18","SF FuneralF818153       250218","","31.63","","294426.56"
"2025-02-20","2025-02-19","SF FuneralFDC00000005TXN250219","","126.5","","294553.06"
"2025-02-20","2025-02-17","SF FuneralFDC00000004CSK250217","","55","","294608.06"
"2025-02-20","2025-02-17","SF FuneralFDC00000004CSL250217","","55","","294663.06"
"2025-02-20","2025-02-17","SF FuneralFDC00000006W4Y250217","","126.5","","294789.56"
"2025-02-20","2025-02-17","SF FuneralFDC000000071X2250217","","126.5","","294916.06"
"2025-02-20","2025-02-17","SF FuneralFDC00000007RDZ250217","","126.5","","295042.56"
"2025-02-20","2025-02-17","SF FuneralFDC00000007X59250217","","126.5","","295169.06"
"2025-02-20","2025-02-17","SF FuneralF797478       250217","","126.5","","295295.56"
"2025-02-20","2025-02-17","SF FuneralFDC00000008CPQ250217","","126.5","","295422.06"
"2025-02-20","2025-02-17","SF FuneralF812202       250217","","31.63","","295453.69"
"2025-02-20","2025-02-17","SF FuneralF814567       250217","","126.5","","295580.19"
"2025-02-20","2025-02-17","SF FuneralF819102       250217","","126.5","","295706.69"
"2025-02-20","2025-02-17","SF FuneralF820956       250216","","31.63","","295738.32"
"2025-02-20","2025-02-17","SF FuneralFDC0000000CWBD250216","","31.63","","295769.95"
"2025-02-20","2025-02-17","SF FuneralF844276       250217","","126.5","","295896.45"
"2025-02-20","2025-02-17","SF FuneralF901219       250217","","126.5","","296022.95"
"2025-02-20","2025-02-17","SF FuneralFDC0000000HGDW250217","","126.5","","296149.45"
"2025-02-20","2025-02-17","SF FuneralF981748       250217","","126.5","","296275.95"
"2025-02-20","2025-02-17","SF FuneralF1111932      250217","","126.5","","296402.45"
"2025-02-20","2025-02-17","SF FuneralF1119704      250217","","126.5","","296528.95"
"2025-02-20","2025-02-15","SF FuneralF1113937      250216","","63.25","","296592.2"
"2025-02-20","2025-02-12","SF FuneralF1118778      250212","","126.5","","296718.7"
"2025-02-20","2025-02-12","SF FuneralF834870       250212","","126.5","","296845.2"
"2025-02-20","2025-02-15","SF FuneralFDC0000000JVCB250216","","31.63","","296876.83"
"2025-02-20","2025-02-17","SF FuneralF1122727      250217","","31.63","","296908.46"
"2025-02-20","2025-02-17","SF FuneralF1123031      250217","","126.5","","297034.96"
"2025-02-20","2025-02-14","SF FuneralFDC0000000D307250214","","31.63","","297066.59"
"2025-02-20","2025-02-14","SF FuneralF989273       250216","","31.63","","297098.22"
"2025-02-20","2025-02-15","SF FuneralF1054743      250216","","31.63","","297129.85"
"2025-02-20","2025-02-15","SF FuneralF1122295      250216","","31.63","","297161.48"
"2025-02-20","2025-02-17","SF FuneralFDC00000005LQV250217","","31.63","","297193.11"
"2025-02-20","2025-02-17","SF FuneralFDC00000005LS9250217","","31.63","","297224.74"
"2025-02-20","2025-02-17","SF FuneralFDC00000005YNL250217","","55","","297279.74"
"2025-02-20","2025-02-17","SF FuneralFDC00000005YW3250217","","31.63","","297311.37"
"2025-02-20","2025-02-17","SF FuneralFDC00000006RQ8250216","","31.63","","297343"
"2025-02-20","2025-02-17","SF FuneralFDC000000087G6250216","","31.63","","297374.63"
"2025-02-20","2025-02-17","SF FuneralF814448       250216","","31.63","","297406.26"
"2025-02-20","2025-02-17","SF FuneralF819012       250217","","31.63","","297437.89"
"2025-02-20","2025-02-17","SF FuneralF820012       250217","","31.63","","297469.52"
"2025-02-20","2025-02-17","SF FuneralF832990       250216","","31.63","","297501.15"
"2025-02-20","2025-02-17","SF FuneralF834650       250216","","31.63","","297532.78"
"2025-02-20","2025-02-17","SF FuneralFDC0000000K09V250217","","31.63","","297564.41"
"2025-02-20","2025-02-17","SF FuneralF1079351      250217","","31.63","","297596.04"
"2025-02-20","2025-02-18","SF FuneralF816581       250218","","31.63","","297627.67"
"2025-02-20","2025-02-18","SF FuneralF816835       250218","","31.63","","297659.3"
"2025-02-20","2025-02-19","SF FuneralF1124138      250219","","31.63","","297690.93"
"2025-02-20","2025-02-17","SF FuneralFDC00000007FTH250217","","126.5","","297817.43"
"2025-02-20","2025-02-17","SF FuneralFDC00000007HQQ250217","","126.5","","297943.93"
"2025-02-20","2025-02-17","SF FuneralF1073148      250217","","126.5","","298070.43"
"2025-02-20","2025-02-17","SF FuneralF1124167      250217","","126.5","","298196.93"
"2025-02-20","2025-02-12","SF FuneralFDC00000007MBF250212","","126.5","","298323.43"
"2025-02-20","2025-02-12","SF FuneralFDC00000007RSN250212","","126.5","","298449.93"
"2025-02-20","2025-02-13","SF FuneralFDC00000008CQR250213","","126.5","","298576.43"
"2025-02-20","2025-02-15","SF FuneralF1017459      250216","","126.5","","298702.93"
"2025-02-20","2025-02-15","SF FuneralF1111567      250216","","126.5","","298829.43"
"2025-02-20","2025-02-15","SF FuneralF1130409      250216","","126.5","","298955.93"
"2025-02-20","2025-02-17","SF FuneralFDC00000005MBH250217","","126.5","","299082.43"
"2025-02-20","2025-02-17","SF FuneralFDC000000071C5250216","","126.5","","299208.93"
"2025-02-20","2025-02-17","SF FuneralFDC000000076WX250217","","126.5","","299335.43"
"2025-02-20","2025-02-17","SF FuneralFDC00000007JPM250216","","63.25","","299398.68"
"2025-02-20","2025-02-17","SF FuneralFDC0000000812F250217","","126.5","","299525.18"
"2025-02-20","2025-02-17","SF FuneralF802762       250217","","126.5","","299651.68"
"2025-02-20","2025-02-17","SF FuneralF819193       250217","","126.5","","299778.18"
"2025-02-20","2025-02-17","SF FuneralF822436       250217","","126.5","","299904.68"
"2025-02-20","2025-02-17","SF FuneralF834853       250216","","126.5","","300031.18"
"2025-02-20","2025-02-17","SF FuneralF844661       250217","","126.5","","300157.68"
"2025-02-20","2025-02-17","SF FuneralFDC0000000GWQQ250217","","126.5","","300284.18"
"2025-02-20","2025-02-17","SF FuneralFDC0000000K17R250217","","126.5","","300410.68"
"2025-02-20","2025-02-17","SF FuneralFDC0000000K18V250217","","126.5","","300537.18"
"2025-02-20","2025-02-17","SF FuneralF1061594      250217","","126.5","","300663.68"
"2025-02-20","2025-02-17","SF FuneralF1080260      250217","","126.5","","300790.18"
"2025-02-20","2025-02-17","SF FuneralF1114639      250217","","126.5","","300916.68"
"2025-02-20","2025-02-17","SF FuneralF1116789      250217","","63.25","","300979.93"
"2025-02-20","2025-02-17","SF FuneralF1124331      250217","","126.5","","301106.43"
"2025-02-20","2025-02-18","SF FuneralFDC00000006K8Z250218","","126.5","","301232.93"
"2025-02-20","2025-02-18","SF FuneralF834979       250218","","63.25","","301296.18"
"2025-02-20","2025-02-18","SF FuneralF1124197      250218","","126.5","","301422.68"
"2025-02-20","2025-02-19","SF FuneralFDC00000008FYX250219","","126.5","","301549.18"
"2025-02-20","2025-02-18","SF FuneralF810426       250218","","31.63","","301580.81"
"2025-02-20","2025-02-16","SF FuneralF833253       250216","","31.63","","301612.44"
"2025-02-20","2025-02-17","SF FuneralFDC00000005XX1250217","","126.5","","301738.94"
"2025-02-20","2025-02-17","SF FuneralFDC0000000602T250217","","126.5","","301865.44"
"2025-02-20","2025-02-17","SF FuneralFDC000000064YD250217","","126.5","","301991.94"
"2025-02-20","2025-02-17","SF FuneralFDC00000006QFW250217","","126.5","","302118.44"
"2025-02-20","2025-02-17","SF FuneralFDC00000006T5Y250217","","126.5","","302244.94"
"2025-02-20","2025-02-17","SF FuneralF804915       250217","","126.5","","302371.44"
"2025-02-20","2025-02-17","SF FuneralF819802       250217","","31.63","","302403.07"
"2025-02-20","2025-02-17","SF FuneralF822927       250217","","126.5","","302529.57"
"2025-02-20","2025-02-17","SF FuneralF829008       250217","","126.5","","302656.07"
"2025-02-20","2025-02-17","SF FuneralF844782       250217","","126.5","","302782.57"
"2025-02-20","2025-02-17","SF FuneralF990712       250217","","126.5","","302909.07"
"2025-02-20","2025-02-17","SF FuneralF1054861      250217","","126.5","","303035.57"
"2025-02-20","2025-02-17","SF FuneralF1061061      250217","","126.5","","303162.07"
"2025-02-20","2025-02-17","SF FuneralF1120655      250217","","31.63","","303193.7"
"2025-02-20","2025-02-17","SF FuneralF1129477      250217","","126.5","","303320.2"
"2025-02-20","2025-02-17","SF FuneralF1130847      250217","","31.63","","303351.83"
"2025-02-20","2025-02-17","SF FuneralF1132080      250217","","126.5","","303478.33"
"2025-02-20","2025-02-15","SF FuneralF1021491      250216","","31.63","","303509.96"
"2025-02-20","2025-02-20","SF FuneralF1120242      250220","","126.5","","303636.46"
"2025-02-20","2025-02-20","SF FuneralFDC00000009F9L250220","","126.5","","303762.96"
"2025-02-20","2025-02-20","SF FuneralFDC00000009VG5250220","","126.5","","303889.46"
"2025-02-20","2025-02-20","SF FuneralFDC000000060XJ250220","","126.5","","304015.96"
"2025-02-20","2025-02-20","SF FuneralFDC00000006329250220","","126.5","","304142.46"
"2025-02-20","2025-02-20","SF FuneralFDC000000078VX250220","","126.5","","304268.96"
"2025-02-20","2025-02-20","SF FuneralFDC00000008LYF250220","","126.5","","304395.46"
"2025-02-20","2025-02-20","SF FuneralF1110071      250220","","126.5","","304521.96"
"2025-02-20","2025-02-15","SF FuneralF817889       250215","","126.5","","304648.46"
"2025-02-20","2025-02-15","SF FuneralF1060968      250216","","31.63","","304680.09"
"2025-02-20","2025-02-17","SF FuneralFDC00000002WYL250217","","55","","304735.09"
"2025-02-20","2025-02-17","SF FuneralFDC00000003591250217","","55","","304790.09"
"2025-02-20","2025-02-17","SF FuneralFDC00000003N3S250217","","220","","305010.09"
"2025-02-20","2025-02-17","SF FuneralFDC00000005PLC250217","","126.5","","305136.59"
"2025-02-20","2025-02-17","SF FuneralFDC00000005QL1250217","","126.5","","305263.09"
"2025-02-20","2025-02-17","SF FuneralFDC00000006G7S250217","","126.5","","305389.59"
"2025-02-20","2025-02-17","SF FuneralFDC00000008097250217","","126.5","","305516.09"
"2025-02-20","2025-02-17","SF FuneralFDC00000008H2Z250217","","126.5","","305642.59"
"2025-02-20","2025-02-17","SF FuneralF811108       250217","","126.5","","305769.09"
"2025-02-20","2025-02-17","SF FuneralF827871       250217","","126.5","","305895.59"
"2025-02-20","2025-02-17","SF FuneralF830987       250217","","126.5","","306022.09"
"2025-02-20","2025-02-17","SF FuneralF831193       250217","","126.5","","306148.59"
"2025-02-20","2025-02-17","SF FuneralF834697       250217","","126.5","","306275.09"
"2025-02-20","2025-02-17","SF FuneralF1059415      250217","","126.5","","306401.59"
"2025-02-20","2025-02-17","SF FuneralFDC0000000LC7N250217","","126.5","","306528.09"
"2025-02-20","2025-02-17","SF FuneralF1075119      250217","","126.5","","306654.59"
"2025-02-20","2025-02-17","SF FuneralF1085015      250217","","126.5","","306781.09"
"2025-02-20","2025-02-17","SF FuneralF1085065      250217","","126.5","","306907.59"
"2025-02-20","2025-02-17","SF FuneralF1104100      250217","","126.5","","307034.09"
"2025-02-20","2025-02-17","SF FuneralF1104109      250217","","126.5","","307160.59"
"2025-02-20","2025-02-17","SF FuneralF1120125      250217","","126.5","","307287.09"
"2025-02-20","2025-02-18","SF FuneralF1115031      250218","","31.63","","307318.72"
"2025-02-20","2025-02-20","SF FuneralF991098       250220","","126.5","","307445.22"
"2025-02-20","2025-02-20","SF FuneralF991567       250220","","126.5","","307571.72"
"2025-02-20","2025-02-20","SF FuneralF1113935      250220","","126.5","","307698.22"
"2025-02-20","2025-02-20","SF FuneralF1120590      250220","","126.5","","307824.72"
"2025-02-20","2025-02-17","SF FuneralFDC00000006QDH250217","","126.5","","307951.22"
"2025-02-20","2025-02-17","SF FuneralFDC00000006VXW250217","","126.5","","308077.72"
"2025-02-20","2025-02-17","SF FuneralFDC00000007HS4250217","","126.5","","308204.22"
"2025-02-20","2025-02-17","SF FuneralFDC00000007J5C250217","","126.5","","308330.72"
"2025-02-20","2025-02-17","SF FuneralFDC00000007MJX250217","","126.5","","308457.22"
"2025-02-20","2025-02-17","SF FuneralFDC00000008JTX250217","","126.5","","308583.72"
"2025-02-20","2025-02-17","SF FuneralF814669       250217","","126.5","","308710.22"
"2025-02-20","2025-02-17","SF FuneralF814899       250217","","126.5","","308836.72"
"2025-02-20","2025-02-17","SF FuneralF828005       250217","","126.5","","308963.22"
"2025-02-20","2025-02-17","SF FuneralF829484       250217","","126.5","","309089.72"
"2025-02-20","2025-02-17","SF FuneralF830817       250217","","126.5","","309216.22"
"2025-02-20","2025-02-17","SF FuneralFDC0000000C29R250217","","126.5","","309342.72"
"2025-02-20","2025-02-17","SF FuneralF1021159      250217","","126.5","","309469.22"
"2025-02-20","2025-02-17","SF FuneralF1022097      250217","","126.5","","309595.72"
"2025-02-20","2025-02-17","SF FuneralF1052756      250217","","126.5","","309722.22"
"2025-02-20","2025-02-17","SF FuneralF1055321      250217","","126.5","","309848.72"
"2025-02-20","2025-02-17","SF FuneralFDC0000000KDL6250217","","126.5","","309975.22"
"2025-02-20","2025-02-17","SF FuneralF1060292      250217","","126.5","","310101.72"
"2025-02-20","2025-02-17","SF FuneralF1061969      250217","","126.5","","310228.22"
"2025-02-20","2025-02-17","SF FuneralF1080472      250217","","126.5","","310354.72"
"2025-02-20","2025-02-17","SF FuneralF1115021      250217","","256.5","","310611.22"
"2025-02-20","2025-02-17","SF FuneralF1130229      250217","","126.5","","310737.72"
"2025-02-20","2025-02-14","SF FuneralF988945       250216","","31.63","","310769.35"
"2025-02-20","2025-02-17","SF FuneralFDC00000005N4P250217","","31.63","","310800.98"
"2025-02-20","2025-02-17","SF FuneralFDC000000067C7250217","","31.63","","310832.61"
"2025-02-20","2025-02-17","SF FuneralF797906       250217","","31.63","","310864.24"
"2025-02-20","2025-02-17","SF FuneralFDC00000008MY8250216","","31.63","","310895.87"
"2025-02-20","2025-02-17","SF FuneralF811324       250217","","112.88","","311008.75"
"2025-02-20","2025-02-17","SF FuneralFDC00000009G6R250217","","31.63","","311040.38"
"2025-02-20","2025-02-17","SF FuneralF818028       250217","","31.63","","311072.01"
"2025-02-20","2025-02-17","SF FuneralF988318       250217","","31.63","","311103.64"
"2025-02-20","2025-02-17","SF FuneralF1052717      250217","","31.63","","311135.27"
"2025-02-20","2025-02-17","SF FuneralF1068000      250217","","31.63","","311166.9"
"2025-02-20","2025-02-17","SF FuneralF1117412      250217","","31.63","","311198.53"
"2025-02-20","2025-02-17","SF FuneralF1130901      250217","","31.63","","311230.16"
"2025-02-20","2025-02-18","SF FuneralF793715       250218","","31.63","","311261.79"
"2025-02-20","2025-02-18","SF FuneralF802295       250218","","31.63","","311293.42"
"2025-02-20","2025-02-18","SF FuneralF809823       250218","","31.63","","311325.05"
"2025-02-20","2025-02-18","SF FuneralF823596       250218","","31.63","","311356.68"
"2025-02-20","2025-02-18","SF FuneralF799620       250218","","64.13","","311420.81"
"2025-02-20","2025-02-11","SF FuneralF795428       250211","","63.25","","311484.06"
"2025-02-20","2025-02-12","SF FuneralFDC00000006997250212","","126.5","","311610.56"
"2025-02-20","2025-02-12","SF FuneralFDC00000006998250212","","126.5","","311737.06"
"2025-02-20","2025-02-12","SF FuneralFDC0000000J28V250212","","126.5","","311863.56"
"2025-02-20","2025-02-15","SF FuneralFDC0000000K1G3250215","","126.5","","311990.06"
"2025-02-20","2025-02-17","SF FuneralFDC0000000369L250217","","220","","312210.06"
"2025-02-20","2025-02-17","SF FuneralFDC00000005D9Y250217","","126.5","","312336.56"
"2025-02-20","2025-02-17","SF FuneralFDC00000005SJP250217","","126.5","","312463.06"
"2025-02-20","2025-02-17","SF FuneralFDC00000005XH1250217","","126.5","","312589.56"
"2025-02-20","2025-02-17","SF FuneralFDC000000070M5250217","","126.5","","312716.06"
"2025-02-20","2025-02-17","SF FuneralFDC00000007488250217","","126.5","","312842.56"
"2025-02-20","2025-02-17","SF FuneralFDC0000000828D250217","","126.5","","312969.06"
"2025-02-20","2025-02-17","SF FuneralFDC00000008L4Z250217","","126.5","","313095.56"
"2025-02-20","2025-02-17","SF FuneralFDC00000008T67250217","","126.5","","313222.06"
"2025-02-20","2025-02-17","SF FuneralF813539       250217","","126.5","","313348.56"
"2025-02-20","2025-02-17","SF FuneralF814406       250217","","126.5","","313475.06"
"2025-02-20","2025-02-17","SF FuneralF777214       250217","","126.5","","313601.56"
"2025-02-20","2025-02-17","SF FuneralF814505       250217","","126.5","","313728.06"
"2025-02-20","2025-02-17","SF FuneralF814570       250217","","126.5","","313854.56"
"2025-02-20","2025-02-17","SF FuneralF822940       250217","","126.5","","313981.06"
"2025-02-20","2025-02-17","SF FuneralF823496       250217","","126.5","","314107.56"
"2025-02-20","2025-02-17","SF FuneralF831364       250217","","126.5","","314234.06"
"2025-02-20","2025-02-17","SF FuneralF844091       250217","","126.5","","314360.56"
"2025-02-20","2025-02-17","SF FuneralF844167       250217","","126.5","","314487.06"
"2025-02-20","2025-02-17","SF FuneralF844407       250217","","126.5","","314613.56"
"2025-02-20","2025-02-17","SF FuneralF988180       250217","","126.5","","314740.06"
"2025-02-20","2025-02-17","SF FuneralF1054599      250217","","126.5","","314866.56"
"2025-02-20","2025-02-17","SF FuneralF1078932      250217","","126.5","","314993.06"
"2025-02-20","2025-02-17","SF FuneralF1104207      250217","","126.5","","315119.56"
"2025-02-20","2025-02-17","SF FuneralF1073293      250217","","126.5","","315246.06"
"2025-02-20","2025-02-20","SF FuneralFDC000000060BM250220","","126.5","","315372.56"
"2025-02-20","2025-02-20","SF FuneralFDC00000006D6Y250220","","126.5","","315499.06"
"2025-02-20","2025-02-20","SF FuneralFDC00000006K90250220","","126.5","","315625.56"
"2025-02-20","2025-02-20","SF FuneralFDC00000006QDX250220","","126.5","","315752.06"
"2025-02-20","2025-02-20","SF FuneralFDC00000007H45250220","","63.25","","315815.31"
"2025-02-20","2025-02-20","SF FuneralFDC00000007H48250220","","63.25","","315878.56"
"2025-02-20","2025-02-20","SF FuneralFDC00000007P0T250220","","126.5","","316005.06"
"2025-02-20","2025-02-20","SF FuneralFDC000000080NR250220","","126.5","","316131.56"
"2025-02-20","2025-02-20","SF FuneralF799893       250220","","126.5","","316258.06"
"2025-02-20","2025-02-20","SF FuneralFDC0000000B6T5250220","","126.5","","316384.56"
"2025-02-20","2025-02-20","SF FuneralF828444       250220","","126.5","","316511.06"
"2025-02-20","2025-02-20","SF FuneralFDC0000000BSQ0250220","","126.5","","316637.56"
"2025-02-20","2025-02-20","SF FuneralF831721       250220","","126.5","","316764.06"
"2025-02-20","2025-02-20","SF FuneralF831817       250220","","126.5","","316890.56"
"2025-02-20","2025-02-20","SF FuneralFDC0000000CHY1250220","","126.5","","317017.06"
"2025-02-20","2025-02-20","SF FuneralF988179       250220","","126.5","","317143.56"
"2025-02-20","2025-02-20","SF FuneralF1108243      250220","","126.5","","317270.06"
"2025-02-20","2025-02-20","SF FuneralF1113330      250220","","126.5","","317396.56"
"2025-02-20","2025-02-20","SF FuneralF1124286      250220","","126.5","","317523.06"
"2025-02-20","2025-02-20","SF FuneralF1127833      250220","","126.5","","317649.56"
"2025-02-20","2025-02-20","SF FuneralF1132205      250220","","126.5","","317776.06"
"2025-02-20","2025-02-20","SF FuneralFDC00000005N6M250220","","31.63","","317807.69"
"2025-02-20","2025-02-20","SF FuneralFDC00000005P8B250220","","31.63","","317839.32"
"2025-02-20","2025-02-17","SF FuneralFDC00000003S1L250217","","55","","317894.32"
"2025-02-20","2025-02-17","SF FuneralFDC00000005Z3L250217","","31.63","","317925.95"
"2025-02-20","2025-02-17","SF FuneralFDC00000005ZFF250217","","126.5","","318052.45"
"2025-02-20","2025-02-17","SF FuneralFDC00000006TT6250217","","126.5","","318178.95"
"2025-02-20","2025-02-17","SF FuneralF803071       250217","","126.5","","318305.45"
"2025-02-20","2025-02-17","SF FuneralF811097       250217","","126.5","","318431.95"
"2025-02-20","2025-02-17","SF FuneralF812333       250217","","126.5","","318558.45"
"2025-02-20","2025-02-17","SF FuneralF830930       250217","","126.5","","318684.95"
"2025-02-20","2025-02-17","SF FuneralFDC0000000HKWY250217","","126.5","","318811.45"
"2025-02-20","2025-02-17","SF FuneralF1017776      250217","","126.5","","318937.95"
"2025-02-20","2025-02-17","SF FuneralFDC0000000KLNT250217","","126.5","","319064.45"
"2025-02-20","2025-02-17","SF FuneralF1073414      250217","","126.5","","319190.95"
"2025-02-20","2025-02-17","SF FuneralF1110284      250217","","126.5","","319317.45"
"2025-02-20","2025-02-17","SF FuneralF1115128      250217","","126.5","","319443.95"
"2025-02-20","2025-02-17","SF FuneralF1131359      250217","","126.5","","319570.45"
"2025-02-20","2025-02-20","SF FuneralFDC00000002TMW250220","","220","","319790.45"
"2025-02-20","2025-02-20","SF FuneralFDC0000000627P250220","","126.5","","319916.95"
"2025-02-20","2025-02-20","SF FuneralFDC000000067GC250220","","126.5","","320043.45"
"2025-02-20","2025-02-20","SF FuneralFDC00000006BF7250220","","126.5","","320169.95"
"2025-02-20","2025-02-20","SF FuneralFDC00000007K38250220","","126.5","","320296.45"
"2025-02-20","2025-02-20","SF FuneralFDC00000007K3D250220","","126.5","","320422.95"
"2025-02-20","2025-02-20","SF FuneralF831580       250220","","126.5","","320549.45"
"2025-02-20","2025-02-20","SF FuneralF847201       250220","","126.5","","320675.95"
"2025-02-20","2025-02-17","SF FuneralF1073092      250217","","126.5","","320802.45"
"2025-02-20","2025-02-18","SF FuneralF1122882      250218","","126.5","","320928.95"
"2025-02-20","2025-02-19","SF FuneralF1073355      250219","","126.5","","321055.45"
"2025-02-20","2025-02-19","Rev SF FuneralFDC0000000PNDR250219","","-126.5","","320928.95"
"2025-02-20","2025-02-17","Rev SF FuneralFDC00000005YNL250217","","-55","","320873.95"
"2025-02-20","2025-02-17","Rev SF FuneralFDC00000005YW3250217","","-31.63","","320842.32"
"2025-02-20","2025-02-17","Rev SF FuneralFDC00000008ZBX250217","","-126.5","","320715.82"
"2025-02-20","2025-02-15","Rev SF FuneralFDC0000000NJMQ250215","","-126.5","","320589.32"
"2025-02-20","2025-02-17","SF FuneralF1080551      250217","","126.5","","320715.82"
"2025-02-20","2025-02-17","SF FuneralF1020919      250217","","126.5","","320842.32"
"2025-02-20","2025-02-12","SF FuneralF859511       250212","","126.5","","320968.82"
"2025-02-20","2025-02-15","SF FuneralF1060491      250216","","126.5","","321095.32"
"2025-02-20","2025-02-17","SF FuneralFDC00000005PZC250217","","220","","321315.32"
"2025-02-20","2025-02-17","SF FuneralFDC00000008TYJ250217","","63.25","","321378.57"
"2025-02-20","2025-02-17","SF FuneralF1052772      250217","","126.5","","321505.07"
"2025-02-20","2025-02-17","SF FuneralF1060123      250217","","126.5","","321631.57"
"2025-02-20","2025-02-17","SF FuneralF1111577      250217","","126.5","","321758.07"
"2025-02-20","2025-02-17","SF FuneralF1114589      250217","","126.5","","321884.57"
"2025-02-20","2025-02-17","SF FuneralFDC0000000PQ01250217","","126.5","","322011.07"
"2025-02-20","2025-02-17","SF FuneralF1127574      250217","","126.5","","322137.57"
"2025-02-20","2025-02-20","SF FuneralFDC0000000756F250220","","126.5","","322264.07"
"2025-02-20","2025-02-15","SF FuneralFDC00000007VKH250215","","31.63","","322295.7"
"2025-02-20","2025-02-18","SF FuneralF822427       250218","","31.63","","322327.33"
"2025-02-20","2025-02-18","SF FuneralF993719       250218","","31.63","","322358.96"
"2025-02-20","2025-02-18","SF FuneralFDC0000000N7MN250218","","31.63","","322390.59"
"2025-02-20","2025-02-18","SF FuneralFDC0000000N8FK250218","","63.25","","322453.84"
"2025-02-20","2025-02-18","SF FuneralF1114433      250218","","31.63","","322485.47"
"2025-02-20","2025-02-18","SF FuneralFDC0000000NT58250218","","31.63","","322517.1"
"2025-02-20","2025-02-17","SF FuneralF817765       250217","","191.5","","322708.6"
"2025-02-20","2025-02-17","SF FuneralF1123966      250217","","126.5","","322835.1"
"2025-02-20","2025-02-11","SF FuneralFDC0000000BHGP250211","","63.25","","322898.35"
"2025-02-20","2025-02-14","SF FuneralFDC0000000KY2H250214","","63.25","","322961.6"
"2025-02-20","2025-02-15","SF FuneralF1124433      250215","","126.5","","323088.1"
"2025-02-20","2025-02-17","SF FuneralFDC000000074Y0250217","","126.5","","323214.6"
"2025-02-20","2025-02-17","SF FuneralF987096       250217","","63.25","","323277.85"
"2025-02-20","2025-02-18","SF FuneralF1132209      250218","","31.63","","323309.48"
"2025-02-20","2025-02-20","SF FuneralF988990       250220","","126.5","","323435.98"
"2025-02-20","2025-02-17","SF FuneralF1021004      250217","","31.63","","323467.61"
"2025-02-20","2025-02-17","SF FuneralF1020562      250217","","126.5","","323594.11"
"2025-02-20","2025-02-17","SF FuneralF1128205      250217","","31.63","","323625.74"
"2025-02-20","2025-02-20","SF FuneralF1122718      250220","","31.63","","323657.37"
"2025-02-20","2025-02-12","SF FuneralF1114152      250212","","126.5","","323783.87"
"2025-02-20","2025-02-17","SF FuneralFDC00000006XFK250217","","31.63","","323815.5"
"2025-02-20","2025-02-18","SF FuneralFDC00000007LMQ250218","","126.5","","323942"
"2025-02-20","2025-02-17","SF FuneralF1111332      250217","","31.63","","323973.63"
"2025-02-20","2025-02-12","SF FuneralFDC00000005KXY250212","","126.5","","324100.13"
"2025-02-20","2025-02-15","SF FuneralFDC00000007GR6250215","","31.63","","324131.76"
"2025-02-20","2025-02-15","SF FuneralF1111595      250216","","31.63","","324163.39"
"2025-02-20","2025-02-17","SF FuneralFDC00000005RR8250217","","31.63","","324195.02"
"2025-02-20","2025-02-17","SF FuneralF810250       250217","","31.63","","324226.65"
"2025-02-20","2025-02-17","SF FuneralF1124140      250217","","31.63","","324258.28"
"2025-02-20","2025-02-18","SF FuneralFDC00000008JVD250218","","31.63","","324289.91"
"2025-02-20","2025-02-18","SF FuneralF827761       250218","","31.63","","324321.54"
"2025-02-20","2025-02-18","SF FuneralF833890       250218","","31.63","","324353.17"
"2025-02-20","2025-02-18","SF FuneralF834932       250218","","63.25","","324416.42"
"2025-02-20","2025-02-18","SF FuneralF1111675      250218","","31.63","","324448.05"
"2025-02-20","2025-02-18","SF FuneralF1124052      250218","","31.63","","324479.68"
"2025-02-20","2025-02-19","SF FuneralFDC0000000LG2D250219","","31.63","","324511.31"
"2025-02-20","2025-02-19","SF FuneralF1078566      250219","","31.63","","324542.94"
"2025-02-20","2025-02-19","SF FuneralFDC0000000PX2N250219","","126.5","","324669.44"
"2025-02-20","2025-02-20","SF FuneralFDC00000006B1H250220","","126.5","","324795.94"
"2025-02-20","2025-02-14","SF FuneralFDC00000008GY4250214","","31.63","","324827.57"
"2025-02-20","2025-02-17","SF FuneralFDC0000000376D250217","","55","","324882.57"
"2025-02-20","2025-02-17","SF FuneralFDC00000004NQM250216","","31.63","","324914.2"
"2025-02-20","2025-02-17","SF FuneralFDC00000004NQP250216","","31.63","","324945.83"
"2025-02-20","2025-02-17","SF FuneralFDC000000070PX250217","","31.63","","324977.46"
"2025-02-20","2025-02-17","SF FuneralFDC00000007H6K250217","","31.63","","325009.09"
"2025-02-20","2025-02-17","SF FuneralF800626       250217","","31.63","","325040.72"
"2025-02-20","2025-02-17","SF FuneralF803226       250217","","31.63","","325072.35"
"2025-02-20","2025-02-17","SF FuneralFDC0000000918Q250217","","47.88","","325120.23"
"2025-02-20","2025-02-17","SF FuneralF830266       250217","","31.63","","325151.86"
"2025-02-20","2025-02-17","SF FuneralF1017630      250217","","31.63","","325183.49"
"2025-02-20","2025-02-17","SF FuneralF1060055      250217","","31.63","","325215.12"
"2025-02-20","2025-02-17","SF FuneralF1110362      250217","","31.63","","325246.75"
"2025-02-20","2025-02-17","SF FuneralF1129904      250217","","31.63","","325278.38"
"2025-02-20","2025-02-17","SF FuneralF1130649      250217","","31.63","","325310.01"
"2025-02-20","2025-02-18","SF FuneralFDC00000005H2H250218","","31.63","","325341.64"
"2025-02-20","2025-02-18","SF FuneralFDC00000005R1B250218","","31.63","","325373.27"
"2025-02-20","2025-02-18","SF FuneralFDC00000007ZD3250218","","31.63","","325404.9"
"2025-02-20","2025-02-18","SF FuneralFDC000000088BV250218","","31.63","","325436.53"
"2025-02-20","2025-02-18","SF FuneralF815955       250218","","31.63","","325468.16"
"2025-02-20","2025-02-18","SF FuneralFDC0000000K09P250218","","65","","325533.16"
"2025-02-20","2025-02-18","SF FuneralF1084842      250218","","31.63","","325564.79"
"2025-02-20","2025-02-18","SF FuneralF1111742      250218","","31.63","","325596.42"
"2025-02-20","2025-02-14","SF FuneralFDC0000000JMVM250214","","63.25","","325659.67"
"2025-02-20","2025-02-17","SF FuneralFDC00000002QJ5250217","","220","","325879.67"
"2025-02-20","2025-02-17","SF FuneralFDC000000078GS250217","","126.5","","326006.17"
"2025-02-20","2025-02-17","SF FuneralF843034       250217","","31.63","","326037.8"
"2025-02-20","2025-02-17","SF FuneralFDC0000000J1SX250217","","126.5","","326164.3"
"2025-02-20","2025-02-17","SF FuneralFDC0000000KL49250217","","126.5","","326290.8"
"2025-02-20","2025-02-17","SF FuneralF1073867      250217","","126.5","","326417.3"
"2025-02-20","2025-02-17","SF FuneralF1080425      250217","","126.5","","326543.8"
"2025-02-20","2025-02-17","SF FuneralF1084993      250217","","63.25","","326607.05"
"2025-02-20","2025-02-17","SF FuneralF1104295      250217","","31.63","","326638.68"
"2025-02-20","2025-02-17","SF FuneralF1117477      250217","","31.63","","326670.31"
"2025-02-20","2025-02-18","SF FuneralF796639       250218","","126.5","","326796.81"
"2025-02-20","2025-02-18","SF FuneralF823908       250218","","126.5","","326923.31"
"2025-02-20","2025-02-18","SF FuneralF831704       250218","","31.63","","326954.94"
"2025-02-20","2025-02-18","SF FuneralF1061865      250218","","31.63","","326986.57"
"2025-02-20","2025-02-19","SF FuneralFDC00000005K0B250219","","126.5","","327113.07"
"2025-02-20","2025-02-19","SF FuneralFDC00000007JD3250219","","126.5","","327239.57"
"2025-02-20","2025-02-20","SF FuneralF821513       250220","","126.5","","327366.07"
"2025-02-20","2025-02-20","SF FuneralF832811       250220","","126.5","","327492.57"
"2025-02-20","2025-02-20","SF FuneralF1080435      250220","","126.5","","327619.07"
"2025-02-20","2025-02-20","SF FuneralF1119083      250220","","126.5","","327745.57"
"2025-02-20","2025-02-18","Rev SF FuneralFDC0000000N7MN250218","","-31.63","","327713.94"
"2025-02-20","2025-02-17","Rev SF FuneralFDC00000007H6K250217","","-31.63","","327682.31"
"2025-02-20","2025-02-17","Rev SF FuneralFDC00000008L4Z250217","","-126.5","","327555.81"
"2025-02-20","2025-02-17","Rev SF FuneralFDC00000008T67250217","","-126.5","","327429.31"
"2025-02-20","2025-01-17","Rev SF FuneralFDC00000008L4Z250117","","-126.5","","327302.81"
"2025-02-20","2025-02-17","Rev SF FuneralFDC00000005XH1250217","","-126.5","","327176.31"
"2025-02-20","2025-02-17","Rev SF FuneralFDC0000000369L250217","","-220","","326956.31"
"2025-02-20","2025-02-17","Rev SF FuneralFDC0000000K17R250217","","-126.5","","326829.81"
"2025-02-20","2025-02-12","Rev SF FuneralFDC0000000J28V250212","","-126.5","","326703.31"
"2025-02-20","2025-02-20","Rev SF FuneralFDC00000006D6Y250220","","-126.5","","326576.81"
"2025-02-20","2025-02-20","Rev SF FuneralFDC0000000756F250220","","-126.5","","326450.31"
"2025-02-20","2025-02-15","Rev SF FuneralFDC0000000K1G3250215","","-126.5","","326323.81"
"2025-02-20","2025-02-17","SF FuneralFDC0000000KZ2C250217","","31.63","","326355.44"
"2025-02-20","2025-02-17","SF FuneralFDC0000000NNDF250217","","31.63","","326387.07"
"2025-02-20","2025-02-17","SF FuneralF1125487      250217","","31.63","","326418.7"
"2025-02-20","2025-02-19","SF FuneralF813578       250219","","63.25","","326481.95"
"2025-02-20","2025-02-17","SF FuneralFDC00000006HDS250217","","126.5","","326608.45"
"2025-02-20","2025-02-17","SF FuneralF811084       250217","","63.25","","326671.7"
"2025-02-20","2025-02-17","SF FuneralF834614       250217","","31.63","","326703.33"
"2025-02-20","2025-02-17","SF FuneralF844339       250217","","31.63","","326734.96"
"2025-02-20","2025-02-17","SF FuneralF987492       250217","","31.63","","326766.59"
"2025-02-20","2025-02-17","SF FuneralF791581       250217","","47.88","","326814.47"
"2025-02-20","2025-02-17","SF FuneralF1100809      250217","","31.63","","326846.1"
"2025-02-20","2025-02-17","SF FuneralF1102815      250217","","31.63","","326877.73"
"2025-02-20","2025-02-17","SF FuneralF1102914      250217","","31.63","","326909.36"
"2025-02-20","2025-02-17","SF FuneralF1115192      250217","","126.5","","327035.86"
"2025-02-20","2025-02-17","SF FuneralF1127801      250217","","31.63","","327067.49"
"2025-02-20","2025-02-17","SF FuneralFDC00000005M4T250217","","63.25","","327130.74"
"2025-02-20","2025-02-17","SF FuneralF1129089      250217","","63.25","","327193.99"
"2025-02-20","2025-02-18","SF FuneralF989212       250218","","63.25","","327257.24"
"2025-02-20","2025-02-15","SF FuneralF1114730      250216","","31.63","","327288.87"
"2025-02-20","2025-02-18","SF FuneralF1118809      250218","","31.63","","327320.5"
"2025-02-20","2025-02-18","SF FuneralF1118848      250218","","31.63","","327352.13"
"2025-02-20","2025-02-18","SF FuneralF1118948      250218","","63.25","","327415.38"
"2025-02-20","2025-02-18","SF FuneralF1131796      250218","","31.63","","327447.01"
"2025-02-20","2025-02-20","SF FuneralF1078865      250220","","47.88","","327494.89"
"2025-02-20","2025-02-19","SF FuneralF831689       250219","","126.5","","327621.39"
"2025-02-20","2025-02-12","SF FuneralFDC00000007R5Y250212","","126.5","","327747.89"
"2025-02-20","2025-02-15","SF FuneralF1060488      250215","","126.5","","327874.39"
"2025-02-20","2025-02-17","SF FuneralFDC0000000MSC7250217","","47.88","","327922.27"
"2025-02-20","2025-02-18","SF FuneralFDC00000002Y4M250218","","55","","327977.27"
"2025-02-20","2025-02-18","SF FuneralF816802       250218","","31.63","","328008.9"
"2025-02-20","2025-02-18","SF FuneralF988913       250218","","31.63","","328040.53"
"2025-02-21","2025-02-18","SF FuneralFDC000000072SM250218","","31.63","","328072.16"
"2025-02-21","2025-02-18","SF FuneralFDC0000000776Q250218","","63.25","","328135.41"
"2025-02-21","2025-02-18","SF FuneralF814465       250218","","31.63","","328167.04"
"2025-02-21","2025-02-18","SF FuneralF816327       250218","","63.25","","328230.29"
"2025-02-21","2025-02-18","SF FuneralF818368       250218","","63.25","","328293.54"
"2025-02-21","2025-02-18","SF FuneralFDC0000000J8LQ250218","","63.25","","328356.79"
"2025-02-21","2025-02-18","SF FuneralFDC0000000KFFJ250218","","31.63","","328388.42"
"2025-02-21","2025-02-18","SF FuneralFDC0000000MWP0250218","","63.25","","328451.67"
"2025-02-21","2025-02-18","SF FuneralF1111979      250218","","63.25","","328514.92"
"2025-02-21","2025-02-18","SF FuneralF1112152      250218","","31.63","","328546.55"
"2025-02-21","2025-02-18","SF FuneralF1114513      250218","","31.63","","328578.18"
"2025-02-21","2025-02-18","SF FuneralF1130277      250218","","31.63","","328609.81"
"2025-02-21","2025-02-12","SF FuneralFDC00000005W8T250212","","126.5","","328736.31"
"2025-02-21","2025-02-12","SF FuneralF820113       250212","","225.75","","328962.06"
"2025-02-21","2025-02-17","SF FuneralFDC00000006BK1250217","","31.63","","328993.69"
"2025-02-21","2025-02-17","SF FuneralFDC00000006W66250216","","126.5","","329120.19"
"2025-02-21","2025-02-17","SF FuneralFDC000000070CJ250217","","31.63","","329151.82"
"2025-02-21","2025-02-17","SF FuneralFDC00000007969250216","","126.5","","329278.32"
"2025-02-21","2025-02-17","SF FuneralFDC00000007GXS250217","","31.63","","329309.95"
"2025-02-21","2025-02-17","SF FuneralFDC00000008VKV250217","","126.5","","329436.45"
"2025-02-21","2025-02-17","SF FuneralFDC000000097F2250217","","63.25","","329499.7"
"2025-02-21","2025-02-17","SF FuneralFDC000000097G6250217","","63.25","","329562.95"
"2025-02-21","2025-02-17","SF FuneralF987157       250217","","63.25","","329626.2"
"2025-02-21","2025-02-17","SF FuneralFDC0000000Q4DG250217","","126.5","","329752.7"
"2025-02-21","2025-02-19","SF FuneralFDC00000005V3Z250219","","126.5","","329879.2"
"2025-02-21","2025-02-19","SF FuneralFDC00000005V4Z250219","","31.63","","329910.83"
"2025-02-21","2025-02-19","SF FuneralFDC0000000618M250219","","126.5","","330037.33"
"2025-02-21","2025-02-19","SF FuneralF841017       250219","","126.5","","330163.83"
"2025-02-21","2025-02-19","SF FuneralFDC0000000NR68250219","","63.25","","330227.08"
"2025-02-21","2025-02-19","SF FuneralF1119016      250219","","95.75","","330322.83"
"2025-02-21","2025-02-19","SF FuneralFDC0000000NWFK250219","","126.5","","330449.33"
"2025-02-21","2025-02-19","SF FuneralF782339       250219","","126.5","","330575.83"
"2025-02-21","2025-02-19","SF FuneralF1127716      250219","","126.5","","330702.33"
"2025-02-21","2025-02-20","SF FuneralFDC00000007SPM250220","","126.5","","330828.83"
"2025-02-21","2025-02-20","SF FuneralF828072       250220","","126.5","","330955.33"
"2025-02-21","2025-02-20","SF FuneralF988760       250220","","126.5","","331081.83"
"2025-02-21","2025-02-20","SF FuneralF1016998      250220","","126.5","","331208.33"
"2025-02-21","2025-02-20","SF FuneralF1108634      250220","","126.5","","331334.83"
"2025-02-21","2025-02-20","SF FuneralF1110763      250220","","31.63","","331366.46"
"2025-02-21","2025-02-18","SF FuneralF833912       250218","","63.25","","331429.71"
"2025-02-21","2025-02-11","SF FuneralFDC00000009W98250211","","126.5","","331556.21"
"2025-02-21","2025-02-12","SF FuneralFDC00000007XQQ250212","","126.5","","331682.71"
"2025-02-21","2025-02-13","SF FuneralF831145       250213","","63.25","","331745.96"
"2025-02-21","2025-02-15","SF FuneralF1016646      250216","","63.25","","331809.21"
"2025-02-21","2025-02-15","SF FuneralF1054967      250216","","126.5","","331935.71"
"2025-02-21","2025-02-17","SF FuneralFDC00000005GH0250217","","31.63","","331967.34"
"2025-02-21","2025-02-17","SF FuneralFDC000000074Y5250217","","55","","332022.34"
"2025-02-21","2025-02-17","SF FuneralF802152       250217","","126.5","","332148.84"
"2025-02-21","2025-02-17","SF FuneralF820769       250217","","31.63","","332180.47"
"2025-02-21","2025-02-17","SF FuneralF827602       250217","","31.63","","332212.1"
"2025-02-21","2025-02-17","SF FuneralF834044       250217","","31.63","","332243.73"
"2025-02-21","2025-02-17","SF FuneralF841850       250217","","31.63","","332275.36"
"2025-02-21","2025-02-17","SF FuneralF901072       250217","","63.25","","332338.61"
"2025-02-21","2025-02-17","SF FuneralF901184       250217","","31.63","","332370.24"
"2025-02-21","2025-02-17","SF FuneralF986655       250217","","31.63","","332401.87"
"2025-02-21","2025-02-17","SF FuneralF990276       250217","","31.63","","332433.5"
"2025-02-21","2025-02-17","SF FuneralF993678       250217","","31.63","","332465.13"
"2025-02-21","2025-02-17","SF FuneralF1016810      250217","","31.63","","332496.76"
"2025-02-21","2025-02-17","SF FuneralF1072928      250217","","31.63","","332528.39"
"2025-02-21","2025-02-17","SF FuneralF1073049      250217","","31.63","","332560.02"
"2025-02-21","2025-02-17","SF FuneralF1073147      250217","","31.63","","332591.65"
"2025-02-21","2025-02-17","SF FuneralF1084032      250217","","31.63","","332623.28"
"2025-02-21","2025-02-17","SF FuneralFDC0000000ML65250217","","31.63","","332654.91"
"2025-02-21","2025-02-17","SF FuneralF1112394      250217","","31.63","","332686.54"
"2025-02-21","2025-02-17","SF FuneralFDC0000000N7Y7250217","","31.63","","332718.17"
"2025-02-21","2025-02-17","SF FuneralF1115136      250217","","31.63","","332749.8"
"2025-02-21","2025-02-17","SF FuneralF1115957      250217","","31.63","","332781.43"
"2025-02-21","2025-02-17","SF FuneralF1117767      250217","","31.63","","332813.06"
"2025-02-21","2025-02-17","SF FuneralF1118005      250217","","31.63","","332844.69"
"2025-02-21","2025-02-17","SF FuneralF1118324      250217","","31.63","","332876.32"
"2025-02-21","2025-02-17","SF FuneralF1125068      250217","","126.5","","333002.82"
"2025-02-21","2025-02-17","SF FuneralF1130713      250217","","31.63","","333034.45"
"2025-02-21","2025-02-17","SF FuneralF1131541      250217","","31.63","","333066.08"
"2025-02-21","2025-02-17","SF FuneralF1131799      250217","","63.25","","333129.33"
"2025-02-21","2025-02-18","SF FuneralFDC00000003BTC250218","","55","","333184.33"
"2025-02-21","2025-02-18","SF FuneralFDC00000005PFJ250218","","31.63","","333215.96"
"2025-02-21","2025-02-18","SF FuneralFDC000000079S6250218","","31.63","","333247.59"
"2025-02-21","2025-02-18","SF FuneralFDC00000007KLD250218","","31.63","","333279.22"
"2025-02-21","2025-02-18","SF FuneralFDC00000007ZH7250218","","31.63","","333310.85"
"2025-02-21","2025-02-18","SF FuneralFDC00000008365250218","","31.63","","333342.48"
"2025-02-21","2025-02-18","SF FuneralFDC00000008JV9250218","","63.25","","333405.73"
"2025-02-21","2025-02-18","SF FuneralFDC00000008JVC250218","","63.25","","333468.98"
"2025-02-21","2025-02-18","SF FuneralFDC00000008L2B250218","","63.25","","333532.23"
"2025-02-21","2025-02-18","SF FuneralFDC00000008P1H250218","","63.25","","333595.48"
"2025-02-21","2025-02-18","SF FuneralF827707       250218","","31.63","","333627.11"
"2025-02-21","2025-02-18","SF FuneralFDC0000000BMW2250218","","31.63","","333658.74"
"2025-02-21","2025-02-18","SF FuneralFDC0000000BT1S250218","","31.63","","333690.37"
"2025-02-21","2025-02-18","SF FuneralF981761       250218","","63.25","","333753.62"
"2025-02-21","2025-02-18","SF FuneralF989374       250218","","63.25","","333816.87"
"2025-02-21","2025-02-18","SF FuneralFDC0000000J00M250218","","31.63","","333848.5"
"2025-02-21","2025-02-18","SF FuneralFDC0000000J0D4250218","","63.25","","333911.75"
"2025-02-21","2025-02-18","SF FuneralFDC0000000JCZG250218","","63.25","","333975"
"2025-02-21","2025-02-18","SF FuneralFDC0000000K22X250218","","31.63","","334006.63"
"2025-02-21","2025-02-18","SF FuneralF1074821      250218","","63.25","","334069.88"
"2025-02-21","2025-02-18","SF FuneralF1079706      250218","","126.5","","334196.38"
"2025-02-21","2025-02-18","SF FuneralF1110634      250218","","31.63","","334228.01"
"2025-02-21","2025-02-18","SF FuneralFDC0000000N526250218","","31.63","","334259.64"
"2025-02-21","2025-02-18","SF FuneralF1118352      250218","","31.63","","334291.27"
"2025-02-21","2025-02-18","SF FuneralF1118865      250218","","31.63","","334322.9"
"2025-02-21","2025-02-18","SF FuneralF1123316      250218","","31.63","","334354.53"
"2025-02-21","2025-02-18","SF FuneralF1125003      250218","","31.63","","334386.16"
"2025-02-21","2025-02-18","SF FuneralF1127482      250218","","31.63","","334417.79"
"2025-02-21","2025-02-18","SF FuneralF1127688      250218","","31.63","","334449.42"
"2025-02-21","2025-02-18","SF FuneralF1128762      250218","","31.63","","334481.05"
"2025-02-21","2025-02-18","SF FuneralF1129356      250218","","31.63","","334512.68"
"2025-02-21","2025-02-18","SF FuneralF1131536      250218","","31.63","","334544.31"
"2025-02-21","2025-02-19","SF FuneralFDC00000006M43250219","","126.5","","334670.81"
"2025-02-21","2025-02-19","SF FuneralFDC00000006M45250219","","126.5","","334797.31"
"2025-02-21","2025-02-19","SF FuneralF800771       250219","","31.63","","334828.94"
"2025-02-21","2025-02-19","SF FuneralF800844       250219","","126.5","","334955.44"
"2025-02-21","2025-02-19","SF FuneralF987993       250219","","126.5","","335081.94"
"2025-02-21","2025-02-19","SF FuneralFDC0000000J2QP250219","","126.5","","335208.44"
"2025-02-21","2025-02-19","SF FuneralF1020888      250219","","126.5","","335334.94"
"2025-02-21","2025-02-19","SF FuneralF1060919      250219","","31.63","","335366.57"
"2025-02-21","2025-02-19","SF FuneralF1112292      250219","","126.5","","335493.07"
"2025-02-21","2025-02-19","SF FuneralF1124144      250219","","31.63","","335524.7"
"2025-02-21","2025-02-20","SF FuneralFDC00000005YCW250220","","126.5","","335651.2"
"2025-02-21","2025-02-20","SF FuneralF814884       250220","","63.25","","335714.45"
"2025-02-21","2025-02-20","SF FuneralF832953       250220","","126.5","","335840.95"
"2025-02-21","2025-02-17","SF FuneralF802251       250217","","31.63","","335872.58"
"2025-02-21","2025-02-17","SF FuneralF802331       250217","","31.63","","335904.21"
"2025-02-21","2025-02-17","SF FuneralF815144       250217","","31.63","","335935.84"
"2025-02-21","2025-02-17","SF FuneralF822865       250217","","31.63","","335967.47"
"2025-02-21","2025-02-17","SF FuneralF1072930      250217","","31.63","","335999.1"
"2025-02-21","2025-02-17","SF FuneralF1073218      250217","","31.63","","336030.73"
"2025-02-21","2025-02-17","SF FuneralF1118957      250217","","31.63","","336062.36"
"2025-02-21","2025-02-17","SF FuneralF1108848      250217","","31.63","","336093.99"
"2025-02-21","2025-02-18","SF FuneralFDC00000006QTN250218","","31.63","","336125.62"
"2025-02-21","2025-02-18","SF FuneralF814063       250218","","31.63","","336157.25"
"2025-02-21","2025-02-18","SF FuneralF814180       250218","","31.63","","336188.88"
"2025-02-21","2025-02-18","SF FuneralF1066227      250218","","31.63","","336220.51"
"2025-02-21","2025-02-18","SF FuneralF1102910      250218","","31.63","","336252.14"
"2025-02-21","2025-02-18","SF FuneralF1126262      250218","","31.63","","336283.77"
"2025-02-21","2025-02-20","SF FuneralFDC00000006ZNM250220","","31.63","","336315.4"
"2025-02-21","2025-02-14","SF FuneralFDC0000000H5YY250216","","31.63","","336347.03"
"2025-02-21","2025-02-17","SF FuneralFDC00000005NR4250217","","31.63","","336378.66"
"2025-02-21","2025-02-17","SF FuneralF1128005      250217","","31.63","","336410.29"
"2025-02-21","2025-02-17","SF FuneralF1132386      250217","","31.63","","336441.92"
"2025-02-21","2025-02-18","SF FuneralFDC00000008CVJ250218","","31.63","","336473.55"
"2025-02-21","2025-02-18","SF FuneralF821837       250218","","47.88","","336521.43"
"2025-02-21","2025-02-18","SF FuneralF987241       250218","","31.63","","336553.06"
"2025-02-21","2025-02-18","SF FuneralF1110079      250218","","31.63","","336584.69"
"2025-02-21","2025-02-18","SF FuneralF1123129      250218","","31.63","","336616.32"
"2025-02-21","2025-02-20","SF FuneralF805236       250220","","31.63","","336647.95"
"2025-02-21","2025-02-11","SF FuneralF1117876      250211","","63.25","","336711.2"
"2025-02-21","2025-02-13","SF FuneralF830601       250213","","126.5","","336837.7"
"2025-02-21","2025-02-17","SF FuneralFDC00000006YP1250217","","126.5","","336964.2"
"2025-02-21","2025-02-17","SF FuneralFDC00000007CWW250217","","126.5","","337090.7"
"2025-02-21","2025-02-17","SF FuneralFDC00000007PP8250217","","31.63","","337122.33"
"2025-02-21","2025-02-17","SF FuneralFDC00000007WVJ250217","","31.63","","337153.96"
"2025-02-21","2025-02-17","SF FuneralF801722       250217","","31.63","","337185.59"
"2025-02-21","2025-02-17","SF FuneralF808988       250217","","31.63","","337217.22"
"2025-02-21","2025-02-17","SF FuneralFDC000000092Y1250217","","63.25","","337280.47"
"2025-02-21","2025-02-17","SF FuneralFDC0000000931H250217","","63.25","","337343.72"
"2025-02-21","2025-02-17","SF FuneralF812315       250217","","63.25","","337406.97"
"2025-02-21","2025-02-17","SF FuneralF813361       250217","","31.63","","337438.6"
"2025-02-21","2025-02-17","SF FuneralF814420       250217","","63.25","","337501.85"
"2025-02-21","2025-02-17","SF FuneralFDC0000000FVPD250217","","31.63","","337533.48"
"2025-02-21","2025-02-17","SF FuneralF981125       250217","","126.5","","337659.98"
"2025-02-21","2025-02-17","SF FuneralF986911       250217","","31.63","","337691.61"
"2025-02-21","2025-02-17","SF FuneralFDC0000000KFF7250217","","126.5","","337818.11"
"2025-02-21","2025-02-17","SF FuneralF1125116      250217","","31.63","","337849.74"
"2025-02-21","2025-02-17","SF FuneralF1128971      250217","","63.25","","337912.99"
"2025-02-21","2025-02-17","SF FuneralFDC0000000PYVQ250217","","31.63","","337944.62"
"2025-02-21","2025-02-18","SF FuneralFDC00000006H1Y250218","","31.63","","337976.25"
"2025-02-21","2025-02-18","SF FuneralFDC0000000BJ3M250218","","63.25","","338039.5"
"2025-02-21","2025-02-18","SF FuneralF828969       250218","","63.25","","338102.75"
"2025-02-21","2025-02-18","SF FuneralF830472       250218","","63.25","","338166"
"2025-02-21","2025-02-18","SF FuneralF1103647      250218","","63.25","","338229.25"
"2025-02-21","2025-02-18","SF FuneralF1065745      250218","","63.25","","338292.5"
"2025-02-21","2025-02-18","SF FuneralFDC0000000PBMD250218","","126.5","","338419"
"2025-02-21","2025-02-18","SF FuneralF1128820      250218","","31.63","","338450.63"
"2025-02-21","2025-02-18","SF FuneralF1129043      250218","","63.25","","338513.88"
"2025-02-21","2025-02-18","SF FuneralFDC0000000Q1HZ250218","","95.75","","338609.63"
"2025-02-21","2025-02-19","SF FuneralFDC00000005RRQ250219","","126.5","","338736.13"
"2025-02-21","2025-02-19","SF FuneralFDC00000008CX1250219","","126.5","","338862.63"
"2025-02-21","2025-02-19","SF FuneralF1067959      250219","","126.5","","338989.13"
"2025-02-21","2025-02-19","SF FuneralFDC0000000KY1M250219","","126.5","","339115.63"
"2025-02-21","2025-02-19","SF FuneralF1124171      250219","","31.63","","339147.26"
"2025-02-21","2025-02-12","SF FuneralF829081       250212","","126.5","","339273.76"
"2025-02-21","2025-02-17","SF FuneralFDC00000006ZGP250216","","126.5","","339400.26"
"2025-02-21","2025-02-17","SF FuneralF843937       250215","","126.5","","339526.76"
"2025-02-21","2025-02-17","SF FuneralF1073360      250217","","126.5","","339653.26"
"2025-02-21","2025-02-17","SF FuneralF1103852      250217","","63.25","","339716.51"
"2025-02-21","2025-02-17","SF FuneralFDC0000000N83K250217","","126.5","","339843.01"
"2025-02-21","2025-02-17","SF FuneralF1132099      250217","","126.5","","339969.51"
"2025-02-21","2025-02-11","SF FuneralF1115170      250211","","63.25","","340032.76"
"2025-02-21","2025-02-17","SF FuneralFDC00000005PMN250217","","126.5","","340159.26"
"2025-02-21","2025-02-17","SF FuneralF813239       250217","","63.25","","340222.51"
"2025-02-21","2025-02-17","SF FuneralF820741       250217","","63.25","","340285.76"
"2025-02-21","2025-02-17","SF FuneralF833744       250216","","126.5","","340412.26"
"2025-02-21","2025-02-17","SF FuneralF833829       250216","","126.5","","340538.76"
"2025-02-21","2025-02-17","SF FuneralF834810       250217","","126.5","","340665.26"
"2025-02-21","2025-02-17","SF FuneralF838867       250217","","63.25","","340728.51"
"2025-02-21","2025-02-17","SF FuneralF842252       250217","","63.25","","340791.76"
"2025-02-21","2025-02-17","SF FuneralF988900       250217","","95.75","","340887.51"
"2025-02-21","2025-02-17","SF FuneralF989102       250217","","63.25","","340950.76"
"2025-02-21","2025-02-17","SF FuneralF1066517      250217","","63.25","","341014.01"
"2025-02-21","2025-02-17","SF FuneralF1067883      250217","","63.25","","341077.26"
"2025-02-21","2025-02-17","SF FuneralFDC0000000LJW6250217","","106.66","","341183.92"
"2025-02-21","2025-02-17","SF FuneralFDC0000000N82R250217","","126.5","","341310.42"
"2025-02-21","2025-02-17","SF FuneralF1117683      250217","","63.25","","341373.67"
"2025-02-21","2025-02-17","SF FuneralF1120146      250217","","126.5","","341500.17"
"2025-02-21","2025-02-17","SF FuneralF1125055      250217","","126.5","","341626.67"
"2025-02-21","2025-02-18","SF FuneralFDC00000007LTS250218","","63.25","","341689.92"
"2025-02-21","2025-02-18","SF FuneralF799997       250218","","63.25","","341753.17"
"2025-02-21","2025-02-18","SF FuneralFDC00000008T3Y250218","","63.25","","341816.42"
"2025-02-21","2025-02-18","SF FuneralF809291       250218","","63.25","","341879.67"
"2025-02-21","2025-02-18","SF FuneralF818508       250218","","63.25","","341942.92"
"2025-02-21","2025-02-18","SF FuneralF821562       250218","","63.25","","342006.17"
"2025-02-21","2025-02-18","SF FuneralF834077       250218","","63.25","","342069.42"
"2025-02-21","2025-02-18","SF FuneralF842929       250218","","63.25","","342132.67"
"2025-02-21","2025-02-18","SF FuneralF1117303      250218","","63.25","","342195.92"
"2025-02-21","2025-02-18","SF FuneralFDC0000000P4SX250218","","95.75","","342291.67"
"2025-02-21","2025-02-18","SF FuneralF1123426      250218","","95.75","","342387.42"
"2025-02-21","2025-02-19","SF FuneralFDC00000005WV0250219","","126.5","","342513.92"
"2025-02-21","2025-02-19","SF FuneralFDC00000008FCD250219","","126.5","","342640.42"
"2025-02-21","2025-02-19","SF FuneralF805493       250219","","126.5","","342766.92"
"2025-02-21","2025-02-19","SF FuneralF810934       250219","","126.5","","342893.42"
"2025-02-21","2025-02-19","SF FuneralFDC00000008FNX250219","","126.5","","343019.92"
"2025-02-21","2025-02-19","SF FuneralFDC00000006SPY250219","","126.5","","343146.42"
"2025-02-21","2025-02-18","SF FuneralF1074647      250218","","31.63","","343178.05"
"2025-02-21","2025-02-18","SF FuneralF1131696      250218","","31.63","","343209.68"
"2025-02-21","2025-02-21","SF FuneralF814303       250221","","31.63","","343241.31"
"2025-02-21","2025-02-21","SF FuneralF986934       250221","","31.63","","343272.94"
"2025-02-21","2025-02-21","SF FuneralF989273       250223","","31.63","","343304.57"
"2025-02-21","2025-02-21","SF FuneralF1079509      250221","","31.63","","343336.2"
"2025-02-21","2025-02-21","SF FuneralF1079664      250221","","31.63","","343367.83"
"2025-02-21","2025-02-17","SF FuneralFDC00000007GG6250217","","126.5","","343494.33"
"2025-02-21","2025-02-17","SF FuneralFDC00000007GGB250217","","126.5","","343620.83"
"2025-02-21","2025-02-17","SF FuneralFDC00000008MKX250217","","31.63","","343652.46"
"2025-02-21","2025-02-17","SF FuneralF815501       250217","","63.25","","343715.71"
"2025-02-21","2025-02-17","SF FuneralF1123277      250217","","31.63","","343747.34"
"2025-02-21","2025-02-18","SF FuneralFDC000000080PW250218","","126.5","","343873.84"
"2025-02-21","2025-02-18","SF FuneralFDC00000009383250218","","31.63","","343905.47"
"2025-02-21","2025-02-18","SF FuneralF816158       250218","","63.25","","343968.72"
"2025-02-21","2025-02-18","SF FuneralF842418       250218","","126.5","","344095.22"
"2025-02-21","2025-02-18","SF FuneralF991967       250218","","63.25","","344158.47"
"2025-02-21","2025-02-18","SF FuneralF1078209      250218","","31.63","","344190.1"
"2025-02-21","2025-02-18","SF FuneralF1118892      250218","","31.63","","344221.73"
"2025-02-21","2025-02-19","SF FuneralFDC00000006W3Z250219","","126.5","","344348.23"
"2025-02-21","2025-02-19","SF FuneralF815056       250219","","126.5","","344474.73"
"2025-02-21","2025-02-19","SF FuneralF834670       250219","","126.5","","344601.23"
"2025-02-21","2025-02-19","SF FuneralF1122596      250219","","126.5","","344727.73"
"2025-02-21","2025-02-19","SF FuneralFDC0000000PSRX250219","","126.5","","344854.23"
"2025-02-21","2025-02-19","SF FuneralFDC0000000PSS5250219","","126.5","","344980.73"
"2025-02-21","2025-02-19","SF FuneralF1129960      250219","","126.5","","345107.23"
"2025-02-21","2025-02-21","SF FuneralFDC00000007MW5250221","","31.63","","345138.86"
"2025-02-21","2025-02-21","SF FuneralFDC00000008H16250221","","126.5","","345265.36"
"2025-02-21","2025-02-21","SF FuneralFDC00000008H22250221","","126.5","","345391.86"
"2025-02-21","2025-02-21","SF FuneralF804893       250221","","126.5","","345518.36"
"2025-02-21","2025-02-21","SF FuneralF819055       250221","","126.5","","345644.86"
"2025-02-21","2025-02-21","SF FuneralFDC0000000LPP2250221","","126.5","","345771.36"
"2025-02-21","2025-02-21","SF FuneralF1132255      250221","","31.63","","345802.99"
"2025-02-21","2025-02-18","SF FuneralFDC000000072H2250218","","63.25","","345866.24"
"2025-02-21","2025-02-18","SF FuneralF797055       250218","","31.63","","345897.87"
"2025-02-21","2025-02-18","SF FuneralF811733       250218","","31.63","","345929.5"
"2025-02-21","2025-02-18","SF FuneralF828867       250218","","31.63","","345961.13"
"2025-02-21","2025-02-18","SF FuneralF830972       250218","","126.5","","346087.63"
"2025-02-21","2025-02-18","SF FuneralF844728       250218","","31.63","","346119.26"
"2025-02-21","2025-02-18","SF FuneralF990639       250218","","126.5","","346245.76"
"2025-02-21","2025-02-18","SF FuneralF1111588      250218","","31.63","","346277.39"
"2025-02-21","2025-02-18","SF FuneralF1118308      250218","","31.63","","346309.02"
"2025-02-21","2025-02-18","SF FuneralF1120129      250218","","31.63","","346340.65"
"2025-02-21","2025-02-18","SF FuneralF1123132      250218","","31.63","","346372.28"
"2025-02-21","2025-02-18","SF FuneralFDC00000006STJ250218","","31.63","","346403.91"
"2025-02-21","2025-02-21","SF FuneralF990787       250222","","31.63","","346435.54"
"2025-02-21","2025-02-21","SF FuneralFDC0000000PK3S250221","","31.63","","346467.17"
"2025-02-21","2025-02-17","SF FuneralF1052812      250217","","31.63","","346498.8"
"2025-02-21","2025-02-17","SF FuneralF1118416      250217","","31.63","","346530.43"
"2025-02-21","2025-02-18","SF FuneralFDC000000051KX250218","","31.63","","346562.06"
"2025-02-21","2025-02-18","SF FuneralFDC00000006SSB250218","","31.63","","346593.69"
"2025-02-21","2025-02-18","SF FuneralFDC00000006ST9250218","","31.63","","346625.32"
"2025-02-21","2025-02-18","SF FuneralFDC000000086B2250218","","31.63","","346656.95"
"2025-02-21","2025-02-18","SF FuneralF799673       250218","","31.63","","346688.58"
"2025-02-21","2025-02-18","SF FuneralFDC00000008M07250218","","31.63","","346720.21"
"2025-02-21","2025-02-18","SF FuneralFDC00000008M09250218","","31.63","","346751.84"
"2025-02-21","2025-02-18","SF FuneralF833515       250218","","31.63","","346783.47"
"2025-02-21","2025-02-18","SF FuneralF833824       250218","","31.63","","346815.1"
"2025-02-21","2025-02-18","SF FuneralF843037       250218","","31.63","","346846.73"
"2025-02-21","2025-02-18","SF FuneralF981838       250218","","31.63","","346878.36"
"2025-02-21","2025-02-18","SF FuneralF1078493      250218","","31.63","","346909.99"
"2025-02-21","2025-02-18","SF FuneralF1079331      250218","","31.63","","346941.62"
"2025-02-21","2025-02-18","SF FuneralF1084860      250218","","31.63","","346973.25"
"2025-02-21","2025-02-18","SF FuneralF1111731      250218","","31.63","","347004.88"
"2025-02-21","2025-02-18","SF FuneralF1112349      250218","","31.63","","347036.51"
"2025-02-21","2025-02-18","SF FuneralF1127528      250218","","31.63","","347068.14"
"2025-02-21","2025-02-18","SF FuneralF1131484      250218","","31.63","","347099.77"
"2025-02-21","2025-02-19","SF FuneralF1110314      250219","","31.63","","347131.4"
"2025-02-21","2025-02-20","SF FuneralF1016768      250220","","31.63","","347163.03"
"2025-02-21","2025-02-21","SF FuneralF1125111      250221","","31.63","","347194.66"
"2025-02-21","2025-02-18","SF FuneralFDC00000007WH2250218","","47.88","","347242.54"
"2025-02-21","2025-02-18","SF FuneralF811275       250218","","31.63","","347274.17"
"2025-02-21","2025-02-18","SF FuneralF832888       250218","","31.63","","347305.8"
"2025-02-21","2025-02-18","SF FuneralF834784       250218","","31.63","","347337.43"
"2025-02-21","2025-02-18","SF FuneralF993770       250218","","31.63","","347369.06"
"2025-02-21","2025-02-18","SF FuneralF1126072      250218","","31.63","","347400.69"
"2025-02-21","2025-02-18","SF FuneralF1131495      250218","","31.63","","347432.32"
"2025-02-21","2025-02-19","SF FuneralF1122926      250219","","31.63","","347463.95"
"2025-02-21","2025-02-21","SF FuneralF817655       250221","","31.63","","347495.58"
"2025-02-21","2025-02-21","SF FuneralFDC0000000J2Y1250222","","31.63","","347527.21"
"2025-02-21","2025-02-17","SF FuneralF1060944      250217","","31.63","","347558.84"
"2025-02-21","2025-02-17","SF FuneralF1123291      250217","","31.63","","347590.47"
"2025-02-21","2025-02-18","SF FuneralFDC0000000690Q250218","","31.63","","347622.1"
"2025-02-21","2025-02-18","SF FuneralF801219       250218","","31.63","","347653.73"
"2025-02-21","2025-02-18","SF FuneralF802169       250218","","31.63","","347685.36"
"2025-02-21","2025-02-18","SF FuneralF900687       250218","","31.63","","347716.99"
"2025-02-21","2025-02-18","SF FuneralF986709       250218","","31.63","","347748.62"
"2025-02-21","2025-02-18","SF FuneralFDC0000000NRQK250218","","31.63","","347780.25"
"2025-02-21","2025-02-21","SF FuneralF1079691      250221","","31.63","","347811.88"
"2025-02-21","2025-02-17","SF FuneralF1074954      250217","","31.63","","347843.51"
"2025-02-21","2025-02-17","SF FuneralF1079348      250217","","31.63","","347875.14"
"2025-02-21","2025-02-18","SF FuneralFDC00000007FBC250218","","31.63","","347906.77"
"2025-02-21","2025-02-18","SF FuneralF819196       250218","","31.63","","347938.4"
"2025-02-21","2025-02-18","SF FuneralF822125       250218","","31.63","","347970.03"
"2025-02-21","2025-02-18","SF FuneralF827812       250218","","31.63","","348001.66"
"2025-02-21","2025-02-18","SF FuneralF1020936      250218","","31.63","","348033.29"
"2025-02-21","2025-02-18","SF FuneralF1021467      250218","","31.63","","348064.92"
"2025-02-21","2025-02-18","SF FuneralF1066647      250218","","31.63","","348096.55"
"2025-02-21","2025-02-18","SF FuneralFDC0000000L215250218","","31.63","","348128.18"
"2025-02-21","2025-02-18","SF FuneralF1073297      250218","","31.63","","348159.81"
"2025-02-21","2025-02-18","SF FuneralF1073828      250218","","31.63","","348191.44"
"2025-02-21","2025-02-18","SF FuneralF1083692      250218","","31.63","","348223.07"
"2025-02-21","2025-02-18","SF FuneralF1110117      250218","","31.63","","348254.7"
"2025-02-21","2025-02-18","SF FuneralF1120226      250218","","31.63","","348286.33"
"2025-02-21","2025-02-18","SF FuneralF1126086      250218","","31.63","","348317.96"
"2025-02-21","2025-02-18","SF FuneralF1127863      250218","","31.63","","348349.59"
"2025-02-21","2025-02-18","SF FuneralF1128998      250218","","31.63","","348381.22"
"2025-02-21","2025-02-18","SF FuneralF1131622      250218","","31.63","","348412.85"
"2025-02-21","2025-02-21","SF FuneralF840580       250221","","31.63","","348444.48"
"2025-02-21","2025-02-21","SF FuneralFDC0000000HVXH250222","","31.63","","348476.11"
"2025-02-21","2025-02-21","SF FuneralF988945       250223","","31.63","","348507.74"
"2025-02-21","2025-02-17","SF FuneralFDC00000003MYN250217","","220","","348727.74"
"2025-02-21","2025-02-17","SF FuneralFDC0000000HS6H250217","","31.63","","348759.37"
"2025-02-21","2025-02-17","SF FuneralF1019192      250217","","126.5","","348885.87"
"2025-02-21","2025-02-17","SF FuneralFDC0000000NC01250217","","63.25","","348949.12"
"2025-02-21","2025-02-17","SF FuneralF1115130      250217","","63.25","","349012.37"
"2025-02-21","2025-02-17","SF FuneralF1125114      250217","","31.63","","349044"
"2025-02-21","2025-02-17","SF FuneralF1126068      250217","","126.5","","349170.5"
"2025-02-21","2025-02-15","SF FuneralF1117998      250216","","31.63","","349202.13"
"2025-02-21","2025-02-19","SF FuneralFDC00000005TSC250219","","126.5","","349328.63"
"2025-02-21","2025-02-19","SF FuneralFDC0000000609P250219","","126.5","","349455.13"
"2025-02-21","2025-02-19","SF FuneralFDC00000006MQV250219","","126.5","","349581.63"
"2025-02-21","2025-02-19","SF FuneralFDC0000000FS50250219","","126.5","","349708.13"
"2025-02-21","2025-02-19","SF FuneralF1059424      250219","","31.63","","349739.76"
"2025-02-21","2025-02-19","SF FuneralF1079269      250219","","31.63","","349771.39"
"2025-02-21","2025-02-19","SF FuneralF1120815      250219","","31.63","","349803.02"
"2025-02-21","2025-02-12","SF FuneralFDC00000005PF9250212","","126.5","","349929.52"
"2025-02-21","2025-02-12","SF FuneralFDC00000005SP8250212","","126.5","","350056.02"
"2025-02-21","2025-02-12","SF FuneralFDC00000006HXF250212","","126.5","","350182.52"
"2025-02-21","2025-02-12","SF FuneralFDC0000000NBV2250212","","63.25","","350245.77"
"2025-02-21","2025-02-12","SF FuneralF1115107      250212","","63.25","","350309.02"
"2025-02-21","2025-02-20","SF FuneralF991574       250220","","126.5","","350435.52"
"2025-02-21","2025-02-20","SF FuneralF1050848      250220","","126.5","","350562.02"
"2025-02-21","2025-02-20","SF FuneralFDC0000000LMBY250220","","126.5","","350688.52"
"2025-02-21","2025-02-12","SF FuneralFDC00000006MK7250212","","126.5","","350815.02"
"2025-02-21","2025-02-12","SF FuneralFDC00000006MKF250212","","126.5","","350941.52"
"2025-02-21","2025-02-17","SF FuneralFDC00000006Z6S250217","","126.5","","351068.02"
"2025-02-21","2025-02-18","SF FuneralF1129149      250218","","63.25","","351131.27"
"2025-02-21","2025-02-19","SF FuneralFDC000000076L1250219","","126.5","","351257.77"
"2025-02-21","2025-02-19","SF FuneralF840787       250219","","126.5","","351384.27"
"2025-02-21","2025-02-19","SF FuneralF844383       250219","","126.5","","351510.77"
"2025-02-21","2025-02-19","SF FuneralF1129895      250219","","126.5","","351637.27"
"2025-02-21","2025-02-20","SF FuneralF991320       250220","","126.5","","351763.77"
"2025-02-21","2025-02-21","SF FuneralFDC000000061WJ250221","","126.5","","351890.27"
"2025-02-21","2025-02-21","SF FuneralF986990       250222","","126.5","","352016.77"
"2025-02-21","2025-02-21","SF FuneralFDC0000000P3JR250221","","126.5","","352143.27"
"2025-02-21","2025-02-20","SF FuneralF1068008      250220","","126.5","","352269.77"
"2025-02-21","2025-02-21","SF FuneralFDC00000003GQF250221","","220","","352489.77"
"2025-02-21","2025-02-21","SF FuneralF1108397      250221","","126.5","","352616.27"
"2025-02-21","2025-02-21","SF FuneralF1112268      250221","","126.5","","352742.77"
"2025-02-21","2025-02-21","SF FuneralFDC00000008V0C250221","","126.5","","352869.27"
"2025-02-21","2025-02-21","SF FuneralF823296       250221","","126.5","","352995.77"
"2025-02-21","2025-02-21","SF FuneralF840763       250221","","126.5","","353122.27"
"2025-02-21","2025-02-18","SF FuneralF980457       250218","","126.5","","353248.77"
"2025-02-21","2025-02-20","SF FuneralF801667       250220","","126.5","","353375.27"
"2025-02-21","2025-02-20","SF FuneralF815293       250220","","126.5","","353501.77"
"2025-02-21","2025-02-21","SF FuneralF803505       250221","","31.63","","353533.4"
"2025-02-21","2025-02-21","SF FuneralF831397       250221","","126.5","","353659.9"
"2025-02-21","2025-02-21","SF FuneralF987624       250222","","126.5","","353786.4"
"2025-02-21","2025-02-21","SF FuneralFDC0000000HYHK250223","","126.5","","353912.9"
"2025-02-21","2025-02-21","SF FuneralF990869       250222","","126.5","","354039.4"
"2025-02-21","2025-02-21","SF FuneralF1131921      250221","","31.63","","354071.03"
"2025-02-21","2025-02-18","SF FuneralF1128929      250218","","63.25","","354134.28"
"2025-02-21","2025-02-19","SF FuneralFDC00000005TXH250219","","126.5","","354260.78"
"2025-02-21","2025-02-21","SF FuneralF1132802      250221","","126.5","","354387.28"
"2025-02-21","2025-02-20","SF FuneralF1124453      250220","","126.5","","354513.78"
"2025-02-21","2025-02-21","SF FuneralFDC00000005YBL250221","","126.5","","354640.28"
"2025-02-21","2025-02-21","SF FuneralF808286       250221","","126.5","","354766.78"
"2025-02-21","2025-02-21","SF FuneralF987214       250222","","126.5","","354893.28"
"2025-02-21","2025-02-21","SF FuneralF988483       250223","","126.5","","355019.78"
"2025-02-21","2025-02-21","SF FuneralFDC00000007TSB250221","","126.5","","355146.28"
"2025-02-21","2025-02-21","SF FuneralFDC00000008B19250221","","126.5","","355272.78"
"2025-02-21","2025-02-17","SF FuneralF831218       250217","","63.25","","355336.03"
"2025-02-21","2025-02-19","SF FuneralF1125678      250219","","126.5","","355462.53"
"2025-02-21","2025-02-20","SF FuneralFDC00000007NCH250220","","126.5","","355589.03"
"2025-02-21","2025-02-20","SF FuneralF993968       250220","","126.5","","355715.53"
"2025-02-21","2025-02-20","SF FuneralF1066036      250220","","126.5","","355842.03"
"2025-02-21","2025-02-20","SF FuneralF1074533      250220","","126.5","","355968.53"
"2025-02-21","2025-02-19","SF FuneralF777675       250219","","256.5","","356225.03"
"2025-02-21","2025-02-19","SF FuneralF1110441      250219","","126.5","","356351.53"
"2025-02-21","2025-02-20","SF FuneralFDC000000060Q8250220","","126.5","","356478.03"
"2025-02-21","2025-02-20","SF FuneralFDC000000063NN250220","","126.5","","356604.53"
"2025-02-21","2025-02-18","SF FuneralF820830       250218","","63.25","","356667.78"
"2025-02-21","2025-02-18","SF FuneralF822295       250218","","63.25","","356731.03"
"2025-02-21","2025-02-18","SF FuneralF1074818      250218","","63.25","","356794.28"
"2025-02-21","2025-02-20","SF FuneralF1112419      250220","","126.5","","356920.78"
"2025-02-21","2025-02-21","SF FuneralF987341       250222","","126.5","","357047.28"
"2025-02-21","2025-02-17","SF FuneralFDC00000005T1R250217","","126.5","","357173.78"
"2025-02-21","2025-02-17","SF FuneralF1060883      250217","","126.5","","357300.28"
"2025-02-21","2025-02-19","SF FuneralF841655       250219","","126.5","","357426.78"
"2025-02-21","2025-02-20","SF FuneralF1017688      250220","","126.5","","357553.28"
"2025-02-21","2025-02-20","SF FuneralF1127997      250220","","126.5","","357679.78"
"2025-02-21","2025-02-21","SF FuneralFDC0000000MKXM250221","","126.5","","357806.28"
"2025-02-21","2025-02-17","SF FuneralF986985       250217","","63.25","","357869.53"
"2025-02-21","2025-02-18","SF FuneralF842064       250218","","63.25","","357932.78"
"2025-02-21","2025-02-18","SF FuneralF1125287      250218","","63.25","","357996.03"
"2025-02-21","2025-02-19","SF FuneralFDC00000007GVT250219","","126.5","","358122.53"
"2025-02-21","2025-02-19","SF FuneralFDC0000000819D250219","","256.5","","358379.03"
"2025-02-21","2025-02-21","SF FuneralFDC00000007HH9250221","","126.5","","358505.53"
"2025-02-21","2025-02-21","SF FuneralFDC0000000HSWB250223","","126.5","","358632.03"
"2025-02-21","2025-02-21","SF FuneralF987617       250223","","126.5","","358758.53"
"2025-02-21","2025-02-21","SF FuneralF981318       250222","","126.5","","358885.03"
"2025-02-21","2025-02-21","SF FuneralFDC0000000J141250222","","126.5","","359011.53"
"2025-02-21","2025-02-21","SF FuneralF991497       250223","","126.5","","359138.03"
"2025-02-21","2025-02-12","SF FuneralFDC0000000635J250212","","126.5","","359264.53"
"2025-02-21","2025-02-12","SF FuneralFDC0000000645W250212","","126.5","","359391.03"
"2025-02-21","2025-02-19","SF FuneralFDC00000007HMX250219","","126.5","","359517.53"
"2025-02-21","2025-02-19","SF FuneralF805613       250219","","126.5","","359644.03"
"2025-02-21","2025-02-19","SF FuneralF809216       250219","","126.5","","359770.53"
"2025-02-21","2025-02-19","SF FuneralF823129       250219","","126.5","","359897.03"
"2025-02-21","2025-02-19","SF FuneralF989171       250219","","126.5","","360023.53"
"2025-02-21","2025-02-19","SF FuneralFDC0000000PFXD250219","","126.5","","360150.03"
"2025-02-21","2025-02-18","SF FuneralF1058830      250218","","63.25","","360213.28"
"2025-02-21","2025-02-18","SF FuneralF1102904      250218","","63.25","","360276.53"
"2025-02-21","2025-02-19","SF FuneralFDC00000005RNY250219","","126.5","","360403.03"
"2025-02-21","2025-02-21","SF FuneralF816087       250221","","126.5","","360529.53"
"2025-02-21","2025-02-21","SF FuneralF900945       250222","","126.5","","360656.03"
"2025-02-21","2025-02-21","SF FuneralF981688       250223","","126.5","","360782.53"
"2025-02-21","2025-02-21","SF FuneralFDC0000000HGS2250222","","126.5","","360909.03"
"2025-02-21","2025-02-18","SF FuneralF814319       250218","","63.25","","360972.28"
"2025-02-21","2025-02-18","SF FuneralF1124763      250218","","63.25","","361035.53"
"2025-02-21","2025-02-18","SF FuneralF1132008      250218","","126.5","","361162.03"
"2025-02-21","2025-02-21","SF FuneralF811091       250221","","126.5","","361288.53"
"2025-02-21","2025-02-17","SF FuneralF1075155      250217","","63.25","","361351.78"
"2025-02-21","2025-02-21","SF FuneralF987412       250222","","126.5","","361478.28"
"2025-02-21","2025-02-17","SF FuneralF794739       250217","","63.25","","361541.53"
"2025-02-21","2025-02-17","SF FuneralFDC00000007X2R250217","","126.5","","361668.03"
"2025-02-21","2025-02-19","SF FuneralFDC00000005ZWM250219","","126.5","","361794.53"
"2025-02-21","2025-02-19","SF FuneralFDC00000006GD6250219","","126.5","","361921.03"
"2025-02-21","2025-02-19","SF FuneralFDC00000006X01250219","","321.5","","362242.53"
"2025-02-21","2025-02-19","SF FuneralFDC0000000758K250219","","126.5","","362369.03"
"2025-02-21","2025-02-19","SF FuneralFDC0000000BXRS250219","","126.5","","362495.53"
"2025-02-21","2025-02-19","SF FuneralF841842       250219","","126.5","","362622.03"
"2025-02-21","2025-02-19","SF FuneralF1118812      250219","","126.5","","362748.53"
"2025-02-21","2025-02-19","SF FuneralF1131358      250219","","126.5","","362875.03"
"2025-02-21","2025-02-20","SF FuneralFDC00000005MXN250220","","126.5","","363001.53"
"2025-02-21","2025-02-20","SF FuneralFDC00000005VN9250220","","126.5","","363128.03"
"2025-02-21","2025-02-20","SF FuneralFDC00000007HSD250220","","126.5","","363254.53"
"2025-02-21","2025-02-20","SF FuneralF805420       250220","","126.5","","363381.03"
"2025-02-21","2025-02-20","SF FuneralFDC00000005WC5250220","","126.5","","363507.53"
"2025-02-21","2025-02-21","SF FuneralF986905       250222","","126.5","","363634.03"
"2025-02-21","2025-02-21","SF FuneralFDC0000000J13S250222","","126.5","","363760.53"
"2025-02-21","2025-02-21","SF FuneralF1132258      250221","","126.5","","363887.03"
"2025-02-21","2025-02-17","SF FuneralF842916       250217","","63.25","","363950.28"
"2025-02-21","2025-02-17","SF FuneralF1080529      250217","","31.63","","363981.91"
"2025-02-21","2025-02-17","SF FuneralF1111602      250217","","126.5","","364108.41"
"2025-02-21","2025-02-17","SF FuneralF1124114      250217","","31.63","","364140.04"
"2025-02-21","2025-02-18","SF FuneralFDC00000006WKK250218","","31.63","","364171.67"
"2025-02-21","2025-02-18","SF FuneralFDC00000007CPB250218","","31.63","","364203.3"
"2025-02-21","2025-02-18","SF FuneralFDC000000080CL250218","","126.5","","364329.8"
"2025-02-21","2025-02-18","SF FuneralFDC000000080WH250218","","31.63","","364361.43"
"2025-02-21","2025-02-18","SF FuneralFDC00000008851250218","","31.63","","364393.06"
"2025-02-21","2025-02-18","SF FuneralF821545       250218","","47.88","","364440.94"
"2025-02-21","2025-02-18","SF FuneralF990255       250218","","31.63","","364472.57"
"2025-02-21","2025-02-18","SF FuneralF1060950      250218","","31.63","","364504.2"
"2025-02-21","2025-02-18","SF FuneralF1080286      250218","","31.63","","364535.83"
"2025-02-21","2025-02-18","SF FuneralF1115105      250218","","31.63","","364567.46"
"2025-02-21","2025-02-18","SF FuneralF1122312      250218","","126.5","","364693.96"
"2025-02-21","2025-02-18","SF FuneralF1132378      250218","","31.63","","364725.59"
"2025-02-21","2025-02-19","SF FuneralFDC00000005TJ3250219","","126.5","","364852.09"
"2025-02-21","2025-02-19","SF FuneralFDC00000005WMJ250219","","126.5","","364978.59"
"2025-02-21","2025-02-19","SF FuneralFDC000000060YG250219","","126.5","","365105.09"
"2025-02-21","2025-02-19","SF FuneralF1061719      250219","","126.5","","365231.59"
"2025-02-21","2025-02-20","SF FuneralFDC0000000623F250220","","126.5","","365358.09"
"2025-02-21","2025-02-20","SF FuneralF810145       250220","","126.5","","365484.59"
"2025-02-21","2025-02-20","SF FuneralF1129095      250220","","126.5","","365611.09"
"2025-02-21","2025-02-21","SF FuneralFDC0000000628F250221","","31.63","","365642.72"
"2025-02-21","2025-02-21","SF FuneralFDC00000006P6D250221","","31.63","","365674.35"
"2025-02-21","2025-02-21","SF FuneralFDC000000070CD250221","","31.63","","365705.98"
"2025-02-21","2025-02-21","SF FuneralF814074       250221","","31.63","","365737.61"
"2025-02-21","2025-02-21","SF FuneralF819108       250221","","126.5","","365864.11"
"2025-02-21","2025-02-21","SF FuneralFDC0000000HQ93250222","","126.5","","365990.61"
"2025-02-21","2025-02-21","SF FuneralF822822       250222","","191.5","","366182.11"
"2025-02-21","2025-02-21","SF FuneralF988516       250222","","126.5","","366308.61"
"2025-02-21","2025-02-21","SF FuneralF993809       250221","","31.63","","366340.24"
"2025-02-21","2025-02-21","SF FuneralF993837       250221","","31.63","","366371.87"
"2025-02-21","2025-02-12","SF FuneralF1072726      250212","","126.5","","366498.37"
"2025-02-21","2025-02-17","SF FuneralFDC00000006Q80250217","","31.63","","366530"
"2025-02-21","2025-02-18","SF FuneralF1073597      250218","","126.5","","366656.5"
"2025-02-21","2025-02-18","Rev SF FuneralFDC00000005PFJ250218","","-31.63","","366624.87"
"2025-02-21","2025-02-18","Rev SF FuneralFDC000000079S6250218","","-31.63","","366593.24"
"2025-02-21","2025-01-24","Rev SF FuneralFDC00000005W51250127","","-126.5","","366466.74"
"2025-02-21","2025-02-17","Rev SF FuneralFDC00000008TYJ250217","","-63.25","","366403.49"
"2025-02-21","2025-02-17","Rev SF FuneralFDC0000000KFF7250217","","-126.5","","366276.99"
"2025-02-21","2025-02-17","Rev SF FuneralFDC0000000N83K250217","","-126.5","","366150.49"
"2025-02-21","2025-02-17","Rev SF FuneralFDC0000000J1SX250217","","-126.5","","366023.99"
"2025-02-21","2025-02-17","SF FuneralF833860       250217","","126.5","","366150.49"
"2025-02-21","2025-02-18","SF FuneralF800205       250218","","31.63","","366182.12"
"2025-02-21","2025-02-18","SF FuneralF831001       250218","","63.25","","366245.37"
"2025-02-21","2025-02-18","SF FuneralF1054618      250218","","31.63","","366277"
"2025-02-21","2025-02-21","SF FuneralF1073874      250221","","126.5","","366403.5"
"2025-02-21","2025-02-14","SF FuneralFDC000000061M3250214","","63.25","","366466.75"
"2025-02-21","2025-02-17","SF FuneralFDC00000007C9V250217","","63.25","","366530"
"2025-02-21","2025-02-17","SF FuneralF821755       250217","","126.5","","366656.5"
"2025-02-21","2025-02-17","SF FuneralF1055052      250217","","126.5","","366783"
"2025-02-21","2025-02-17","SF FuneralF1060981      250217","","63.25","","366846.25"
"2025-02-21","2025-02-17","SF FuneralF1124749      250217","","126.5","","366972.75"
"2025-02-21","2025-02-18","SF FuneralF823292       250218","","63.25","","367036"
"2025-02-21","2025-02-18","SF FuneralF1066156      250218","","63.25","","367099.25"
"2025-02-21","2025-02-18","SF FuneralF1124420      250218","","63.25","","367162.5"
"2025-02-21","2025-02-20","SF FuneralFDC000000065X7250220","","126.5","","367289"
"2025-02-21","2025-02-21","SF FuneralF841617       250221","","126.5","","367415.5"
"2025-02-21","2025-02-21","SF FuneralF989355       250222","","126.5","","367542"
"2025-02-21","2025-02-21","SF FuneralF1075083      250221","","126.5","","367668.5"
"2025-02-21","2025-02-21","SF FuneralF1078544      250221","","126.5","","367795"
"2025-02-21","2025-02-21","SF FuneralF1120621      250221","","126.5","","367921.5"
"2025-02-21","2025-02-17","SF FuneralF1073425      250217","","31.63","","367953.13"
"2025-02-21","2025-02-17","SF FuneralF1102887      250217","","31.63","","367984.76"
"2025-02-21","2025-02-17","SF FuneralF1123166      250217","","31.63","","368016.39"
"2025-02-21","2025-02-18","SF FuneralF833363       250218","","31.63","","368048.02"
"2025-02-21","2025-02-18","SF FuneralF841781       250218","","31.63","","368079.65"
"2025-02-21","2025-02-18","SF FuneralF1128951      250218","","31.63","","368111.28"
"2025-02-21","2025-02-18","SF FuneralF1130733      250218","","31.63","","368142.91"
"2025-02-21","2025-02-21","SF FuneralF841714       250221","","31.63","","368174.54"
"2025-02-21","2025-02-18","SF FuneralF822587       250218","","31.63","","368206.17"
"2025-02-21","2025-02-18","SF FuneralF1118693      250218","","63.25","","368269.42"
"2025-02-21","2025-02-19","SF FuneralFDC0000000828X250219","","126.5","","368395.92"
"2025-02-21","2025-02-12","SF FuneralFDC00000005MGJ250212","","126.5","","368522.42"
"2025-02-21","2025-02-17","SF FuneralF1118033      250217","","31.63","","368554.05"
"2025-02-21","2025-02-18","SF FuneralFDC00000007S9L250218","","31.63","","368585.68"
"2025-02-21","2025-02-18","SF FuneralF811706       250218","","63.25","","368648.93"
"2025-02-21","2025-02-18","SF FuneralF818338       250218","","63.25","","368712.18"
"2025-02-21","2025-02-18","SF FuneralF989270       250218","","31.63","","368743.81"
"2025-02-21","2025-02-18","SF FuneralF1118420      250218","","31.63","","368775.44"
"2025-02-21","2025-02-18","SF FuneralF1130616      250218","","31.63","","368807.07"
"2025-02-21","2025-02-18","SF FuneralF1131287      250218","","63.25","","368870.32"
"2025-02-21","2025-02-19","SF FuneralFDC000000073VV250219","","126.5","","368996.82"
"2025-02-21","2025-02-21","SF FuneralFDC0000000J3VD250223","","126.5","","369123.32"
"2025-02-21","2025-02-21","SF FuneralF1079205      250221","","126.5","","369249.82"
"2025-02-21","2025-02-21","SF FuneralF1108395      250221","","126.5","","369376.32"
"2025-02-21","2025-02-21","SF FuneralF1114116      250221","","31.63","","369407.95"
"2025-02-21","2025-02-18","SF FuneralFDC00000005P72250218","","63.25","","369471.2"
"2025-02-21","2025-02-18","SF FuneralFDC00000006X91250218","","31.63","","369502.83"
"2025-02-21","2025-02-18","SF FuneralFDC0000000HTVZ250218","","63.25","","369566.08"
"2025-02-21","2025-02-18","SF FuneralF1052659      250218","","31.63","","369597.71"
"2025-02-21","2025-02-18","SF FuneralF1078543      250218","","63.25","","369660.96"
"2025-02-21","2025-02-18","SF FuneralF1078560      250218","","63.25","","369724.21"
"2025-02-21","2025-02-18","SF FuneralF1112534      250218","","63.25","","369787.46"
"2025-02-21","2025-02-17","SF FuneralF1061516      250217","","63.25","","369850.71"
"2025-02-21","2025-02-13","SF FuneralF1110817      250213","","63.25","","369913.96"
"2025-02-21","2025-02-17","SF FuneralFDC00000006XGF250217","","63.25","","369977.21"
"2025-02-21","2025-02-17","SF FuneralF986862       250217","","63.25","","370040.46"
"2025-02-21","2025-02-17","SF FuneralF991465       250217","","31.63","","370072.09"
"2025-02-21","2025-02-17","SF FuneralFDC0000000LT6F250217","","126.5","","370198.59"
"2025-02-21","2025-02-17","SF FuneralF1111352      250217","","63.25","","370261.84"
"2025-02-21","2025-02-18","SF FuneralFDC00000003V68250218","","55","","370316.84"
"2025-02-21","2025-02-18","SF FuneralFDC00000005X2M250218","","31.63","","370348.47"
"2025-02-21","2025-02-18","SF FuneralFDC00000007CY2250218","","63.25","","370411.72"
"2025-02-21","2025-02-18","SF FuneralF814235       250218","","63.25","","370474.97"
"2025-02-21","2025-02-18","SF FuneralF819158       250218","","31.63","","370506.6"
"2025-02-21","2025-02-18","SF FuneralF830023       250218","","31.63","","370538.23"
"2025-02-21","2025-02-18","SF FuneralF988932       250218","","63.25","","370601.48"
"2025-02-21","2025-02-18","SF FuneralF989148       250218","","31.63","","370633.11"
"2025-02-21","2025-02-18","SF FuneralF990591       250218","","31.63","","370664.74"
"2025-02-21","2025-02-18","SF FuneralF991480       250218","","31.63","","370696.37"
"2025-02-21","2025-02-18","SF FuneralF1079430      250218","","63.25","","370759.62"
"2025-02-21","2025-02-18","SF FuneralF1118471      250218","","31.63","","370791.25"
"2025-02-21","2025-02-18","SF FuneralFDC0000000NTBQ250218","","31.63","","370822.88"
"2025-02-21","2025-02-18","SF FuneralF1120133      250218","","31.63","","370854.51"
"2025-02-21","2025-02-20","SF FuneralF986771       250220","","126.5","","370981.01"
"2025-02-21","2025-02-21","SF FuneralF988703       250222","","126.5","","371107.51"
"2025-02-21","2025-02-21","SF FuneralF1061782      250221","","31.63","","371139.14"
"2025-02-21","2025-02-18","SF FuneralF989085       250218","","31.63","","371170.77"
"2025-02-21","2025-02-18","SF FuneralF1067978      250218","","31.63","","371202.4"
"2025-02-21","2025-02-18","SF FuneralF1113963      250218","","31.63","","371234.03"
"2025-02-21","2025-02-21","SF FuneralFDC00000007M62250221","","126.5","","371360.53"
"2025-02-21","2025-02-18","SF FuneralFDC0000000CY56250218","","31.63","","371392.16"
"2025-02-21","2025-02-17","SF FuneralFDC00000005NWL250217","","31.63","","371423.79"
"2025-02-21","2025-02-18","SF FuneralFDC000000030DF250218","","55","","371478.79"
"2025-02-21","2025-02-18","SF FuneralF810630       250218","","63.25","","371542.04"
"2025-02-21","2025-02-18","SF FuneralF798602       250218","","63.25","","371605.29"
"2025-02-21","2025-02-18","SF FuneralF833229       250218","","63.25","","371668.54"
"2025-02-21","2025-02-18","SF FuneralF991505       250218","","63.25","","371731.79"
"2025-02-21","2025-02-18","SF FuneralF1033965      250218","","63.25","","371795.04"
"2025-02-21","2025-02-21","SF FuneralF1021793      250221","","126.5","","371921.54"
"2025-02-21","2025-02-18","SF FuneralFDC000000078FZ250218","","31.63","","371953.17"
"2025-02-21","2025-02-18","SF FuneralF820929       250218","","31.63","","371984.8"
"2025-02-21","2025-02-18","SF FuneralF1079259      250218","","31.63","","372016.43"
"2025-02-21","2025-02-18","SF FuneralF1113987      250218","","31.63","","372048.06"
"2025-02-21","2025-02-21","SF FuneralFDC0000000D307250221","","31.63","","372079.69"
"2025-02-21","2025-02-12","SF FuneralF981168       250212","","126.5","","372206.19"
"2025-02-21","2025-02-15","SF FuneralFDC00000007M50250215","","126.5","","372332.69"
"2025-02-21","2025-02-17","SF FuneralFDC000000063B7250217","","110","","372442.69"
"2025-02-21","2025-02-17","SF FuneralFDC00000006T74250217","","63.25","","372505.94"
"2025-02-21","2025-02-17","SF FuneralFDC00000007DSV250217","","31.63","","372537.57"
"2025-02-21","2025-02-17","SF FuneralF830431       250217","","31.63","","372569.2"
"2025-02-21","2025-02-17","SF FuneralFDC0000000FCJY250217","","31.63","","372600.83"
"2025-02-21","2025-02-17","SF FuneralF989598       250217","","63.25","","372664.08"
"2025-02-21","2025-02-17","SF FuneralF991385       250217","","31.63","","372695.71"
"2025-02-21","2025-02-17","SF FuneralF1060604      250217","","126.5","","372822.21"
"2025-02-21","2025-02-18","SF FuneralFDC000000062B9250218","","63.25","","372885.46"
"2025-02-21","2025-02-18","SF FuneralFDC00000006MV3250218","","63.25","","372948.71"
"2025-02-21","2025-02-18","SF FuneralFDC000000073P4250218","","31.63","","372980.34"
"2025-02-21","2025-02-18","SF FuneralF798676       250218","","31.63","","373011.97"
"2025-02-21","2025-02-18","SF FuneralF810870       250218","","63.25","","373075.22"
"2025-02-21","2025-02-18","SF FuneralF812125       250218","","31.63","","373106.85"
"2025-02-21","2025-02-18","SF FuneralF815933       250218","","63.25","","373170.1"
"2025-02-21","2025-02-18","SF FuneralF820828       250218","","63.25","","373233.35"
"2025-02-21","2025-02-18","SF FuneralF822306       250218","","63.25","","373296.6"
"2025-02-21","2025-02-18","SF FuneralF841866       250218","","63.25","","373359.85"
"2025-02-21","2025-02-18","SF FuneralF986691       250218","","31.63","","373391.48"
"2025-02-21","2025-02-18","SF FuneralF987466       250218","","63.25","","373454.73"
"2025-02-21","2025-02-18","SF FuneralF991415       250218","","31.63","","373486.36"
"2025-02-21","2025-02-18","SF FuneralF1033680      250218","","31.63","","373517.99"
"2025-02-21","2025-02-18","SF FuneralF1060838      250218","","31.63","","373549.62"
"2025-02-21","2025-02-18","SF FuneralF1062646      250218","","31.63","","373581.25"
"2025-02-21","2025-02-18","SF FuneralF1066029      250218","","31.63","","373612.88"
"2025-02-21","2025-02-18","SF FuneralF1067990      250218","","31.63","","373644.51"
"2025-02-21","2025-02-18","SF FuneralF1073704      250218","","126.5","","373771.01"
"2025-02-21","2025-02-18","SF FuneralFDC0000000LK43250218","","31.63","","373802.64"
"2025-02-21","2025-02-18","SF FuneralFDC0000000LVMD250218","","31.63","","373834.27"
"2025-02-21","2025-02-18","SF FuneralFDC0000000ML5T250218","","63.25","","373897.52"
"2025-02-21","2025-02-18","SF FuneralFDC0000000NBRM250218","","31.63","","373929.15"
"2025-02-21","2025-02-18","SF FuneralF1116010      250218","","31.63","","373960.78"
"2025-02-21","2025-02-18","SF FuneralF1123402      250218","","63.25","","374024.03"
"2025-02-21","2025-02-18","SF FuneralF1128976      250218","","63.25","","374087.28"
"2025-02-21","2025-02-18","SF FuneralF1131800      250218","","63.25","","374150.53"
"2025-02-21","2025-02-18","SF FuneralF1132383      250218","","63.25","","374213.78"
"2025-02-21","2025-02-19","SF FuneralFDC00000008J7N250219","","126.5","","374340.28"
"2025-02-21","2025-02-19","SF FuneralF1120754      250219","","31.63","","374371.91"
"2025-02-21","2025-02-19","SF FuneralF1120890      250219","","126.5","","374498.41"
"2025-02-21","2025-02-20","SF FuneralFDC00000005ZK4250220","","126.5","","374624.91"
"2025-02-21","2025-02-20","SF FuneralFDC00000005ZKG250220","","126.5","","374751.41"
"2025-02-21","2025-02-20","SF FuneralFDC00000005ZKP250220","","126.5","","374877.91"
"2025-02-21","2025-02-21","SF FuneralFDC000000060CR250221","","126.5","","375004.41"
"2025-02-21","2025-02-21","SF FuneralFDC000000064R8250221","","126.5","","375130.91"
"2025-02-21","2025-02-21","SF FuneralFDC0000000K8Y6250221","","31.63","","375162.54"
"2025-02-21","2025-02-21","SF FuneralF1068059      250221","","126.5","","375289.04"
"2025-02-21","2025-02-21","SF FuneralF1078457      250221","","31.63","","375320.67"
"2025-02-21","2025-02-18","Rev SF FuneralFDC00000006ST9250218","","-31.63","","375289.04"
"2025-02-21","2025-02-18","Rev SF FuneralFDC00000008365250218","","-31.63","","375257.41"
"2025-02-21","2025-02-18","Rev SF FuneralFDC00000006STJ250218","","-31.63","","375225.78"
"2025-02-21","2025-02-19","Rev SF FuneralFDC0000000LG2D250219","","-31.63","","375194.15"
"2025-02-21","2025-02-10","Rev SF FuneralFDC000000070Z5250209","","-31.63","","375162.52"
"2025-02-21","2025-02-21","Rev SF FuneralFDC0000000PK3S250221","","-31.63","","375130.89"
"2025-02-21","2025-02-03","Rev SF FuneralFDC0000000NL09250203","","-31.63","","375099.26"
"2025-02-21","2025-02-03","Rev SF FuneralFDC000000070Z5250202","","-31.63","","375067.63"
"2025-02-21","2025-02-17","Rev SF FuneralFDC0000000FCJY250217","","-31.63","","375036"
"2025-02-21","2025-02-17","Rev SF FuneralFDC000000070Z5250216","","-31.63","","375004.37"
"2025-02-21","2025-02-10","Rev SF FuneralFDC0000000NL09250210","","-31.63","","374972.74"
"2025-02-21","2025-02-19","Rev SF FuneralFDC00000006GD6250219","","-126.5","","374846.24"
"2025-02-21","2025-02-19","Rev SF FuneralFDC00000006X01250219","","-321.5","","374524.74"
"2025-02-21","2025-02-21","Rev SF FuneralFDC00000005YBL250221","","-126.5","","374398.24"
"2025-02-21","2025-02-21","Rev SF FuneralFDC0000000J3VD250223","","-126.5","","374271.74"
"2025-02-21","2025-02-20","Rev SF FuneralFDC00000006QDX250220","","-126.5","","374145.24"
"2025-02-21","2025-02-20","Rev SF FuneralFDC00000005ZK4250220","","-126.5","","374018.74"
"2025-02-21","2025-02-21","Rev SF FuneralFDC00000008V0C250221","","-126.5","","373892.24"
"2025-02-21","2025-02-20","Rev SF FuneralFDC00000005ZKG250220","","-126.5","","373765.74"
"2025-02-21","2025-02-20","Rev SF FuneralFDC00000007NCH250220","","-126.5","","373639.24"
"2025-02-21","2025-02-19","Rev SF FuneralFDC00000007GVT250219","","-126.5","","373512.74"
"2025-02-21","2025-02-21","Rev SF FuneralFDC00000003GQF250221","","-220","","373292.74"
"2025-02-21","2025-01-20","Rev SF FuneralFDC00000007GVT250119","","-126.5","","373166.24"
"2025-02-21","2025-01-21","Rev SF FuneralFDC00000007N60250121","","-126.5","","373039.74"
"2025-02-21","2025-01-22","Rev SF FuneralFDC000000039N2250122","","-220","","372819.74"
"2025-02-21","2025-01-24","Rev SF FuneralFDC0000000PSD7250125","","-126.5","","372693.24"
"2025-02-21","2025-02-12","Rev SF FuneralFDC00000005MGJ250212","","-126.5","","372566.74"
"2025-02-21","2025-02-18","SF FuneralF801331       250218","","31.63","","372598.37"
"2025-02-21","2025-02-18","SF FuneralF993778       250218","","63.25","","372661.62"
"2025-02-21","2025-02-18","SF FuneralFDC0000000N7JJ250218","","63.25","","372724.87"
"2025-02-21","2025-02-18","SF FuneralF1122862      250218","","31.63","","372756.5"
"2025-02-21","2025-02-18","SF FuneralFDC00000005P4K250218","","31.63","","372788.13"
"2025-02-21","2025-02-18","SF FuneralFDC00000006CWD250218","","55","","372843.13"
"2025-02-21","2025-02-18","SF FuneralF827810       250218","","63.25","","372906.38"
"2025-02-21","2025-02-18","SF FuneralF830037       250218","","63.25","","372969.63"
"2025-02-21","2025-02-18","SF FuneralF828946       250218","","63.25","","373032.88"
"2025-02-21","2025-02-18","SF FuneralF1084995      250218","","31.63","","373064.51"
"2025-02-21","2025-02-18","SF FuneralF1118898      250218","","63.25","","373127.76"
"2025-02-21","2025-02-21","SF FuneralF1127416      250221","","63.25","","373191.01"
"2025-02-21","2025-02-17","SF FuneralF823312       250217","","126.5","","373317.51"
"2025-02-21","2025-02-17","SF FuneralFDC0000000CSY7250217","","31.63","","373349.14"
"2025-02-21","2025-02-19","SF FuneralFDC00000005Z4Z250219","","126.5","","373475.64"
"2025-02-21","2025-02-19","SF FuneralFDC000000082T4250219","","126.5","","373602.14"
"2025-02-21","2025-02-19","SF FuneralF810636       250219","","126.5","","373728.64"
"2025-02-21","2025-02-18","SF FuneralF1123395      250218","","63.25","","373791.89"
"2025-02-21","2025-02-19","SF FuneralF819111       250219","","31.63","","373823.52"
"2025-02-21","2025-02-21","SF FuneralF801313       250221","","126.5","","373950.02"
"2025-02-21","2025-02-21","SF FuneralF992014       250221","","126.5","","374076.52"
"2025-02-21","2025-02-18","SF FuneralFDC000000061NF250218","","31.63","","374108.15"
"2025-02-21","2025-02-18","SF FuneralF806032       250218","","31.63","","374139.78"
"2025-02-21","2025-02-18","SF FuneralF809435       250218","","31.63","","374171.41"
"2025-02-21","2025-02-18","SF FuneralF829557       250218","","31.63","","374203.04"
"2025-02-21","2025-02-18","SF FuneralF986694       250218","","31.63","","374234.67"
"2025-02-21","2025-02-18","SF FuneralFDC0000000J23L250218","","31.63","","374266.3"
"2025-02-21","2025-02-18","SF FuneralF1022115      250218","","31.63","","374297.93"
"2025-02-21","2025-02-18","SF FuneralF1052200      250218","","31.63","","374329.56"
"2025-02-21","2025-02-18","SF FuneralF843649       250218","","31.63","","374361.19"
"2025-02-21","2025-02-18","SF FuneralF1061075      250218","","31.63","","374392.82"
"2025-02-21","2025-02-18","SF FuneralF1068023      250218","","31.63","","374424.45"
"2025-02-21","2025-02-18","SF FuneralF1074952      250218","","126.5","","374550.95"
"2025-02-21","2025-02-18","SF FuneralFDC0000000MCB7250218","","63.25","","374614.2"
"2025-02-21","2025-02-18","SF FuneralF1111329      250218","","31.63","","374645.83"
"2025-02-21","2025-02-18","SF FuneralF1117702      250218","","31.63","","374677.46"
"2025-02-21","2025-02-18","SF FuneralF820999       250218","","31.63","","374709.09"
"2025-02-21","2025-02-18","SF FuneralF1123172      250218","","31.63","","374740.72"
"2025-02-21","2025-02-18","SF FuneralF1125142      250218","","31.63","","374772.35"
"2025-02-22","2025-02-17","SF FuneralFDC000000069C5250217","","31.63","","374803.98"
"2025-02-22","2025-02-17","SF FuneralF810327       250217","","31.63","","374835.61"
"2025-02-22","2025-02-17","SF FuneralF1079340      250217","","31.63","","374867.24"
"2025-02-22","2025-02-18","SF FuneralF817682       250218","","31.63","","374898.87"
"2025-02-22","2025-02-18","SF FuneralFDC0000000CWFK250218","","31.63","","374930.5"
"2025-02-22","2025-02-18","SF FuneralF1020608      250218","","31.63","","374962.13"
"2025-02-22","2025-02-18","SF FuneralF1020683      250218","","31.63","","374993.76"
"2025-02-22","2025-02-18","SF FuneralF1115225      250218","","31.63","","375025.39"
"2025-02-22","2025-02-18","SF FuneralFDC0000000NRVB250218","","31.63","","375057.02"
"2025-02-22","2025-02-18","SF FuneralF1123030      250218","","31.63","","375088.65"
"2025-02-22","2025-02-18","SF FuneralF743038       250218","","31.63","","375120.28"
"2025-02-22","2025-02-18","SF FuneralF1132382      250218","","31.63","","375151.91"
"2025-02-22","2025-02-18","SF FuneralF805200       250218","","31.63","","375183.54"
"2025-02-22","2025-02-18","SF FuneralF833123       250218","","31.63","","375215.17"
"2025-02-22","2025-02-18","SF FuneralF1050698      250218","","31.63","","375246.8"
"2025-02-22","2025-02-18","SF FuneralF1073379      250218","","31.63","","375278.43"
"2025-02-22","2025-02-18","SF FuneralF1073746      250218","","31.63","","375310.06"
"2025-02-22","2025-02-18","SF FuneralF1074598      250218","","31.63","","375341.69"
"2025-02-22","2025-02-18","SF FuneralF1129064      250218","","31.63","","375373.32"
"2025-02-22","2025-02-18","SF FuneralFDC0000000616W250218","","126.5","","375499.82"
"2025-02-22","2025-02-18","SF FuneralFDC00000008TK0250218","","126.5","","375626.32"
"2025-02-22","2025-02-18","SF FuneralF819579       250218","","126.5","","375752.82"
"2025-02-22","2025-02-18","SF FuneralF833247       250218","","63.25","","375816.07"
"2025-02-22","2025-02-18","SF FuneralF989331       250218","","63.25","","375879.32"
"2025-02-22","2025-02-18","SF FuneralF1124139      250218","","126.5","","376005.82"
"2025-02-22","2025-02-19","SF FuneralFDC0000000541D250219","","126.5","","376132.32"
"2025-02-22","2025-02-19","SF FuneralFDC00000005RNF250219","","126.5","","376258.82"
"2025-02-22","2025-02-19","SF FuneralFDC00000005ZZG250219","","126.5","","376385.32"
"2025-02-22","2025-02-19","SF FuneralFDC000000087TZ250219","","126.5","","376511.82"
"2025-02-22","2025-02-19","SF FuneralFDC000000087V0250219","","126.5","","376638.32"
"2025-02-22","2025-02-19","SF FuneralF805384       250219","","126.5","","376764.82"
"2025-02-22","2025-02-19","SF FuneralF847303       250219","","126.5","","376891.32"
"2025-02-22","2025-02-19","SF FuneralFDC0000000K8JJ250219","","126.5","","377017.82"
"2025-02-22","2025-02-19","SF FuneralF1083874      250219","","63.25","","377081.07"
"2025-02-22","2025-02-19","SF FuneralFDC0000000P9YG250219","","126.5","","377207.57"
"2025-02-22","2025-02-19","SF FuneralF1124426      250219","","126.5","","377334.07"
"2025-02-22","2025-02-20","SF FuneralFDC00000006Y2D250220","","126.5","","377460.57"
"2025-02-22","2025-02-20","SF FuneralFDC00000007X6J250220","","126.5","","377587.07"
"2025-02-22","2025-02-20","SF FuneralFDC000000089G7250220","","126.5","","377713.57"
"2025-02-22","2025-02-20","SF FuneralF1123896      250220","","126.5","","377840.07"
"2025-02-22","2025-02-20","SF FuneralF1130022      250220","","126.5","","377966.57"
"2025-02-22","2025-02-21","SF FuneralF989811       250222","","126.5","","378093.07"
"2025-02-22","2025-02-21","SF FuneralF990274       250222","","126.5","","378219.57"
"2025-02-22","2025-02-12","SF FuneralFDC000000043BW250212","","220","","378439.57"
"2025-02-22","2025-02-17","SF FuneralFDC00000005ZJC250217","","126.5","","378566.07"
"2025-02-22","2025-02-17","SF FuneralFDC00000005ZJD250217","","126.5","","378692.57"
"2025-02-22","2025-02-17","SF FuneralFDC000000061DH250217","","126.5","","378819.07"
"2025-02-22","2025-02-17","SF FuneralF799122       250217","","126.5","","378945.57"
"2025-02-22","2025-02-17","SF FuneralF1116080      250217","","126.5","","379072.07"
"2025-02-22","2025-02-18","SF FuneralFDC00000005L57250218","","31.63","","379103.7"
"2025-02-22","2025-02-18","SF FuneralFDC000000064P9250218","","31.63","","379135.33"
"2025-02-22","2025-02-18","SF FuneralFDC00000006Y7S250218","","31.63","","379166.96"
"2025-02-22","2025-02-18","SF FuneralFDC0000000722W250218","","63.25","","379230.21"
"2025-02-22","2025-02-18","SF FuneralFDC000000076ZR250218","","126.5","","379356.71"
"2025-02-22","2025-02-18","SF FuneralF815053       250218","","63.25","","379419.96"
"2025-02-22","2025-02-18","SF FuneralF819740       250218","","126.5","","379546.46"
"2025-02-22","2025-02-18","SF FuneralF821893       250218","","63.25","","379609.71"
"2025-02-22","2025-02-18","SF FuneralF993963       250218","","63.25","","379672.96"
"2025-02-22","2025-02-18","SF FuneralFDC0000000JJ2Y250218","","63.25","","379736.21"
"2025-02-22","2025-02-18","SF FuneralF1060963      250218","","63.25","","379799.46"
"2025-02-22","2025-02-18","SF FuneralF1078491      250218","","63.25","","379862.71"
"2025-02-22","2025-02-18","SF FuneralF1079384      250218","","63.25","","379925.96"
"2025-02-22","2025-02-18","SF FuneralFDC0000000MK76250218","","63.25","","379989.21"
"2025-02-22","2025-02-18","SF FuneralF1111967      250218","","63.25","","380052.46"
"2025-02-22","2025-02-18","SF FuneralF1121999      250218","","63.25","","380115.71"
"2025-02-22","2025-02-18","SF FuneralF1122767      250218","","63.25","","380178.96"
"2025-02-22","2025-02-18","SF FuneralF1127719      250218","","31.63","","380210.59"
"2025-02-22","2025-02-18","SF FuneralF1129417      250218","","31.63","","380242.22"
"2025-02-22","2025-02-18","SF FuneralF1130519      250218","","63.25","","380305.47"
"2025-02-22","2025-02-18","SF FuneralF1130748      250218","","63.25","","380368.72"
"2025-02-22","2025-02-18","SF FuneralF1131855      250218","","63.25","","380431.97"
"2025-02-22","2025-02-18","SF FuneralF739720       250218","","64.13","","380496.1"
"2025-02-22","2025-02-19","SF FuneralFDC00000009F2S250219","","126.5","","380622.6"
"2025-02-22","2025-02-19","SF FuneralF823094       250219","","31.63","","380654.23"
"2025-02-22","2025-02-19","SF FuneralF834869       250219","","126.5","","380780.73"
"2025-02-22","2025-02-20","SF FuneralFDC00000006PPW250220","","126.5","","380907.23"
"2025-02-22","2025-02-20","SF FuneralF809258       250220","","126.5","","381033.73"
"2025-02-22","2025-02-20","SF FuneralF1122638      250220","","63.25","","381096.98"
"2025-02-22","2025-02-21","SF FuneralFDC00000005N5S250221","","31.63","","381128.61"
"2025-02-22","2025-02-21","SF FuneralFDC00000006ZZZ250221","","126.5","","381255.11"
"2025-02-22","2025-02-21","SF FuneralFDC0000000795Q250221","","126.5","","381381.61"
"2025-02-22","2025-02-21","SF FuneralFDC000000087Y5250221","","126.5","","381508.11"
"2025-02-22","2025-02-21","SF FuneralF813030       250221","","31.63","","381539.74"
"2025-02-22","2025-02-21","SF FuneralF987794       250223","","126.5","","381666.24"
"2025-02-22","2025-02-21","SF FuneralF988262       250222","","126.5","","381792.74"
"2025-02-22","2025-02-21","SF FuneralF988455       250222","","126.5","","381919.24"
"2025-02-22","2025-02-21","SF FuneralF1130404      250221","","126.5","","382045.74"
"2025-02-22","2025-02-15","SF FuneralF1055127      250216","","126.5","","382172.24"
"2025-02-22","2025-02-17","SF FuneralF991450       250217","","126.5","","382298.74"
"2025-02-22","2025-02-17","SF FuneralF1073564      250217","","126.5","","382425.24"
"2025-02-22","2025-02-18","SF FuneralFDC00000006Y8Q250218","","126.5","","382551.74"
"2025-02-22","2025-02-18","SF FuneralF810730       250218","","63.25","","382614.99"
"2025-02-22","2025-02-18","SF FuneralF817760       250218","","63.25","","382678.24"
"2025-02-22","2025-02-19","SF FuneralF805474       250219","","126.5","","382804.74"
"2025-02-22","2025-02-19","SF FuneralF812302       250219","","126.5","","382931.24"
"2025-02-22","2025-02-19","SF FuneralF815170       250219","","126.5","","383057.74"
"2025-02-22","2025-02-20","SF FuneralF838770       250220","","126.5","","383184.24"
"2025-02-22","2025-02-21","SF FuneralFDC00000005RZ8250221","","126.5","","383310.74"
"2025-02-22","2025-02-21","SF FuneralFDC000000080TP250221","","126.5","","383437.24"
"2025-02-22","2025-02-21","SF FuneralFDC0000000HRQH250222","","126.5","","383563.74"
"2025-02-22","2025-02-21","SF FuneralF1118195      250221","","126.5","","383690.24"
"2025-02-22","2025-02-17","SF FuneralF1084895      250217","","126.5","","383816.74"
"2025-02-22","2025-02-18","SF FuneralFDC00000006B9G250218","","31.63","","383848.37"
"2025-02-22","2025-02-18","SF FuneralF1016973      250218","","31.63","","383880"
"2025-02-22","2025-02-18","SF FuneralF1022184      250218","","31.63","","383911.63"
"2025-02-22","2025-02-18","SF FuneralF1110349      250218","","31.63","","383943.26"
"2025-02-22","2025-02-18","SF FuneralF1118994      250218","","63.25","","384006.51"
"2025-02-22","2025-02-18","SF FuneralF1123619      250218","","63.25","","384069.76"
"2025-02-22","2025-02-13","SF FuneralF821468       250213","","126.5","","384196.26"
"2025-02-22","2025-02-21","SF FuneralFDC000000070HM250221","","63.25","","384259.51"
"2025-02-22","2025-02-21","SF FuneralF798583       250221","","31.63","","384291.14"
"2025-02-22","2025-02-19","SF FuneralF819230       250219","","126.5","","384417.64"
"2025-02-22","2025-02-20","SF FuneralF1123292      250220","","126.5","","384544.14"
"2025-02-22","2025-02-22","SF FuneralFDC00000007KR2250222","","126.5","","384670.64"
"2025-02-22","2025-02-22","SF FuneralF1108398      250222","","126.5","","384797.14"
"2025-02-22","2025-02-17","SF FuneralF1119102      250217","","63.25","","384860.39"
"2025-02-22","2025-02-19","SF FuneralF828217       250219","","126.5","","384986.89"
"2025-02-22","2025-02-20","SF FuneralF840625       250220","","126.5","","385113.39"
"2025-02-22","2025-02-20","SF FuneralF989215       250220","","126.5","","385239.89"
"2025-02-22","2025-02-20","SF FuneralF1079631      250220","","31.63","","385271.52"
"2025-02-22","2025-02-18","SF FuneralFDC00000007CQV250218","","31.63","","385303.15"
"2025-02-22","2025-02-18","SF FuneralF812669       250218","","63.25","","385366.4"
"2025-02-22","2025-02-18","SF FuneralF1054884      250218","","31.63","","385398.03"
"2025-02-22","2025-02-18","SF FuneralF1116013      250218","","126.5","","385524.53"
"2025-02-22","2025-02-18","SF FuneralFDC0000000NN7N250218","","31.63","","385556.16"
"2025-02-22","2025-02-18","SF FuneralF1130344      250218","","31.63","","385587.79"
"2025-02-22","2025-02-18","SF FuneralF1130991      250218","","31.63","","385619.42"
"2025-02-22","2025-02-17","SF FuneralFDC00000006CXK250217","","126.5","","385745.92"
"2025-02-22","2025-02-17","SF FuneralF1061614      250217","","126.5","","385872.42"
"2025-02-22","2025-02-18","SF FuneralF822239       250218","","31.63","","385904.05"
"2025-02-22","2025-02-18","SF FuneralF1122750      250218","","31.63","","385935.68"
"2025-02-22","2025-02-18","SF FuneralF1130346      250218","","31.63","","385967.31"
"2025-02-22","2025-02-18","SF FuneralF1131657      250218","","31.63","","385998.94"
"2025-02-22","2025-02-19","SF FuneralFDC000000063F4250219","","126.5","","386125.44"
"2025-02-22","2025-02-19","SF FuneralF819349       250219","","126.5","","386251.94"
"2025-02-22","2025-02-20","SF FuneralFDC00000005ZQ2250220","","126.5","","386378.44"
"2025-02-22","2025-02-21","SF FuneralF990280       250222","","126.5","","386504.94"
"2025-02-22","2025-02-22","SF FuneralFDC00000005ZLL250222","","126.5","","386631.44"
"2025-02-22","2025-02-22","SF FuneralFDC000000061LQ250222","","126.5","","386757.94"
"2025-02-22","2025-02-22","SF FuneralFDC000000061ML250222","","126.5","","386884.44"
"2025-02-22","2025-02-22","SF FuneralFDC0000000624R250222","","126.5","","387010.94"
"2025-02-22","2025-02-22","SF FuneralFDC000000063D4250222","","126.5","","387137.44"
"2025-02-22","2025-02-22","SF FuneralFDC000000064X8250222","","126.5","","387263.94"
"2025-02-22","2025-02-22","SF FuneralFDC00000006563250222","","126.5","","387390.44"
"2025-02-22","2025-02-22","SF FuneralFDC0000000691X250222","","126.5","","387516.94"
"2025-02-22","2025-02-22","SF FuneralFDC00000006QWK250222","","126.5","","387643.44"
"2025-02-22","2025-02-22","SF FuneralFDC00000006ZTG250222","","126.5","","387769.94"
"2025-02-22","2025-02-22","SF FuneralFDC000000073YH250222","","126.5","","387896.44"
"2025-02-22","2025-02-22","SF FuneralFDC00000007DCG250222","","126.5","","388022.94"
"2025-02-22","2025-02-22","SF FuneralFDC00000007NYY250222","","126.5","","388149.44"
"2025-02-22","2025-02-22","SF FuneralF801394       250222","","126.5","","388275.94"
"2025-02-22","2025-02-22","SF FuneralFDC00000008PKS250222","","126.5","","388402.44"
"2025-02-22","2025-02-22","SF FuneralFDC00000008SFD250222","","126.5","","388528.94"
"2025-02-22","2025-02-22","SF FuneralF804917       250222","","126.5","","388655.44"
"2025-02-22","2025-02-22","SF FuneralF814422       250222","","126.5","","388781.94"
"2025-02-22","2025-02-22","SF FuneralF816104       250222","","126.5","","388908.44"
"2025-02-22","2025-02-22","SF FuneralF823445       250222","","126.5","","389034.94"
"2025-02-22","2025-02-22","SF FuneralF823566       250222","","126.5","","389161.44"
"2025-02-22","2025-02-22","SF FuneralF842445       250222","","126.5","","389287.94"
"2025-02-22","2025-02-22","SF FuneralF992442       250222","","126.5","","389414.44"
"2025-02-22","2025-02-22","SF FuneralF1052763      250223","","126.5","","389540.94"
"2025-02-22","2025-02-22","SF FuneralF1052929      250222","","126.5","","389667.44"
"2025-02-22","2025-02-22","SF FuneralF1112025      250222","","126.5","","389793.94"
"2025-02-22","2025-02-22","SF FuneralF1116766      250222","","126.5","","389920.44"
"2025-02-22","2025-02-22","SF FuneralF1118051      250222","","126.5","","390046.94"
"2025-02-22","2025-02-22","SF FuneralF1120141      250222","","126.5","","390173.44"
"2025-02-22","2025-02-22","SF FuneralF1123228      250222","","126.5","","390299.94"
"2025-02-22","2025-02-22","SF FuneralF1125746      250222","","126.5","","390426.44"
"2025-02-22","2025-02-22","SF FuneralF1130472      250222","","126.5","","390552.94"
"2025-02-22","2025-02-22","SF FuneralF1131885      250222","","126.5","","390679.44"
"2025-02-22","2025-02-22","SF FuneralFDC00000004GMZ250222","","220","","390899.44"
"2025-02-22","2025-02-22","SF FuneralFDC00000005951250222","","256.5","","391155.94"
"2025-02-22","2025-02-22","SF FuneralFDC00000005RMS250222","","126.5","","391282.44"
"2025-02-22","2025-02-22","SF FuneralFDC00000005WY0250222","","126.5","","391408.94"
"2025-02-22","2025-02-22","SF FuneralFDC0000000606N250222","","126.5","","391535.44"
"2025-02-22","2025-02-22","SF FuneralFDC00000006222250222","","126.5","","391661.94"
"2025-02-22","2025-02-22","SF FuneralFDC0000000640S250222","","126.5","","391788.44"
"2025-02-22","2025-02-22","SF FuneralFDC000000067S8250222","","126.5","","391914.94"
"2025-02-22","2025-02-22","SF FuneralFDC00000006KKS250222","","126.5","","392041.44"
"2025-02-22","2025-02-22","SF FuneralFDC00000007C1G250222","","256.5","","392297.94"
"2025-02-22","2025-02-22","SF FuneralFDC00000007KRY250222","","126.5","","392424.44"
"2025-02-22","2025-02-22","SF FuneralF795057       250222","","126.5","","392550.94"
"2025-02-22","2025-02-22","SF FuneralFDC00000007W4F250222","","126.5","","392677.44"
"2025-02-22","2025-02-22","SF FuneralFDC00000007X00250222","","126.5","","392803.94"
"2025-02-22","2025-02-22","SF FuneralFDC00000008L2W250222","","126.5","","392930.44"
"2025-02-22","2025-02-22","SF FuneralF803725       250222","","126.5","","393056.94"
"2025-02-22","2025-02-22","SF FuneralFDC00000008TZ1250222","","126.5","","393183.44"
"2025-02-22","2025-02-22","SF FuneralF778535       250222","","126.5","","393309.94"
"2025-02-22","2025-02-22","SF FuneralF822624       250222","","126.5","","393436.44"
"2025-02-22","2025-02-22","SF FuneralF842497       250222","","126.5","","393562.94"
"2025-02-22","2025-02-22","SF FuneralFDC0000000JVQC250222","","126.5","","393689.44"
"2025-02-22","2025-02-22","SF FuneralF1033874      250223","","126.5","","393815.94"
"2025-02-22","2025-02-22","SF FuneralF1060707      250222","","126.5","","393942.44"
"2025-02-22","2025-02-22","SF FuneralF1066388      250222","","126.5","","394068.94"
"2025-02-22","2025-02-22","SF FuneralFDC0000000KXVC250223","","126.5","","394195.44"
"2025-02-22","2025-02-22","SF FuneralF1072856      250223","","31.63","","394227.07"
"2025-02-22","2025-02-22","SF FuneralF1078520      250222","","126.5","","394353.57"
"2025-02-22","2025-02-22","SF FuneralF1094338      250222","","126.5","","394480.07"
"2025-02-22","2025-02-22","SF FuneralF1108380      250222","","126.5","","394606.57"
"2025-02-22","2025-02-22","SF FuneralF1109891      250222","","126.5","","394733.07"
"2025-02-22","2025-02-22","SF FuneralFDC0000000NCZJ250222","","126.5","","394859.57"
"2025-02-22","2025-02-22","SF FuneralF1118426      250222","","126.5","","394986.07"
"2025-02-22","2025-02-22","SF FuneralF1118518      250222","","126.5","","395112.57"
"2025-02-22","2025-02-22","SF FuneralF1118947      250222","","126.5","","395239.07"
"2025-02-22","2025-02-22","SF FuneralF1120783      250222","","126.5","","395365.57"
"2025-02-22","2025-02-22","SF FuneralF1120805      250222","","126.5","","395492.07"
"2025-02-22","2025-02-22","SF FuneralF1120753      250222","","126.5","","395618.57"
"2025-02-22","2025-02-22","SF FuneralF1127325      250222","","126.5","","395745.07"
"2025-02-22","2025-02-22","SF FuneralF1127619      250222","","126.5","","395871.57"
"2025-02-22","2025-02-22","SF FuneralF1128886      250222","","126.5","","395998.07"
"2025-02-22","2025-02-22","SF FuneralFDC000000031GC250222","","220","","396218.07"
"2025-02-22","2025-02-22","SF FuneralFDC000000043MT250222","","220","","396438.07"
"2025-02-22","2025-02-22","SF FuneralFDC00000005KGX250222","","126.5","","396564.57"
"2025-02-22","2025-02-22","SF FuneralFDC0000000614P250222","","126.5","","396691.07"
"2025-02-22","2025-02-22","SF FuneralFDC0000000668B250222","","126.5","","396817.57"
"2025-02-22","2025-02-22","SF FuneralFDC00000007098250222","","126.5","","396944.07"
"2025-02-22","2025-02-22","SF FuneralFDC000000073LP250222","","126.5","","397070.57"
"2025-02-22","2025-02-22","SF FuneralFDC000000074CL250222","","126.5","","397197.07"
"2025-02-22","2025-02-22","SF FuneralFDC000000077ZW250222","","126.5","","397323.57"
"2025-02-22","2025-02-22","SF FuneralFDC00000007HTV250222","","126.5","","397450.07"
"2025-02-22","2025-02-22","SF FuneralFDC00000007J5L250222","","126.5","","397576.57"
"2025-02-22","2025-02-22","SF FuneralFDC00000007MDC250222","","126.5","","397703.07"
"2025-02-22","2025-02-22","SF FuneralF803329       250222","","126.5","","397829.57"
"2025-02-22","2025-02-22","SF FuneralF805891       250222","","126.5","","397956.07"
"2025-02-22","2025-02-22","SF FuneralF811210       250222","","126.5","","398082.57"
"2025-02-22","2025-02-22","SF FuneralF816117       250222","","126.5","","398209.07"
"2025-02-22","2025-02-22","SF FuneralF841916       250222","","126.5","","398335.57"
"2025-02-22","2025-02-22","SF FuneralF993651       250222","","126.5","","398462.07"
"2025-02-22","2025-02-22","SF FuneralF1020598      250222","","126.5","","398588.57"
"2025-02-22","2025-02-22","SF FuneralF1078516      250222","","126.5","","398715.07"
"2025-02-22","2025-02-22","SF FuneralF1079389      250222","","126.5","","398841.57"
"2025-02-22","2025-02-22","SF FuneralF1108592      250222","","126.5","","398968.07"
"2025-02-22","2025-02-22","SF FuneralFDC0000000NFD3250222","","126.5","","399094.57"
"2025-02-22","2025-02-22","SF FuneralF1125279      250222","","126.5","","399221.07"
"2025-02-22","2025-02-22","SF FuneralFDC0000000PS37250222","","126.5","","399347.57"
"2025-02-22","2025-02-22","SF FuneralF1129023      250223","","126.5","","399474.07"
"2025-02-22","2025-02-13","SF FuneralFDC00000005YHY250213","","126.5","","399600.57"
"2025-02-22","2025-02-17","SF FuneralFDC00000007HBL250217","","126.5","","399727.07"
"2025-02-22","2025-02-16","SF FuneralFDC00000008V16250216","","126.5","","399853.57"
"2025-02-22","2025-02-18","SF FuneralFDC00000002XZF250218","","110","","399963.57"
"2025-02-22","2025-02-18","SF FuneralFDC0000000804H250218","","126.5","","400090.07"
"2025-02-22","2025-02-18","SF FuneralF815591       250218","","126.5","","400216.57"
"2025-02-22","2025-02-18","SF FuneralF831106       250218","","31.63","","400248.2"
"2025-02-22","2025-02-18","SF FuneralF1068221      250218","","31.63","","400279.83"
"2025-02-22","2025-02-20","SF FuneralF821684       250220","","126.5","","400406.33"
"2025-02-22","2025-02-20","SF FuneralF844722       250220","","126.5","","400532.83"
"2025-02-22","2025-02-21","SF FuneralFDC00000008BC1250221","","126.5","","400659.33"
"2025-02-22","2025-02-21","SF FuneralF987226       250222","","126.5","","400785.83"
"2025-02-22","2025-02-22","SF FuneralFDC00000002Q5G250222","","220","","401005.83"
"2025-02-22","2025-02-22","SF FuneralFDC00000003153250222","","220","","401225.83"
"2025-02-22","2025-02-22","SF FuneralFDC000000032NM250222","","220","","401445.83"
"2025-02-22","2025-02-22","SF FuneralFDC000000061X6250222","","126.5","","401572.33"
"2025-02-22","2025-02-22","SF FuneralFDC00000006K8B250222","","126.5","","401698.83"
"2025-02-22","2025-02-22","SF FuneralFDC00000006XF8250222","","126.5","","401825.33"
"2025-02-22","2025-02-22","SF FuneralFDC00000006Y5P250222","","126.5","","401951.83"
"2025-02-22","2025-02-22","SF FuneralFDC00000006TZS250222","","126.5","","402078.33"
"2025-02-22","2025-02-22","SF FuneralFDC00000007TDT250222","","126.5","","402204.83"
"2025-02-22","2025-02-22","SF FuneralFDC00000008VW9250222","","126.5","","402331.33"
"2025-02-22","2025-02-22","SF FuneralF805921       250222","","126.5","","402457.83"
"2025-02-22","2025-02-22","SF FuneralF818868       250222","","126.5","","402584.33"
"2025-02-22","2025-02-22","SF FuneralF820022       250222","","126.5","","402710.83"
"2025-02-22","2025-02-22","SF FuneralFDC0000000C0PL250222","","126.5","","402837.33"
"2025-02-22","2025-02-22","SF FuneralF832472       250222","","126.5","","402963.83"
"2025-02-22","2025-02-22","SF FuneralFDC0000000DBRB250222","","126.5","","403090.33"
"2025-02-22","2025-02-22","SF FuneralFDC0000000DBRD250222","","126.5","","403216.83"
"2025-02-22","2025-02-22","SF FuneralF1020601      250222","","31.63","","403248.46"
"2025-02-22","2025-02-22","SF FuneralFDC0000000JZDF250222","","126.5","","403374.96"
"2025-02-22","2025-02-22","SF FuneralF1054957      250222","","126.5","","403501.46"
"2025-02-22","2025-02-22","SF FuneralF1108337      250222","","126.5","","403627.96"
"2025-02-22","2025-02-22","SF FuneralF1108942      250222","","126.5","","403754.46"
"2025-02-22","2025-02-22","SF FuneralF1115048      250222","","126.5","","403880.96"
"2025-02-22","2025-02-22","SF FuneralF1117394      250223","","126.5","","404007.46"
"2025-02-22","2025-02-22","SF FuneralF1118004      250223","","126.5","","404133.96"
"2025-02-22","2025-02-22","SF FuneralF1118642      250222","","126.5","","404260.46"
"2025-02-22","2025-02-22","SF FuneralF1119009      250222","","126.5","","404386.96"
"2025-02-22","2025-02-22","SF FuneralFDC0000000PBQS250222","","126.5","","404513.46"
"2025-02-22","2025-02-22","SF FuneralFDC0000000Q1CK250222","","126.5","","404639.96"
"2025-02-22","2025-02-22","SF FuneralF1132368      250222","","126.5","","404766.46"
"2025-02-22","2025-02-22","SF FuneralF1132457      250222","","126.5","","404892.96"
"2025-02-22","2025-02-21","SF FuneralFDC0000000D8BK250221","","126.5","","405019.46"
"2025-02-22","2025-02-21","SF FuneralF981670       250221","","31.63","","405051.09"
"2025-02-22","2025-02-21","SF FuneralF993478       250221","","31.63","","405082.72"
"2025-02-22","2025-02-22","SF FuneralFDC00000007GR6250222","","31.63","","405114.35"
"2025-02-22","2025-02-22","SF FuneralFDC00000007VKH250222","","31.63","","405145.98"
"2025-02-22","2025-02-22","SF FuneralFDC000000086GN250222","","126.5","","405272.48"
"2025-02-22","2025-02-22","SF FuneralFDC000000086P0250222","","126.5","","405398.98"
"2025-02-22","2025-02-22","SF FuneralFDC0000000KH3D250223","","31.63","","405430.61"
"2025-02-22","2025-02-22","SF FuneralF1084539      250223","","31.63","","405462.24"
"2025-02-22","2025-02-17","SF FuneralFDC0000000F7T2250217","","31.63","","405493.87"
"2025-02-22","2025-02-18","SF FuneralF834882       250218","","31.63","","405525.5"
"2025-02-22","2025-02-18","SF FuneralF1104234      250218","","31.63","","405557.13"
"2025-02-22","2025-02-21","SF FuneralFDC00000007Q48250221","","31.63","","405588.76"
"2025-02-22","2025-02-22","SF FuneralF1120593      250223","","31.63","","405620.39"
"2025-02-22","2025-02-22","SF FuneralFDC000000030J1250222","","220","","405840.39"
"2025-02-22","2025-02-22","SF FuneralFDC000000059HX250222","","126.5","","405966.89"
"2025-02-22","2025-02-22","SF FuneralFDC00000005FWB250222","","126.5","","406093.39"
"2025-02-22","2025-02-22","SF FuneralFDC00000005RK6250222","","126.5","","406219.89"
"2025-02-22","2025-02-22","SF FuneralFDC000000061V4250222","","126.5","","406346.39"
"2025-02-22","2025-02-22","SF FuneralFDC000000062H2250222","","126.5","","406472.89"
"2025-02-22","2025-02-22","SF FuneralFDC00000006ZR6250222","","126.5","","406599.39"
"2025-02-22","2025-02-22","SF FuneralFDC0000000757K250222","","126.5","","406725.89"
"2025-02-22","2025-02-22","SF FuneralFDC0000000770G250222","","126.5","","406852.39"
"2025-02-22","2025-02-22","SF FuneralFDC0000000794N250222","","126.5","","406978.89"
"2025-02-22","2025-02-22","SF FuneralFDC00000007JZ3250222","","126.5","","407105.39"
"2025-02-22","2025-02-22","SF FuneralFDC00000008190250222","","126.5","","407231.89"
"2025-02-22","2025-02-22","SF FuneralFDC000000087MB250222","","126.5","","407358.39"
"2025-02-22","2025-02-22","SF FuneralFDC00000008CDL250222","","126.5","","407484.89"
"2025-02-22","2025-02-22","SF FuneralFDC00000008JXM250222","","126.5","","407611.39"
"2025-02-22","2025-02-22","SF FuneralFDC00000008LJ9250222","","126.5","","407737.89"
"2025-02-22","2025-02-22","SF FuneralF805453       250222","","126.5","","407864.39"
"2025-02-22","2025-02-22","SF FuneralFDC00000009R9J250222","","126.5","","407990.89"
"2025-02-22","2025-02-22","SF FuneralF823287       250222","","126.5","","408117.39"
"2025-02-22","2025-02-22","SF FuneralFDC0000000CY83250222","","126.5","","408243.89"
"2025-02-22","2025-02-22","SF FuneralF779782       250222","","126.5","","408370.39"
"2025-02-22","2025-02-22","SF FuneralF1078466      250222","","126.5","","408496.89"
"2025-02-22","2025-02-22","SF FuneralF1084029      250222","","126.5","","408623.39"
"2025-02-22","2025-02-22","SF FuneralF1102943      250222","","126.5","","408749.89"
"2025-02-22","2025-02-22","SF FuneralFDC0000000MK28250222","","126.5","","408876.39"
"2025-02-22","2025-02-22","SF FuneralFDC0000000MWR3250222","","126.5","","409002.89"
"2025-02-22","2025-02-22","SF FuneralF1112433      250222","","126.5","","409129.39"
"2025-02-22","2025-02-22","SF FuneralFDC0000000NJ5J250222","","126.5","","409255.89"
"2025-02-22","2025-02-22","SF FuneralF1118392      250222","","126.5","","409382.39"
"2025-02-22","2025-02-22","SF FuneralF1122849      250222","","126.5","","409508.89"
"2025-02-22","2025-02-22","SF FuneralF1130340      250222","","126.5","","409635.39"
"2025-02-22","2025-02-22","SF FuneralF1131785      250222","","126.5","","409761.89"
"2025-02-22","2025-02-22","SF FuneralFDC0000000Q6QQ250222","","126.5","","409888.39"
"2025-02-22","2025-02-20","SF FuneralF1072895      250220","","126.5","","410014.89"
"2025-02-22","2025-02-21","SF FuneralF1100806      250221","","126.5","","410141.39"
"2025-02-22","2025-02-22","SF FuneralFDC000000034JT250222","","220","","410361.39"
"2025-02-22","2025-02-22","SF FuneralFDC00000005S2X250222","","126.5","","410487.89"
"2025-02-22","2025-02-22","SF FuneralFDC00000005S4B250222","","126.5","","410614.39"
"2025-02-22","2025-02-22","SF FuneralFDC00000005Z4G250222","","126.5","","410740.89"
"2025-02-22","2025-02-22","SF FuneralFDC0000000672M250222","","126.5","","410867.39"
"2025-02-22","2025-02-22","SF FuneralFDC00000006XD5250222","","126.5","","410993.89"
"2025-02-22","2025-02-22","SF FuneralFDC00000006Z4M250222","","126.5","","411120.39"
"2025-02-22","2025-02-22","SF FuneralFDC00000006Z4R250222","","126.5","","411246.89"
"2025-02-22","2025-02-22","SF FuneralF797664       250222","","126.5","","411373.39"
"2025-02-22","2025-02-22","SF FuneralFDC00000008GNM250222","","126.5","","411499.89"
"2025-02-22","2025-02-22","SF FuneralF818521       250222","","126.5","","411626.39"
"2025-02-22","2025-02-22","SF FuneralF823489       250222","","126.5","","411752.89"
"2025-02-22","2025-02-22","SF FuneralF833099       250222","","126.5","","411879.39"
"2025-02-22","2025-02-22","SF FuneralF842700       250222","","126.5","","412005.89"
"2025-02-22","2025-02-22","SF FuneralF993092       250223","","126.5","","412132.39"
"2025-02-22","2025-02-22","SF FuneralF1054490      250222","","126.5","","412258.89"
"2025-02-22","2025-02-22","SF FuneralF1058783      250222","","126.5","","412385.39"
"2025-02-22","2025-02-22","SF FuneralFDC0000000L6BZ250222","","191.5","","412576.89"
"2025-02-22","2025-02-22","SF FuneralF1085118      250222","","126.5","","412703.39"
"2025-02-22","2025-02-22","SF FuneralF1085147      250222","","126.5","","412829.89"
"2025-02-22","2025-02-22","SF FuneralF1108053      250222","","126.5","","412956.39"
"2025-02-22","2025-02-22","SF FuneralF1108168      250222","","126.5","","413082.89"
"2025-02-22","2025-02-22","SF FuneralFDC0000000MCXM250222","","126.5","","413209.39"
"2025-02-22","2025-02-22","SF FuneralFDC0000000MGMY250222","","126.5","","413335.89"
"2025-02-22","2025-02-22","SF FuneralFDC0000000MLM6250222","","126.5","","413462.39"
"2025-02-22","2025-02-22","SF FuneralFDC0000000N80P250222","","126.5","","413588.89"
"2025-02-22","2025-02-22","SF FuneralF1115816      250222","","126.5","","413715.39"
"2025-02-22","2025-02-22","SF FuneralF1118891      250222","","126.5","","413841.89"
"2025-02-22","2025-02-22","SF FuneralF1120218      250222","","126.5","","413968.39"
"2025-02-22","2025-02-22","SF FuneralF1122675      250222","","126.5","","414094.89"
"2025-02-22","2025-02-22","SF FuneralF1130914      250222","","126.5","","414221.39"
"2025-02-22","2025-02-13","SF FuneralFDC000000061C9250213","","63.25","","414284.64"
"2025-02-22","2025-02-17","SF FuneralF843944       250217","","63.25","","414347.89"
"2025-02-22","2025-02-18","SF FuneralF1073139      250218","","63.25","","414411.14"
"2025-02-22","2025-02-21","SF FuneralFDC0000000D3F5250221","","126.5","","414537.64"
"2025-02-22","2025-02-22","SF FuneralFDC000000058N5250222","","126.5","","414664.14"
"2025-02-22","2025-02-22","SF FuneralFDC00000005ZVW250222","","126.5","","414790.64"
"2025-02-22","2025-02-22","SF FuneralFDC00000005ZWV250222","","126.5","","414917.14"
"2025-02-22","2025-02-22","SF FuneralFDC000000060XP250222","","126.5","","415043.64"
"2025-02-22","2025-02-22","SF FuneralFDC000000061V9250222","","126.5","","415170.14"
"2025-02-22","2025-02-22","SF FuneralFDC00000006539250222","","126.5","","415296.64"
"2025-02-22","2025-02-22","SF FuneralFDC00000006NG2250222","","126.5","","415423.14"
"2025-02-22","2025-02-22","SF FuneralFDC00000006P7X250222","","191.5","","415614.64"
"2025-02-22","2025-02-22","SF FuneralFDC0000000757M250222","","126.5","","415741.14"
"2025-02-22","2025-02-22","SF FuneralF799323       250222","","126.5","","415867.64"
"2025-02-22","2025-02-22","SF FuneralF802341       250222","","126.5","","415994.14"
"2025-02-22","2025-02-22","SF FuneralF805170       250222","","126.5","","416120.64"
"2025-02-22","2025-02-22","SF FuneralF812664       250222","","126.5","","416247.14"
"2025-02-22","2025-02-22","SF FuneralFDC00000009N16250222","","126.5","","416373.64"
"2025-02-22","2025-02-22","SF FuneralF808693       250222","","126.5","","416500.14"
"2025-02-22","2025-02-22","SF FuneralFDC00000009NWR250222","","126.5","","416626.64"
"2025-02-22","2025-02-22","SF FuneralF817661       250222","","126.5","","416753.14"
"2025-02-22","2025-02-22","SF FuneralF818302       250222","","126.5","","416879.64"
"2025-02-22","2025-02-22","SF FuneralF993052       250222","","126.5","","417006.14"
"2025-02-22","2025-02-22","SF FuneralF1020500      250222","","126.5","","417132.64"
"2025-02-22","2025-02-22","SF FuneralF1054927      250222","","126.5","","417259.14"
"2025-02-22","2025-02-22","SF FuneralF1054937      250222","","126.5","","417385.64"
"2025-02-22","2025-02-22","SF FuneralF1055203      250222","","126.5","","417512.14"
"2025-02-22","2025-02-22","SF FuneralFDC0000000L7G2250222","","126.5","","417638.64"
"2025-02-22","2025-02-22","SF FuneralF1108099      250222","","126.5","","417765.14"
"2025-02-22","2025-02-22","SF FuneralFDC0000000NY0F250222","","126.5","","417891.64"
"2025-02-22","2025-02-22","SF FuneralFDC0000000PB79250222","","126.5","","418018.14"
"2025-02-22","2025-02-22","SF FuneralF1128246      250222","","126.5","","418144.64"
"2025-02-22","2025-02-22","SF FuneralF1128704      250222","","126.5","","418271.14"
"2025-02-22","2025-02-22","SF FuneralF1132331      250222","","126.5","","418397.64"
"2025-02-22","2025-02-15","SF FuneralF1118895      250215","","126.5","","418524.14"
"2025-02-22","2025-02-21","SF FuneralF981088       250223","","126.5","","418650.64"
"2025-02-22","2025-02-22","SF FuneralFDC00000005427250222","","126.5","","418777.14"
"2025-02-22","2025-02-22","SF FuneralFDC00000005Q18250222","","126.5","","418903.64"
"2025-02-22","2025-02-22","SF FuneralFDC00000005R26250222","","126.5","","419030.14"
"2025-02-22","2025-02-22","SF FuneralFDC00000005ZVF250222","","126.5","","419156.64"
"2025-02-22","2025-02-22","SF FuneralFDC000000062VN250222","","126.5","","419283.14"
"2025-02-22","2025-02-22","SF FuneralFDC0000000636B250222","","126.5","","419409.64"
"2025-02-22","2025-02-22","SF FuneralFDC000000082JV250222","","126.5","","419536.14"
"2025-02-22","2025-02-22","SF FuneralF797656       250222","","126.5","","419662.64"
"2025-02-22","2025-02-22","SF FuneralFDC0000000834F250222","","126.5","","419789.14"
"2025-02-22","2025-02-22","SF FuneralF813314       250222","","126.5","","419915.64"
"2025-02-22","2025-02-22","SF FuneralF820457       250222","","126.5","","420042.14"
"2025-02-22","2025-02-22","SF FuneralF1052923      250222","","126.5","","420168.64"
"2025-02-22","2025-02-22","SF FuneralF1054629      250222","","126.5","","420295.14"
"2025-02-22","2025-02-22","SF FuneralFDC0000000KDK6250222","","126.5","","420421.64"
"2025-02-22","2025-02-22","SF FuneralFDC0000000KXSZ250222","","126.5","","420548.14"
"2025-02-22","2025-02-22","SF FuneralF1067921      250222","","126.5","","420674.64"
"2025-02-22","2025-02-22","SF FuneralFDC0000000NHLX250222","","126.5","","420801.14"
"2025-02-22","2025-02-22","SF FuneralF1120124      250222","","126.5","","420927.64"
"2025-02-22","2025-02-22","SF FuneralF1126267      250222","","126.5","","421054.14"
"2025-02-22","2025-02-22","SF FuneralF1127899      250222","","126.5","","421180.64"
"2025-02-22","2025-02-22","SF FuneralF1130787      250222","","126.5","","421307.14"
"2025-02-22","2025-02-21","SF FuneralF981027       250221","","126.5","","421433.64"
"2025-02-22","2025-02-22","SF FuneralFDC000000060NF250222","","126.5","","421560.14"
"2025-02-22","2025-02-22","SF FuneralFDC0000000616Y250222","","126.5","","421686.64"
"2025-02-22","2025-02-22","SF FuneralFDC00000006JZM250222","","126.5","","421813.14"
"2025-02-22","2025-02-22","SF FuneralFDC00000006TBH250222","","126.5","","421939.64"
"2025-02-22","2025-02-22","SF FuneralFDC000000080FN250222","","126.5","","422066.14"
"2025-02-22","2025-02-22","SF FuneralFDC00000008HGX250222","","126.5","","422192.64"
"2025-02-22","2025-02-22","SF FuneralFDC00000008HH0250222","","126.5","","422319.14"
"2025-02-22","2025-02-22","SF FuneralF811136       250222","","126.5","","422445.64"
"2025-02-22","2025-02-22","SF FuneralF821169       250222","","126.5","","422572.14"
"2025-02-22","2025-02-22","SF FuneralF823774       250222","","126.5","","422698.64"
"2025-02-22","2025-02-22","SF FuneralF833141       250222","","126.5","","422825.14"
"2025-02-22","2025-02-22","SF FuneralF833804       250222","","126.5","","422951.64"
"2025-02-22","2025-02-22","SF FuneralF1074728      250223","","126.5","","423078.14"
"2025-02-22","2025-02-22","SF FuneralF1074868      250222","","126.5","","423204.64"
"2025-02-22","2025-02-22","SF FuneralF1083982      250222","","126.5","","423331.14"
"2025-02-22","2025-02-22","SF FuneralF1084261      250222","","126.5","","423457.64"
"2025-02-22","2025-02-22","SF FuneralF1084932      250222","","126.5","","423584.14"
"2025-02-22","2025-02-22","SF FuneralF1084969      250222","","126.5","","423710.64"
"2025-02-22","2025-02-22","SF FuneralF1112455      250223","","126.5","","423837.14"
"2025-02-22","2025-02-22","SF FuneralF1117300      250222","","126.5","","423963.64"
"2025-02-22","2025-02-22","SF FuneralF1127423      250223","","126.5","","424090.14"
"2025-02-22","2025-02-22","SF FuneralF1130777      250222","","126.5","","424216.64"
"2025-02-22","2025-02-21","SF FuneralF1073750      250221","","126.5","","424343.14"
"2025-02-22","2025-02-22","SF FuneralFDC00000005K72250222","","220","","424563.14"
"2025-02-22","2025-02-22","SF FuneralFDC00000005P39250222","","126.5","","424689.64"
"2025-02-22","2025-02-22","SF FuneralFDC00000005XSP250222","","126.5","","424816.14"
"2025-02-22","2025-02-22","SF FuneralFDC00000005YF6250222","","126.5","","424942.64"
"2025-02-22","2025-02-22","SF FuneralFDC00000005Z1Q250222","","126.5","","425069.14"
"2025-02-22","2025-02-22","SF FuneralFDC000000060LY250222","","126.5","","425195.64"
"2025-02-22","2025-02-22","SF FuneralFDC00000006H2X250222","","126.5","","425322.14"
"2025-02-22","2025-02-22","SF FuneralFDC00000006H3V250222","","126.5","","425448.64"
"2025-02-22","2025-02-22","SF FuneralFDC00000006H8M250222","","126.5","","425575.14"
"2025-02-22","2025-02-22","SF FuneralFDC00000006SC8250222","","126.5","","425701.64"
"2025-02-22","2025-02-22","SF FuneralFDC00000006Y7W250222","","126.5","","425828.14"
"2025-02-22","2025-02-22","SF FuneralFDC00000007N5J250222","","126.5","","425954.64"
"2025-02-22","2025-02-22","SF FuneralF799648       250222","","126.5","","426081.14"
"2025-02-22","2025-02-22","SF FuneralF799881       250222","","126.5","","426207.64"
"2025-02-22","2025-02-22","SF FuneralF801333       250222","","126.5","","426334.14"
"2025-02-22","2025-02-22","SF FuneralF789371       250222","","126.5","","426460.64"
"2025-02-22","2025-02-22","SF FuneralF818133       250222","","126.5","","426587.14"
"2025-02-22","2025-02-22","SF FuneralF819429       250222","","126.5","","426713.64"
"2025-02-22","2025-02-22","SF FuneralF805500       250222","","126.5","","426840.14"
"2025-02-22","2025-02-22","SF FuneralF819977       250222","","126.5","","426966.64"
"2025-02-22","2025-02-22","SF FuneralF823871       250222","","126.5","","427093.14"
"2025-02-22","2025-02-22","SF FuneralF833892       250222","","126.5","","427219.64"
"2025-02-22","2025-02-22","SF FuneralF842893       250222","","126.5","","427346.14"
"2025-02-22","2025-02-22","SF FuneralF992669       250223","","126.5","","427472.64"
"2025-02-22","2025-02-22","SF FuneralF1017674      250222","","126.5","","427599.14"
"2025-02-22","2025-02-22","SF FuneralF1050827      250222","","126.5","","427725.64"
"2025-02-22","2025-02-22","SF FuneralF1054637      250222","","126.5","","427852.14"
"2025-02-22","2025-02-22","SF FuneralF1060612      250222","","126.5","","427978.64"
"2025-02-22","2025-02-22","SF FuneralF1061550      250222","","126.5","","428105.14"
"2025-02-22","2025-02-22","SF FuneralF1074989      250222","","126.5","","428231.64"
"2025-02-22","2025-02-22","SF FuneralF1075009      250223","","126.5","","428358.14"
"2025-02-22","2025-02-22","SF FuneralF1080374      250222","","126.5","","428484.64"
"2025-02-22","2025-02-22","SF FuneralFDC0000000LNMK250222","","126.5","","428611.14"
"2025-02-22","2025-02-22","SF FuneralF1080376      250222","","126.5","","428737.64"
"2025-02-22","2025-02-22","SF FuneralF1083678      250222","","126.5","","428864.14"
"2025-02-22","2025-02-22","SF FuneralF783858       250222","","256.5","","429120.64"
"2025-02-22","2025-02-22","SF FuneralF1110243      250223","","126.5","","429247.14"
"2025-02-22","2025-02-22","SF FuneralF1114411      250222","","126.5","","429373.64"
"2025-02-22","2025-02-22","SF FuneralF1114417      250223","","126.5","","429500.14"
"2025-02-22","2025-02-22","SF FuneralF1115863      250223","","126.5","","429626.64"
"2025-02-22","2025-02-22","SF FuneralFDC0000000NFC3250222","","126.5","","429753.14"
"2025-02-22","2025-02-22","SF FuneralF1117624      250223","","126.5","","429879.64"
"2025-02-22","2025-02-22","SF FuneralF1123070      250223","","126.5","","430006.14"
"2025-02-22","2025-02-22","SF FuneralF1125155      250222","","126.5","","430132.64"
"2025-02-22","2025-02-22","SF FuneralFDC0000000PFT6250222","","126.5","","430259.14"
"2025-02-22","2025-02-22","SF FuneralF1125805      250222","","126.5","","430385.64"
"2025-02-22","2025-02-22","SF FuneralF1126047      250222","","126.5","","430512.14"
"2025-02-22","2025-02-22","SF FuneralF1126871      250222","","126.5","","430638.64"
"2025-02-22","2025-02-22","SF FuneralFDC0000000PQYT250223","","126.5","","430765.14"
"2025-02-22","2025-02-22","SF FuneralF1131154      250222","","126.5","","430891.64"
"2025-02-22","2025-02-22","SF FuneralF1132814      250222","","126.5","","431018.14"
"2025-02-22","2025-02-22","SF FuneralFDC000000038N6250222","","220","","431238.14"
"2025-02-22","2025-02-22","SF FuneralFDC00000005YMV250222","","126.5","","431364.64"
"2025-02-22","2025-02-22","SF FuneralFDC000000063V6250222","","126.5","","431491.14"
"2025-02-22","2025-02-22","SF FuneralFDC000000064JW250222","","126.5","","431617.64"
"2025-02-22","2025-02-22","SF FuneralFDC00000006V08250222","","126.5","","431744.14"
"2025-02-22","2025-02-22","SF FuneralFDC00000007DK7250222","","126.5","","431870.64"
"2025-02-22","2025-02-22","SF FuneralFDC000000084Y7250222","","126.5","","431997.14"
"2025-02-22","2025-02-22","SF FuneralFDC00000008G73250222","","126.5","","432123.64"
"2025-02-22","2025-02-22","SF FuneralF809969       250222","","126.5","","432250.14"
"2025-02-22","2025-02-22","SF FuneralF828916       250222","","126.5","","432376.64"
"2025-02-22","2025-02-22","SF FuneralF840998       250222","","126.5","","432503.14"
"2025-02-22","2025-02-22","SF FuneralF1033800      250222","","126.5","","432629.64"
"2025-02-22","2025-02-22","SF FuneralF1065816      250222","","126.5","","432756.14"
"2025-02-22","2025-02-22","SF FuneralF1074579      250222","","126.5","","432882.64"
"2025-02-22","2025-02-22","SF FuneralF1117050      250223","","126.5","","433009.14"
"2025-02-22","2025-02-22","SF FuneralFDC0000000P9RQ250222","","126.5","","433135.64"
"2025-02-22","2025-02-22","SF FuneralFDC0000000P9RR250222","","126.5","","433262.14"
"2025-02-22","2025-02-22","SF FuneralF1124410      250222","","126.5","","433388.64"
"2025-02-22","2025-02-22","SF FuneralFDC00000006SQF250222","","126.5","","433515.14"
"2025-02-22","2025-02-22","SF FuneralF1119098      250222","","126.5","","433641.64"
"2025-02-22","2025-02-22","SF FuneralF1120114      250222","","126.5","","433768.14"
"2025-02-22","2025-02-18","Rev SF FuneralFDC00000005L57250218","","-31.63","","433736.51"
"2025-02-22","2025-02-21","Rev SF FuneralFDC00000007MW5250221","","-31.63","","433704.88"
"2025-02-22","2025-02-17","Rev SF FuneralFDC00000005NT1250217","","-31.63","","433673.25"
"2025-02-22","2025-02-17","Rev SF FuneralFDC000000069C5250217","","-31.63","","433641.62"
"2025-02-22","2025-02-22","Rev SF FuneralFDC0000000757M250222","","-126.5","","433515.12"
"2025-02-22","2025-02-22","Rev SF FuneralFDC0000000757K250222","","-126.5","","433388.62"
"2025-02-22","2025-02-17","Rev SF FuneralFDC00000008JTX250217","","-126.5","","433262.12"
"2025-02-22","2025-02-21","Rev SF FuneralFDC0000000MKXM250221","","-126.5","","433135.62"
"2025-02-22","2025-02-21","Rev SF FuneralFDC000000087Y5250221","","-126.5","","433009.12"
"2025-02-22","2025-02-21","Rev SF FuneralFDC0000000D8BK250221","","-126.5","","432882.62"
"2025-02-22","2025-02-12","Rev SF FuneralFDC00000007DLP250212","","-126.5","","432756.12"
"2025-02-22","2025-02-18","Rev SF FuneralFDC0000000MK76250218","","-63.25","","432692.87"
"2025-02-22","2025-02-12","Rev SF FuneralFDC000000043BW250212","","-220","","432472.87"
"2025-02-22","2025-02-12","Rev SF FuneralFDC0000000HJLD250212","","-126.5","","432346.37"
"2025-02-22","2025-02-18","Rev SF FuneralFDC000000076ZR250218","","-126.5","","432219.87"
"2025-02-22","2025-02-19","Rev SF FuneralFDC00000009F2S250219","","-126.5","","432093.37"
"2025-02-22","2025-02-19","Rev SF FuneralFDC000000087TZ250219","","-126.5","","431966.87"
"2025-02-22","2025-01-13","Rev SF FuneralFDC00000007DLP250112","","-126.5","","431840.37"
"2025-02-22","2025-02-19","Rev SF FuneralFDC000000087V0250219","","-126.5","","431713.87"
"2025-02-22","2025-02-19","Rev SF FuneralFDC00000008J7N250219","","-126.5","","431587.37"
"2025-02-22","2025-02-19","Rev SF FuneralFDC0000000P9YG250219","","-126.5","","431460.87"
"2025-02-22","2025-02-14","SF FuneralF831174       250214","","63.25","","431524.12"
"2025-02-22","2025-02-17","SF FuneralF833471       250217","","126.5","","431650.62"
"2025-02-22","2025-02-18","SF FuneralF833072       250218","","31.63","","431682.25"
"2025-02-22","2025-02-19","SF FuneralF840927       250219","","63.25","","431745.5"
"2025-02-22","2025-02-19","SF FuneralF842872       250219","","31.63","","431777.13"
"2025-02-22","2025-02-19","SF FuneralF1020962      250219","","126.5","","431903.63"
"2025-02-22","2025-02-19","SF FuneralF1129376      250219","","31.63","","431935.26"
"2025-02-22","2025-02-20","SF FuneralFDC0000000807N250220","","126.5","","432061.76"
"2025-02-22","2025-02-20","SF FuneralF981395       250220","","126.5","","432188.26"
"2025-02-22","2025-02-20","SF FuneralF993402       250220","","126.5","","432314.76"
"2025-02-22","2025-02-20","SF FuneralF1124561      250220","","126.5","","432441.26"
"2025-02-22","2025-02-21","SF FuneralFDC00000005YTT250221","","126.5","","432567.76"
"2025-02-22","2025-02-21","SF FuneralFDC000000071N5250221","","126.5","","432694.26"
"2025-02-22","2025-02-21","SF FuneralFDC00000007KS4250221","","126.5","","432820.76"
"2025-02-22","2025-02-21","SF FuneralFDC00000008NYM250221","","31.63","","432852.39"
"2025-02-22","2025-02-21","SF FuneralFDC0000000D8C4250221","","126.5","","432978.89"
"2025-02-22","2025-02-21","SF FuneralF993205       250221","","31.63","","433010.52"
"2025-02-22","2025-02-21","SF FuneralF1033704      250221","","31.63","","433042.15"
"2025-02-22","2025-02-22","SF FuneralFDC00000005KXR250222","","31.63","","433073.78"
"2025-02-22","2025-02-22","SF FuneralFDC00000005YG4250222","","126.5","","433200.28"
"2025-02-22","2025-02-22","SF FuneralFDC0000000697X250222","","126.5","","433326.78"
"2025-02-22","2025-02-22","SF FuneralFDC00000006ZWP250222","","126.5","","433453.28"
"2025-02-22","2025-02-22","SF FuneralFDC00000007JGY250222","","126.5","","433579.78"
"2025-02-22","2025-02-22","SF FuneralFDC00000008PQM250222","","126.5","","433706.28"
"2025-02-22","2025-02-22","SF FuneralF811513       250222","","126.5","","433832.78"
"2025-02-22","2025-02-22","SF FuneralF813701       250222","","126.5","","433959.28"
"2025-02-22","2025-02-22","SF FuneralF819630       250222","","126.5","","434085.78"
"2025-02-22","2025-02-22","SF FuneralF819999       250222","","126.5","","434212.28"
"2025-02-22","2025-02-22","SF FuneralF812543       250222","","126.5","","434338.78"
"2025-02-22","2025-02-22","SF FuneralF827633       250222","","126.5","","434465.28"
"2025-02-22","2025-02-22","SF FuneralFDC0000000BNCC250222","","126.5","","434591.78"
"2025-02-22","2025-02-22","SF FuneralFDC0000000JD04250222","","126.5","","434718.28"
"2025-02-22","2025-02-22","SF FuneralF1020821      250222","","126.5","","434844.78"
"2025-02-22","2025-02-22","SF FuneralF1022101      250222","","126.5","","434971.28"
"2025-02-22","2025-02-22","SF FuneralF1050863      250222","","126.5","","435097.78"
"2025-02-22","2025-02-22","SF FuneralF1052177      250222","","126.5","","435224.28"
"2025-02-22","2025-02-22","SF FuneralF1055069      250222","","126.5","","435350.78"
"2025-02-22","2025-02-22","SF FuneralF1055263      250222","","126.5","","435477.28"
"2025-02-22","2025-02-22","SF FuneralF819521       250222","","126.5","","435603.78"
"2025-02-22","2025-02-22","SF FuneralF1083847      250222","","126.5","","435730.28"
"2025-02-22","2025-02-22","SF FuneralF1108414      250222","","126.5","","435856.78"
"2025-02-22","2025-02-22","SF FuneralF1112006      250222","","126.5","","435983.28"
"2025-02-22","2025-02-22","SF FuneralF1115901      250222","","126.5","","436109.78"
"2025-02-22","2025-02-22","SF FuneralFDC0000000NL14250222","","126.5","","436236.28"
"2025-02-22","2025-02-22","SF FuneralF1120195      250222","","126.5","","436362.78"
"2025-02-22","2025-02-22","SF FuneralF1120208      250222","","126.5","","436489.28"
"2025-02-22","2025-02-22","SF FuneralF1120224      250222","","126.5","","436615.78"
"2025-02-22","2025-02-22","SF FuneralF1120430      250222","","126.5","","436742.28"
"2025-02-22","2025-02-22","SF FuneralF1130418      250222","","126.5","","436868.78"
"2025-02-22","2025-02-22","SF FuneralF1124272      250222","","126.5","","436995.28"
"2025-02-22","2025-02-17","Rev SF FuneralFDC0000000HKWY250217","","-126.5","","436868.78"
"2025-02-22","2025-02-21","Rev SF FuneralFDC00000008NYM250221","","-31.63","","436837.15"
"2025-02-22","2025-02-22","Rev SF FuneralFDC0000000KH3D250223","","-31.63","","436805.52"
"2025-02-22","2025-02-22","Rev SF FuneralFDC0000000770G250222","","-126.5","","436679.02"
"2025-02-22","2025-02-22","Rev SF FuneralFDC0000000NFC3250222","","-126.5","","436552.52"
"2025-02-22","2025-02-22","Rev SF FuneralFDC00000005S2X250222","","-126.5","","436426.02"
"2025-02-22","2025-02-22","Rev SF FuneralFDC0000000834F250222","","-126.5","","436299.52"
"2025-02-22","2025-02-21","Rev SF FuneralFDC0000000795Q250221","","-126.5","","436173.02"
"2025-02-22","2025-02-17","Rev SF FuneralFDC00000005ZJC250217","","-126.5","","436046.52"
"2025-02-22","2025-02-17","Rev SF FuneralFDC00000005ZJD250217","","-126.5","","435920.02"
"2025-02-22","2025-02-17","Rev SF FuneralFDC00000005T1R250217","","-126.5","","435793.52"
"2025-02-22","2025-02-22","Rev SF FuneralFDC0000000Q6QQ250222","","-126.5","","435667.02"
"2025-02-22","2025-02-22","Rev SF FuneralFDC00000005S4B250222","","-126.5","","435540.52"
"2025-02-22","2025-02-22","Rev SF FuneralFDC0000000CY83250222","","-126.5","","435414.02"
"2025-02-22","2025-02-20","SF FuneralFDC000000064JL250220","","126.5","","435540.52"
"2025-02-22","2025-02-20","SF FuneralFDC000000078FQ250220","","126.5","","435667.02"
"2025-02-22","2025-02-21","SF FuneralFDC00000007MLR250221","","126.5","","435793.52"
"2025-02-22","2025-02-21","SF FuneralF989080       250222","","126.5","","435920.02"
"2025-02-22","2025-02-22","SF FuneralFDC000000066C5250222","","126.5","","436046.52"
"2025-02-22","2025-02-22","SF FuneralFDC00000006M3C250222","","126.5","","436173.02"
"2025-02-22","2025-02-22","SF FuneralFDC00000006VRQ250222","","126.5","","436299.52"
"2025-02-22","2025-02-22","SF FuneralFDC00000007DYW250222","","126.5","","436426.02"
"2025-02-22","2025-02-22","SF FuneralFDC00000007JR4250222","","126.5","","436552.52"
"2025-02-22","2025-02-22","SF FuneralF831613       250222","","126.5","","436679.02"
"2025-02-22","2025-02-22","SF FuneralF1016816      250222","","126.5","","436805.52"
"2025-02-22","2025-02-22","SF FuneralF1022049      250222","","126.5","","436932.02"
"2025-02-22","2025-02-22","SF FuneralF1054581      250222","","126.5","","437058.52"
"2025-02-22","2025-02-22","SF FuneralF1054621      250222","","126.5","","437185.02"
"2025-02-22","2025-02-22","SF FuneralF1120918      250222","","126.5","","437311.52"
"2025-02-22","2025-02-16","SF FuneralF819229       250216","","31.63","","437343.15"
"2025-02-22","2025-02-21","SF FuneralF991558       250223","","126.5","","437469.65"
"2025-02-22","2025-02-22","SF FuneralF1127672      250222","","126.5","","437596.15"
"2025-02-22","2025-02-18","SF FuneralFDC0000000788B250218","","31.63","","437627.78"
"2025-02-22","2025-02-22","SF FuneralF1117973      250222","","126.5","","437754.28"
"2025-02-22","2025-02-22","SF FuneralFDC000000061SP250222","","126.5","","437880.78"
"2025-02-22","2025-02-22","SF FuneralF812686       250222","","126.5","","438007.28"
"2025-02-22","2025-02-22","SF FuneralF819397       250222","","126.5","","438133.78"
"2025-02-22","2025-02-22","SF FuneralF840459       250222","","126.5","","438260.28"
"2025-02-22","2025-02-22","SF FuneralF1021497      250222","","126.5","","438386.78"
"2025-02-22","2025-02-22","SF FuneralF1128055      250223","","31.63","","438418.41"
"2025-02-22","2025-02-20","SF FuneralFDC00000007C8J250220","","126.5","","438544.91"
"2025-02-22","2025-02-20","SF FuneralFDC00000007C8P250220","","126.5","","438671.41"
