"Txn date","Effective","Description","Truncated card number","Amount","Charges","Balance"
"2025-03-25","2025-03-22","SF FuneralFDC00000005L7Z250322","","126.5","","544396.11"
"2025-03-25","2025-03-25","SF FuneralF1103986      250325","","31.63","","544427.74"
"2025-03-25","2025-03-22","SF FuneralFDC00000005K7F250322","","126.5","","544554.24"
"2025-03-25","2025-03-22","SF FuneralFDC00000005ZDV250321","","126.5","","544680.74"
"2025-03-25","2025-03-22","SF FuneralFDC000000060B6250322","","126.5","","544807.24"
"2025-03-25","2025-03-22","SF FuneralFDC000000078NN250322","","126.5","","544933.74"
"2025-03-25","2025-03-22","SF FuneralFDC00000007N00250321","","126.5","","545060.24"
"2025-03-25","2025-03-22","SF FuneralFDC0000000836W250322","","126.5","","545186.74"
"2025-03-25","2025-03-22","SF FuneralF808972       250322","","126.5","","545313.24"
"2025-03-25","2025-03-22","SF FuneralF820095       250322","","126.5","","545439.74"
"2025-03-25","2025-03-22","SF FuneralF830990       250322","","126.5","","545566.24"
"2025-03-25","2025-03-22","SF FuneralFDC0000000CS3Z250322","","126.5","","545692.74"
"2025-03-25","2025-03-22","SF FuneralF778512       250322","","126.5","","545819.24"
"2025-03-25","2025-03-22","SF FuneralF1061659      250322","","126.5","","545945.74"
"2025-03-25","2025-03-22","SF FuneralF1120233      250322","","126.5","","546072.24"
"2025-03-25","2025-03-22","SF FuneralFDC0000000PY8T250322","","126.5","","546198.74"
"2025-03-25","2025-03-24","SF FuneralFDC000000060CJ250323","","126.5","","546325.24"
"2025-03-25","2025-03-24","SF FuneralFDC00000006867250324","","126.5","","546451.74"
"2025-03-25","2025-03-24","SF FuneralF815135       250324","","31.63","","546483.37"
"2025-03-25","2025-03-24","SF FuneralF1103857      250324","","31.63","","546515"
"2025-03-25","2025-03-18","SF FuneralF812316       250318","","31.63","","546546.63"
"2025-03-25","2025-03-20","SF FuneralF1073818      250321","","31.63","","546578.26"
"2025-03-25","2025-03-20","SF FuneralF1054780      250321","","31.63","","546609.89"
"2025-03-25","2025-03-22","SF FuneralF1054925      250323","","31.63","","546641.52"
"2025-03-25","2025-03-24","SF FuneralFDC00000005RR8250324","","31.63","","546673.15"
"2025-03-25","2025-03-24","SF FuneralF804126       250324","","31.63","","546704.78"
"2025-03-25","2025-03-24","SF FuneralF819012       250324","","31.63","","546736.41"
"2025-03-25","2025-03-24","SF FuneralF827602       250324","","31.63","","546768.04"
"2025-03-25","2025-03-24","SF FuneralFDC0000000Q9HH250324","","31.63","","546799.67"
"2025-03-25","2025-03-18","SF FuneralFDC00000005LTH250318","","64.5","","546864.17"
"2025-03-25","2025-03-19","SF FuneralF980675       250319","","126.5","","546990.67"
"2025-03-25","2025-03-20","SF FuneralF813952       250320","","126.5","","547117.17"
"2025-03-25","2025-03-20","SF FuneralFDC0000000N8Q4250320","","126.5","","547243.67"
"2025-03-25","2025-03-22","SF FuneralFDC00000005ZFL250322","","126.5","","547370.17"
"2025-03-25","2025-03-22","SF FuneralFDC0000000773W250321","","126.5","","547496.67"
"2025-03-25","2025-03-22","SF FuneralFDC00000008W82250322","","126.5","","547623.17"
"2025-03-25","2025-03-22","SF FuneralF805880       250322","","126.5","","547749.67"
"2025-03-25","2025-03-22","SF FuneralF807917       250322","","126.5","","547876.17"
"2025-03-25","2025-03-22","SF FuneralF821886       250322","","126.5","","548002.67"
"2025-03-25","2025-03-22","SF FuneralF1060768      250322","","126.5","","548129.17"
"2025-03-25","2025-03-22","SF FuneralF1108238      250322","","126.5","","548255.67"
"2025-03-25","2025-03-22","SF FuneralFDC0000000PY8V250322","","126.5","","548382.17"
"2025-03-25","2025-03-18","SF FuneralFDC00000008TLN250318","","63.25","","548445.42"
"2025-03-25","2025-03-18","SF FuneralF900893       250318","","126.5","","548571.92"
"2025-03-25","2025-03-22","SF FuneralFDC000000056SL250322","","126.5","","548698.42"
"2025-03-25","2025-03-22","SF FuneralFDC00000006551250322","","126.5","","548824.92"
"2025-03-25","2025-03-22","SF FuneralFDC000000073YF250322","","126.5","","548951.42"
"2025-03-25","2025-03-22","SF FuneralFDC00000007445250322","","63.25","","549014.67"
"2025-03-25","2025-03-22","SF FuneralFDC0000000754G250322","","126.5","","549141.17"
"2025-03-25","2025-03-22","SF FuneralFDC00000007LCV250322","","126.5","","549267.67"
"2025-03-25","2025-03-22","SF FuneralFDC000000081XT250321","","126.5","","549394.17"
"2025-03-25","2025-03-22","SF FuneralFDC0000000823Z250322","","126.5","","549520.67"
"2025-03-25","2025-03-22","SF FuneralFDC00000008SHW250321","","126.5","","549647.17"
"2025-03-25","2025-03-22","SF FuneralF812515       250322","","126.5","","549773.67"
"2025-03-25","2025-03-22","SF FuneralF815204       250322","","126.5","","549900.17"
"2025-03-25","2025-03-22","SF FuneralF1054758      250322","","126.5","","550026.67"
"2025-03-25","2025-03-22","SF FuneralF1073850      250322","","126.5","","550153.17"
"2025-03-25","2025-03-22","SF FuneralF1074579      250322","","126.5","","550279.67"
"2025-03-25","2025-03-22","SF FuneralF1108351      250322","","126.5","","550406.17"
"2025-03-25","2025-03-22","SF FuneralF1112092      250322","","126.5","","550532.67"
"2025-03-25","2025-03-22","SF FuneralF1118507      250322","","126.5","","550659.17"
"2025-03-25","2025-03-22","SF FuneralFDC0000000NTYT250322","","126.5","","550785.67"
"2025-03-25","2025-03-22","SF FuneralF1127556      250322","","126.5","","550912.17"
"2025-03-25","2025-03-22","SF FuneralFDC0000000Q1VB250322","","126.5","","551038.67"
"2025-03-25","2025-03-22","SF FuneralF1132486      250322","","126.5","","551165.17"
"2025-03-25","2025-03-24","SF FuneralFDC0000000FBN6250322","","126.5","","551291.67"
"2025-03-25","2025-03-24","SF FuneralFDC0000000FHS8250321","","126.5","","551418.17"
"2025-03-25","2025-03-24","SF FuneralFDC0000000JC4J250324","","126.5","","551544.67"
"2025-03-25","2025-03-24","SF FuneralF1129279      250324","","126.5","","551671.17"
"2025-03-25","2025-03-17","SF FuneralFDC0000000PHBH250317","","126.5","","551797.67"
"2025-03-25","2025-03-19","SF FuneralFDC000000064QR250319","","126.5","","551924.17"
"2025-03-25","2025-03-20","SF FuneralF823669       250320","","126.5","","552050.67"
"2025-03-25","2025-03-20","SF FuneralF1116021      250321","","126.5","","552177.17"
"2025-03-25","2025-03-20","SF FuneralF1127765      250321","","126.5","","552303.67"
"2025-03-25","2025-03-20","SF FuneralF1133316      250321","","126.5","","552430.17"
"2025-03-25","2025-03-22","SF FuneralFDC00000005S2X250322","","126.5","","552556.67"
"2025-03-25","2025-03-22","SF FuneralFDC00000005Z00250322","","126.5","","552683.17"
"2025-03-25","2025-03-22","SF FuneralFDC00000005Z4D250322","","126.5","","552809.67"
"2025-03-25","2025-03-22","SF FuneralFDC00000005Z4G250322","","126.5","","552936.17"
"2025-03-25","2025-03-22","SF FuneralFDC000000066PF250322","","126.5","","553062.67"
"2025-03-25","2025-03-22","SF FuneralFDC00000006C48250322","","126.5","","553189.17"
"2025-03-25","2025-03-22","SF FuneralFDC00000006Y54250321","","126.5","","553315.67"
"2025-03-25","2025-03-22","SF FuneralFDC000000073CR250322","","126.5","","553442.17"
"2025-03-25","2025-03-22","SF FuneralFDC00000007J7N250322","","126.5","","553568.67"
"2025-03-25","2025-03-22","SF FuneralFDC00000007K6M250322","","126.5","","553695.17"
"2025-03-25","2025-03-22","SF FuneralFDC00000007N1B250322","","126.5","","553821.67"
"2025-03-25","2025-03-22","SF FuneralF797296       250322","","126.5","","553948.17"
"2025-03-25","2025-03-22","SF FuneralFDC00000008MBH250322","","126.5","","554074.67"
"2025-03-25","2025-03-22","SF FuneralF808231       250322","","126.5","","554201.17"
"2025-03-25","2025-03-22","SF FuneralF808577       250322","","126.5","","554327.67"
"2025-03-25","2025-03-22","SF FuneralF808654       250321","","126.5","","554454.17"
"2025-03-25","2025-03-22","SF FuneralFDC000000098T8250321","","126.5","","554580.67"
"2025-03-25","2025-03-22","SF FuneralF789371       250322","","126.5","","554707.17"
"2025-03-25","2025-03-22","SF FuneralF818137       250322","","126.5","","554833.67"
"2025-03-25","2025-03-22","SF FuneralF818958       250322","","126.5","","554960.17"
"2025-03-25","2025-03-22","SF FuneralF819388       250322","","126.5","","555086.67"
"2025-03-25","2025-03-22","SF FuneralF819409       250321","","126.5","","555213.17"
"2025-03-25","2025-03-22","SF FuneralF828916       250322","","126.5","","555339.67"
"2025-03-25","2025-03-22","SF FuneralF831844       250322","","126.5","","555466.17"
"2025-03-25","2025-03-22","SF FuneralFDC0000000CLXS250322","","126.5","","555592.67"
"2025-03-25","2025-03-22","SF FuneralF833615       250322","","126.5","","555719.17"
"2025-03-25","2025-03-22","SF FuneralF785200       250322","","256.5","","555975.67"
"2025-03-25","2025-03-22","SF FuneralF1021981      250322","","126.5","","556102.17"
"2025-03-25","2025-03-22","SF FuneralF1052923      250322","","126.5","","556228.67"
"2025-03-25","2025-03-22","SF FuneralFDC0000000L6BZ250322","","191.5","","556420.17"
"2025-03-25","2025-03-22","SF FuneralF1074476      250322","","126.5","","556546.67"
"2025-03-25","2025-03-22","SF FuneralFDC0000000LH7P250322","","126.5","","556673.17"
"2025-03-25","2025-03-22","SF FuneralF1083911      250322","","126.5","","556799.67"
"2025-03-25","2025-03-22","SF FuneralFDC0000000ND49250322","","220","","557019.67"
"2025-03-25","2025-03-22","SF FuneralF1124410      250322","","126.5","","557146.17"
"2025-03-25","2025-03-22","SF FuneralFDC0000000Q3LK250322","","126.5","","557272.67"
"2025-03-25","2025-03-22","SF FuneralF1132331      250322","","126.5","","557399.17"
"2025-03-25","2025-03-22","SF FuneralF1133720      250322","","126.5","","557525.67"
"2025-03-25","2025-03-22","SF FuneralFDC0000000QJML250322","","126.5","","557652.17"
"2025-03-25","2025-03-24","SF FuneralFDC0000000570D250324","","126.5","","557778.67"
"2025-03-25","2025-03-24","SF FuneralFDC0000000617K250323","","126.5","","557905.17"
"2025-03-25","2025-03-24","SF FuneralFDC0000000B48N250323","","126.5","","558031.67"
"2025-03-25","2025-03-20","SF FuneralFDC0000000614D250320","","126.5","","558158.17"
"2025-03-25","2025-03-22","SF FuneralFDC00000003132250321","","220","","558378.17"
"2025-03-25","2025-03-22","SF FuneralFDC00000005G5L250321","","126.5","","558504.67"
"2025-03-25","2025-03-22","SF FuneralFDC00000005J5B250322","","126.5","","558631.17"
"2025-03-25","2025-03-22","SF FuneralFDC00000005V6K250322","","191.5","","558822.67"
"2025-03-25","2025-03-22","SF FuneralFDC000000060XP250322","","126.5","","558949.17"
"2025-03-25","2025-03-22","SF FuneralFDC00000006MCZ250321","","126.5","","559075.67"
"2025-03-25","2025-03-22","SF FuneralFDC00000006RZ9250322","","126.5","","559202.17"
"2025-03-25","2025-03-22","SF FuneralFDC00000006XKG250322","","126.5","","559328.67"
"2025-03-25","2025-03-22","SF FuneralFDC00000006XLJ250322","","126.5","","559455.17"
"2025-03-25","2025-03-22","SF FuneralFDC00000007JZ3250322","","126.5","","559581.67"
"2025-03-25","2025-03-22","SF FuneralFDC00000007KSY250322","","126.5","","559708.17"
"2025-03-25","2025-03-22","SF FuneralF798344       250322","","126.5","","559834.67"
"2025-03-25","2025-03-22","SF FuneralFDC00000008TX4250321","","126.5","","559961.17"
"2025-03-25","2025-03-22","SF FuneralF815451       250322","","126.5","","560087.67"
"2025-03-25","2025-03-22","SF FuneralF823005       250322","","126.5","","560214.17"
"2025-03-25","2025-03-22","SF FuneralF829541       250322","","126.5","","560340.67"
"2025-03-25","2025-03-22","SF FuneralF829547       250322","","126.5","","560467.17"
"2025-03-25","2025-03-22","SF FuneralF1061785      250322","","126.5","","560593.67"
"2025-03-25","2025-03-22","SF FuneralF1061821      250322","","126.5","","560720.17"
"2025-03-25","2025-03-22","SF FuneralF1080464      250322","","126.5","","560846.67"
"2025-03-25","2025-03-22","SF FuneralFDC0000000LPZW250322","","126.5","","560973.17"
"2025-03-25","2025-03-22","SF FuneralF1124765      250322","","126.5","","561099.67"
"2025-03-25","2025-03-22","SF FuneralF1128982      250322","","126.5","","561226.17"
"2025-03-25","2025-03-22","SF FuneralF1131867      250322","","126.5","","561352.67"
"2025-03-25","2025-03-24","SF FuneralF823675       250323","","126.5","","561479.17"
"2025-03-25","2025-03-24","SF FuneralF831118       250323","","126.5","","561605.67"
"2025-03-25","2025-03-24","SF FuneralF841782       250323","","126.5","","561732.17"
"2025-03-25","2025-03-24","SF FuneralFDC0000000QM4Y250324","","191.5","","561923.67"
"2025-03-25","2025-03-20","SF FuneralF1022106      250321","","31.63","","561955.3"
"2025-03-25","2025-03-20","SF FuneralFDC0000000JXK7250321","","31.63","","561986.93"
"2025-03-25","2025-03-22","SF FuneralFDC00000007TC1250321","","31.63","","562018.56"
"2025-03-25","2025-03-22","SF FuneralF840580       250321","","31.63","","562050.19"
"2025-03-25","2025-03-24","SF FuneralFDC00000005WTC250324","","55","","562105.19"
"2025-03-25","2025-03-24","SF FuneralF1130713      250324","","31.63","","562136.82"
"2025-03-25","2025-03-20","SF FuneralF1124354      250321","","126.5","","562263.32"
"2025-03-25","2025-03-22","SF FuneralFDC000000043W1250322","","220","","562483.32"
"2025-03-25","2025-03-22","SF FuneralFDC00000005LS1250322","","126.5","","562609.82"
"2025-03-25","2025-03-22","SF FuneralFDC00000005ZLJ250322","","126.5","","562736.32"
"2025-03-25","2025-03-22","SF FuneralFDC000000061B9250322","","126.5","","562862.82"
"2025-03-25","2025-03-22","SF FuneralFDC00000006LGX250321","","126.5","","562989.32"
"2025-03-25","2025-03-22","SF FuneralFDC00000007JVL250322","","126.5","","563115.82"
"2025-03-25","2025-03-22","SF FuneralFDC00000007N22250322","","126.5","","563242.32"
"2025-03-25","2025-03-22","SF FuneralFDC0000000CPY3250322","","126.5","","563368.82"
"2025-03-25","2025-03-22","SF FuneralFDC0000000CPY7250322","","126.5","","563495.32"
"2025-03-25","2025-03-22","SF FuneralF1054927      250322","","126.5","","563621.82"
"2025-03-25","2025-03-22","SF FuneralF1078238      250322","","126.5","","563748.32"
"2025-03-25","2025-03-22","SF FuneralF1110507      250322","","126.5","","563874.82"
"2025-03-25","2025-03-22","SF FuneralF1110708      250322","","126.5","","564001.32"
"2025-03-25","2025-03-22","SF FuneralF989130       250322","","126.5","","564127.82"
"2025-03-25","2025-03-22","SF FuneralFDC0000000N6M4250322","","126.5","","564254.32"
"2025-03-25","2025-03-22","SF FuneralF1115776      250322","","126.5","","564380.82"
"2025-03-25","2025-03-22","SF FuneralF1115788      250322","","126.5","","564507.32"
"2025-03-25","2025-03-22","SF FuneralF1118112      250322","","126.5","","564633.82"
"2025-03-25","2025-03-22","SF FuneralF1133630      250322","","126.5","","564760.32"
"2025-03-25","2025-03-22","SF FuneralFDC0000000QFVX250322","","126.5","","564886.82"
"2025-03-25","2025-03-24","SF FuneralF808894       250323","","126.5","","565013.32"
"2025-03-25","2025-03-20","SF FuneralFDC00000005MSW250320","","126.5","","565139.82"
"2025-03-25","2025-03-20","SF FuneralFDC00000007JZ0250320","","126.5","","565266.32"
"2025-03-25","2025-03-20","SF FuneralF987036       250322","","126.5","","565392.82"
"2025-03-25","2025-03-20","SF FuneralF1060095      250321","","63.25","","565456.07"
"2025-03-25","2025-03-20","SF FuneralF1132890      250321","","126.5","","565582.57"
"2025-03-25","2025-03-20","SF FuneralF1133257      250321","","126.5","","565709.07"
"2025-03-25","2025-03-22","SF FuneralFDC00000005V5F250322","","126.5","","565835.57"
"2025-03-25","2025-03-22","SF FuneralFDC00000006019250322","","126.5","","565962.07"
"2025-03-25","2025-03-22","SF FuneralFDC000000061KK250322","","126.5","","566088.57"
"2025-03-25","2025-03-22","SF FuneralFDC000000061V9250322","","126.5","","566215.07"
"2025-03-25","2025-03-22","SF FuneralFDC00000006239250322","","126.5","","566341.57"
"2025-03-25","2025-03-22","SF FuneralFDC000000063V7250322","","126.5","","566468.07"
"2025-03-25","2025-03-22","SF FuneralFDC00000007MJB250322","","126.5","","566594.57"
"2025-03-25","2025-03-22","SF FuneralF814745       250321","","126.5","","566721.07"
"2025-03-25","2025-03-22","SF FuneralF808922       250321","","126.5","","566847.57"
"2025-03-25","2025-03-22","SF FuneralF840931       250322","","126.5","","566974.07"
"2025-03-25","2025-03-22","SF FuneralF1112585      250322","","126.5","","567100.57"
"2025-03-25","2025-03-22","SF FuneralF1114981      250322","","126.5","","567227.07"
"2025-03-25","2025-03-22","SF FuneralF1120288      250322","","126.5","","567353.57"
"2025-03-25","2025-03-22","SF FuneralF1130509      250322","","126.5","","567480.07"
"2025-03-25","2025-03-22","SF FuneralFDC0000000Q246250322","","126.5","","567606.57"
"2025-03-25","2025-03-22","SF FuneralF1130645      250322","","126.5","","567733.07"
"2025-03-25","2025-03-20","SF FuneralF981788       250321","","31.63","","567764.7"
"2025-03-25","2025-03-24","SF FuneralFDC00000005YNL250324","","55","","567819.7"
"2025-03-25","2025-03-24","SF FuneralFDC00000005YW3250324","","31.63","","567851.33"
"2025-03-25","2025-03-20","SF FuneralF1054689      250320","","126.5","","567977.83"
"2025-03-25","2025-03-20","SF FuneralF1066148      250320","","126.5","","568104.33"
"2025-03-25","2025-03-22","SF FuneralFDC0000000645B250322","","126.5","","568230.83"
"2025-03-25","2025-03-22","SF FuneralFDC00000006WY7250321","","126.5","","568357.33"
"2025-03-25","2025-03-22","SF FuneralFDC00000008639250322","","126.5","","568483.83"
"2025-03-25","2025-03-22","SF FuneralFDC000000087Y5250321","","126.5","","568610.33"
"2025-03-25","2025-03-22","SF FuneralFDC00000008T2Z250322","","126.5","","568736.83"
"2025-03-25","2025-03-22","SF FuneralF818403       250322","","126.5","","568863.33"
"2025-03-25","2025-03-22","SF FuneralF819486       250322","","126.5","","568989.83"
"2025-03-25","2025-03-22","SF FuneralF823218       250322","","126.5","","569116.33"
"2025-03-25","2025-03-22","SF FuneralF823473       250322","","126.5","","569242.83"
"2025-03-25","2025-03-22","SF FuneralF842693       250322","","126.5","","569369.33"
"2025-03-25","2025-03-22","SF FuneralF993357       250322","","126.5","","569495.83"
"2025-03-25","2025-03-22","SF FuneralF1058783      250322","","126.5","","569622.33"
"2025-03-25","2025-03-22","SF FuneralFDC0000000L6ST250322","","126.5","","569748.83"
"2025-03-25","2025-03-22","SF FuneralF1083731      250322","","126.5","","569875.33"
"2025-03-25","2025-03-22","SF FuneralF1083737      250322","","126.5","","570001.83"
"2025-03-25","2025-03-22","SF FuneralF1104172      250322","","126.5","","570128.33"
"2025-03-25","2025-03-22","SF FuneralF1115989      250322","","126.5","","570254.83"
"2025-03-25","2025-03-22","SF FuneralF1118000      250322","","126.5","","570381.33"
"2025-03-25","2025-03-22","SF FuneralF1122849      250322","","126.5","","570507.83"
"2025-03-25","2025-03-22","SF FuneralF1130446      250322","","126.5","","570634.33"
"2025-03-25","2025-03-22","SF FuneralFDC0000000QCPX250322","","126.5","","570760.83"
"2025-03-25","2025-03-22","SF FuneralF1133609      250322","","126.5","","570887.33"
"2025-03-25","2025-03-22","SF FuneralFDC0000000QGC1250322","","126.5","","571013.83"
"2025-03-25","2025-03-24","SF FuneralFDC0000000HZBN250324","","278.31","","571292.14"
"2025-03-25","2025-03-24","SF FuneralF991106       250324","","126.5","","571418.64"
"2025-03-25","2025-03-20","SF FuneralF987493       250322","","126.5","","571545.14"
"2025-03-25","2025-03-20","SF FuneralF989714       250321","","126.5","","571671.64"
"2025-03-25","2025-03-20","SF FuneralF991519       250321","","126.5","","571798.14"
"2025-03-25","2025-03-20","SF FuneralFDC0000000MM4X250320","","126.5","","571924.64"
"2025-03-25","2025-03-20","SF FuneralF1129491      250321","","126.5","","572051.14"
"2025-03-25","2025-03-22","SF FuneralFDC000000031NC250322","","220","","572271.14"
"2025-03-25","2025-03-22","SF FuneralFDC00000006192250322","","126.5","","572397.64"
"2025-03-25","2025-03-22","SF FuneralFDC00000006KR2250321","","126.5","","572524.14"
"2025-03-25","2025-03-22","SF FuneralFDC00000006M8K250322","","126.5","","572650.64"
"2025-03-25","2025-03-22","SF FuneralFDC00000006YV4250322","","126.5","","572777.14"
"2025-03-25","2025-03-22","SF FuneralFDC00000007DK7250322","","126.5","","572903.64"
"2025-03-25","2025-03-22","SF FuneralFDC00000007KFP250321","","126.5","","573030.14"
"2025-03-25","2025-03-22","SF FuneralF810368       250322","","126.5","","573156.64"
"2025-03-25","2025-03-22","SF FuneralF810586       250321","","126.5","","573283.14"
"2025-03-25","2025-03-22","SF FuneralFDC0000000BCVB250322","","126.5","","573409.64"
"2025-03-25","2025-03-22","SF FuneralF823874       250322","","126.5","","573536.14"
"2025-03-25","2025-03-22","SF FuneralF831374       250322","","126.5","","573662.64"
"2025-03-25","2025-03-22","SF FuneralF838813       250322","","126.5","","573789.14"
"2025-03-25","2025-03-22","SF FuneralFDC0000000D6PQ250322","","126.5","","573915.64"
"2025-03-25","2025-03-22","SF FuneralF840502       250322","","126.5","","574042.14"
"2025-03-25","2025-03-22","SF FuneralFDC0000000KSYY250322","","126.5","","574168.64"
"2025-03-25","2025-03-22","SF FuneralF1066152      250322","","126.5","","574295.14"
"2025-03-25","2025-03-22","SF FuneralF1128983      250322","","126.5","","574421.64"
"2025-03-25","2025-03-22","SF FuneralF1130330      250322","","126.5","","574548.14"
"2025-03-25","2025-03-22","SF FuneralF1132384      250322","","126.5","","574674.64"
"2025-03-25","2025-03-18","SF FuneralF815518       250318","","63.25","","574737.89"
"2025-03-25","2025-03-20","SF FuneralF900945       250322","","126.5","","574864.39"
"2025-03-25","2025-03-22","SF FuneralF811389       250322","","126.5","","574990.89"
"2025-03-25","2025-03-22","SF FuneralF1121775      250323","","47.88","","575038.77"
"2025-03-25","2025-03-24","SF FuneralFDC00000005V61250323","","126.5","","575165.27"
"2025-03-25","2025-03-24","SF FuneralFDC00000007N2Y250324","","126.5","","575291.77"
"2025-03-25","2025-03-24","SF FuneralF818445       250323","","126.5","","575418.27"
"2025-03-25","2025-03-24","SF FuneralFDC0000000N7NV250324","","126.5","","575544.77"
"2025-03-25","2025-03-20","SF FuneralF815090       250320","","126.5","","575671.27"
"2025-03-25","2025-03-20","SF FuneralF987790       250321","","126.5","","575797.77"
"2025-03-25","2025-03-20","SF FuneralF1062692      250321","","126.5","","575924.27"
"2025-03-25","2025-03-20","SF FuneralF1108341      250321","","126.5","","576050.77"
"2025-03-25","2025-03-20","SF FuneralF1108833      250321","","126.5","","576177.27"
"2025-03-25","2025-03-20","SF FuneralFDC0000000MKXM250321","","126.5","","576303.77"
"2025-03-25","2025-03-22","SF FuneralFDC000000037HW250322","","220","","576523.77"
"2025-03-25","2025-03-22","SF FuneralFDC00000005S4P250322","","126.5","","576650.27"
"2025-03-25","2025-03-22","SF FuneralFDC00000005S9G250322","","126.5","","576776.77"
"2025-03-25","2025-03-22","SF FuneralFDC000000060C3250322","","126.5","","576903.27"
"2025-03-25","2025-03-22","SF FuneralFDC000000062Q0250322","","126.5","","577029.77"
"2025-03-25","2025-03-22","SF FuneralFDC000000063V6250322","","126.5","","577156.27"
"2025-03-25","2025-03-22","SF FuneralFDC00000006ZY8250322","","126.5","","577282.77"
"2025-03-25","2025-03-22","SF FuneralFDC00000007DWP250322","","126.5","","577409.27"
"2025-03-25","2025-03-22","SF FuneralFDC00000007VJR250322","","126.5","","577535.77"
"2025-03-25","2025-03-22","SF FuneralFDC0000000836V250322","","126.5","","577662.27"
"2025-03-25","2025-03-22","SF FuneralF811295       250322","","126.5","","577788.77"
"2025-03-25","2025-03-22","SF FuneralF822641       250322","","126.5","","577915.27"
"2025-03-25","2025-03-22","SF FuneralF842634       250322","","126.5","","578041.77"
"2025-03-25","2025-03-22","SF FuneralF1050703      250322","","126.5","","578168.27"
"2025-03-25","2025-03-22","SF FuneralF1058854      250322","","126.5","","578294.77"
"2025-03-25","2025-03-22","SF FuneralF1074447      250322","","126.5","","578421.27"
"2025-03-25","2025-03-22","SF FuneralF1079740      250322","","126.5","","578547.77"
"2025-03-25","2025-03-22","SF FuneralF1083632      250322","","126.5","","578674.27"
"2025-03-25","2025-03-22","SF FuneralF1083831      250322","","126.5","","578800.77"
"2025-03-25","2025-03-22","SF FuneralFDC0000000LYM0250322","","126.5","","578927.27"
"2025-03-25","2025-03-22","SF FuneralF1112281      250322","","191.5","","579118.77"
"2025-03-25","2025-03-22","SF FuneralF1120320      250323","","126.5","","579245.27"
"2025-03-25","2025-03-22","SF FuneralF1127754      250322","","126.5","","579371.77"
"2025-03-25","2025-03-22","SF FuneralFDC0000000Q1V8250322","","126.5","","579498.27"
"2025-03-25","2025-03-24","SF FuneralFDC00000006QVN250323","","126.5","","579624.77"
"2025-03-25","2025-03-20","SF FuneralF1117916      250321","","126.5","","579751.27"
"2025-03-25","2025-03-22","SF FuneralFDC0000000672M250322","","126.5","","579877.77"
"2025-03-25","2025-03-22","SF FuneralFDC00000006Z1Z250322","","126.5","","580004.27"
"2025-03-25","2025-03-22","SF FuneralFDC00000006ZX8250322","","126.5","","580130.77"
"2025-03-25","2025-03-22","SF FuneralFDC000000075DT250322","","126.5","","580257.27"
"2025-03-25","2025-03-22","SF FuneralFDC000000075DV250322","","126.5","","580383.77"
"2025-03-25","2025-03-22","SF FuneralFDC00000008JYC250322","","126.5","","580510.27"
"2025-03-25","2025-03-22","SF FuneralF802278       250322","","126.5","","580636.77"
"2025-03-25","2025-03-22","SF FuneralF805851       250322","","126.5","","580763.27"
"2025-03-25","2025-03-22","SF FuneralF815138       250322","","126.5","","580889.77"
"2025-03-25","2025-03-22","SF FuneralF823968       250322","","126.5","","581016.27"
"2025-03-25","2025-03-22","SF FuneralF832934       250322","","126.5","","581142.77"
"2025-03-25","2025-03-22","SF FuneralF840686       250321","","126.5","","581269.27"
"2025-03-25","2025-03-22","SF FuneralF1022295      250322","","191.5","","581460.77"
"2025-03-25","2025-03-22","SF FuneralF1061970      250322","","126.5","","581587.27"
"2025-03-25","2025-03-22","SF FuneralFDC0000000L13V250322","","126.5","","581713.77"
"2025-03-25","2025-03-22","SF FuneralFDC0000000L9D1250322","","126.5","","581840.27"
"2025-03-25","2025-03-22","SF FuneralFDC0000000MTMT250322","","126.5","","581966.77"
"2025-03-25","2025-03-22","SF FuneralFDC0000000NJV2250322","","126.5","","582093.27"
"2025-03-25","2025-03-22","SF FuneralFDC0000000NL55250322","","126.5","","582219.77"
"2025-03-25","2025-03-22","SF FuneralF1133238      250322","","126.5","","582346.27"
"2025-03-25","2025-03-22","SF FuneralF1135123      250322","","126.5","","582472.77"
"2025-03-25","2025-03-24","SF FuneralFDC000000079BQ250323","","126.5","","582599.27"
"2025-03-25","2025-03-22","SF FuneralFDC00000007C2D250322","","126.5","","582725.77"
"2025-03-25","2025-03-22","SF FuneralFDC00000007JC7250322","","126.5","","582852.27"
"2025-03-25","2025-03-22","SF FuneralFDC00000007MLR250321","","126.5","","582978.77"
"2025-03-25","2025-03-22","SF FuneralFDC00000007MP6250322","","126.5","","583105.27"
"2025-03-25","2025-03-22","SF FuneralF811599       250322","","126.5","","583231.77"
"2025-03-25","2025-03-22","SF FuneralF822855       250322","","126.5","","583358.27"
"2025-03-25","2025-03-22","SF FuneralFDC0000000DFN2250322","","126.5","","583484.77"
"2025-03-25","2025-03-22","SF FuneralF840786       250321","","126.5","","583611.27"
"2025-03-25","2025-03-22","SF FuneralF1052821      250322","","126.5","","583737.77"
"2025-03-25","2025-03-18","SF FuneralF829052       250318","","63.25","","583801.02"
"2025-03-25","2025-03-20","SF FuneralFDC0000000JY3G250321","","126.5","","583927.52"
"2025-03-25","2025-03-20","SF FuneralF1061734      250320","","126.5","","584054.02"
"2025-03-25","2025-03-20","SF FuneralF1130404      250321","","126.5","","584180.52"
"2025-03-25","2025-03-22","SF FuneralFDC00000003GZH250321","","220","","584400.52"
"2025-03-25","2025-03-22","SF FuneralFDC00000005SKB250322","","126.5","","584527.02"
"2025-03-25","2025-03-22","SF FuneralFDC000000069GJ250322","","126.5","","584653.52"
"2025-03-25","2025-03-22","SF FuneralFDC00000006BQJ250322","","126.5","","584780.02"
"2025-03-25","2025-03-22","SF FuneralFDC00000006Z9F250322","","126.5","","584906.52"
"2025-03-25","2025-03-22","SF FuneralFDC00000006Z9T250322","","126.5","","585033.02"
"2025-03-25","2025-03-22","SF FuneralFDC00000006ZBN250322","","126.5","","585159.52"
"2025-03-25","2025-03-22","SF FuneralFDC0000000727D250322","","126.5","","585286.02"
"2025-03-25","2025-03-22","SF FuneralFDC00000007JVD250322","","126.5","","585412.52"
"2025-03-25","2025-03-22","SF FuneralFDC00000008CDL250322","","126.5","","585539.02"
"2025-03-25","2025-03-22","SF FuneralF808318       250322","","126.5","","585665.52"
"2025-03-25","2025-03-22","SF FuneralFDC0000000996J250322","","126.5","","585792.02"
"2025-03-25","2025-03-22","SF FuneralF808693       250322","","126.5","","585918.52"
"2025-03-25","2025-03-22","SF FuneralF823845       250322","","126.5","","586045.02"
"2025-03-25","2025-03-22","SF FuneralF830827       250322","","126.5","","586171.52"
"2025-03-25","2025-03-22","SF FuneralF832775       250322","","126.5","","586298.02"
"2025-03-25","2025-03-22","SF FuneralF1052794      250322","","126.5","","586424.52"
"2025-03-25","2025-03-22","SF FuneralF988454       250322","","126.5","","586551.02"
"2025-03-25","2025-03-22","SF FuneralF1073813      250322","","126.5","","586677.52"
"2025-03-25","2025-03-22","SF FuneralF1080439      250322","","126.5","","586804.02"
"2025-03-25","2025-03-22","SF FuneralF1108264      250322","","126.5","","586930.52"
"2025-03-25","2025-03-22","SF FuneralF1115768      250322","","126.5","","587057.02"
"2025-03-25","2025-03-22","SF FuneralF1123606      250322","","126.5","","587183.52"
"2025-03-25","2025-03-22","SF FuneralF1124595      250322","","126.5","","587310.02"
"2025-03-25","2025-03-24","SF FuneralFDC00000006W3K250323","","126.5","","587436.52"
"2025-03-25","2025-03-24","SF FuneralFDC0000000DCGV250324","","126.5","","587563.02"
"2025-03-25","2025-03-24","SF FuneralF844566       250322","","126.5","","587689.52"
"2025-03-25","2025-03-20","SF FuneralF987350       250322","","126.5","","587816.02"
"2025-03-25","2025-03-20","SF FuneralF1083868      250321","","126.5","","587942.52"
"2025-03-25","2025-03-20","SF FuneralF1124428      250321","","126.5","","588069.02"
"2025-03-25","2025-03-22","SF FuneralFDC000000072JN250322","","126.5","","588195.52"
"2025-03-25","2025-03-22","SF FuneralFDC000000072NG250322","","126.5","","588322.02"
"2025-03-25","2025-03-24","SF FuneralFDC00000003XTD250323","","220","","588542.02"
"2025-03-25","2025-03-24","SF FuneralF831366       250324","","126.5","","588668.52"
"2025-03-25","2025-03-19","SF FuneralFDC00000006PWT250319","","126.5","","588795.02"
"2025-03-25","2025-03-20","SF FuneralF1122619      250320","","126.5","","588921.52"
"2025-03-25","2025-03-20","SF FuneralF1132260      250321","","126.5","","589048.02"
"2025-03-25","2025-03-22","SF FuneralFDC0000000795Q250321","","126.5","","589174.52"
"2025-03-25","2025-03-22","SF FuneralFDC00000007JVC250322","","126.5","","589301.02"
"2025-03-25","2025-03-22","SF FuneralFDC000000082HZ250321","","126.5","","589427.52"
"2025-03-25","2025-03-22","SF FuneralFDC00000008RHF250322","","126.5","","589554.02"
"2025-03-25","2025-03-22","SF FuneralFDC0000000D548250322","","126.5","","589680.52"
"2025-03-25","2025-03-22","SF FuneralF1074480      250322","","126.5","","589807.02"
"2025-03-25","2025-03-22","SF FuneralF1108157      250322","","126.5","","589933.52"
"2025-03-25","2025-03-22","SF FuneralF787638       250322","","191.5","","590125.02"
"2025-03-25","2025-03-22","SF FuneralFDC0000000PX1W250322","","126.5","","590251.52"
"2025-03-25","2025-03-24","SF FuneralF900552       250322","","126.5","","590378.02"
"2025-03-25","2025-03-24","SF FuneralFDC0000000P2T5250324","","126.5","","590504.52"
"2025-03-25","2025-03-22","SF FuneralFDC00000004GMZ250322","","220","","590724.52"
"2025-03-25","2025-03-22","SF FuneralFDC00000005JZV250322","","126.5","","590851.02"
"2025-03-25","2025-03-22","SF FuneralFDC0000000606N250322","","126.5","","590977.52"
"2025-03-25","2025-03-22","SF FuneralFDC000000062V3250322","","126.5","","591104.02"
"2025-03-25","2025-03-22","SF FuneralFDC00000006X3Y250322","","126.5","","591230.52"
"2025-03-25","2025-03-22","SF FuneralFDC00000006YM3250322","","126.5","","591357.02"
"2025-03-25","2025-03-22","SF FuneralFDC000000072FV250322","","126.5","","591483.52"
"2025-03-25","2025-03-22","SF FuneralF796481       250322","","126.5","","591610.02"
"2025-03-25","2025-03-22","SF FuneralF815605       250322","","126.5","","591736.52"
"2025-03-25","2025-03-22","SF FuneralF819261       250322","","126.5","","591863.02"
"2025-03-25","2025-03-22","SF FuneralF819702       250322","","126.5","","591989.52"
"2025-03-25","2025-03-22","SF FuneralF823729       250322","","126.5","","592116.02"
"2025-03-25","2025-03-22","SF FuneralF840617       250322","","126.5","","592242.52"
"2025-03-25","2025-03-22","SF FuneralF841796       250322","","126.5","","592369.02"
"2025-03-25","2025-03-22","SF FuneralF781872       250322","","126.5","","592495.52"
"2025-03-25","2025-03-22","SF FuneralFDC0000000JS95250322","","126.5","","592622.02"
"2025-03-25","2025-03-22","SF FuneralFDC0000000JVQC250322","","126.5","","592748.52"
"2025-03-25","2025-03-22","SF FuneralF1054917      250322","","126.5","","592875.02"
"2025-03-25","2025-03-22","SF FuneralF1055257      250322","","126.5","","593001.52"
"2025-03-25","2025-03-22","SF FuneralF1065706      250322","","126.5","","593128.02"
"2025-03-25","2025-03-22","SF FuneralF1066018      250322","","126.5","","593254.52"
"2025-03-25","2025-03-22","SF FuneralF1073832      250322","","126.5","","593381.02"
"2025-03-25","2025-03-22","SF FuneralFDC0000000LMPJ250322","","126.5","","593507.52"
"2025-03-25","2025-03-22","SF FuneralF1080449      250322","","126.5","","593634.02"
"2025-03-25","2025-03-22","SF FuneralF1114302      250322","","126.5","","593760.52"
"2025-03-25","2025-03-22","SF FuneralF1120339      250323","","126.5","","593887.02"
"2025-03-25","2025-03-22","SF FuneralF1122894      250322","","126.5","","594013.52"
"2025-03-25","2025-03-22","SF FuneralF1123448      250322","","126.5","","594140.02"
"2025-03-25","2025-03-22","SF FuneralF1123623      250322","","126.5","","594266.52"
"2025-03-25","2025-03-22","SF FuneralF1124438      250322","","126.5","","594393.02"
"2025-03-25","2025-03-22","SF FuneralF1112376      250322","","126.5","","594519.52"
"2025-03-25","2025-03-22","SF FuneralF1127971      250322","","126.5","","594646.02"
"2025-03-25","2025-03-22","SF FuneralF1129172      250322","","126.5","","594772.52"
"2025-03-25","2025-03-22","SF FuneralF1131597      250322","","126.5","","594899.02"
"2025-03-25","2025-03-22","SF FuneralFDC0000000QCMR250322","","126.5","","595025.52"
"2025-03-25","2025-03-22","SF FuneralFDC0000000QCMT250322","","126.5","","595152.02"
"2025-03-25","2025-03-22","SF FuneralFDC0000000QCMW250322","","126.5","","595278.52"
"2025-03-25","2025-03-22","SF FuneralFDC0000000QCMY250322","","126.5","","595405.02"
"2025-03-25","2025-03-22","SF FuneralFDC0000000QCMZ250322","","126.5","","595531.52"
"2025-03-25","2025-03-22","SF FuneralF1135132      250322","","126.5","","595658.02"
"2025-03-25","2025-03-24","SF FuneralFDC00000005VYT250323","","126.5","","595784.52"
"2025-03-25","2025-03-24","SF FuneralF1102815      250324","","31.63","","595816.15"
"2025-03-25","2025-03-18","SF FuneralF843976       250318","","31.63","","595847.78"
"2025-03-25","2025-03-21","SF FuneralFDC00000009FRV250321","","126.5","","595974.28"
"2025-03-25","2025-03-21","SF FuneralF820027       250321","","126.5","","596100.78"
"2025-03-25","2025-03-20","SF FuneralF987411       250322","","126.5","","596227.28"
"2025-03-25","2025-03-20","SF FuneralF989215       250320","","126.5","","596353.78"
"2025-03-25","2025-03-20","SF FuneralF989551       250322","","126.5","","596480.28"
"2025-03-25","2025-03-20","SF FuneralF1129028      250320","","126.5","","596606.78"
"2025-03-25","2025-03-17","SF FuneralFDC00000005YVB250317","","126.5","","596733.28"
"2025-03-25","2025-03-17","SF FuneralFDC0000000620Z250317","","126.5","","596859.78"
"2025-03-25","2025-03-20","SF FuneralFDC000000061SB250320","","126.5","","596986.28"
"2025-03-25","2025-03-20","SF FuneralF1113985      250321","","126.5","","597112.78"
"2025-03-25","2025-03-22","SF FuneralFDC00000005XG7250322","","126.5","","597239.28"
"2025-03-25","2025-03-22","SF FuneralFDC000000063T6250322","","126.5","","597365.78"
"2025-03-25","2025-03-22","SF FuneralFDC00000006583250322","","126.5","","597492.28"
"2025-03-25","2025-03-22","SF FuneralFDC00000006WHC250322","","126.5","","597618.78"
"2025-03-25","2025-03-22","SF FuneralFDC00000006WK6250322","","126.5","","597745.28"
"2025-03-25","2025-03-22","SF FuneralFDC00000006WQS250322","","126.5","","597871.78"
"2025-03-25","2025-03-22","SF FuneralFDC00000006YD9250322","","126.5","","597998.28"
"2025-03-25","2025-03-22","SF FuneralFDC00000007M57250322","","126.5","","598124.78"
"2025-03-25","2025-03-22","SF FuneralFDC00000007M5L250322","","126.5","","598251.28"
"2025-03-25","2025-03-22","SF FuneralFDC00000007RK0250322","","126.5","","598377.78"
"2025-03-25","2025-03-22","SF FuneralFDC00000008G8J250322","","126.5","","598504.28"
"2025-03-25","2025-03-22","SF FuneralF801527       250322","","126.5","","598630.78"
"2025-03-25","2025-03-22","SF FuneralF831128       250322","","126.5","","598757.28"
"2025-03-25","2025-03-22","SF FuneralF831217       250322","","126.5","","598883.78"
"2025-03-25","2025-03-22","SF FuneralF992037       250322","","126.5","","599010.28"
"2025-03-25","2025-03-22","SF FuneralF1016665      250322","","126.5","","599136.78"
"2025-03-25","2025-03-22","SF FuneralF1054731      250322","","126.5","","599263.28"
"2025-03-25","2025-03-22","SF FuneralFDC0000000KJB9250322","","126.5","","599389.78"
"2025-03-25","2025-03-22","SF FuneralF1060943      250322","","126.5","","599516.28"
"2025-03-25","2025-03-22","SF FuneralF823216       250322","","126.5","","599642.78"
"2025-03-25","2025-03-22","SF FuneralFDC0000000M6GH250322","","126.5","","599769.28"
"2025-03-25","2025-03-22","SF FuneralFDC0000000MGPJ250322","","126.5","","599895.78"
"2025-03-25","2025-03-22","SF FuneralFDC0000000NMS5250322","","126.5","","600022.28"
"2025-03-25","2025-03-22","SF FuneralF1127691      250322","","126.5","","600148.78"
"2025-03-25","2025-03-22","SF FuneralFDC0000000PSHX250322","","126.5","","600275.28"
"2025-03-25","2025-03-22","SF FuneralFDC0000000PX26250322","","126.5","","600401.78"
"2025-03-25","2025-03-22","SF FuneralF1129448      250322","","126.5","","600528.28"
"2025-03-25","2025-03-22","SF FuneralF1130660      250322","","126.5","","600654.78"
"2025-03-25","2025-03-24","SF FuneralFDC000000031HJ250323","","220","","600874.78"
"2025-03-25","2025-03-24","SF FuneralF1114627      250324","","63.25","","600938.03"
"2025-03-25","2025-03-17","SF FuneralF1124998      250317","","126.5","","601064.53"
"2025-03-25","2025-03-25","SF FuneralF1110796      250325","","31.63","","601096.16"
"2025-03-25","2025-03-25","SF FuneralFDC00000005DGT250325","","191.5","","601287.66"
"2025-03-25","2025-03-25","SF FuneralFDC00000007QQ4250325","","126.5","","601414.16"
"2025-03-25","2025-03-25","SF FuneralF1111329      250325","","31.63","","601445.79"
"2025-03-25","2025-03-25","SF FuneralFDC00000007MQ0250325","","126.5","","601572.29"
"2025-03-25","2025-03-25","SF FuneralF823277       250325","","126.5","","601698.79"
"2025-03-25","2025-03-25","SF FuneralF1078284      250325","","126.5","","601825.29"
"2025-03-25","2025-03-25","SF FuneralF829557       250325","","31.63","","601856.92"
"2025-03-25","2025-03-25","SF FuneralF1115181      250325","","63.25","","601920.17"
"2025-03-25","2025-03-25","SF FuneralF843976       250325","","31.63","","601951.8"
"2025-03-25","2025-03-25","SF FuneralF1111540      250325","","63.25","","602015.05"
"2025-03-25","2025-03-25","SF FuneralFDC00000005PJW250325","","126.5","","602141.55"
"2025-03-25","2025-03-25","SF FuneralFDC0000000455X250325","","55","","602196.55"
"2025-03-25","2025-03-25","SF FuneralFDC00000005NFK250325","","31.63","","602228.18"
"2025-03-25","2025-03-25","SF FuneralFDC00000006QTN250325","","31.63","","602259.81"
"2025-03-25","2025-03-25","SF FuneralFDC00000007X30250325","","31.63","","602291.44"
"2025-03-25","2025-03-25","SF FuneralFDC00000007X31250325","","31.63","","602323.07"
"2025-03-25","2025-03-25","SF FuneralFDC00000007YZB250325","","31.63","","602354.7"
"2025-03-25","2025-03-25","SF FuneralFDC000000086B2250325","","31.63","","602386.33"
"2025-03-25","2025-03-25","SF FuneralFDC00000008H47250325","","31.63","","602417.96"
"2025-03-25","2025-03-25","SF FuneralF811401       250325","","31.63","","602449.59"
"2025-03-25","2025-03-25","SF FuneralF812316       250325","","31.63","","602481.22"
"2025-03-25","2025-03-25","SF FuneralF814431       250325","","31.63","","602512.85"
"2025-03-25","2025-03-25","SF FuneralF817293       250325","","31.63","","602544.48"
"2025-03-25","2025-03-25","SF FuneralF981838       250325","","31.63","","602576.11"
"2025-03-25","2025-03-25","SF FuneralFDC0000000HK7D250325","","31.63","","602607.74"
"2025-03-25","2025-03-25","SF FuneralF989148       250325","","31.63","","602639.37"
"2025-03-25","2025-03-25","SF FuneralF989177       250325","","31.63","","602671"
"2025-03-25","2025-03-25","SF FuneralF1020936      250325","","31.63","","602702.63"
"2025-03-25","2025-03-25","SF FuneralFDC0000000K09P250325","","65","","602767.63"
"2025-03-25","2025-03-25","SF FuneralF1050833      250325","","31.63","","602799.26"
"2025-03-25","2025-03-25","SF FuneralF1059867      250325","","31.63","","602830.89"
"2025-03-25","2025-03-25","SF FuneralF1061865      250325","","31.63","","602862.52"
"2025-03-25","2025-03-25","SF FuneralFDC0000000L0TL250325","","31.63","","602894.15"
"2025-03-25","2025-03-25","SF FuneralFDC0000000L0TM250325","","31.63","","602925.78"
"2025-03-25","2025-03-25","SF FuneralF1073801      250325","","31.63","","602957.41"
"2025-03-25","2025-03-25","SF FuneralF1078493      250325","","31.63","","602989.04"
"2025-03-25","2025-03-25","SF FuneralF1079259      250325","","31.63","","603020.67"
"2025-03-25","2025-03-25","SF FuneralF1102938      250325","","31.63","","603052.3"
"2025-03-25","2025-03-25","SF FuneralF1102942      250325","","31.63","","603083.93"
"2025-03-25","2025-03-25","SF FuneralF1110117      250325","","31.63","","603115.56"
"2025-03-25","2025-03-25","SF FuneralF1111731      250325","","31.63","","603147.19"
"2025-03-25","2025-03-25","SF FuneralFDC0000000N526250325","","31.63","","603178.82"
"2025-03-25","2025-03-25","SF FuneralF1113741      250325","","31.63","","603210.45"
"2025-03-25","2025-03-25","SF FuneralFDC0000000N8G1250325","","31.63","","603242.08"
"2025-03-25","2025-03-25","SF FuneralF1118335      250325","","31.63","","603273.71"
"2025-03-25","2025-03-25","SF FuneralF1127417      250325","","31.63","","603305.34"
"2025-03-25","2025-03-25","SF FuneralF1128998      250325","","31.63","","603336.97"
"2025-03-25","2025-03-25","SF FuneralF1129356      250325","","31.63","","603368.6"
"2025-03-25","2025-03-25","SF FuneralF1132366      250325","","31.63","","603400.23"
"2025-03-25","2025-03-25","SF FuneralF1134866      250325","","31.63","","603431.86"
"2025-03-25","2025-03-24","SF FuneralF987310       250324","","31.63","","603463.49"
"2025-03-25","2025-03-22","SF FuneralFDC00000005KXR250322","","31.63","","603495.12"
"2025-03-25","2025-03-22","SF FuneralFDC000000039MC250322","","220","","603715.12"
"2025-03-25","2025-03-22","SF FuneralFDC00000005JNR250322","","126.5","","603841.62"
"2025-03-25","2025-03-22","SF FuneralFDC00000005Z24250322","","126.5","","603968.12"
"2025-03-25","2025-03-22","SF FuneralFDC0000000640S250322","","126.5","","604094.62"
"2025-03-25","2025-03-22","SF FuneralFDC00000006TPV250322","","126.5","","604221.12"
"2025-03-25","2025-03-22","SF FuneralFDC000000072RJ250322","","126.5","","604347.62"
"2025-03-25","2025-03-22","SF FuneralFDC000000079WK250322","","126.5","","604474.12"
"2025-03-25","2025-03-22","SF FuneralFDC00000007KRY250322","","126.5","","604600.62"
"2025-03-25","2025-03-22","SF FuneralFDC00000007KS7250322","","126.5","","604727.12"
"2025-03-25","2025-03-22","SF FuneralF798145       250322","","126.5","","604853.62"
"2025-03-25","2025-03-22","SF FuneralF798710       250322","","126.5","","604980.12"
"2025-03-25","2025-03-22","SF FuneralF801422       250322","","126.5","","605106.62"
"2025-03-25","2025-03-22","SF FuneralF804701       250322","","126.5","","605233.12"
"2025-03-25","2025-03-22","SF FuneralFDC00000008SF1250322","","126.5","","605359.62"
"2025-03-25","2025-03-22","SF FuneralF805615       250322","","126.5","","605486.12"
"2025-03-25","2025-03-22","SF FuneralF805618       250322","","126.5","","605612.62"
"2025-03-25","2025-03-22","SF FuneralF811771       250322","","126.5","","605739.12"
"2025-03-25","2025-03-22","SF FuneralF815165       250322","","126.5","","605865.62"
"2025-03-25","2025-03-22","SF FuneralFDC00000009YXK250322","","126.5","","605992.12"
"2025-03-25","2025-03-22","SF FuneralF819618       250322","","126.5","","606118.62"
"2025-03-25","2025-03-22","SF FuneralFDC0000000B59R250322","","126.5","","606245.12"
"2025-03-25","2025-03-22","SF FuneralF785624       250322","","126.5","","606371.62"
"2025-03-25","2025-03-22","SF FuneralF823509       250322","","126.5","","606498.12"
"2025-03-25","2025-03-22","SF FuneralF831231       250322","","126.5","","606624.62"
"2025-03-25","2025-03-22","SF FuneralF833546       250322","","126.5","","606751.12"
"2025-03-25","2025-03-22","SF FuneralF838858       250322","","126.5","","606877.62"
"2025-03-25","2025-03-22","SF FuneralF841651       250322","","126.5","","607004.12"
"2025-03-25","2025-03-22","SF FuneralF841874       250322","","126.5","","607130.62"
"2025-03-25","2025-03-22","SF FuneralF1020453      250322","","126.5","","607257.12"
"2025-03-25","2025-03-22","SF FuneralF1054799      250322","","126.5","","607383.62"
"2025-03-25","2025-03-22","SF FuneralF1054953      250322","","126.5","","607510.12"
"2025-03-25","2025-03-22","SF FuneralF1060864      250322","","126.5","","607636.62"
"2025-03-25","2025-03-22","SF FuneralF991470       250322","","126.5","","607763.12"
"2025-03-25","2025-03-22","SF FuneralF1074444      250322","","126.5","","607889.62"
"2025-03-25","2025-03-22","SF FuneralF1079341      250323","","126.5","","608016.12"
"2025-03-25","2025-03-22","SF FuneralF797148       250322","","126.5","","608142.62"
"2025-03-25","2025-03-22","SF FuneralFDC0000000LPQQ250322","","126.5","","608269.12"
"2025-03-25","2025-03-22","SF FuneralF1094338      250322","","126.5","","608395.62"
"2025-03-25","2025-03-22","SF FuneralF1108330      250322","","126.5","","608522.12"
"2025-03-25","2025-03-22","SF FuneralF1108336      250322","","126.5","","608648.62"
"2025-03-25","2025-03-22","SF FuneralF1108498      250322","","126.5","","608775.12"
"2025-03-25","2025-03-22","SF FuneralF1110432      250322","","126.5","","608901.62"
"2025-03-25","2025-03-22","SF FuneralF1113577      250322","","126.5","","609028.12"
"2025-03-25","2025-03-22","SF FuneralF1114429      250322","","126.5","","609154.62"
"2025-03-25","2025-03-22","SF FuneralF1114597      250322","","126.5","","609281.12"
"2025-03-25","2025-03-22","SF FuneralF1117248      250322","","126.5","","609407.62"
"2025-03-25","2025-03-22","SF FuneralF1118518      250322","","126.5","","609534.12"
"2025-03-25","2025-03-22","SF FuneralF1118947      250322","","126.5","","609660.62"
"2025-03-25","2025-03-22","SF FuneralF1119884      250322","","126.5","","609787.12"
"2025-03-25","2025-03-22","SF FuneralF1120777      250322","","126.5","","609913.62"
"2025-03-25","2025-03-22","SF FuneralF1122877      250322","","126.5","","610040.12"
"2025-03-25","2025-03-22","SF FuneralF1124349      250322","","126.5","","610166.62"
"2025-03-25","2025-03-22","SF FuneralF1124623      250322","","126.5","","610293.12"
"2025-03-25","2025-03-22","SF FuneralF1124835      250322","","126.5","","610419.62"
"2025-03-25","2025-03-22","SF FuneralF1126870      250322","","126.5","","610546.12"
"2025-03-25","2025-03-22","SF FuneralF1127579      250322","","126.5","","610672.62"
"2025-03-25","2025-03-22","SF FuneralF1127665      250322","","126.5","","610799.12"
"2025-03-25","2025-03-22","SF FuneralF1128355      250322","","126.5","","610925.62"
"2025-03-25","2025-03-22","SF FuneralF1129129      250322","","126.5","","611052.12"
"2025-03-25","2025-03-22","SF FuneralF1130027      250322","","126.5","","611178.62"
"2025-03-25","2025-03-22","SF FuneralFDC0000000QBXV250322","","126.5","","611305.12"
"2025-03-25","2025-03-22","SF FuneralF1133749      250322","","126.5","","611431.62"
"2025-03-25","2025-03-24","SF FuneralFDC0000000GC91250322","","126.5","","611558.12"
"2025-03-25","2025-03-24","SF FuneralFDC0000000GC9V250322","","126.5","","611684.62"
"2025-03-25","2025-03-24","SF FuneralF1066050      250324","","126.5","","611811.12"
"2025-03-25","2025-03-25","SF FuneralF811733       250325","","31.63","","611842.75"
"2025-03-25","2025-03-25","SF FuneralF831061       250325","","63.25","","611906"
"2025-03-25","2025-03-25","SF FuneralF1116023      250325","","126.5","","612032.5"
"2025-03-25","2025-03-25","SF FuneralFDC00000006L9F250325","","31.63","","612064.13"
"2025-03-25","2025-03-25","SF FuneralF1123172      250325","","31.63","","612095.76"
"2025-03-25","2025-03-20","SF FuneralFDC00000002VFK250320","","220","","612315.76"
"2025-03-25","2025-03-20","SF FuneralFDC000000063ZZ250320","","126.5","","612442.26"
"2025-03-25","2025-03-20","SF FuneralFDC000000064DJ250320","","126.5","","612568.76"
"2025-03-25","2025-03-20","SF FuneralF818016       250320","","126.5","","612695.26"
"2025-03-25","2025-03-20","SF FuneralF981846       250322","","126.5","","612821.76"
"2025-03-25","2025-03-20","SF FuneralF830936       250322","","126.5","","612948.26"
"2025-03-25","2025-03-20","SF FuneralF986990       250322","","126.5","","613074.76"
"2025-03-25","2025-03-20","SF FuneralFDC0000000HZKZ250322","","126.5","","613201.26"
"2025-03-25","2025-03-20","SF FuneralF991069       250322","","126.5","","613327.76"
"2025-03-25","2025-03-20","SF FuneralF991399       250322","","126.5","","613454.26"
"2025-03-25","2025-03-20","SF FuneralF1124376      250320","","126.5","","613580.76"
"2025-03-25","2025-03-20","SF FuneralF1124293      250320","","126.5","","613707.26"
"2025-03-25","2025-03-25","SF FuneralF1130807      250325","","126.5","","613833.76"
"2025-03-25","2025-03-20","SF FuneralFDC00000005ZZ6250320","","126.5","","613960.26"
"2025-03-25","2025-03-20","SF FuneralFDC00000006GR0250320","","126.5","","614086.76"
"2025-03-25","2025-03-20","SF FuneralF901336       250322","","126.5","","614213.26"
"2025-03-25","2025-03-20","SF FuneralF980694       250322","","126.5","","614339.76"
"2025-03-25","2025-03-20","SF FuneralF981476       250322","","126.5","","614466.26"
"2025-03-25","2025-03-20","SF FuneralF981844       250322","","126.5","","614592.76"
"2025-03-25","2025-03-20","SF FuneralF986710       250322","","126.5","","614719.26"
"2025-03-25","2025-03-20","SF FuneralF986906       250322","","126.5","","614845.76"
"2025-03-25","2025-03-20","SF FuneralF987128       250322","","126.5","","614972.26"
"2025-03-25","2025-03-20","SF FuneralF779244       250322","","126.5","","615098.76"
"2025-03-25","2025-03-20","SF FuneralF987143       250322","","126.5","","615225.26"
"2025-03-25","2025-03-20","SF FuneralF987205       250322","","126.5","","615351.76"
"2025-03-25","2025-03-20","SF FuneralF987251       250322","","126.5","","615478.26"
"2025-03-25","2025-03-20","SF FuneralF987538       250322","","126.5","","615604.76"
"2025-03-25","2025-03-20","SF FuneralF988622       250322","","126.5","","615731.26"
"2025-03-25","2025-03-20","SF FuneralF988778       250322","","126.5","","615857.76"
"2025-03-25","2025-03-20","SF FuneralFDC0000000HXDG250323","","126.5","","615984.26"
"2025-03-25","2025-03-20","SF FuneralF988843       250322","","126.5","","616110.76"
"2025-03-25","2025-03-20","SF FuneralF989259       250322","","126.5","","616237.26"
"2025-03-25","2025-03-20","SF FuneralF989333       250322","","126.5","","616363.76"
"2025-03-25","2025-03-20","SF FuneralF989453       250322","","126.5","","616490.26"
"2025-03-25","2025-03-20","SF FuneralF991427       250322","","126.5","","616616.76"
"2025-03-25","2025-03-20","SF FuneralF991554       250322","","126.5","","616743.26"
"2025-03-25","2025-03-20","SF FuneralFDC0000000JHG4250321","","126.5","","616869.76"
"2025-03-25","2025-03-20","SF FuneralF1021234      250321","","126.5","","616996.26"
"2025-03-25","2025-03-20","SF FuneralF1080460      250320","","126.5","","617122.76"
"2025-03-25","2025-03-20","SF FuneralF1104054      250320","","126.5","","617249.26"
"2025-03-25","2025-03-20","SF FuneralF1110166      250320","","126.5","","617375.76"
"2025-03-25","2025-03-20","SF FuneralF1112127      250321","","126.5","","617502.26"
"2025-03-25","2025-03-20","SF FuneralF1127903      250321","","126.5","","617628.76"
"2025-03-25","2025-03-20","SF FuneralF792792       250321","","220","","617848.76"
"2025-03-25","2025-03-22","SF FuneralFDC00000005PBH250322","","126.5","","617975.26"
"2025-03-25","2025-03-22","SF FuneralFDC000000062YG250322","","126.5","","618101.76"
"2025-03-25","2025-03-22","SF FuneralFDC0000000630S250322","","126.5","","618228.26"
"2025-03-25","2025-03-22","SF FuneralFDC00000007J0Y250322","","126.5","","618354.76"
"2025-03-25","2025-03-22","SF FuneralFDC00000007JGM250322","","126.5","","618481.26"
"2025-03-25","2025-03-22","SF FuneralFDC00000007JGY250322","","126.5","","618607.76"
"2025-03-25","2025-03-22","SF FuneralFDC00000007JX2250322","","126.5","","618734.26"
"2025-03-25","2025-03-22","SF FuneralFDC00000007JXZ250322","","126.5","","618860.76"
"2025-03-25","2025-03-22","SF FuneralF1065704      250322","","126.5","","618987.26"
"2025-03-25","2025-03-22","SF FuneralF1073720      250322","","126.5","","619113.76"
"2025-03-25","2025-03-22","SF FuneralF1074759      250322","","126.5","","619240.26"
"2025-03-25","2025-03-22","SF FuneralF1084352      250322","","126.5","","619366.76"
"2025-03-25","2025-03-22","SF FuneralF1108643      250322","","126.5","","619493.26"
"2025-03-25","2025-03-22","SF FuneralF1108676      250322","","126.5","","619619.76"
"2025-03-25","2025-03-22","SF FuneralF1108721      250322","","126.5","","619746.26"
"2025-03-25","2025-03-22","SF FuneralF1108906      250322","","126.5","","619872.76"
"2025-03-25","2025-03-22","SF FuneralF1110808      250322","","126.5","","619999.26"
"2025-03-25","2025-03-22","SF FuneralFDC0000000MS44250322","","126.5","","620125.76"
"2025-03-25","2025-03-22","SF FuneralF1111991      250322","","126.5","","620252.26"
"2025-03-25","2025-03-22","SF FuneralF1112006      250322","","126.5","","620378.76"
"2025-03-25","2025-03-22","SF FuneralF1112121      250322","","126.5","","620505.26"
"2025-03-25","2025-03-22","SF FuneralF1112167      250322","","126.5","","620631.76"
"2025-03-25","2025-03-22","SF FuneralF1112248      250322","","126.5","","620758.26"
"2025-03-25","2025-03-22","SF FuneralF1112257      250322","","126.5","","620884.76"
"2025-03-25","2025-03-22","SF FuneralF1112371      250322","","126.5","","621011.26"
"2025-03-25","2025-03-22","SF FuneralF1112576      250322","","126.5","","621137.76"
"2025-03-25","2025-03-22","SF FuneralF1114404      250322","","126.5","","621264.26"
"2025-03-25","2025-03-22","SF FuneralF1114411      250322","","126.5","","621390.76"
"2025-03-25","2025-03-22","SF FuneralF1114945      250322","","126.5","","621517.26"
"2025-03-25","2025-03-22","SF FuneralFDC0000000ND5V250322","","126.5","","621643.76"
"2025-03-25","2025-03-22","SF FuneralF787947       250322","","126.5","","621770.26"
"2025-03-25","2025-03-22","SF FuneralF1116085      250322","","126.5","","621896.76"
"2025-03-25","2025-03-22","SF FuneralF1116094      250322","","126.5","","622023.26"
"2025-03-25","2025-03-22","SF FuneralF1116118      250322","","126.5","","622149.76"
"2025-03-25","2025-03-22","SF FuneralF1117582      250322","","126.5","","622276.26"
"2025-03-25","2025-03-22","SF FuneralF1120918      250322","","126.5","","622402.76"
"2025-03-25","2025-03-22","SF FuneralFDC0000000P09G250322","","126.5","","622529.26"
"2025-03-25","2025-03-22","SF FuneralF1122333      250322","","126.5","","622655.76"
"2025-03-25","2025-03-22","SF FuneralF1122938      250322","","126.5","","622782.26"
"2025-03-25","2025-03-22","SF FuneralF1123040      250322","","126.5","","622908.76"
"2025-03-25","2025-03-22","SF FuneralF1125846      250322","","126.5","","623035.26"
"2025-03-25","2025-03-22","SF FuneralF1127862      250322","","126.5","","623161.76"
"2025-03-25","2025-03-22","SF FuneralF1130418      250322","","126.5","","623288.26"
"2025-03-25","2025-03-22","SF FuneralF1122321      250322","","126.5","","623414.76"
"2025-03-25","2025-03-22","SF FuneralF1132291      250322","","126.5","","623541.26"
"2025-03-25","2025-03-22","SF FuneralF1132338      250322","","126.5","","623667.76"
"2025-03-25","2025-03-22","SF FuneralF1133150      250322","","126.5","","623794.26"
"2025-03-25","2025-03-22","SF FuneralF1133198      250322","","126.5","","623920.76"
"2025-03-25","2025-03-22","SF FuneralF1133255      250322","","126.5","","624047.26"
"2025-03-25","2025-03-22","SF FuneralFDC0000000QCS1250322","","126.5","","624173.76"
"2025-03-25","2025-03-22","SF FuneralF1133494      250322","","126.5","","624300.26"
"2025-03-25","2025-03-22","SF FuneralF1133705      250322","","126.5","","624426.76"
"2025-03-25","2025-03-22","SF FuneralFDC00000002T32250322","","220","","624646.76"
"2025-03-25","2025-03-22","SF FuneralFDC00000002X18250322","","220","","624866.76"
"2025-03-25","2025-03-22","SF FuneralFDC00000003085250322","","220","","625086.76"
"2025-03-25","2025-03-22","SF FuneralFDC000000030QM250322","","220","","625306.76"
"2025-03-25","2025-03-22","SF FuneralFDC000000031C3250322","","220","","625526.76"
"2025-03-25","2025-03-22","SF FuneralFDC0000000340D250322","","220","","625746.76"
"2025-03-25","2025-03-22","SF FuneralFDC000000037LR250322","","220","","625966.76"
"2025-03-25","2025-03-22","SF FuneralFDC000000037LS250322","","220","","626186.76"
"2025-03-25","2025-03-22","SF FuneralFDC000000037ZP250322","","220","","626406.76"
"2025-03-25","2025-03-22","SF FuneralFDC00000003CVT250322","","220","","626626.76"
"2025-03-25","2025-03-22","SF FuneralFDC00000003D66250322","","220","","626846.76"
"2025-03-25","2025-03-22","SF FuneralFDC00000003JFB250321","","220","","627066.76"
"2025-03-25","2025-03-22","SF FuneralFDC00000003X1F250321","","220","","627286.76"
"2025-03-25","2025-03-22","SF FuneralFDC000000058N5250322","","126.5","","627413.26"
"2025-03-25","2025-03-22","SF FuneralFDC00000005JNX250322","","126.5","","627539.76"
"2025-03-25","2025-03-22","SF FuneralFDC00000005SKV250322","","126.5","","627666.26"
"2025-03-25","2025-03-22","SF FuneralFDC00000005TFL250322","","126.5","","627792.76"
"2025-03-25","2025-03-22","SF FuneralFDC00000005V39250322","","126.5","","627919.26"
"2025-03-25","2025-03-22","SF FuneralFDC00000005V69250322","","191.5","","628110.76"
"2025-03-25","2025-03-22","SF FuneralFDC00000005XBY250322","","220","","628330.76"
"2025-03-25","2025-03-22","SF FuneralFDC00000005XWT250322","","126.5","","628457.26"
"2025-03-25","2025-03-22","SF FuneralFDC00000005Z3G250322","","126.5","","628583.76"
"2025-03-25","2025-03-22","SF FuneralFDC00000005Z3H250322","","126.5","","628710.26"
"2025-03-25","2025-03-22","SF FuneralFDC00000005ZBD250322","","126.5","","628836.76"
"2025-03-25","2025-03-22","SF FuneralFDC00000005ZL2250322","","126.5","","628963.26"
"2025-03-25","2025-03-22","SF FuneralFDC00000005ZMJ250322","","126.5","","629089.76"
"2025-03-25","2025-03-22","SF FuneralFDC00000005ZQ8250322","","126.5","","629216.26"
"2025-03-25","2025-03-22","SF FuneralFDC00000005ZVW250322","","126.5","","629342.76"
"2025-03-25","2025-03-22","SF FuneralFDC00000005ZWV250322","","126.5","","629469.26"
"2025-03-25","2025-03-22","SF FuneralFDC00000005ZX8250322","","126.5","","629595.76"
"2025-03-25","2025-03-22","SF FuneralFDC00000005ZYK250321","","126.5","","629722.26"
"2025-03-25","2025-03-22","SF FuneralFDC000000060BW250322","","126.5","","629848.76"
"2025-03-25","2025-03-22","SF FuneralFDC000000060L2250322","","126.5","","629975.26"
"2025-03-25","2025-03-22","SF FuneralFDC000000060TX250322","","126.5","","630101.76"
"2025-03-25","2025-03-22","SF FuneralFDC00000006105250322","","126.5","","630228.26"
"2025-03-25","2025-03-22","SF FuneralFDC000000061YT250322","","126.5","","630354.76"
"2025-03-25","2025-03-22","SF FuneralFDC0000000627W250322","","126.5","","630481.26"
"2025-03-25","2025-03-22","SF FuneralFDC000000062JQ250322","","126.5","","630607.76"
"2025-03-25","2025-03-22","SF FuneralFDC000000063C5250322","","126.5","","630734.26"
"2025-03-25","2025-03-22","SF FuneralFDC000000063GH250322","","126.5","","630860.76"
"2025-03-25","2025-03-22","SF FuneralFDC00000006438250322","","126.5","","630987.26"
"2025-03-25","2025-03-22","SF FuneralFDC000000064F5250322","","126.5","","631113.76"
"2025-03-25","2025-03-22","SF FuneralFDC000000064JW250322","","126.5","","631240.26"
"2025-03-25","2025-03-22","SF FuneralFDC000000064RH250322","","126.5","","631366.76"
"2025-03-25","2025-03-22","SF FuneralFDC0000000659H250322","","126.5","","631493.26"
"2025-03-25","2025-03-22","SF FuneralFDC000000065H2250322","","126.5","","631619.76"
"2025-03-25","2025-03-22","SF FuneralFDC000000065NY250322","","126.5","","631746.26"
"2025-03-25","2025-03-22","SF FuneralFDC00000006625250322","","126.5","","631872.76"
"2025-03-25","2025-03-22","SF FuneralFDC00000006686250322","","126.5","","631999.26"
"2025-03-25","2025-03-22","SF FuneralFDC00000006947250322","","126.5","","632125.76"
"2025-03-25","2025-03-22","SF FuneralFDC0000000698S250322","","126.5","","632252.26"
"2025-03-25","2025-03-22","SF FuneralFDC000000069RG250322","","126.5","","632378.76"
"2025-03-25","2025-03-22","SF FuneralFDC00000006BLQ250322","","126.5","","632505.26"
"2025-03-25","2025-03-22","SF FuneralFDC00000006FNG250322","","126.5","","632631.76"
"2025-03-25","2025-03-22","SF FuneralFDC00000006HYD250322","","126.5","","632758.26"
"2025-03-25","2025-03-22","SF FuneralFDC00000006J1C250322","","126.5","","632884.76"
"2025-03-25","2025-03-22","SF FuneralFDC00000006KF1250322","","126.5","","633011.26"
"2025-03-25","2025-03-22","SF FuneralFDC00000006KKP250322","","126.5","","633137.76"
"2025-03-25","2025-03-22","SF FuneralFDC00000006MDH250322","","126.5","","633264.26"
"2025-03-25","2025-03-22","SF FuneralFDC00000006PS8250322","","126.5","","633390.76"
"2025-03-25","2025-03-22","SF FuneralFDC00000006PSD250322","","126.5","","633517.26"
"2025-03-25","2025-03-22","SF FuneralFDC00000006PVN250321","","126.5","","633643.76"
"2025-03-25","2025-03-22","SF FuneralFDC00000006R8Y250322","","126.5","","633770.26"
"2025-03-25","2025-03-22","SF FuneralFDC00000006RLZ250322","","126.5","","633896.76"
"2025-03-25","2025-03-22","SF FuneralFDC00000006SHH250322","","126.5","","634023.26"
"2025-03-25","2025-03-22","SF FuneralFDC00000006SQH250322","","126.5","","634149.76"
"2025-03-25","2025-03-22","SF FuneralFDC00000006T4X250322","","126.5","","634276.26"
"2025-03-25","2025-03-22","SF FuneralFDC00000006T86250322","","126.5","","634402.76"
"2025-03-25","2025-03-22","SF FuneralFDC00000006TSY250322","","220","","634622.76"
"2025-03-25","2025-03-22","SF FuneralFDC00000006V60250322","","126.5","","634749.26"
"2025-03-25","2025-03-22","SF FuneralFDC00000006V63250322","","126.5","","634875.76"
"2025-03-25","2025-03-22","SF FuneralFDC00000006VBB250322","","126.5","","635002.26"
"2025-03-25","2025-03-22","SF FuneralFDC00000006VP1250322","","126.5","","635128.76"
"2025-03-25","2025-03-22","SF FuneralFDC00000006VP2250322","","126.5","","635255.26"
"2025-03-25","2025-03-22","SF FuneralFDC00000006W6N250322","","126.5","","635381.76"
"2025-03-25","2025-03-22","SF FuneralFDC00000006W6P250322","","126.5","","635508.26"
"2025-03-25","2025-03-22","SF FuneralFDC00000006WL5250322","","126.5","","635634.76"
"2025-03-25","2025-03-22","SF FuneralFDC00000006WYR250322","","126.5","","635761.26"
"2025-03-25","2025-03-22","SF FuneralFDC00000006WYX250322","","126.5","","635887.76"
"2025-03-25","2025-03-22","SF FuneralFDC00000006X0G250322","","126.5","","636014.26"
"2025-03-25","2025-03-22","SF FuneralFDC00000006XJF250322","","126.5","","636140.76"
"2025-03-25","2025-03-22","SF FuneralFDC00000006XKD250322","","126.5","","636267.26"
"2025-03-25","2025-03-22","SF FuneralFDC00000006XRT250321","","126.5","","636393.76"
"2025-03-25","2025-03-22","SF FuneralFDC00000006XTC250322","","126.5","","636520.26"
"2025-03-25","2025-03-22","SF FuneralFDC00000006XTN250322","","126.5","","636646.76"
"2025-03-25","2025-03-22","SF FuneralFDC00000006Y7W250322","","126.5","","636773.26"
"2025-03-25","2025-03-22","SF FuneralFDC00000006Y9P250322","","126.5","","636899.76"
"2025-03-25","2025-03-22","SF FuneralFDC00000006YDY250322","","126.5","","637026.26"
"2025-03-25","2025-03-22","SF FuneralFDC00000006YJN250322","","126.5","","637152.76"
"2025-03-25","2025-03-22","SF FuneralFDC00000006YKK250322","","126.5","","637279.26"
"2025-03-25","2025-03-22","SF FuneralFDC00000006YQF250322","","220","","637499.26"
"2025-03-25","2025-03-22","SF FuneralFDC00000006YVW250322","","126.5","","637625.76"
"2025-03-25","2025-03-22","SF FuneralFDC00000006Z7C250322","","126.5","","637752.26"
"2025-03-25","2025-03-22","SF FuneralFDC00000006Z7G250322","","126.5","","637878.76"
"2025-03-25","2025-03-22","SF FuneralFDC00000006ZX0250322","","126.5","","638005.26"
"2025-03-25","2025-03-22","SF FuneralFDC0000000711K250322","","126.5","","638131.76"
"2025-03-25","2025-03-22","SF FuneralFDC0000000720Q250322","","126.5","","638258.26"
"2025-03-25","2025-03-22","SF FuneralFDC000000073JX250322","","126.5","","638384.76"
"2025-03-25","2025-03-22","SF FuneralFDC0000000748R250321","","126.5","","638511.26"
"2025-03-25","2025-03-22","SF FuneralFDC000000074S4250322","","126.5","","638637.76"
"2025-03-25","2025-03-22","SF FuneralFDC000000074VG250322","","126.5","","638764.26"
"2025-03-25","2025-03-22","SF FuneralFDC000000076LX250322","","126.5","","638890.76"
"2025-03-25","2025-03-22","SF FuneralFDC000000076RT250322","","126.5","","639017.26"
"2025-03-25","2025-03-22","SF FuneralFDC000000076RZ250322","","126.5","","639143.76"
"2025-03-25","2025-03-22","SF FuneralFDC0000000794N250322","","126.5","","639270.26"
"2025-03-25","2025-03-22","SF FuneralFDC000000079BG250322","","126.5","","639396.76"
"2025-03-25","2025-03-22","SF FuneralFDC00000007B3K250322","","126.5","","639523.26"
"2025-03-25","2025-03-22","SF FuneralFDC00000007B6H250321","","126.5","","639649.76"
"2025-03-25","2025-03-22","SF FuneralFDC00000007FC0250322","","126.5","","639776.26"
"2025-03-25","2025-03-22","SF FuneralFDC00000007HH9250321","","126.5","","639902.76"
"2025-03-25","2025-03-22","SF FuneralFDC00000007HJ6250322","","126.5","","640029.26"
"2025-03-25","2025-03-22","SF FuneralFDC00000007HYF250322","","126.5","","640155.76"
"2025-03-25","2025-03-22","SF FuneralFDC00000007L73250322","","126.5","","640282.26"
"2025-03-25","2025-03-22","SF FuneralFDC00000007LJP250322","","126.5","","640408.76"
"2025-03-25","2025-03-22","SF FuneralFDC00000007MH8250322","","126.5","","640535.26"
"2025-03-25","2025-03-22","SF FuneralFDC00000007MW0250322","","126.5","","640661.76"
"2025-03-25","2025-03-22","SF FuneralFDC00000007NPV250322","","126.5","","640788.26"
"2025-03-25","2025-03-22","SF FuneralFDC00000007Q3Z250322","","126.5","","640914.76"
"2025-03-25","2025-03-22","SF FuneralFDC00000007RR4250322","","126.5","","641041.26"
"2025-03-25","2025-03-22","SF FuneralF794522       250322","","126.5","","641167.76"
"2025-03-25","2025-03-22","SF FuneralFDC00000007SZ9250322","","126.5","","641294.26"
"2025-03-25","2025-03-22","SF FuneralFDC00000007VGY250321","","126.5","","641420.76"
"2025-03-25","2025-03-22","SF FuneralFDC00000007VSR250322","","126.5","","641547.26"
"2025-03-25","2025-03-22","SF FuneralFDC00000007W03250322","","126.5","","641673.76"
"2025-03-25","2025-03-22","SF FuneralFDC00000007W65250322","","126.5","","641800.26"
"2025-03-25","2025-03-22","SF FuneralFDC00000007YHN250322","","126.5","","641926.76"
"2025-03-25","2025-03-22","SF FuneralFDC00000007YVT250322","","126.5","","642053.26"
"2025-03-25","2025-03-22","SF FuneralFDC00000007ZWC250322","","126.5","","642179.76"
"2025-03-25","2025-03-22","SF FuneralFDC000000080TP250321","","126.5","","642306.26"
"2025-03-25","2025-03-22","SF FuneralFDC00000008136250322","","126.5","","642432.76"
"2025-03-25","2025-03-22","SF FuneralFDC000000081DZ250322","","126.5","","642559.26"
"2025-03-25","2025-03-22","SF FuneralFDC00000008284250322","","126.5","","642685.76"
"2025-03-25","2025-03-22","SF FuneralFDC000000082DL250322","","126.5","","642812.26"
"2025-03-25","2025-03-22","SF FuneralFDC000000082JV250322","","126.5","","642938.76"
"2025-03-25","2025-03-22","SF FuneralFDC0000000837Q250322","","126.5","","643065.26"
"2025-03-25","2025-03-22","SF FuneralFDC000000083D2250322","","126.5","","643191.76"
"2025-03-25","2025-03-22","SF FuneralF798370       250322","","126.5","","643318.26"
"2025-03-25","2025-03-22","SF FuneralFDC000000086MN250322","","126.5","","643444.76"
"2025-03-25","2025-03-22","SF FuneralFDC00000008FL2250322","","126.5","","643571.26"
"2025-03-25","2025-03-22","SF FuneralF801210       250322","","126.5","","643697.76"
"2025-03-25","2025-03-22","SF FuneralF801266       250322","","126.5","","643824.26"
"2025-03-25","2025-03-22","SF FuneralFDC00000008G01250322","","126.5","","643950.76"
"2025-03-25","2025-03-22","SF FuneralFDC00000008G73250322","","126.5","","644077.26"
"2025-03-25","2025-03-22","SF FuneralF801424       250322","","126.5","","644203.76"
"2025-03-25","2025-03-22","SF FuneralF801475       250322","","126.5","","644330.26"
"2025-03-25","2025-03-22","SF FuneralF801543       250322","","126.5","","644456.76"
"2025-03-25","2025-03-22","SF FuneralFDC00000008HYN250322","","126.5","","644583.26"
"2025-03-25","2025-03-22","SF FuneralFDC00000008HZX250322","","126.5","","644709.76"
"2025-03-25","2025-03-22","SF FuneralF802087       250322","","126.5","","644836.26"
"2025-03-25","2025-03-22","SF FuneralFDC00000008JC4250322","","126.5","","644962.76"
"2025-03-25","2025-03-22","SF FuneralF802207       250322","","126.5","","645089.26"
"2025-03-25","2025-03-22","SF FuneralF802296       250322","","126.5","","645215.76"
"2025-03-25","2025-03-22","SF FuneralF803286       250322","","126.5","","645342.26"
"2025-03-25","2025-03-22","SF FuneralF803364       250322","","126.5","","645468.76"
"2025-03-25","2025-03-22","SF FuneralFDC00000008N5F250322","","126.5","","645595.26"
"2025-03-25","2025-03-22","SF FuneralF804239       250322","","126.5","","645721.76"
"2025-03-25","2025-03-22","SF FuneralF805416       250322","","126.5","","645848.26"
"2025-03-25","2025-03-22","SF FuneralFDC00000008V0C250321","","126.5","","645974.76"
"2025-03-25","2025-03-22","SF FuneralF805490       250322","","126.5","","646101.26"
"2025-03-25","2025-03-22","SF FuneralFDC00000008V7W250322","","126.5","","646227.76"
"2025-03-25","2025-03-22","SF FuneralF805765       250322","","126.5","","646354.26"
"2025-03-25","2025-03-22","SF FuneralF805799       250322","","126.5","","646480.76"
"2025-03-25","2025-03-22","SF FuneralF805865       250322","","126.5","","646607.26"
"2025-03-25","2025-03-22","SF FuneralF808139       250322","","126.5","","646733.76"
"2025-03-25","2025-03-22","SF FuneralF808286       250321","","126.5","","646860.26"
"2025-03-25","2025-03-22","SF FuneralFDC00000008ZMS250322","","126.5","","646986.76"
"2025-03-25","2025-03-22","SF FuneralFDC000000094FC250322","","126.5","","647113.26"
"2025-03-25","2025-03-22","SF FuneralF809915       250322","","126.5","","647239.76"
"2025-03-25","2025-03-22","SF FuneralFDC000000096MY250322","","126.5","","647366.26"
"2025-03-25","2025-03-22","SF FuneralF811091       250321","","126.5","","647492.76"
"2025-03-25","2025-03-22","SF FuneralF811177       250322","","126.5","","647619.26"
"2025-03-25","2025-03-22","SF FuneralF811197       250322","","126.5","","647745.76"
"2025-03-25","2025-03-22","SF FuneralFDC000000098VG250322","","126.5","","647872.26"
"2025-03-25","2025-03-22","SF FuneralF811354       250322","","126.5","","647998.76"
"2025-03-25","2025-03-22","SF FuneralF811424       250322","","126.5","","648125.26"
"2025-03-25","2025-03-22","SF FuneralF811573       250322","","126.5","","648251.76"
"2025-03-25","2025-03-22","SF FuneralF811647       250322","","126.5","","648378.26"
"2025-03-25","2025-03-22","SF FuneralF811787       250322","","126.5","","648504.76"
"2025-03-25","2025-03-22","SF FuneralF812034       250322","","126.5","","648631.26"
"2025-03-25","2025-03-22","SF FuneralF812630       250322","","126.5","","648757.76"
"2025-03-25","2025-03-22","SF FuneralF813548       250322","","126.5","","648884.26"
"2025-03-25","2025-03-22","SF FuneralF794097       250322","","191.5","","649075.76"
"2025-03-25","2025-03-22","SF FuneralF813949       250322","","126.5","","649202.26"
"2025-03-25","2025-03-22","SF FuneralFDC00000009N16250322","","126.5","","649328.76"
"2025-03-25","2025-03-22","SF FuneralF815101       250322","","126.5","","649455.26"
"2025-03-25","2025-03-22","SF FuneralF815157       250322","","126.5","","649581.76"
"2025-03-25","2025-03-22","SF FuneralF815174       250322","","126.5","","649708.26"
"2025-03-25","2025-03-22","SF FuneralF815268       250322","","126.5","","649834.76"
"2025-03-25","2025-03-22","SF FuneralF815307       250322","","126.5","","649961.26"
"2025-03-25","2025-03-22","SF FuneralF815321       250322","","126.5","","650087.76"
"2025-03-25","2025-03-22","SF FuneralF815322       250322","","126.5","","650214.26"
"2025-03-25","2025-03-22","SF FuneralF815418       250322","","126.5","","650340.76"
"2025-03-25","2025-03-22","SF FuneralF815541       250322","","126.5","","650467.26"
"2025-03-25","2025-03-22","SF FuneralF815732       250321","","126.5","","650593.76"
"2025-03-25","2025-03-22","SF FuneralF815770       250322","","126.5","","650720.26"
"2025-03-25","2025-03-22","SF FuneralF815831       250322","","126.5","","650846.76"
"2025-03-25","2025-03-22","SF FuneralF816160       250322","","126.5","","650973.26"
"2025-03-25","2025-03-22","SF FuneralF817624       250322","","126.5","","651099.76"
"2025-03-25","2025-03-22","SF FuneralF817881       250322","","126.5","","651226.26"
"2025-03-25","2025-03-22","SF FuneralF818146       250322","","126.5","","651352.76"
"2025-03-25","2025-03-22","SF FuneralF818384       250322","","126.5","","651479.26"
"2025-03-25","2025-03-22","SF FuneralF818830       250322","","126.5","","651605.76"
"2025-03-25","2025-03-22","SF FuneralF819315       250322","","126.5","","651732.26"
"2025-03-25","2025-03-22","SF FuneralF819323       250322","","126.5","","651858.76"
"2025-03-25","2025-03-22","SF FuneralF819537       250322","","126.5","","651985.26"
"2025-03-25","2025-03-22","SF FuneralF819543       250322","","126.5","","652111.76"
"2025-03-25","2025-03-22","SF FuneralF819625       250322","","126.5","","652238.26"
"2025-03-25","2025-03-22","SF FuneralF819878       250322","","126.5","","652364.76"
"2025-03-25","2025-03-22","SF FuneralF820527       250322","","126.5","","652491.26"
"2025-03-25","2025-03-22","SF FuneralF821017       250322","","126.5","","652617.76"
"2025-03-25","2025-03-22","SF FuneralF821117       250322","","126.5","","652744.26"
"2025-03-25","2025-03-22","SF FuneralF821147       250322","","126.5","","652870.76"
"2025-03-25","2025-03-22","SF FuneralF821178       250322","","126.5","","652997.26"
"2025-03-25","2025-03-22","SF FuneralF821476       250322","","126.5","","653123.76"
"2025-03-25","2025-03-22","SF FuneralFDC0000000BBCW250322","","126.5","","653250.26"
"2025-03-25","2025-03-22","SF FuneralFDC0000000BBY2250322","","126.5","","653376.76"
"2025-03-25","2025-03-22","SF FuneralF822667       250322","","126.5","","653503.26"
"2025-03-25","2025-03-22","SF FuneralF823062       250322","","126.5","","653629.76"
"2025-03-25","2025-03-22","SF FuneralF823169       250322","","126.5","","653756.26"
"2025-03-25","2025-03-22","SF FuneralF823179       250322","","126.5","","653882.76"
"2025-03-25","2025-03-22","SF FuneralF823276       250322","","126.5","","654009.26"
"2025-03-25","2025-03-22","SF FuneralF823413       250322","","126.5","","654135.76"
"2025-03-25","2025-03-22","SF FuneralF823643       250322","","126.5","","654262.26"
"2025-03-25","2025-03-22","SF FuneralF823774       250322","","126.5","","654388.76"
"2025-03-25","2025-03-22","SF FuneralF823871       250322","","126.5","","654515.26"
"2025-03-25","2025-03-22","SF FuneralF823979       250322","","126.5","","654641.76"
"2025-03-25","2025-03-22","SF FuneralFDC0000000BMH8250322","","126.5","","654768.26"
"2025-03-25","2025-03-22","SF FuneralF827727       250322","","126.5","","654894.76"
"2025-03-25","2025-03-22","SF FuneralF828797       250322","","126.5","","655021.26"
"2025-03-25","2025-03-22","SF FuneralF829525       250322","","126.5","","655147.76"
"2025-03-25","2025-03-22","SF FuneralF829925       250322","","126.5","","655274.26"
"2025-03-25","2025-03-22","SF FuneralF830821       250322","","126.5","","655400.76"
"2025-03-25","2025-03-22","SF FuneralF830834       250322","","126.5","","655527.26"
"2025-03-25","2025-03-22","SF FuneralF830848       250322","","126.5","","655653.76"
"2025-03-25","2025-03-22","SF FuneralF831034       250322","","126.5","","655780.26"
"2025-03-25","2025-03-22","SF FuneralF831377       250321","","126.5","","655906.76"
"2025-03-25","2025-03-22","SF FuneralF831843       250322","","126.5","","656033.26"
"2025-03-25","2025-03-22","SF FuneralFDC0000000CH50250322","","126.5","","656159.76"
"2025-03-25","2025-03-22","SF FuneralF832094       250322","","126.5","","656286.26"
"2025-03-25","2025-03-22","SF FuneralF832232       250322","","126.5","","656412.76"
"2025-03-25","2025-03-22","SF FuneralFDC0000000CKHP250322","","126.5","","656539.26"
"2025-03-25","2025-03-22","SF FuneralFDC0000000CPMP250322","","126.5","","656665.76"
"2025-03-25","2025-03-22","SF FuneralF832995       250322","","126.5","","656792.26"
"2025-03-25","2025-03-22","SF FuneralF833210       250322","","126.5","","656918.76"
"2025-03-25","2025-03-22","SF FuneralF833495       250322","","126.5","","657045.26"
"2025-03-25","2025-03-22","SF FuneralF833877       250322","","126.5","","657171.76"
"2025-03-25","2025-03-22","SF FuneralF834015       250322","","126.5","","657298.26"
"2025-03-25","2025-03-22","SF FuneralF834070       250322","","126.5","","657424.76"
"2025-03-25","2025-03-22","SF FuneralF838818       250322","","126.5","","657551.26"
"2025-03-25","2025-03-22","SF FuneralFDC0000000D6CZ250322","","126.5","","657677.76"
"2025-03-25","2025-03-22","SF FuneralF838844       250322","","126.5","","657804.26"
"2025-03-25","2025-03-22","SF FuneralF838869       250322","","126.5","","657930.76"
"2025-03-25","2025-03-22","SF FuneralF840713       250322","","126.5","","658057.26"
"2025-03-25","2025-03-22","SF FuneralF840764       250322","","126.5","","658183.76"
"2025-03-25","2025-03-22","SF FuneralF840778       250322","","126.5","","658310.26"
"2025-03-25","2025-03-22","SF FuneralF840888       250322","","126.5","","658436.76"
"2025-03-25","2025-03-22","SF FuneralF840954       250322","","126.5","","658563.26"
"2025-03-25","2025-03-22","SF FuneralF840959       250322","","126.5","","658689.76"
"2025-03-25","2025-03-22","SF FuneralF841059       250322","","126.5","","658816.26"
"2025-03-25","2025-03-22","SF FuneralF841228       250322","","126.5","","658942.76"
"2025-03-25","2025-03-22","SF FuneralF842001       250322","","126.5","","659069.26"
"2025-03-25","2025-03-22","SF FuneralFDC0000000J589250322","","126.5","","659195.76"
"2025-03-25","2025-03-22","SF FuneralFDC0000000J5BL250322","","126.5","","659322.26"
"2025-03-25","2025-03-22","SF FuneralFDC0000000J5CV250322","","126.5","","659448.76"
"2025-03-25","2025-03-22","SF FuneralF991644       250322","","126.5","","659575.26"
"2025-03-25","2025-03-22","SF FuneralF991749       250322","","126.5","","659701.76"
"2025-03-25","2025-03-22","SF FuneralFDC0000000JB8Y250322","","126.5","","659828.26"
"2025-03-25","2025-03-22","SF FuneralF993610       250322","","126.5","","659954.76"
"2025-03-25","2025-03-22","SF FuneralF993648       250322","","126.5","","660081.26"
"2025-03-25","2025-03-22","SF FuneralF1016987      250322","","126.5","","660207.76"
"2025-03-25","2025-03-22","SF FuneralF1017641      250322","","126.5","","660334.26"
"2025-03-25","2025-03-22","SF FuneralF1017779      250322","","126.5","","660460.76"
"2025-03-25","2025-03-22","SF FuneralF1017809      250322","","126.5","","660587.26"
"2025-03-25","2025-03-22","SF FuneralF1020444      250322","","126.5","","660713.76"
"2025-03-25","2025-03-22","SF FuneralFDC0000000JN0G250322","","126.5","","660840.26"
"2025-03-25","2025-03-22","SF FuneralF1020500      250322","","126.5","","660966.76"
"2025-03-25","2025-03-22","SF FuneralF1020596      250322","","126.5","","661093.26"
"2025-03-25","2025-03-22","SF FuneralF1020667      250322","","126.5","","661219.76"
"2025-03-25","2025-03-22","SF FuneralF1020887      250322","","126.5","","661346.26"
"2025-03-25","2025-03-22","SF FuneralF1021394      250322","","126.5","","661472.76"
"2025-03-25","2025-03-22","SF FuneralF1022101      250322","","126.5","","661599.26"
"2025-03-25","2025-03-22","SF FuneralF801464       250322","","126.5","","661725.76"
"2025-03-25","2025-03-22","SF FuneralFDC0000000K3QC250322","","126.5","","661852.26"
"2025-03-25","2025-03-22","SF FuneralFDC0000000K3QT250322","","126.5","","661978.76"
"2025-03-25","2025-03-22","SF FuneralF1054581      250322","","126.5","","662105.26"
"2025-03-25","2025-03-22","SF FuneralF1054637      250322","","126.5","","662231.76"
"2025-03-25","2025-03-22","SF FuneralF1054774      250322","","126.5","","662358.26"
"2025-03-25","2025-03-22","SF FuneralF1054797      250322","","126.5","","662484.76"
"2025-03-25","2025-03-22","SF FuneralFDC0000000K6N6250322","","126.5","","662611.26"
"2025-03-25","2025-03-22","SF FuneralF1055271      250322","","126.5","","662737.76"
"2025-03-25","2025-03-22","SF FuneralF1055302      250322","","126.5","","662864.26"
"2025-03-25","2025-03-22","SF FuneralF1058861      250322","","126.5","","662990.76"
"2025-03-25","2025-03-22","SF FuneralFDC0000000KC34250322","","126.5","","663117.26"
"2025-03-25","2025-03-22","SF FuneralF1059873      250322","","126.5","","663243.76"
"2025-03-25","2025-03-22","SF FuneralF1060375      250322","","126.5","","663370.26"
"2025-03-25","2025-03-22","SF FuneralF1060612      250322","","126.5","","663496.76"
"2025-03-25","2025-03-22","SF FuneralF1060638      250322","","126.5","","663623.26"
"2025-03-25","2025-03-22","SF FuneralF792102       250322","","191.5","","663814.76"
"2025-03-25","2025-03-22","SF FuneralFDC0000000KLMP250322","","126.5","","663941.26"
"2025-03-25","2025-03-22","SF FuneralF1061773      250322","","126.5","","664067.76"
"2025-03-25","2025-03-22","SF FuneralF1061910      250322","","126.5","","664194.26"
"2025-03-25","2025-03-22","SF FuneralF1065715      250322","","126.5","","664320.76"
"2025-03-25","2025-03-22","SF FuneralF1065744      250322","","126.5","","664447.26"
"2025-03-25","2025-03-22","SF FuneralF1066155      250322","","126.5","","664573.76"
"2025-03-25","2025-03-22","SF FuneralF1067919      250322","","126.5","","664700.26"
"2025-03-25","2025-03-22","SF FuneralF1067929      250322","","126.5","","664826.76"
"2025-03-25","2025-03-22","SF FuneralFDC0000000L0CC250322","","126.5","","664953.26"
"2025-03-25","2025-03-22","SF FuneralF1073810      250322","","126.5","","665079.76"
"2025-03-25","2025-03-22","SF FuneralF1074446      250322","","126.5","","665206.26"
"2025-03-25","2025-03-22","SF FuneralFDC0000000L9Q5250322","","126.5","","665332.76"
"2025-03-25","2025-03-22","SF FuneralF1075009      250323","","126.5","","665459.26"
"2025-03-25","2025-03-22","SF FuneralF1075192      250322","","126.5","","665585.76"
"2025-03-25","2025-03-22","SF FuneralF1075281      250322","","126.5","","665712.26"
"2025-03-25","2025-03-22","SF FuneralF1079301      250322","","126.5","","665838.76"
"2025-03-25","2025-03-22","SF FuneralFDC0000000LMX4250322","","126.5","","665965.26"
"2025-03-25","2025-03-22","SF FuneralF1080420      250322","","126.5","","666091.76"
"2025-03-25","2025-03-22","SF FuneralF778543       250322","","126.5","","666218.26"
"2025-03-25","2025-03-22","SF FuneralF900692       250322","","126.5","","666344.76"
"2025-03-25","2025-03-22","SF FuneralF1080534      250323","","126.5","","666471.26"
"2025-03-25","2025-03-22","SF FuneralF1080539      250323","","126.5","","666597.76"
"2025-03-25","2025-03-22","SF FuneralF1085118      250322","","126.5","","666724.26"
"2025-03-25","2025-03-22","SF FuneralF1085291      250322","","126.5","","666850.76"
"2025-03-25","2025-03-22","SF FuneralF1102831      250322","","126.5","","666977.26"
"2025-03-25","2025-03-22","SF FuneralFDC0000000M3WM250322","","256.5","","667233.76"
"2025-03-25","2025-03-22","SF FuneralF783858       250322","","256.5","","667490.26"
"2025-03-25","2025-03-22","SF FuneralF782768       250322","","126.5","","667616.76"
"2025-03-25","2025-03-22","SF FuneralF1108138      250322","","126.5","","667743.26"
"2025-03-25","2025-03-22","SF FuneralF1108244      250322","","126.5","","667869.76"
"2025-03-25","2025-03-22","SF FuneralF1108364      250322","","126.5","","667996.26"
"2025-03-25","2025-03-22","SF FuneralF1108523      250322","","126.5","","668122.76"
"2025-03-25","2025-03-22","SF FuneralF1108702      250322","","126.5","","668249.26"
"2025-03-25","2025-03-22","SF FuneralFDC0000000MLZ6250322","","126.5","","668375.76"
"2025-03-25","2025-03-22","SF FuneralF1113176      250322","","126.5","","668502.26"
"2025-03-25","2025-03-22","SF FuneralF1113125      250322","","126.5","","668628.76"
"2025-03-25","2025-03-22","SF FuneralF792923       250322","","126.5","","668755.26"
"2025-03-25","2025-03-22","SF FuneralF1114245      250322","","126.5","","668881.76"
"2025-03-25","2025-03-22","SF FuneralF1114640      250322","","126.5","","669008.26"
"2025-03-25","2025-03-22","SF FuneralFDC0000000N9D8250322","","126.5","","669134.76"
"2025-03-25","2025-03-22","SF FuneralF1114836      250322","","126.5","","669261.26"
"2025-03-25","2025-03-22","SF FuneralF1115728      250322","","126.5","","669387.76"
"2025-03-25","2025-03-22","SF FuneralFDC0000000NCQ5250322","","126.5","","669514.26"
"2025-03-25","2025-03-22","SF FuneralF1115731      250322","","126.5","","669640.76"
"2025-03-25","2025-03-22","SF FuneralF1115816      250322","","126.5","","669767.26"
"2025-03-25","2025-03-22","SF FuneralF1115839      250322","","126.5","","669893.76"
"2025-03-25","2025-03-22","SF FuneralF1115846      250322","","126.5","","670020.26"
"2025-03-25","2025-03-22","SF FuneralFDC0000000NDR3250322","","126.5","","670146.76"
"2025-03-25","2025-03-22","SF FuneralF1115863      250323","","126.5","","670273.26"
"2025-03-25","2025-03-22","SF FuneralFDC0000000NFC3250322","","126.5","","670399.76"
"2025-03-25","2025-03-22","SF FuneralFDC0000000NFTV250322","","126.5","","670526.26"
"2025-03-25","2025-03-22","SF FuneralF1115996      250322","","126.5","","670652.76"
"2025-03-25","2025-03-22","SF FuneralF1116046      250322","","126.5","","670779.26"
"2025-03-25","2025-03-22","SF FuneralF1117343      250322","","126.5","","670905.76"
"2025-03-25","2025-03-22","SF FuneralF1117877      250322","","126.5","","671032.26"
"2025-03-25","2025-03-22","SF FuneralF1118303      250322","","126.5","","671158.76"
"2025-03-25","2025-03-22","SF FuneralF1119866      250322","","126.5","","671285.26"
"2025-03-25","2025-03-22","SF FuneralFDC0000000NSNR250322","","191.5","","671476.76"
"2025-03-25","2025-03-22","SF FuneralF1119886      250322","","126.5","","671603.26"
"2025-03-25","2025-03-22","SF FuneralF1119887      250322","","126.5","","671729.76"
"2025-03-25","2025-03-22","SF FuneralFDC0000000NT5V250322","","126.5","","671856.26"
"2025-03-25","2025-03-22","SF FuneralF1120124      250322","","126.5","","671982.76"
"2025-03-25","2025-03-22","SF FuneralF1120136      250322","","126.5","","672109.26"
"2025-03-25","2025-03-22","SF FuneralF1120139      250322","","126.5","","672235.76"
"2025-03-25","2025-03-22","SF FuneralF1120208      250322","","126.5","","672362.26"
"2025-03-25","2025-03-22","SF FuneralFDC0000000NV3X250322","","126.5","","672488.76"
"2025-03-25","2025-03-22","SF FuneralFDC0000000NV7X250322","","126.5","","672615.26"
"2025-03-25","2025-03-22","SF FuneralF1120271      250322","","126.5","","672741.76"
"2025-03-25","2025-03-22","SF FuneralFDC0000000NVMY250322","","126.5","","672868.26"
"2025-03-25","2025-03-22","SF FuneralF1120275      250322","","126.5","","672994.76"
"2025-03-25","2025-03-22","SF FuneralF1120279      250322","","126.5","","673121.26"
"2025-03-25","2025-03-22","SF FuneralF1120430      250322","","126.5","","673247.76"
"2025-03-25","2025-03-22","SF FuneralFDC0000000NY0F250322","","126.5","","673374.26"
"2025-03-25","2025-03-22","SF FuneralFDC0000000P18M250322","","126.5","","673500.76"
"2025-03-25","2025-03-22","SF FuneralF1122675      250322","","126.5","","673627.26"
"2025-03-25","2025-03-22","SF FuneralF1122993      250322","","126.5","","673753.76"
"2025-03-25","2025-03-22","SF FuneralFDC0000000P32C250322","","126.5","","673880.26"
"2025-03-25","2025-03-22","SF FuneralF1123168      250322","","126.5","","674006.76"
"2025-03-25","2025-03-22","SF FuneralF1124198      250322","","126.5","","674133.26"
"2025-03-25","2025-03-22","SF FuneralF1124203      250322","","126.5","","674259.76"
"2025-03-25","2025-03-22","SF FuneralF1124421      250322","","126.5","","674386.26"
"2025-03-25","2025-03-22","SF FuneralF1124439      250322","","126.5","","674512.76"
"2025-03-25","2025-03-22","SF FuneralF1124471      250322","","126.5","","674639.26"
"2025-03-25","2025-03-22","SF FuneralF1124538      250322","","126.5","","674765.76"
"2025-03-25","2025-03-22","SF FuneralF1125136      250322","","126.5","","674892.26"
"2025-03-25","2025-03-22","SF FuneralFDC0000000PKLP250322","","126.5","","675018.76"
"2025-03-25","2025-03-22","SF FuneralF1126178      250322","","126.5","","675145.26"
"2025-03-25","2025-03-22","SF FuneralF830840       250322","","126.5","","675271.76"
"2025-03-25","2025-03-22","SF FuneralF1127448      250322","","126.5","","675398.26"
"2025-03-25","2025-03-22","SF FuneralF1127527      250322","","126.5","","675524.76"
"2025-03-25","2025-03-22","SF FuneralF1127605      250322","","126.5","","675651.26"
"2025-03-25","2025-03-22","SF FuneralF1127624      250322","","126.5","","675777.76"
"2025-03-25","2025-03-22","SF FuneralFDC0000000PS98250322","","126.5","","675904.26"
"2025-03-25","2025-03-22","SF FuneralF1128014      250322","","126.5","","676030.76"
"2025-03-25","2025-03-22","SF FuneralF1128246      250322","","126.5","","676157.26"
"2025-03-25","2025-03-22","SF FuneralF1128704      250322","","126.5","","676283.76"
"2025-03-25","2025-03-22","SF FuneralF1128783      250322","","126.5","","676410.26"
"2025-03-25","2025-03-22","SF FuneralF1128785      250322","","126.5","","676536.76"
"2025-03-25","2025-03-22","SF FuneralF1129084      250322","","126.5","","676663.26"
"2025-03-25","2025-03-22","SF FuneralF1129101      250322","","126.5","","676789.76"
"2025-03-25","2025-03-22","SF FuneralF1129165      250322","","126.5","","676916.26"
"2025-03-25","2025-03-22","SF FuneralF1129272      250322","","126.5","","677042.76"
"2025-03-25","2025-03-22","SF FuneralF1129334      250322","","126.5","","677169.26"
"2025-03-25","2025-03-22","SF FuneralFDC0000000PZ72250322","","126.5","","677295.76"
"2025-03-25","2025-03-22","SF FuneralF1130251      250322","","126.5","","677422.26"
"2025-03-25","2025-03-22","SF FuneralF1130395      250322","","126.5","","677548.76"
"2025-03-25","2025-03-22","SF FuneralF1130618      250322","","126.5","","677675.26"
"2025-03-25","2025-03-22","SF FuneralF1130651      250322","","126.5","","677801.76"
"2025-03-25","2025-03-22","SF FuneralFDC0000000Q28Q250322","","126.5","","677928.26"
"2025-03-25","2025-03-22","SF FuneralF1131331      250322","","126.5","","678054.76"
"2025-03-25","2025-03-22","SF FuneralF1131347      250322","","126.5","","678181.26"
"2025-03-25","2025-03-22","SF FuneralF1131486      250322","","126.5","","678307.76"
"2025-03-25","2025-03-22","SF FuneralF1131712      250322","","126.5","","678434.26"
"2025-03-25","2025-03-22","SF FuneralF1131763      250322","","126.5","","678560.76"
"2025-03-25","2025-03-22","SF FuneralF1131914      250322","","126.5","","678687.26"
"2025-03-25","2025-03-22","SF FuneralF1131945      250322","","126.5","","678813.76"
"2025-03-25","2025-03-22","SF FuneralF1132093      250322","","126.5","","678940.26"
"2025-03-25","2025-03-22","SF FuneralF1132457      250322","","126.5","","679066.76"
"2025-03-25","2025-03-22","SF FuneralF1132494      250322","","126.5","","679193.26"
"2025-03-25","2025-03-22","SF FuneralF1132498      250322","","126.5","","679319.76"
"2025-03-25","2025-03-22","SF FuneralF1132984      250322","","126.5","","679446.26"
"2025-03-25","2025-03-22","SF FuneralF1132515      250322","","126.5","","679572.76"
"2025-03-25","2025-03-22","SF FuneralF1133137      250322","","126.5","","679699.26"
"2025-03-25","2025-03-22","SF FuneralF1133160      250322","","126.5","","679825.76"
"2025-03-25","2025-03-22","SF FuneralFDC0000000QC5G250322","","126.5","","679952.26"
"2025-03-25","2025-03-22","SF FuneralF1133204      250322","","256.5","","680208.76"
"2025-03-25","2025-03-22","SF FuneralF1133231      250322","","126.5","","680335.26"
"2025-03-25","2025-03-22","SF FuneralF1133259      250323","","126.5","","680461.76"
"2025-03-25","2025-03-22","SF FuneralFDC0000000QCS0250322","","126.5","","680588.26"
"2025-03-25","2025-03-22","SF FuneralF1133509      250322","","126.5","","680714.76"
"2025-03-25","2025-03-22","SF FuneralFDC0000000QFZ3250322","","126.5","","680841.26"
"2025-03-25","2025-03-22","SF FuneralF1134170      250322","","126.5","","680967.76"
"2025-03-25","2025-03-22","SF FuneralF1134515      250322","","126.5","","681094.26"
"2025-03-25","2025-03-22","SF FuneralFDC0000000QHY1250322","","126.5","","681220.76"
"2025-03-25","2025-03-22","SF FuneralF1134732      250322","","126.5","","681347.26"
"2025-03-25","2025-03-22","SF FuneralF1134763      250322","","126.5","","681473.76"
"2025-03-25","2025-03-22","SF FuneralF1134851      250322","","126.5","","681600.26"
"2025-03-25","2025-03-22","SF FuneralF1134859      250322","","126.5","","681726.76"
"2025-03-25","2025-03-22","SF FuneralF1134884      250322","","126.5","","681853.26"
"2025-03-25","2025-03-22","SF FuneralF1134959      250322","","126.5","","681979.76"
"2025-03-25","2025-03-17","SF FuneralFDC00000005PBP250317","","126.5","","682106.26"
"2025-03-25","2025-03-17","SF FuneralFDC00000005TL3250317","","126.5","","682232.76"
"2025-03-25","2025-03-17","SF FuneralFDC00000005Z9N250317","","126.5","","682359.26"
"2025-03-25","2025-03-17","SF FuneralF829881       250317","","126.5","","682485.76"
"2025-03-25","2025-03-17","SF FuneralF830609       250317","","126.5","","682612.26"
"2025-03-25","2025-03-17","SF FuneralF1124325      250317","","126.5","","682738.76"
"2025-03-25","2025-03-17","SF FuneralFDC0000000PBBT250317","","126.5","","682865.26"
"2025-03-25","2025-03-17","SF FuneralF1125299      250317","","126.5","","682991.76"
"2025-03-25","2025-03-18","SF FuneralFDC00000002WZ9250318","","110","","683101.76"
"2025-03-25","2025-03-18","SF FuneralFDC00000005YRX250318","","126.5","","683228.26"
"2025-03-25","2025-03-18","SF FuneralFDC0000000PFVZ250318","","126.5","","683354.76"
"2025-03-25","2025-03-24","SF FuneralFDC00000006MYR250323","","126.5","","683481.26"
"2025-03-25","2025-03-24","SF FuneralFDC000000070Q9250324","","126.5","","683607.76"
"2025-03-25","2025-03-24","SF FuneralF793393       250324","","126.5","","683734.26"
"2025-03-25","2025-03-24","SF FuneralF799138       250323","","126.5","","683860.76"
"2025-03-25","2025-03-24","SF FuneralF799615       250323","","126.5","","683987.26"
"2025-03-25","2025-03-24","SF FuneralFDC00000008XD4250323","","126.5","","684113.76"
"2025-03-25","2025-03-24","SF FuneralF844762       250322","","126.5","","684240.26"
"2025-03-25","2025-03-24","SF FuneralF844792       250322","","126.5","","684366.76"
"2025-03-25","2025-03-24","SF FuneralF847327       250322","","126.5","","684493.26"
"2025-03-25","2025-03-24","SF FuneralF847364       250322","","126.5","","684619.76"
"2025-03-25","2025-03-24","SF FuneralF988978       250324","","126.5","","684746.26"
"2025-03-25","2025-03-24","SF FuneralF989157       250324","","126.5","","684872.76"
"2025-03-25","2025-03-24","SF FuneralF1127618      250324","","126.5","","684999.26"
"2025-03-25","2025-03-20","SF FuneralFDC0000000643W250320","","126.5","","685125.76"
"2025-03-25","2025-03-20","SF FuneralF980697       250322","","126.5","","685252.26"
"2025-03-25","2025-03-20","SF FuneralF987539       250321","","126.5","","685378.76"
"2025-03-25","2025-03-20","SF FuneralF991009       250322","","191.5","","685570.26"
"2025-03-25","2025-03-20","SF FuneralFDC0000000J418250322","","126.5","","685696.76"
"2025-03-25","2025-03-20","SF FuneralF991430       250322","","126.5","","685823.26"
"2025-03-25","2025-03-20","SF FuneralF1017796      250321","","126.5","","685949.76"
"2025-03-25","2025-03-20","SF FuneralF1124394      250320","","126.5","","686076.26"
"2025-03-25","2025-03-22","SF FuneralFDC0000000375G250322","","220","","686296.26"
"2025-03-25","2025-03-22","SF FuneralFDC0000000375T250322","","220","","686516.26"
"2025-03-25","2025-03-22","SF FuneralFDC0000000578N250322","","126.5","","686642.76"
"2025-03-25","2025-03-22","SF FuneralFDC00000005G1T250322","","126.5","","686769.26"
"2025-03-25","2025-03-22","SF FuneralFDC00000005YKS250321","","126.5","","686895.76"
"2025-03-25","2025-03-22","SF FuneralFDC00000005YMQ250321","","126.5","","687022.26"
"2025-03-25","2025-03-22","SF FuneralFDC00000005YQ4250321","","126.5","","687148.76"
"2025-03-25","2025-03-22","SF FuneralFDC00000005Z47250322","","126.5","","687275.26"
"2025-03-25","2025-03-22","SF FuneralFDC00000005ZRZ250322","","126.5","","687401.76"
"2025-03-25","2025-03-22","SF FuneralFDC00000005ZX0250322","","126.5","","687528.26"
"2025-03-25","2025-03-22","SF FuneralFDC000000060QF250322","","126.5","","687654.76"
"2025-03-25","2025-03-22","SF FuneralFDC00000006237250322","","126.5","","687781.26"
"2025-03-25","2025-03-22","SF FuneralFDC000000062W4250322","","126.5","","687907.76"
"2025-03-25","2025-03-22","SF FuneralFDC0000000631V250322","","126.5","","688034.26"
"2025-03-25","2025-03-22","SF FuneralFDC0000000653J250322","","126.5","","688160.76"
"2025-03-25","2025-03-22","SF FuneralFDC00000006QY1250322","","126.5","","688287.26"
"2025-03-25","2025-03-22","SF FuneralFDC00000006SC3250322","","126.5","","688413.76"
"2025-03-25","2025-03-22","SF FuneralFDC00000006X9C250322","","126.5","","688540.26"
"2025-03-25","2025-03-22","SF FuneralFDC00000006XL8250322","","126.5","","688666.76"
"2025-03-25","2025-03-22","SF FuneralFDC00000006YCN250322","","126.5","","688793.26"
"2025-03-25","2025-03-22","SF FuneralFDC000000072JP250322","","126.5","","688919.76"
"2025-03-25","2025-03-22","SF FuneralFDC000000078GX250322","","126.5","","689046.26"
"2025-03-25","2025-03-22","SF FuneralFDC00000007K4N250322","","126.5","","689172.76"
"2025-03-25","2025-03-22","SF FuneralFDC00000007KX0250322","","126.5","","689299.26"
"2025-03-25","2025-03-22","SF FuneralFDC000000080YG250322","","126.5","","689425.76"
"2025-03-25","2025-03-22","SF FuneralFDC00000008BXT250322","","126.5","","689552.26"
"2025-03-25","2025-03-22","SF FuneralF803477       250322","","126.5","","689678.76"
"2025-03-25","2025-03-22","SF FuneralF805395       250322","","126.5","","689805.26"
"2025-03-25","2025-03-22","SF FuneralF805665       250322","","126.5","","689931.76"
"2025-03-25","2025-03-22","SF FuneralF805921       250322","","126.5","","690058.26"
"2025-03-25","2025-03-22","SF FuneralFDC00000008XBH250322","","126.5","","690184.76"
"2025-03-25","2025-03-22","SF FuneralF811207       250322","","126.5","","690311.26"
"2025-03-25","2025-03-22","SF FuneralF811233       250322","","126.5","","690437.76"
"2025-03-25","2025-03-22","SF FuneralF818350       250322","","126.5","","690564.26"
"2025-03-25","2025-03-22","SF FuneralF823570       250322","","126.5","","690690.76"
"2025-03-25","2025-03-22","SF FuneralF830639       250322","","126.5","","690817.26"
"2025-03-25","2025-03-22","SF FuneralFDC0000000C0PL250322","","126.5","","690943.76"
"2025-03-25","2025-03-21","SF FuneralF831577       250321","","126.5","","691070.26"
"2025-03-25","2025-03-22","SF FuneralF833263       250322","","126.5","","691196.76"
"2025-03-25","2025-03-22","SF FuneralF833898       250322","","126.5","","691323.26"
"2025-03-25","2025-03-22","SF FuneralFDC0000000DBRB250322","","126.5","","691449.76"
"2025-03-25","2025-03-22","SF FuneralF840741       250322","","191.5","","691641.26"
"2025-03-25","2025-03-22","SF FuneralF992162       250322","","126.5","","691767.76"
"2025-03-25","2025-03-22","SF FuneralF993517       250322","","126.5","","691894.26"
"2025-03-25","2025-03-22","SF FuneralF1020447      250322","","126.5","","692020.76"
"2025-03-25","2025-03-22","SF FuneralF1054932      250322","","126.5","","692147.26"
"2025-03-25","2025-03-22","SF FuneralF1065708      250322","","126.5","","692273.76"
"2025-03-25","2025-03-22","SF FuneralFDC0000000LMSF250322","","126.5","","692400.26"
"2025-03-25","2025-03-22","SF FuneralF1080303      250322","","126.5","","692526.76"
"2025-03-25","2025-03-22","SF FuneralF1080557      250322","","126.5","","692653.26"
"2025-03-25","2025-03-22","SF FuneralF1084651      250322","","126.5","","692779.76"
"2025-03-25","2025-03-22","SF FuneralF1108370      250322","","126.5","","692906.26"
"2025-03-25","2025-03-22","SF FuneralF1108865      250322","","126.5","","693032.76"
"2025-03-25","2025-03-22","SF FuneralF1110499      250322","","126.5","","693159.26"
"2025-03-25","2025-03-22","SF FuneralF1110514      250322","","126.5","","693285.76"
"2025-03-25","2025-03-22","SF FuneralF1112015      250322","","126.5","","693412.26"
"2025-03-25","2025-03-22","SF FuneralF1112034      250322","","126.5","","693538.76"
"2025-03-25","2025-03-22","SF FuneralFDC0000000NCZB250322","","126.5","","693665.26"
"2025-03-25","2025-03-22","SF FuneralFDC0000000NNYB250322","","126.5","","693791.76"
"2025-03-25","2025-03-22","SF FuneralF1118936      250322","","126.5","","693918.26"
"2025-03-25","2025-03-22","SF FuneralF1120140      250322","","126.5","","694044.76"
"2025-03-25","2025-03-22","SF FuneralF1120817      250322","","126.5","","694171.26"
"2025-03-25","2025-03-22","SF FuneralF1120927      250322","","126.5","","694297.76"
"2025-03-25","2025-03-22","SF FuneralF1121790      250322","","126.5","","694424.26"
"2025-03-25","2025-03-22","SF FuneralFDC0000000P7VJ250322","","321.5","","694745.76"
"2025-03-25","2025-03-22","SF FuneralF1124170      250322","","126.5","","694872.26"
"2025-03-25","2025-03-22","SF FuneralF1124208      250322","","126.5","","694998.76"
"2025-03-25","2025-03-22","SF FuneralFDC0000000P937250322","","126.5","","695125.26"
"2025-03-25","2025-03-22","SF FuneralFDC0000000P93F250322","","126.5","","695251.76"
"2025-03-25","2025-03-22","SF FuneralF1124535      250322","","126.5","","695378.26"
"2025-03-25","2025-03-22","SF FuneralFDC0000000QB5X250322","","126.5","","695504.76"
"2025-03-25","2025-03-22","SF FuneralF1132980      250322","","126.5","","695631.26"
"2025-03-25","2025-03-22","SF FuneralF1133135      250322","","126.5","","695757.76"
"2025-03-25","2025-03-22","SF FuneralF1133154      250322","","126.5","","695884.26"
"2025-03-25","2025-03-22","SF FuneralF1133995      250322","","126.5","","696010.76"
"2025-03-25","2025-03-22","SF FuneralF1134805      250322","","126.5","","696137.26"
"2025-03-25","2025-03-22","SF FuneralF1134978      250322","","126.5","","696263.76"
"2025-03-25","2025-03-24","SF FuneralFDC00000006234250323","","126.5","","696390.26"
"2025-03-25","2025-03-23","SF FuneralF815399       250323","","126.5","","696516.76"
"2025-03-25","2025-03-23","SF FuneralF841825       250323","","126.5","","696643.26"
"2025-03-25","2025-03-24","SF FuneralF843508       250322","","126.5","","696769.76"
"2025-03-25","2025-03-24","SF FuneralF847314       250322","","126.5","","696896.26"
"2025-03-25","2025-03-24","SF FuneralF900703       250323","","126.5","","697022.76"
"2025-03-25","2025-03-24","SF FuneralF1124416      250324","","126.5","","697149.26"
"2025-03-25","2025-03-25","SF FuneralFDC000000061YD250325","","31.63","","697180.89"
"2025-03-25","2025-03-25","SF FuneralFDC00000007CPB250325","","31.63","","697212.52"
"2025-03-25","2025-03-25","SF FuneralFDC00000007KDF250325","","126.5","","697339.02"
"2025-03-25","2025-03-25","SF FuneralFDC00000007XJ5250325","","126.5","","697465.52"
"2025-03-25","2025-03-25","SF FuneralF796010       250325","","256.5","","697722.02"
"2025-03-25","2025-03-25","SF FuneralFDC000000080WH250325","","31.63","","697753.65"
"2025-03-25","2025-03-25","SF FuneralF811608       250325","","126.5","","697880.15"
"2025-03-25","2025-03-25","SF FuneralF831106       250325","","31.63","","697911.78"
"2025-03-25","2025-03-25","SF FuneralF1020916      250325","","31.63","","697943.41"
"2025-03-25","2025-03-25","SF FuneralF1060950      250325","","31.63","","697975.04"
"2025-03-25","2025-03-25","SF FuneralF1065982      250325","","31.63","","698006.67"
"2025-03-25","2025-03-25","SF FuneralF1074649      250325","","31.63","","698038.3"
"2025-03-25","2025-03-25","SF FuneralF1110299      250325","","31.63","","698069.93"
"2025-03-25","2025-03-25","SF FuneralF1112301      250325","","126.5","","698196.43"
"2025-03-25","2025-03-25","SF FuneralF1115105      250325","","31.63","","698228.06"
"2025-03-25","2025-03-25","SF FuneralF1115749      250325","","31.63","","698259.69"
"2025-03-25","2025-03-25","SF FuneralF1120169      250325","","126.5","","698386.19"
"2025-03-25","2025-03-25","SF FuneralF1127485      250325","","31.63","","698417.82"
"2025-03-25","2025-03-25","SF FuneralF1132796      250325","","126.5","","698544.32"
"2025-03-25","2025-03-19","SF FuneralFDC00000006PQ2250319","","126.5","","698670.82"
"2025-03-25","2025-03-19","SF FuneralF811769       250319","","126.5","","698797.32"
"2025-03-25","2025-03-19","SF FuneralFDC00000009F2S250319","","126.5","","698923.82"
"2025-03-25","2025-03-24","SF FuneralFDC00000002TWX250323","","220","","699143.82"
"2025-03-25","2025-03-24","SF FuneralFDC00000007L44250324","","126.5","","699270.32"
"2025-03-25","2025-03-24","SF FuneralF796059       250323","","126.5","","699396.82"
"2025-03-25","2025-03-24","SF FuneralFDC0000000B6SN250323","","126.5","","699523.32"
"2025-03-25","2025-03-24","SF FuneralF823608       250324","","126.5","","699649.82"
"2025-03-25","2025-03-24","SF FuneralFDC0000000BKXY250323","","126.5","","699776.32"
"2025-03-25","2025-03-24","SF FuneralF823827       250324","","126.5","","699902.82"
"2025-03-25","2025-03-24","SF FuneralF830211       250324","","126.5","","700029.32"
"2025-03-25","2025-03-24","SF FuneralF838881       250323","","126.5","","700155.82"
"2025-03-25","2025-03-24","SF FuneralF840681       250324","","126.5","","700282.32"
"2025-03-25","2025-03-24","SF FuneralF843389       250322","","126.5","","700408.82"
"2025-03-25","2025-03-24","SF FuneralF843985       250322","","126.5","","700535.32"
"2025-03-25","2025-03-24","SF FuneralF844571       250322","","126.5","","700661.82"
"2025-03-25","2025-03-24","SF FuneralF844677       250322","","126.5","","700788.32"
"2025-03-25","2025-03-24","SF FuneralF900449       250322","","126.5","","700914.82"
"2025-03-25","2025-03-24","SF FuneralFDC0000000H03Y250322","","126.5","","701041.32"
"2025-03-25","2025-03-24","SF FuneralF991850       250324","","126.5","","701167.82"
"2025-03-25","2025-03-24","SF FuneralF1074692      250324","","126.5","","701294.32"
"2025-03-25","2025-03-24","SF FuneralF1108006      250324","","126.5","","701420.82"
"2025-03-25","2025-03-20","SF FuneralF992036       250320","","126.5","","701547.32"
"2025-03-25","2025-03-22","SF FuneralFDC00000005S21250322","","126.5","","701673.82"
"2025-03-25","2025-03-22","SF FuneralFDC00000006YCZ250322","","126.5","","701800.32"
"2025-03-25","2025-03-22","SF FuneralFDC00000008GS7250322","","126.5","","701926.82"
"2025-03-25","2025-03-22","SF FuneralF802189       250322","","126.5","","702053.32"
"2025-03-25","2025-03-22","SF FuneralF804564       250322","","126.5","","702179.82"
"2025-03-25","2025-03-22","SF FuneralF811454       250322","","126.5","","702306.32"
"2025-03-25","2025-03-22","SF FuneralFDC0000000DBRD250322","","126.5","","702432.82"
"2025-03-25","2025-03-22","SF FuneralF992782       250322","","126.5","","702559.32"
"2025-03-25","2025-03-22","SF FuneralF1017589      250322","","126.5","","702685.82"
"2025-03-25","2025-03-22","SF FuneralFDC0000000KH35250322","","126.5","","702812.32"
"2025-03-25","2025-03-22","SF FuneralF1074613      250322","","126.5","","702938.82"
"2025-03-25","2025-03-22","SF FuneralF1108942      250322","","126.5","","703065.32"
"2025-03-25","2025-03-22","SF FuneralF1116783      250322","","126.5","","703191.82"
"2025-03-25","2025-03-22","SF FuneralF1120137      250322","","126.5","","703318.32"
"2025-03-25","2025-03-22","SF FuneralFDC0000000NV5D250322","","126.5","","703444.82"
"2025-03-25","2025-03-22","SF FuneralF1122667      250322","","126.5","","703571.32"
"2025-03-25","2025-03-22","SF FuneralFDC0000000PBQS250322","","126.5","","703697.82"
"2025-03-25","2025-03-22","SF FuneralF1125662      250322","","31.63","","703729.45"
"2025-03-25","2025-03-22","SF FuneralF1131711      250322","","126.5","","703855.95"
"2025-03-25","2025-03-22","SF FuneralF1134017      250322","","126.5","","703982.45"
"2025-03-25","2025-03-22","SF FuneralF1134054      250322","","126.5","","704108.95"
"2025-03-25","2025-03-25","SF FuneralF793907       250325","","126.5","","704235.45"
"2025-03-25","2025-03-25","SF FuneralFDC00000008LM6250325","","126.5","","704361.95"
"2025-03-25","2025-03-25","SF FuneralF990232       250325","","31.63","","704393.58"
"2025-03-25","2025-03-25","SF FuneralF1129103      250325","","31.63","","704425.21"
"2025-03-25","2025-03-25","SF FuneralF1132314      250325","","31.63","","704456.84"
"2025-03-25","2025-03-22","SF FuneralFDC0000000Q5B6250322","","126.5","","704583.34"
"2025-03-25","2025-03-25","SF FuneralFDC00000005LS0250325","","126.5","","704709.84"
"2025-03-25","2025-03-25","SF FuneralFDC00000005VXN250325","","126.5","","704836.34"
"2025-03-25","2025-03-25","SF FuneralFDC00000005WF7250325","","126.5","","704962.84"
"2025-03-25","2025-03-25","SF FuneralFDC00000005Z3K250325","","126.5","","705089.34"
"2025-03-25","2025-03-25","SF FuneralFDC00000007MXH250325","","126.5","","705215.84"
"2025-03-25","2025-03-25","SF FuneralF781301       250325","","126.5","","705342.34"
"2025-03-25","2025-03-25","SF FuneralFDC0000000D21J250325","","126.5","","705468.84"
"2025-03-25","2025-03-25","SF FuneralF840751       250325","","126.5","","705595.34"
"2025-03-25","2025-03-25","SF FuneralFDC0000000FQV0250325","","63.25","","705658.59"
"2025-03-25","2025-03-25","SF FuneralF989478       250325","","126.5","","705785.09"
"2025-03-25","2025-03-25","SF FuneralF990246       250325","","63.25","","705848.34"
"2025-03-25","2025-03-25","SF FuneralF1078570      250325","","126.5","","705974.84"
"2025-03-25","2025-03-25","SF FuneralFDC0000000NC20250325","","126.5","","706101.34"
"2025-03-25","2025-03-25","SF FuneralF1120281      250325","","126.5","","706227.84"
"2025-03-25","2025-03-25","SF FuneralF1120559      250325","","126.5","","706354.34"
"2025-03-25","2025-03-25","SF FuneralF1121874      250325","","126.5","","706480.84"
"2025-03-25","2025-03-25","SF FuneralF1124772      250325","","126.5","","706607.34"
"2025-03-25","2025-03-25","SF FuneralF1131918      250325","","126.5","","706733.84"
"2025-03-25","2025-03-25","SF FuneralF1131920      250325","","126.5","","706860.34"
"2025-03-25","2025-03-25","SF FuneralF1131936      250325","","126.5","","706986.84"
"2025-03-25","2025-03-25","SF FuneralF992514       250325","","126.5","","707113.34"
"2025-03-25","2025-03-25","SF FuneralFDC0000000JKF4250325","","126.5","","707239.84"
"2025-03-25","2025-03-25","SF FuneralF1020521      250325","","126.5","","707366.34"
"2025-03-25","2025-03-25","SF FuneralF1033783      250325","","126.5","","707492.84"
"2025-03-25","2025-03-25","SF FuneralF1058651      250325","","126.5","","707619.34"
"2025-03-25","2025-03-25","SF FuneralF1079185      250325","","126.5","","707745.84"
"2025-03-25","2025-03-25","SF FuneralF1120350      250325","","126.5","","707872.34"
"2025-03-25","2025-03-25","SF FuneralF1127919      250325","","63.25","","707935.59"
"2025-03-25","2025-03-25","SF FuneralF1103971      250325","","126.5","","708062.09"
"2025-03-25","2025-03-25","SF FuneralF1133535      250325","","126.5","","708188.59"
"2025-03-25","2025-03-25","SF FuneralFDC00000006CRY250325","","126.5","","708315.09"
"2025-03-25","2025-03-25","SF FuneralFDC00000006FKH250325","","63.25","","708378.34"
"2025-03-25","2025-03-25","SF FuneralFDC00000006LLR250325","","126.5","","708504.84"
"2025-03-25","2025-03-25","SF FuneralFDC00000006R2Y250325","","126.5","","708631.34"
"2025-03-25","2025-03-25","SF FuneralFDC00000006WN0250325","","126.5","","708757.84"
"2025-03-25","2025-03-25","SF FuneralFDC00000006WN4250325","","126.5","","708884.34"
"2025-03-25","2025-03-25","SF FuneralFDC00000006WN6250325","","126.5","","709010.84"
"2025-03-25","2025-03-25","SF FuneralFDC00000006WN7250325","","126.5","","709137.34"
"2025-03-25","2025-03-25","SF FuneralFDC000000072Q2250325","","126.5","","709263.84"
"2025-03-25","2025-03-25","SF FuneralFDC000000072YQ250325","","63.25","","709327.09"
"2025-03-25","2025-03-25","SF FuneralFDC000000077PK250325","","126.5","","709453.59"
"2025-03-25","2025-03-25","SF FuneralFDC000000078QF250325","","126.5","","709580.09"
"2025-03-25","2025-03-25","SF FuneralFDC00000007NSD250325","","126.5","","709706.59"
"2025-03-25","2025-03-25","SF FuneralFDC00000007P5T250325","","126.5","","709833.09"
"2025-03-25","2025-03-25","SF FuneralFDC00000007XJV250325","","126.5","","709959.59"
"2025-03-25","2025-03-25","SF FuneralF800702       250325","","126.5","","710086.09"
"2025-03-25","2025-03-25","SF FuneralFDC00000008J9J250325","","126.5","","710212.59"
"2025-03-25","2025-03-25","SF FuneralFDC00000008NR5250325","","126.5","","710339.09"
"2025-03-25","2025-03-25","SF FuneralFDC00000008XF8250325","","126.5","","710465.59"
"2025-03-25","2025-03-25","SF FuneralF808312       250325","","63.25","","710528.84"
"2025-03-25","2025-03-25","SF FuneralF809397       250325","","126.5","","710655.34"
"2025-03-25","2025-03-25","SF FuneralF815997       250325","","126.5","","710781.84"
"2025-03-25","2025-03-25","SF FuneralF819799       250325","","126.5","","710908.34"
"2025-03-25","2025-03-25","SF FuneralF829999       250325","","126.5","","711034.84"
"2025-03-25","2025-03-25","SF FuneralF986879       250325","","126.5","","711161.34"
"2025-03-25","2025-03-25","SF FuneralF1074546      250325","","126.5","","711287.84"
"2025-03-25","2025-03-25","SF FuneralFDC0000000LPJZ250325","","191.5","","711479.34"
"2025-03-25","2025-03-25","SF FuneralFDC0000000LQTG250325","","126.5","","711605.84"
"2025-03-25","2025-03-25","SF FuneralF1112390      250325","","126.5","","711732.34"
"2025-03-25","2025-03-25","SF FuneralFDC0000000PQ0R250325","","126.5","","711858.84"
"2025-03-25","2025-03-25","SF FuneralFDC0000000PW05250325","","126.5","","711985.34"
"2025-03-25","2025-03-25","SF FuneralFDC0000000PWW4250325","","126.5","","712111.84"
"2025-03-25","2025-03-20","SF FuneralF812421       250320","","126.5","","712238.34"
"2025-03-25","2025-03-20","SF FuneralF847394       250320","","126.5","","712364.84"
"2025-03-25","2025-03-20","SF FuneralF980794       250322","","126.5","","712491.34"
"2025-03-25","2025-03-20","SF FuneralF987379       250322","","126.5","","712617.84"
"2025-03-25","2025-03-20","SF FuneralF987419       250322","","126.5","","712744.34"
"2025-03-25","2025-03-20","SF FuneralF988006       250322","","126.5","","712870.84"
"2025-03-25","2025-03-20","SF FuneralF991449       250322","","126.5","","712997.34"
"2025-03-25","2025-03-20","SF FuneralFDC0000000LPP2250321","","126.5","","713123.84"
"2025-03-25","2025-03-20","SF FuneralF1122345      250321","","126.5","","713250.34"
"2025-03-25","2025-03-22","SF FuneralFDC000000031G5250322","","220","","713470.34"
"2025-03-25","2025-03-22","SF FuneralFDC000000031X6250322","","220","","713690.34"
"2025-03-25","2025-03-22","SF FuneralFDC00000005C4S250322","","126.5","","713816.84"
"2025-03-25","2025-03-22","SF FuneralFDC00000005DDD250322","","126.5","","713943.34"
"2025-03-25","2025-03-22","SF FuneralFDC00000005DWJ250322","","126.5","","714069.84"
"2025-03-25","2025-03-22","SF FuneralFDC00000005FX5250322","","126.5","","714196.34"
"2025-03-25","2025-03-22","SF FuneralFDC00000005ZFW250322","","126.5","","714322.84"
"2025-03-25","2025-03-22","SF FuneralFDC00000005ZLL250322","","126.5","","714449.34"
"2025-03-25","2025-03-22","SF FuneralFDC00000005ZLV250322","","126.5","","714575.84"
"2025-03-25","2025-03-22","SF FuneralFDC000000060BH250322","","126.5","","714702.34"
"2025-03-25","2025-03-22","SF FuneralFDC000000060PZ250322","","126.5","","714828.84"
"2025-03-25","2025-03-22","SF FuneralFDC000000060TZ250322","","126.5","","714955.34"
"2025-03-25","2025-03-22","SF FuneralFDC000000061LQ250322","","126.5","","715081.84"
"2025-03-25","2025-03-22","SF FuneralFDC000000061QZ250322","","126.5","","715208.34"
"2025-03-25","2025-03-22","SF FuneralFDC000000062S9250322","","126.5","","715334.84"
"2025-03-25","2025-03-22","SF FuneralFDC000000062XV250322","","126.5","","715461.34"
"2025-03-25","2025-03-22","SF FuneralFDC000000063S6250322","","126.5","","715587.84"
"2025-03-25","2025-03-22","SF FuneralFDC000000063SV250322","","126.5","","715714.34"
"2025-03-25","2025-03-22","SF FuneralFDC000000063X4250322","","126.5","","715840.84"
"2025-03-25","2025-03-22","SF FuneralFDC000000064DK250321","","126.5","","715967.34"
"2025-03-25","2025-03-22","SF FuneralFDC000000064RW250322","","126.5","","716093.84"
"2025-03-25","2025-03-22","SF FuneralFDC000000064X8250322","","126.5","","716220.34"
"2025-03-25","2025-03-22","SF FuneralFDC000000066KD250322","","126.5","","716346.84"
"2025-03-25","2025-03-22","SF FuneralFDC000000069H1250322","","126.5","","716473.34"
"2025-03-25","2025-03-22","SF FuneralFDC00000006CW1250322","","126.5","","716599.84"
"2025-03-25","2025-03-22","SF FuneralFDC00000006CWM250322","","126.5","","716726.34"
"2025-03-25","2025-03-22","SF FuneralFDC00000006CZ4250322","","126.5","","716852.84"
"2025-03-25","2025-03-22","SF FuneralFDC00000006DRC250322","","126.5","","716979.34"
"2025-03-25","2025-03-22","SF FuneralFDC00000006FZW250322","","126.5","","717105.84"
"2025-03-25","2025-03-22","SF FuneralFDC00000006G4S250322","","126.5","","717232.34"
"2025-03-25","2025-03-22","SF FuneralFDC00000006GQ0250322","","126.5","","717358.84"
"2025-03-25","2025-03-22","SF FuneralFDC00000006N9D250322","","126.5","","717485.34"
"2025-03-25","2025-03-22","SF FuneralFDC00000006NLB250322","","126.5","","717611.84"
"2025-03-25","2025-03-22","SF FuneralFDC00000006S3P250322","","126.5","","717738.34"
"2025-03-25","2025-03-22","SF FuneralFDC00000006SL5250322","","126.5","","717864.84"
"2025-03-25","2025-03-22","SF FuneralFDC00000006TFH250322","","126.5","","717991.34"
"2025-03-25","2025-03-22","SF FuneralFDC00000006VLX250322","","126.5","","718117.84"
"2025-03-25","2025-03-22","SF FuneralFDC00000006VNK250322","","126.5","","718244.34"
"2025-03-25","2025-03-22","SF FuneralFDC00000006WKY250322","","126.5","","718370.84"
"2025-03-25","2025-03-22","SF FuneralFDC00000006XHW250322","","126.5","","718497.34"
"2025-03-25","2025-03-22","SF FuneralFDC00000006YNB250322","","126.5","","718623.84"
"2025-03-25","2025-03-22","SF FuneralFDC00000006ZSN250322","","126.5","","718750.34"
"2025-03-25","2025-03-22","SF FuneralFDC00000007007250321","","126.5","","718876.84"
"2025-03-25","2025-03-22","SF FuneralFDC000000075XC250322","","126.5","","719003.34"
"2025-03-25","2025-03-22","SF FuneralFDC000000079XZ250322","","126.5","","719129.84"
"2025-03-25","2025-03-22","SF FuneralFDC00000007DCG250322","","126.5","","719256.34"
"2025-03-25","2025-03-22","SF FuneralFDC00000007FFT250322","","126.5","","719382.84"
"2025-03-25","2025-03-22","SF FuneralFDC00000007JDV250322","","126.5","","719509.34"
"2025-03-25","2025-03-22","SF FuneralFDC00000007JTB250322","","126.5","","719635.84"
"2025-03-25","2025-03-22","SF FuneralFDC00000007KD3250322","","126.5","","719762.34"
"2025-03-25","2025-03-22","SF FuneralFDC00000007KJK250322","","126.5","","719888.84"
"2025-03-25","2025-03-22","SF FuneralFDC00000007KL9250322","","126.5","","720015.34"
"2025-03-25","2025-03-22","SF FuneralFDC00000007L0Y250322","","126.5","","720141.84"
"2025-03-25","2025-03-22","SF FuneralFDC00000007RYH250322","","126.5","","720268.34"
"2025-03-25","2025-03-22","SF FuneralF794889       250322","","126.5","","720394.84"
"2025-03-25","2025-03-22","SF FuneralFDC00000007VTS250322","","126.5","","720521.34"
"2025-03-25","2025-03-22","SF FuneralFDC000000080LC250322","","126.5","","720647.84"
"2025-03-25","2025-03-22","SF FuneralFDC000000081K9250322","","126.5","","720774.34"
"2025-03-25","2025-03-22","SF FuneralFDC000000082LK250322","","126.5","","720900.84"
"2025-03-25","2025-03-22","SF FuneralF800711       250322","","126.5","","721027.34"
"2025-03-25","2025-03-22","SF FuneralFDC00000008FMT250322","","126.5","","721153.84"
"2025-03-25","2025-03-22","SF FuneralFDC00000008G40250322","","126.5","","721280.34"
"2025-03-25","2025-03-22","SF FuneralFDC00000008H5F250321","","126.5","","721406.84"
"2025-03-25","2025-03-22","SF FuneralFDC00000008H5J250321","","126.5","","721533.34"
"2025-03-25","2025-03-22","SF FuneralFDC00000008HY7250322","","126.5","","721659.84"
"2025-03-25","2025-03-22","SF FuneralFDC00000008J08250321","","126.5","","721786.34"
"2025-03-25","2025-03-22","SF FuneralF801930       250321","","126.5","","721912.84"
"2025-03-25","2025-03-22","SF FuneralF802703       250321","","126.5","","722039.34"
"2025-03-25","2025-03-22","SF FuneralF804476       250322","","126.5","","722165.84"
"2025-03-25","2025-03-22","SF FuneralF805413       250322","","126.5","","722292.34"
"2025-03-25","2025-03-22","SF FuneralFDC00000008VVR250322","","126.5","","722418.84"
"2025-03-25","2025-03-22","SF FuneralF805816       250322","","126.5","","722545.34"
"2025-03-25","2025-03-22","SF FuneralF809033       250322","","126.5","","722671.84"
"2025-03-25","2025-03-22","SF FuneralF809456       250322","","126.5","","722798.34"
"2025-03-25","2025-03-22","SF FuneralF810602       250322","","126.5","","722924.84"
"2025-03-25","2025-03-22","SF FuneralF811445       250322","","126.5","","723051.34"
"2025-03-25","2025-03-22","SF FuneralF811912       250322","","126.5","","723177.84"
"2025-03-25","2025-03-22","SF FuneralFDC00000009DFS250322","","126.5","","723304.34"
"2025-03-25","2025-03-22","SF FuneralF813389       250322","","126.5","","723430.84"
"2025-03-25","2025-03-22","SF FuneralF817209       250321","","126.5","","723557.34"
"2025-03-25","2025-03-22","SF FuneralFDC0000000B0HR250321","","126.5","","723683.84"
"2025-03-25","2025-03-22","SF FuneralF819417       250322","","126.5","","723810.34"
"2025-03-25","2025-03-22","SF FuneralF819727       250322","","126.5","","723936.84"
"2025-03-25","2025-03-22","SF FuneralF828454       250322","","126.5","","724063.34"
"2025-03-25","2025-03-22","SF FuneralF820996       250322","","126.5","","724189.84"
"2025-03-25","2025-03-22","SF FuneralF823445       250322","","126.5","","724316.34"
"2025-03-25","2025-03-22","SF FuneralF827676       250322","","126.5","","724442.84"
"2025-03-25","2025-03-22","SF FuneralF830818       250322","","126.5","","724569.34"
"2025-03-25","2025-03-22","SF FuneralF831296       250322","","126.5","","724695.84"
"2025-03-25","2025-03-22","SF FuneralF831763       250321","","126.5","","724822.34"
"2025-03-25","2025-03-22","SF FuneralF834160       250322","","126.5","","724948.84"
"2025-03-25","2025-03-22","SF FuneralF838820       250322","","126.5","","725075.34"
"2025-03-25","2025-03-22","SF FuneralF842445       250322","","126.5","","725201.84"
"2025-03-25","2025-03-22","SF FuneralF842618       250322","","126.5","","725328.34"
"2025-03-25","2025-03-22","SF FuneralF992096       250322","","126.5","","725454.84"
"2025-03-25","2025-03-22","SF FuneralFDC0000000JHWC250322","","126.5","","725581.34"
"2025-03-25","2025-03-22","SF FuneralF1017760      250322","","126.5","","725707.84"
"2025-03-25","2025-03-22","SF FuneralF1017884      250322","","126.5","","725834.34"
"2025-03-25","2025-03-22","SF FuneralF1052590      250322","","126.5","","725960.84"
"2025-03-25","2025-03-22","SF FuneralF1054601      250322","","126.5","","726087.34"
"2025-03-25","2025-03-22","SF FuneralF1054620      250322","","126.5","","726213.84"
"2025-03-25","2025-03-22","SF FuneralFDC0000000KC29250322","","126.5","","726340.34"
"2025-03-25","2025-03-22","SF FuneralF1074741      250322","","126.5","","726466.84"
"2025-03-25","2025-03-22","SF FuneralF1074767      250322","","126.5","","726593.34"
"2025-03-25","2025-03-22","SF FuneralF1079667      250322","","126.5","","726719.84"
"2025-03-25","2025-03-22","SF FuneralF1083882      250322","","126.5","","726846.34"
"2025-03-25","2025-03-22","SF FuneralF1103526      250322","","126.5","","726972.84"
"2025-03-25","2025-03-22","SF FuneralF1108014      250322","","126.5","","727099.34"
"2025-03-25","2025-03-22","SF FuneralF1108116      250322","","126.5","","727225.84"
"2025-03-25","2025-03-22","SF FuneralF1108174      250322","","126.5","","727352.34"
"2025-03-25","2025-03-22","SF FuneralFDC0000000MHMS250322","","126.5","","727478.84"
"2025-03-25","2025-03-22","SF FuneralF1110463      250322","","126.5","","727605.34"
"2025-03-25","2025-03-22","SF FuneralF1111601      250322","","126.5","","727731.84"
"2025-03-25","2025-03-22","SF FuneralF1112225      250322","","126.5","","727858.34"
"2025-03-25","2025-03-22","SF FuneralF818303       250322","","321.5","","728179.84"
"2025-03-25","2025-03-22","SF FuneralF1112274      250322","","126.5","","728306.34"
"2025-03-25","2025-03-22","SF FuneralF1113881      250322","","126.5","","728432.84"
"2025-03-25","2025-03-22","SF FuneralF1114511      250322","","126.5","","728559.34"
"2025-03-25","2025-03-22","SF FuneralF1114549      250322","","126.5","","728685.84"
"2025-03-25","2025-03-22","SF FuneralF1114733      250322","","126.5","","728812.34"
"2025-03-25","2025-03-22","SF FuneralF1115182      250322","","126.5","","728938.84"
"2025-03-25","2025-03-22","SF FuneralFDC0000000NNBV250322","","126.5","","729065.34"
"2025-03-25","2025-03-22","SF FuneralFDC0000000NNC1250322","","126.5","","729191.84"
"2025-03-25","2025-03-22","SF FuneralF1118478      250322","","126.5","","729318.34"
"2025-03-25","2025-03-22","SF FuneralF787088       250322","","191.5","","729509.84"
"2025-03-25","2025-03-22","SF FuneralF1120318      250322","","126.5","","729636.34"
"2025-03-25","2025-03-22","SF FuneralF1120387      250322","","126.5","","729762.84"
"2025-03-25","2025-03-22","SF FuneralF1121885      250322","","126.5","","729889.34"
"2025-03-25","2025-03-22","SF FuneralFDC0000000P196250322","","126.5","","730015.84"
"2025-03-25","2025-03-22","SF FuneralF1123628      250322","","126.5","","730142.34"
"2025-03-25","2025-03-22","SF FuneralF1124272      250322","","126.5","","730268.84"
"2025-03-25","2025-03-22","SF FuneralF1124353      250322","","126.5","","730395.34"
"2025-03-25","2025-03-22","SF FuneralFDC0000000P9D7250322","","126.5","","730521.84"
"2025-03-25","2025-03-22","SF FuneralFDC0000000PKHB250322","","126.5","","730648.34"
"2025-03-25","2025-03-22","SF FuneralFDC0000000PL5R250322","","126.5","","730774.84"
"2025-03-25","2025-03-22","SF FuneralF1127438      250322","","126.5","","730901.34"
"2025-03-25","2025-03-22","SF FuneralFDC0000000PTGV250322","","126.5","","731027.84"
"2025-03-25","2025-03-22","SF FuneralF1128986      250322","","126.5","","731154.34"
"2025-03-25","2025-03-22","SF FuneralF1130282      250322","","126.5","","731280.84"
"2025-03-25","2025-03-22","SF FuneralF1130639      250322","","126.5","","731407.34"
"2025-03-25","2025-03-22","SF FuneralFDC0000000Q2GR250322","","126.5","","731533.84"
"2025-03-25","2025-03-22","SF FuneralF1130421      250322","","31.63","","731565.47"
"2025-03-25","2025-03-22","SF FuneralF1131885      250322","","126.5","","731691.97"
"2025-03-25","2025-03-22","SF FuneralF1131922      250322","","126.5","","731818.47"
"2025-03-25","2025-03-22","SF FuneralF1132238      250322","","126.5","","731944.97"
"2025-03-25","2025-03-22","SF FuneralF1132979      250322","","126.5","","732071.47"
"2025-03-25","2025-03-22","SF FuneralF1134541      250322","","126.5","","732197.97"
"2025-03-25","2025-03-17","SF FuneralFDC000000065J5250317","","126.5","","732324.47"
"2025-03-25","2025-03-19","SF FuneralF1080366      250319","","126.5","","732450.97"
"2025-03-25","2025-03-24","SF FuneralFDC0000000610R250324","","126.5","","732577.47"
"2025-03-25","2025-03-24","SF FuneralFDC000000066CH250323","","126.5","","732703.97"
"2025-03-25","2025-03-24","SF FuneralFDC000000066DB250323","","126.5","","732830.47"
"2025-03-25","2025-03-24","SF FuneralFDC00000007Y7J250323","","126.5","","732956.97"
"2025-03-25","2025-03-24","SF FuneralF808801       250323","","126.5","","733083.47"
"2025-03-25","2025-03-24","SF FuneralF822549       250324","","31.63","","733115.1"
"2025-03-25","2025-03-24","SF FuneralF843208       250322","","126.5","","733241.6"
"2025-03-25","2025-03-24","SF FuneralF844553       250322","","126.5","","733368.1"
"2025-03-25","2025-03-24","SF FuneralF900589       250322","","126.5","","733494.6"
"2025-03-25","2025-03-24","SF FuneralF1118440      250324","","126.5","","733621.1"
"2025-03-25","2025-03-20","SF FuneralF987150       250322","","126.5","","733747.6"
"2025-03-25","2025-03-22","SF FuneralFDC00000005ZGF250322","","126.5","","733874.1"
"2025-03-25","2025-03-22","SF FuneralFDC000000062BF250322","","126.5","","734000.6"
"2025-03-25","2025-03-22","SF FuneralFDC00000006S2R250322","","220","","734220.6"
"2025-03-25","2025-03-22","SF FuneralFDC000000079S2250322","","220","","734440.6"
"2025-03-25","2025-03-22","SF FuneralFDC00000007WGF250321","","126.5","","734567.1"
"2025-03-25","2025-03-22","SF FuneralFDC00000008FY8250322","","126.5","","734693.6"
"2025-03-25","2025-03-22","SF FuneralF805670       250322","","126.5","","734820.1"
"2025-03-25","2025-03-22","SF FuneralF805450       250322","","126.5","","734946.6"
"2025-03-25","2025-03-22","SF FuneralFDC0000000B4JK250322","","126.5","","735073.1"
"2025-03-25","2025-03-22","SF FuneralF832019       250322","","126.5","","735199.6"
"2025-03-25","2025-03-22","SF FuneralF1075086      250322","","126.5","","735326.1"
"2025-03-25","2025-03-22","SF FuneralF1102866      250322","","126.5","","735452.6"
"2025-03-25","2025-03-22","SF FuneralF1112220      250322","","126.5","","735579.1"
"2025-03-25","2025-03-22","SF FuneralFDC0000000Q18B250322","","126.5","","735705.6"
"2025-03-25","2025-03-22","SF FuneralF1133962      250322","","126.5","","735832.1"
"2025-03-25","2025-03-22","SF FuneralFDC0000000QJKW250323","","126.5","","735958.6"
"2025-03-25","2025-03-24","SF FuneralFDC0000000L98R250324","","126.5","","736085.1"
"2025-03-25","2025-03-25","SF FuneralFDC000000039MH250325","","220","","736305.1"
"2025-03-25","2025-03-25","SF FuneralFDC00000007J5R250325","","126.5","","736431.6"
"2025-03-25","2025-03-25","SF FuneralF795781       250325","","126.5","","736558.1"
"2025-03-25","2025-03-25","SF FuneralFDC00000007WYB250325","","126.5","","736684.6"
"2025-03-25","2025-03-25","SF FuneralFDC00000007Z0K250325","","126.5","","736811.1"
"2025-03-25","2025-03-25","SF FuneralFDC00000008HPF250325","","126.5","","736937.6"
"2025-03-25","2025-03-25","SF FuneralFDC00000008HX5250325","","126.5","","737064.1"
"2025-03-25","2025-03-25","SF FuneralF804091       250325","","31.63","","737095.73"
"2025-03-25","2025-03-25","SF FuneralF820335       250325","","126.5","","737222.23"
"2025-03-25","2025-03-25","SF FuneralF1113939      250325","","126.5","","737348.73"
"2025-03-25","2025-03-25","SF FuneralF1124597      250325","","126.5","","737475.23"
"2025-03-25","2025-03-25","SF FuneralF1130428      250325","","126.5","","737601.73"
"2025-03-25","2025-03-25","SF FuneralFDC0000000QK3K250325","","126.5","","737728.23"
"2025-03-25","2025-03-25","SF FuneralFDC000000062FY250325","","126.5","","737854.73"
"2025-03-25","2025-03-25","SF FuneralFDC0000000CY56250325","","31.63","","737886.36"
"2025-03-25","2025-03-25","SF FuneralF834459       250325","","126.5","","738012.86"
"2025-03-25","2025-03-25","SF FuneralFDC00000006B9G250325","","31.63","","738044.49"
"2025-03-25","2025-03-25","SF FuneralFDC00000006ZDP250325","","126.5","","738170.99"
"2025-03-25","2025-03-25","SF FuneralFDC00000007JMC250325","","126.5","","738297.49"
"2025-03-25","2025-03-25","SF FuneralFDC0000000KFFJ250325","","31.63","","738329.12"
"2025-03-25","2025-03-25","SF FuneralF1118437      250325","","126.5","","738455.62"
"2025-03-25","2025-03-25","SF FuneralFDC0000000Q4KT250325","","126.5","","738582.12"
"2025-03-25","2025-03-25","SF FuneralF1132219      250325","","126.5","","738708.62"
"2025-03-25","2025-03-25","SF FuneralF1132977      250325","","126.5","","738835.12"
"2025-03-25","2025-03-25","SF FuneralFDC000000080LX250325","","126.5","","738961.62"
"2025-03-25","2025-03-25","SF FuneralF792738       250325","","126.5","","739088.12"
"2025-03-25","2025-03-22","SF FuneralF805492       250322","","126.5","","739214.62"
"2025-03-25","2025-03-22","SF FuneralF1068347      250322","","126.5","","739341.12"
"2025-03-25","2025-03-22","SF FuneralF1119098      250322","","126.5","","739467.62"
"2025-03-25","2025-03-22","SF FuneralF1120114      250322","","126.5","","739594.12"
"2025-03-25","2025-03-20","SF FuneralFDC00000005GLY250320","","126.5","","739720.62"
"2025-03-25","2025-03-20","SF FuneralFDC00000006CVR250320","","126.5","","739847.12"
"2025-03-25","2025-03-20","SF FuneralFDC0000000HX7W250321","","31.63","","739878.75"
"2025-03-25","2025-03-20","SF FuneralF989868       250322","","126.5","","740005.25"
"2025-03-25","2025-03-20","SF FuneralF990869       250322","","126.5","","740131.75"
"2025-03-25","2025-03-20","SF FuneralF1062695      250321","","126.5","","740258.25"
"2025-03-25","2025-03-20","SF FuneralF1108634      250320","","126.5","","740384.75"
"2025-03-25","2025-03-22","SF FuneralFDC00000003GPW250322","","220","","740604.75"
"2025-03-25","2025-03-22","SF FuneralFDC00000003H19250322","","220.01","","740824.76"
"2025-03-25","2025-03-22","SF FuneralFDC00000003M35250322","","220","","741044.76"
"2025-03-25","2025-03-22","SF FuneralFDC000000042Q8250322","","220","","741264.76"
"2025-03-25","2025-03-22","SF FuneralFDC00000004G0C250322","","220","","741484.76"
"2025-03-25","2025-03-22","SF FuneralFDC00000005KGX250322","","126.5","","741611.26"
"2025-03-25","2025-03-22","SF FuneralFDC00000005LKL250322","","126.5","","741737.76"
"2025-03-25","2025-03-22","SF FuneralFDC00000005YFY250322","","126.5","","741864.26"
"2025-03-25","2025-03-22","SF FuneralFDC00000005YMD250322","","126.5","","741990.76"
"2025-03-25","2025-03-22","SF FuneralFDC00000005Z6D250322","","126.5","","742117.26"
"2025-03-25","2025-03-22","SF FuneralFDC00000005ZQ9250322","","126.5","","742243.76"
"2025-03-25","2025-03-22","SF FuneralFDC0000000614P250322","","126.5","","742370.26"
"2025-03-25","2025-03-22","SF FuneralFDC0000000640W250322","","126.5","","742496.76"
"2025-03-25","2025-03-22","SF FuneralFDC0000000654J250322","","126.5","","742623.26"
"2025-03-25","2025-03-22","SF FuneralFDC000000065GY250322","","126.5","","742749.76"
"2025-03-25","2025-03-22","SF FuneralFDC0000000670V250322","","126.5","","742876.26"
"2025-03-25","2025-03-22","SF FuneralFDC000000068SG250322","","126.5","","743002.76"
"2025-03-25","2025-03-22","SF FuneralFDC00000006D61250322","","126.5","","743129.26"
"2025-03-25","2025-03-22","SF FuneralFDC00000006F4X250322","","126.5","","743255.76"
"2025-03-25","2025-03-22","SF FuneralFDC00000006FJD250322","","126.5","","743382.26"
"2025-03-25","2025-03-22","SF FuneralFDC00000006Q2B250322","","126.5","","743508.76"
"2025-03-25","2025-03-22","SF FuneralFDC000000070RF250322","","126.5","","743635.26"
"2025-03-25","2025-03-22","SF FuneralFDC000000071D4250322","","126.5","","743761.76"
"2025-03-25","2025-03-22","SF FuneralFDC000000072D4250322","","126.5","","743888.26"
"2025-03-25","2025-03-22","SF FuneralFDC000000072ND250322","","126.5","","744014.76"
"2025-03-25","2025-03-22","SF FuneralFDC000000077WM250322","","126.5","","744141.26"
"2025-03-25","2025-03-22","SF FuneralFDC000000077X8250322","","126.5","","744267.76"
"2025-03-25","2025-03-22","SF FuneralFDC00000007FBP250322","","126.5","","744394.26"
"2025-03-25","2025-03-22","SF FuneralFDC00000007KYM250322","","220","","744614.26"
"2025-03-25","2025-03-22","SF FuneralFDC00000007M08250322","","126.5","","744740.76"
"2025-03-25","2025-03-22","SF FuneralFDC00000007M71250322","","126.5","","744867.26"
"2025-03-25","2025-03-22","SF FuneralFDC00000007QBZ250322","","126.5","","744993.76"
"2025-03-25","2025-03-22","SF FuneralFDC00000007TN9250322","","126.5","","745120.26"
"2025-03-25","2025-03-22","SF FuneralFDC00000008112250322","","126.5","","745246.76"
"2025-03-25","2025-03-22","SF FuneralFDC000000081T7250322","","126.5","","745373.26"
"2025-03-25","2025-03-22","SF FuneralFDC000000081T8250322","","126.5","","745499.76"
"2025-03-25","2025-03-22","SF FuneralFDC000000081TT250322","","126.5","","745626.26"
"2025-03-25","2025-03-22","SF FuneralF802419       250322","","126.5","","745752.76"
"2025-03-25","2025-03-22","SF FuneralF803570       250321","","126.5","","745879.26"
"2025-03-25","2025-03-22","SF FuneralF804128       250322","","126.5","","746005.76"
"2025-03-25","2025-03-22","SF FuneralF804134       250322","","126.5","","746132.26"
"2025-03-25","2025-03-22","SF FuneralF809767       250321","","126.5","","746258.76"
"2025-03-25","2025-03-22","SF FuneralFDC000000095VP250322","","126.5","","746385.26"
"2025-03-25","2025-03-22","SF FuneralF811210       250322","","126.5","","746511.76"
"2025-03-25","2025-03-22","SF FuneralF811397       250322","","126.5","","746638.26"
"2025-03-25","2025-03-22","SF FuneralF812846       250322","","126.5","","746764.76"
"2025-03-25","2025-03-22","SF FuneralF813381       250322","","126.5","","746891.26"
"2025-03-25","2025-03-22","SF FuneralF798152       250322","","126.5","","747017.76"
"2025-03-25","2025-03-22","SF FuneralF815856       250322","","126.5","","747144.26"
"2025-03-25","2025-03-22","SF FuneralFDC00000009XXT250322","","126.5","","747270.76"
"2025-03-25","2025-03-22","SF FuneralF821539       250322","","126.5","","747397.26"
"2025-03-25","2025-03-22","SF FuneralF821957       250322","","126.5","","747523.76"
"2025-03-25","2025-03-22","SF FuneralF828106       250322","","126.5","","747650.26"
"2025-03-25","2025-03-22","SF FuneralF830985       250322","","126.5","","747776.76"
"2025-03-25","2025-03-22","SF FuneralF833186       250322","","126.5","","747903.26"
"2025-03-25","2025-03-22","SF FuneralFDC0000000CV68250322","","126.5","","748029.76"
"2025-03-25","2025-03-22","SF FuneralF834524       250322","","126.5","","748156.26"
"2025-03-25","2025-03-22","SF FuneralF834545       250322","","126.5","","748282.76"
"2025-03-25","2025-03-22","SF FuneralFDC0000000DHQ3250322","","126.5","","748409.26"
"2025-03-25","2025-03-22","SF FuneralF840953       250321","","126.5","","748535.76"
"2025-03-25","2025-03-22","SF FuneralF842878       250322","","126.5","","748662.26"
"2025-03-25","2025-03-22","SF FuneralF1021497      250322","","126.5","","748788.76"
"2025-03-25","2025-03-22","SF FuneralF1021876      250322","","126.5","","748915.26"
"2025-03-25","2025-03-22","SF FuneralF1054909      250322","","126.5","","749041.76"
"2025-03-25","2025-03-22","SF FuneralF1055001      250322","","126.5","","749168.26"
"2025-03-25","2025-03-22","SF FuneralF1060391      250322","","126.5","","749294.76"
"2025-03-25","2025-03-22","SF FuneralF1061884      250322","","126.5","","749421.26"
"2025-03-25","2025-03-22","SF FuneralFDC0000000KPHD250322","","126.5","","749547.76"
"2025-03-25","2025-03-22","SF FuneralF1066051      250323","","126.5","","749674.26"
"2025-03-25","2025-03-22","SF FuneralF1066396      250323","","126.5","","749800.76"
"2025-03-25","2025-03-22","SF FuneralF1066723      250322","","126.5","","749927.26"
"2025-03-25","2025-03-22","SF FuneralF1066964      250322","","126.5","","750053.76"
"2025-03-25","2025-03-22","SF FuneralF1067973      250322","","126.5","","750180.26"
"2025-03-25","2025-03-22","SF FuneralF1068177      250322","","126.5","","750306.76"
"2025-03-25","2025-03-22","SF FuneralF1073207      250322","","126.5","","750433.26"
"2025-03-25","2025-03-22","SF FuneralFDC0000000L24R250322","","126.5","","750559.76"
"2025-03-25","2025-03-22","SF FuneralFDC0000000L24X250322","","126.5","","750686.26"
"2025-03-25","2025-03-22","SF FuneralF1073222      250322","","126.5","","750812.76"
"2025-03-25","2025-03-22","SF FuneralF1074465      250322","","126.5","","750939.26"
"2025-03-25","2025-03-22","SF FuneralF1074820      250322","","126.5","","751065.76"
"2025-03-25","2025-03-22","SF FuneralF1078504      250322","","126.5","","751192.26"
"2025-03-25","2025-03-22","SF FuneralFDC0000000LQNQ250322","","126.5","","751318.76"
"2025-03-25","2025-03-22","SF FuneralF1083936      250322","","126.5","","751445.26"
"2025-03-25","2025-03-22","SF FuneralF1108045      250322","","126.5","","751571.76"
"2025-03-25","2025-03-22","SF FuneralF1108706      250322","","126.5","","751698.26"
"2025-03-25","2025-03-22","SF FuneralF1108875      250322","","126.5","","751824.76"
"2025-03-25","2025-03-22","SF FuneralF1109837      250323","","126.5","","751951.26"
"2025-03-25","2025-03-22","SF FuneralF1113899      250322","","126.5","","752077.76"
"2025-03-25","2025-03-22","SF FuneralF1114925      250322","","126.5","","752204.26"
"2025-03-25","2025-03-22","SF FuneralF1115944      250322","","126.5","","752330.76"
"2025-03-25","2025-03-22","SF FuneralF1115973      250322","","126.5","","752457.26"
"2025-03-25","2025-03-22","SF FuneralFDC0000000NLY4250322","","126.5","","752583.76"
"2025-03-25","2025-03-22","SF FuneralFDC0000000NPS6250322","","126.5","","752710.26"
"2025-03-25","2025-03-22","SF FuneralF1120161      250322","","126.5","","752836.76"
"2025-03-25","2025-03-22","SF FuneralFDC0000000NVZY250322","","256.5","","753093.26"
"2025-03-25","2025-03-22","SF FuneralFDC0000000P0Z1250322","","126.5","","753219.76"
"2025-03-25","2025-03-22","SF FuneralFDC0000000P0Z9250322","","126.5","","753346.26"
"2025-03-25","2025-03-22","SF FuneralF1122947      250322","","126.5","","753472.76"
"2025-03-25","2025-03-22","SF FuneralF1124596      250322","","126.5","","753599.26"
"2025-03-25","2025-03-22","SF FuneralF1127365      250322","","126.5","","753725.76"
"2025-03-25","2025-03-22","SF FuneralF1127549      250322","","126.5","","753852.26"
"2025-03-25","2025-03-22","SF FuneralFDC0000000PVMR250322","","126.5","","753978.76"
"2025-03-25","2025-03-22","SF FuneralFDC0000000Q390250322","","126.5","","754105.26"
"2025-03-25","2025-03-22","SF FuneralF1131018      250322","","126.5","","754231.76"
"2025-03-25","2025-03-22","SF FuneralFDC0000000Q5N2250322","","126.5","","754358.26"
"2025-03-25","2025-03-22","SF FuneralFDC0000000QC7D250322","","126.5","","754484.76"
"2025-03-25","2025-03-22","SF FuneralF1133246      250322","","126.5","","754611.26"
"2025-03-25","2025-03-22","SF FuneralFDC0000000QCDP250322","","126.5","","754737.76"
"2025-03-25","2025-03-22","SF FuneralFDC0000000QCFT250322","","126.5","","754864.26"
"2025-03-25","2025-03-22","SF FuneralFDC0000000QCFV250322","","126.5","","754990.76"
"2025-03-25","2025-03-22","SF FuneralF1108279      250322","","126.5","","755117.26"
"2025-03-25","2025-03-22","SF FuneralF1133985      250322","","126.5","","755243.76"
"2025-03-25","2025-03-24","SF FuneralFDC00000003XCX250323","","220","","755463.76"
"2025-03-25","2025-03-24","SF FuneralFDC00000006W2R250324","","126.5","","755590.26"
"2025-03-25","2025-03-24","SF FuneralF805633       250324","","126.5","","755716.76"
"2025-03-25","2025-03-24","SF FuneralFDC00000008X5Z250323","","126.5","","755843.26"
"2025-03-25","2025-03-24","SF FuneralFDC00000009DX3250323","","31.63","","755874.89"
"2025-03-25","2025-03-24","SF FuneralF847239       250322","","126.5","","756001.39"
"2025-03-25","2025-03-24","SF FuneralFDC0000000GJWB250322","","126.5","","756127.89"
"2025-03-25","2025-03-24","SF FuneralF1085335      250324","","126.5","","756254.39"
"2025-03-25","2025-03-24","SF FuneralF1124769      250324","","126.5","","756380.89"
"2025-03-25","2025-02-22","Rev SF FuneralFDC000000086MN250222","","-126.5","","756254.39"
"2025-03-25","2025-03-22","Rev SF FuneralFDC0000000PR6H250322","","-126.5","","756127.89"
"2025-03-25","2025-03-22","Rev SF FuneralFDC0000000J589250322","","-126.5","","756001.39"
"2025-03-25","2025-03-22","Rev SF FuneralFDC0000000J5BL250322","","-126.5","","755874.89"
"2025-03-25","2025-03-22","Rev SF FuneralFDC0000000J5CV250322","","-126.5","","755748.39"
"2025-03-25","2025-03-20","Rev SF FuneralFDC00000006D6Y250320","","-126.5","","755621.89"
"2025-03-25","2025-03-22","Rev SF FuneralFDC00000006BQJ250322","","-126.5","","755495.39"
"2025-03-25","2025-03-20","Rev SF FuneralFDC00000004950250320","","-220","","755275.39"
"2025-03-25","2025-03-22","Rev SF FuneralFDC0000000607F250322","","-126.5","","755148.89"
"2025-03-25","2025-03-20","Rev SF FuneralFDC0000000N8Q4250320","","-126.5","","755022.39"
"2025-03-25","2025-03-22","Rev SF FuneralFDC0000000BMH8250322","","-126.5","","754895.89"
"2025-03-25","2025-03-22","Rev SF FuneralFDC0000000PX1W250322","","-126.5","","754769.39"
"2025-03-25","2025-03-22","Rev SF FuneralFDC0000000QFZ3250322","","-126.5","","754642.89"
"2025-03-25","2025-03-22","Rev SF FuneralFDC000000086MN250322","","-126.5","","754516.39"
"2025-03-25","2025-03-22","Rev SF FuneralFDC0000000Q1V8250322","","-126.5","","754389.89"
"2025-03-25","2025-03-22","Rev SF FuneralFDC0000000QCPX250322","","-126.5","","754263.39"
"2025-03-25","2025-03-22","Rev SF FuneralFDC00000006Z9F250322","","-126.5","","754136.89"
"2025-03-25","2025-03-22","Rev SF FuneralFDC00000007HJ6250322","","-126.5","","754010.39"
"2025-03-25","2025-03-22","Rev SF FuneralFDC0000000795Q250321","","-126.5","","753883.89"
"2025-03-25","2025-03-22","Rev SF FuneralFDC00000007W65250322","","-126.5","","753757.39"
"2025-03-25","2025-03-22","Rev SF FuneralFDC0000000KLMP250322","","-126.5","","753630.89"
"2025-03-25","2025-03-22","Rev SF FuneralFDC00000005J5B250322","","-126.5","","753504.39"
"2025-03-25","2025-03-22","Rev SF FuneralFDC00000005K7F250322","","-126.5","","753377.89"
"2025-03-25","2025-03-22","Rev SF FuneralFDC0000000BBCW250322","","-126.5","","753251.39"
"2025-03-25","2025-03-22","Rev SF FuneralFDC00000006Y54250321","","-126.5","","753124.89"
"2025-03-25","2025-03-22","Rev SF FuneralFDC00000005Z3H250322","","-126.5","","752998.39"
"2025-03-25","2025-03-22","Rev SF FuneralFDC00000007M57250322","","-126.5","","752871.89"
"2025-03-25","2025-03-22","Rev SF FuneralFDC000000060XP250322","","-126.5","","752745.39"
"2025-03-25","2025-03-22","Rev SF FuneralFDC00000005S2X250322","","-126.5","","752618.89"
"2025-03-25","2025-03-22","Rev SF FuneralFDC00000005S9G250322","","-126.5","","752492.39"
"2025-03-25","2025-03-22","Rev SF FuneralFDC0000000711K250322","","-126.5","","752365.89"
"2025-03-25","2025-03-22","Rev SF FuneralFDC0000000CPMP250322","","-126.5","","752239.39"
"2025-03-25","2025-03-22","Rev SF FuneralFDC00000008T2Z250322","","-126.5","","752112.89"
"2025-03-25","2025-03-22","Rev SF FuneralFDC0000000NXVF250323","","-126.5","","751986.39"
"2025-03-25","2025-03-22","Rev SF FuneralFDC0000000BH7D250321","","-126.5","","751859.89"
"2025-03-25","2025-03-22","Rev SF FuneralFDC00000008W82250322","","-126.5","","751733.39"
"2025-03-25","2025-03-22","Rev SF FuneralFDC0000000L0CC250322","","-126.5","","751606.89"
"2025-03-25","2025-03-24","Rev SF FuneralFDC0000000B6SN250323","","-126.5","","751480.39"
"2025-03-25","2025-03-24","Rev SF FuneralFDC00000005V61250323","","-126.5","","751353.89"
"2025-03-25","2025-03-24","Rev SF FuneralFDC00000006W3K250323","","-126.5","","751227.39"
"2025-03-25","2025-03-24","Rev SF FuneralFDC000000079BQ250323","","-126.5","","751100.89"
"2025-03-25","2025-03-20","Rev SF FuneralFDC0000000NNGY250321","","-31.63","","751069.26"
"2025-03-25","2025-03-22","Rev SF FuneralFDC00000007MW5250321","","-31.63","","751037.63"
"2025-03-25","2025-03-24","Rev SF FuneralFDC00000005YW3250324","","-31.63","","751006"
"2025-03-25","2025-03-24","Rev SF FuneralFDC00000005YNL250324","","-55","","750951"
"2025-03-25","2025-03-25","Rev SF FuneralFDC00000007MXH250325","","-126.5","","750824.5"
"2025-03-25","2025-03-25","Rev SF FuneralFDC00000006R2Y250325","","-126.5","","750698"
"2025-03-25","2025-03-19","Rev SF FuneralFDC0000000PZX0250319","","-126.5","","750571.5"
"2025-03-25","2025-03-20","SF FuneralF990865       250322","","126.5","","750698"
"2025-03-25","2025-03-22","SF FuneralF1127672      250322","","126.5","","750824.5"
"2025-03-25","2025-03-22","SF FuneralFDC00000007HRH250322","","126.5","","750951"
"2025-03-25","2025-03-22","SF FuneralFDC00000007HRN250322","","126.5","","751077.5"
"2025-03-25","2025-03-22","SF FuneralF823881       250322","","126.5","","751204"
"2025-03-25","2025-03-22","SF FuneralF987229       250322","","126.5","","751330.5"
"2025-03-25","2025-03-25","SF FuneralF832498       250325","","191.5","","751522"
"2025-03-25","2025-03-20","SF FuneralFDC0000000HSSY250322","","126.5","","751648.5"
"2025-03-25","2025-03-22","SF FuneralF1058678      250322","","126.5","","751775"
"2025-03-25","2025-03-22","SF FuneralF1074438      250322","","126.5","","751901.5"
"2025-03-25","2025-03-22","SF FuneralF1083857      250322","","126.5","","752028"
"2025-03-25","2025-03-24","SF FuneralFDC00000008L4W250324","","126.5","","752154.5"
"2025-03-25","2025-03-18","SF FuneralFDC0000000B379250318","","63.25","","752217.75"
"2025-03-25","2025-03-20","SF FuneralF986775       250323","","126.5","","752344.25"
"2025-03-25","2025-03-20","SF FuneralF987876       250322","","126.5","","752470.75"
"2025-03-25","2025-03-20","SF FuneralF1125165      250321","","126.5","","752597.25"
"2025-03-25","2025-03-22","SF FuneralFDC00000003GQF250321","","220","","752817.25"
"2025-03-25","2025-03-22","SF FuneralFDC00000006ZWP250322","","126.5","","752943.75"
"2025-03-25","2025-03-22","SF FuneralFDC00000007ZW7250322","","126.5","","753070.25"
"2025-03-25","2025-03-22","SF FuneralFDC000000081H9250322","","126.5","","753196.75"
"2025-03-25","2025-03-22","SF FuneralFDC000000081VZ250322","","126.5","","753323.25"
"2025-03-25","2025-03-22","SF FuneralFDC000000085MM250322","","126.5","","753449.75"
"2025-03-25","2025-03-22","SF FuneralFDC000000087QS250322","","126.5","","753576.25"
"2025-03-25","2025-03-22","SF FuneralF820542       250322","","126.5","","753702.75"
"2025-03-25","2025-03-22","SF FuneralF823181       250322","","126.5","","753829.25"
"2025-03-25","2025-03-22","SF FuneralF840643       250322","","126.5","","753955.75"
"2025-03-25","2025-03-22","SF FuneralFDC0000000DF1Q250322","","126.5","","754082.25"
"2025-03-25","2025-03-22","SF FuneralF1108269      250322","","126.5","","754208.75"
"2025-03-25","2025-03-22","SF FuneralFDC0000000N651250322","","126.5","","754335.25"
"2025-03-25","2025-03-22","SF FuneralF1124196      250322","","126.5","","754461.75"
"2025-03-25","2025-03-22","SF FuneralFDC0000000PB3V250322","","321.5","","754783.25"
"2025-03-25","2025-03-22","SF FuneralF1125876      250322","","126.5","","754909.75"
"2025-03-25","2025-03-22","SF FuneralFDC0000000Q22P250322","","126.5","","755036.25"
"2025-03-25","2025-03-22","SF FuneralF1133798      250322","","126.5","","755162.75"
"2025-03-25","2025-03-22","SF FuneralFDC0000000QJVB250322","","126.5","","755289.25"
"2025-03-25","2025-03-24","SF FuneralFDC00000008X7G250324","","126.5","","755415.75"
"2025-03-25","2025-03-24","SF FuneralFDC0000000L661250324","","126.5","","755542.25"
"2025-03-25","2025-03-24","SF FuneralF1110473      250324","","126.5","","755668.75"
"2025-03-25","2025-03-25","SF FuneralFDC00000006BTY250325","","126.5","","755795.25"
"2025-03-25","2025-03-25","SF FuneralFDC00000006M59250325","","126.5","","755921.75"
"2025-03-25","2025-03-25","SF FuneralFDC000000082V5250325","","126.5","","756048.25"
"2025-03-25","2025-03-20","SF FuneralF1108742      250320","","126.5","","756174.75"
"2025-03-25","2025-03-20","SF FuneralF1134876      250321","","63.25","","756238"
"2025-03-25","2025-03-22","SF FuneralFDC00000002RJP250322","","220","","756458"
"2025-03-25","2025-03-22","SF FuneralFDC00000003N7T250322","","220","","756678"
"2025-03-25","2025-03-22","SF FuneralF797664       250322","","126.5","","756804.5"
"2025-03-25","2025-03-22","SF FuneralF815977       250322","","126.5","","756931"
"2025-03-25","2025-03-22","SF FuneralF1017064      250322","","126.5","","757057.5"
"2025-03-25","2025-03-22","SF FuneralFDC0000000KYQP250322","","126.5","","757184"
"2025-03-25","2025-03-22","SF FuneralF1074974      250322","","126.5","","757310.5"
"2025-03-25","2025-03-22","SF FuneralF1130824      250322","","126.5","","757437"
"2025-03-25","2025-03-24","SF FuneralFDC00000006XCF250324","","126.5","","757563.5"
"2025-03-25","2025-03-24","SF FuneralF847273       250322","","126.5","","757690"
"2025-03-25","2025-03-24","SF FuneralFDC0000000NC8P250324","","126.5","","757816.5"
"2025-03-25","2025-03-25","SF FuneralFDC00000006XY7250325","","126.5","","757943"
"2025-03-25","2025-03-25","SF FuneralF811759       250325","","126.5","","758069.5"
"2025-03-25","2025-03-25","SF FuneralF812990       250325","","126.5","","758196"
"2025-03-25","2025-03-25","SF FuneralFDC0000000HVZS250325","","126.5","","758322.5"
"2025-03-25","2025-03-25","SF FuneralFDC0000000K08S250325","","126.5","","758449"
"2025-03-25","2025-03-25","SF FuneralF1112091      250325","","126.5","","758575.5"
"2025-03-25","2025-03-25","SF FuneralF1134943      250325","","126.5","","758702"
"2025-03-25","2025-03-22","SF FuneralF1131726      250322","","31.63","","758733.63"
"2025-03-25","2025-03-24","SF FuneralF1131541      250324","","31.63","","758765.26"
"2025-03-25","2025-03-25","SF FuneralF987244       250325","","31.63","","758796.89"
"2025-03-25","2025-03-25","SF FuneralF1129417      250325","","31.63","","758828.52"
"2025-03-25","2025-03-20","SF FuneralF991044       250320","","126.5","","758955.02"
"2025-03-25","2025-03-22","SF FuneralFDC00000005K72250322","","220","","759175.02"
"2025-03-25","2025-03-22","SF FuneralFDC00000005LVF250322","","126.5","","759301.52"
"2025-03-25","2025-03-22","SF FuneralF811877       250322","","126.5","","759428.02"
"2025-03-25","2025-03-22","SF FuneralF815051       250322","","126.5","","759554.52"
"2025-03-25","2025-03-22","SF FuneralF815478       250322","","126.5","","759681.02"
"2025-03-25","2025-03-22","SF FuneralF821578       250322","","126.5","","759807.52"
"2025-03-25","2025-03-22","SF FuneralF1060484      250322","","126.5","","759934.02"
"2025-03-25","2025-03-22","SF FuneralF1065688      250322","","126.5","","760060.52"
"2025-03-25","2025-03-22","SF FuneralF1073121      250322","","126.5","","760187.02"
"2025-03-25","2025-03-20","SF FuneralFDC000000063TZ250320","","126.5","","760313.52"
"2025-03-25","2025-03-20","SF FuneralF988433       250322","","126.5","","760440.02"
"2025-03-25","2025-03-24","SF FuneralF819085       250324","","63.25","","760503.27"
"2025-03-25","2025-03-22","SF FuneralFDC00000007K8M250322","","126.5","","760629.77"
"2025-03-25","2025-03-22","SF FuneralFDC00000007L14250322","","126.5","","760756.27"
"2025-03-25","2025-03-22","SF FuneralFDC00000007VJH250322","","126.5","","760882.77"
"2025-03-25","2025-03-22","SF FuneralFDC00000007VJV250322","","126.5","","761009.27"
"2025-03-25","2025-03-22","SF FuneralF803914       250322","","126.5","","761135.77"
"2025-03-25","2025-03-22","SF FuneralF1020528      250322","","126.5","","761262.27"
"2025-03-25","2025-03-22","SF FuneralF1108619      250323","","126.5","","761388.77"
"2025-03-25","2025-03-22","SF FuneralF1110306      250322","","126.5","","761515.27"
"2025-03-25","2025-03-22","Rev SF FuneralFDC00000007HRH250322","","-126.5","","761388.77"
"2025-03-25","2025-03-17","SF FuneralF817765       250317","","191.5","","761580.27"
"2025-03-25","2025-03-20","SF FuneralF980379       250321","","31.63","","761611.9"
"2025-03-25","2025-03-20","SF FuneralF1124558      250320","","126.5","","761738.4"
"2025-03-25","2025-03-22","SF FuneralFDC00000006F54250322","","191.5","","761929.9"
"2025-03-25","2025-03-22","SF FuneralFDC0000000722R250322","","126.5","","762056.4"
"2025-03-25","2025-03-22","SF FuneralFDC00000008K9Z250322","","126.5","","762182.9"
"2025-03-25","2025-03-22","SF FuneralF819549       250322","","126.5","","762309.4"
"2025-03-25","2025-03-22","SF FuneralF823170       250322","","126.5","","762435.9"
"2025-03-25","2025-03-22","SF FuneralF1054511      250322","","126.5","","762562.4"
"2025-03-25","2025-03-22","SF FuneralF1073814      250322","","126.5","","762688.9"
"2025-03-25","2025-03-22","SF FuneralF1108084      250322","","126.5","","762815.4"
"2025-03-25","2025-03-22","SF FuneralF1125063      250322","","126.5","","762941.9"
"2025-03-25","2025-03-20","SF FuneralF991582       250320","","126.5","","763068.4"
"2025-03-25","2025-03-22","SF FuneralFDC00000005ZW7250321","","126.5","","763194.9"
"2025-03-25","2025-03-22","SF FuneralFDC0000000941V250322","","126.5","","763321.4"
"2025-03-25","2025-03-22","SF FuneralF805500       250322","","126.5","","763447.9"
"2025-03-25","2025-03-22","SF FuneralFDC0000000BHZJ250322","","126.5","","763574.4"
"2025-03-25","2025-03-22","SF FuneralFDC0000000KWVL250322","","126.5","","763700.9"
"2025-03-25","2025-03-22","SF FuneralF1074451      250322","","126.5","","763827.4"
"2025-03-25","2025-03-22","SF FuneralF1108053      250322","","126.5","","763953.9"
"2025-03-25","2025-03-22","SF FuneralF1111962      250322","","126.5","","764080.4"
"2025-03-25","2025-03-22","SF FuneralF1112160      250322","","126.5","","764206.9"
"2025-03-25","2025-03-22","SF FuneralF1112165      250322","","126.5","","764333.4"
"2025-03-25","2025-03-24","SF FuneralF811738       250324","","126.5","","764459.9"
"2025-03-25","2025-03-24","SF FuneralF827664       250324","","63.25","","764523.15"
"2025-03-25","2025-03-24","SF FuneralF834561       250324","","126.5","","764649.65"
"2025-03-25","2025-03-24","SF FuneralF1130771      250324","","126.5","","764776.15"
"2025-03-25","2025-03-25","SF FuneralFDC00000007N0P250325","","126.5","","764902.65"
"2025-03-25","2025-03-25","SF FuneralFDC00000007N5C250325","","126.5","","765029.15"
"2025-03-25","2025-03-25","SF FuneralF1052117      250325","","63.25","","765092.4"
"2025-03-25","2025-03-25","SF FuneralF1119069      250325","","126.5","","765218.9"
"2025-03-25","2025-03-22","SF FuneralF810304       250322","","126.5","","765345.4"
"2025-03-25","2025-03-24","SF FuneralF1111395      250324","","31.63","","765377.03"
"2025-03-25","2025-03-25","SF FuneralF1132363      250325","","126.5","","765503.53"
"2025-03-25","2025-03-22","SF FuneralFDC0000000JB1L250322","","126.5","","765630.03"
"2025-03-25","2025-03-22","SF FuneralF1065807      250322","","126.5","","765756.53"
"2025-03-25","2025-03-22","SF FuneralF786291       250322","","126.5","","765883.03"
"2025-03-25","2025-03-24","SF FuneralFDC00000007H77250323","","126.5","","766009.53"
"2025-03-25","2025-03-24","SF FuneralFDC00000007HG8250323","","126.5","","766136.03"
"2025-03-25","2025-03-24","SF FuneralF900678       250324","","126.5","","766262.53"
"2025-03-25","2025-03-25","SF FuneralF991420       250325","","126.5","","766389.03"
"2025-03-25","2025-03-25","Fee-Teller Transactions","","-14.8","","766374.23"
"2025-03-25","2025-03-25","Dep-Cash-SFTDC2022782997","","220","14.8","766594.23"
"2025-03-25","2025-03-20","SF FuneralF811276       250321","","126.5","","766720.73"
"2025-03-25","2025-03-22","SF FuneralF809910       250322","","126.5","","766847.23"
"2025-03-25","2025-03-22","SF FuneralF1108109      250322","","126.5","","766973.73"
"2025-03-25","2025-03-25","SF FuneralFDC00000007LNP250325","","126.5","","767100.23"
"2025-03-25","2025-03-25","SF FuneralFDC00000008HNM250325","","126.5","","767226.73"
"2025-03-25","2025-03-25","SF FuneralF1083746      250325","","126.5","","767353.23"
"2025-03-25","2025-03-25","Fee-Teller Transactions","","-14.8","","767338.43"
"2025-03-25","2025-03-25","Dep-Cash-6010245805083","","220","14.8","767558.43"
"2025-03-25","2025-03-22","SF FuneralF812779       250321","","31.63","","767590.06"
"2025-03-25","2025-03-25","SF FuneralFDC0000000HN9N250325","","31.63","","767621.69"
"2025-03-25","2025-03-22","SF FuneralFDC000000089DN250322","","126.5","","767748.19"
"2025-03-25","2025-03-22","SF FuneralF1128955      250322","","126.5","","767874.69"
"2025-03-25","2025-03-24","SF FuneralFDC00000005GH0250324","","31.63","","767906.32"
"2025-03-25","2025-03-24","SF FuneralFDC0000000JRDD250324","","126.5","","768032.82"
"2025-03-25","2025-03-25","SF FuneralFDC00000007KLD250325","","31.63","","768064.45"
"2025-03-25","2025-03-25","SF FuneralFDC00000007NHT250325","","126.5","","768190.95"
"2025-03-25","2025-03-25","SF FuneralFDC0000000HXY2250325","","31.63","","768222.58"
"2025-03-25","2025-03-20","SF FuneralF988853       250322","","126.5","","768349.08"
"2025-03-25","2025-03-22","SF FuneralFDC000000030JF250322","","220","","768569.08"
"2025-03-25","2025-03-22","SF FuneralFDC000000061B7250322","","126.5","","768695.58"
"2025-03-25","2025-03-22","SF FuneralF815368       250322","","126.5","","768822.08"
"2025-03-25","2025-03-22","SF FuneralF842227       250322","","126.5","","768948.58"
"2025-03-25","2025-03-22","SF FuneralF992546       250322","","126.5","","769075.08"
"2025-03-25","2025-03-22","SF FuneralF1016962      250322","","126.5","","769201.58"
"2025-03-25","2025-03-22","SF FuneralF1068327      250322","","126.5","","769328.08"
"2025-03-25","2025-03-22","SF FuneralF1074591      250322","","126.5","","769454.58"
"2025-03-25","2025-03-22","SF FuneralFDC0000000LRHQ250322","","126.5","","769581.08"
"2025-03-25","2025-03-22","SF FuneralF1116092      250322","","126.5","","769707.58"
"2025-03-25","2025-03-22","SF FuneralF1124356      250322","","126.5","","769834.08"
"2025-03-25","2025-03-22","SF FuneralF1133885      250322","","126.5","","769960.58"
"2025-03-25","2025-03-24","SF FuneralFDC00000005ZD0250323","","126.5","","770087.08"
"2025-03-25","2025-03-24","SF FuneralFDC00000007KRD250323","","191.5","","770278.58"
"2025-03-25","2025-03-24","SF FuneralFDC0000000B1BT250323","","126.5","","770405.08"
"2025-03-25","2025-03-25","SF FuneralFDC00000004J3N250325","","220","","770625.08"
"2025-03-25","2025-03-25","SF FuneralFDC00000007BQ3250325","","126.5","","770751.58"
"2025-03-25","2025-03-25","SF FuneralF992274       250325","","126.5","","770878.08"
"2025-03-25","2025-03-25","SF FuneralF1132357      250325","","126.5","","771004.58"
"2025-03-25","2025-03-19","SF FuneralF1115069      250319","","63.25","","771067.83"
"2025-03-25","2025-03-22","SF FuneralFDC000000057TS250322","","126.5","","771194.33"
"2025-03-25","2025-03-22","SF FuneralFDC000000060Y7250322","","126.5","","771320.83"
"2025-03-25","2025-03-22","SF FuneralFDC0000000617L250322","","126.5","","771447.33"
"2025-03-25","2025-03-22","SF FuneralFDC000000061B3250322","","126.5","","771573.83"
"2025-03-25","2025-03-22","SF FuneralF1054537      250322","","126.5","","771700.33"
"2025-03-25","2025-03-24","SF FuneralF818423       250324","","126.5","","771826.83"
"2025-03-25","2025-03-24","SF FuneralFDC0000000B1ZX250324","","126.5","","771953.33"
"2025-03-25","2025-03-24","SF FuneralF820104       250324","","126.5","","772079.83"
"2025-03-25","2025-03-24","SF FuneralF1060914      250324","","63.25","","772143.08"
"2025-03-25","2025-03-25","SF FuneralF1055108      250325","","126.5","","772269.58"
"2025-03-25","2025-03-25","SF FuneralF792924       250325","","126.5","","772396.08"
"2025-03-25","2025-03-20","SF FuneralF988465       250321","","126.5","","772522.58"
"2025-03-25","2025-03-20","SF FuneralF1124386      250321","","126.5","","772649.08"
"2025-03-25","2025-03-22","SF FuneralF811344       250322","","126.5","","772775.58"
"2025-03-25","2025-03-22","SF FuneralF1052457      250322","","126.5","","772902.08"
"2025-03-25","2025-03-22","SF FuneralFDC0000000NGY6250322","","126.5","","773028.58"
"2025-03-25","2025-03-22","SF FuneralFDC0000000PWSK250322","","126.5","","773155.08"
"2025-03-25","2025-03-24","SF FuneralFDC000000061CB250323","","126.5","","773281.58"
"2025-03-25","2025-03-24","SF FuneralFDC00000006WM1250324","","126.5","","773408.08"
"2025-03-25","2025-03-24","SF FuneralFDC0000000K6KT250324","","126.5","","773534.58"
"2025-03-25","2025-03-25","SF FuneralF843423       250325","","126.5","","773661.08"
"2025-03-25","2025-03-20","SF FuneralFDC000000058K3250320","","126.5","","773787.58"
"2025-03-25","2025-03-24","SF FuneralF811320       250323","","126.5","","773914.08"
"2025-03-25","2025-03-24","SF FuneralF811557       250323","","126.5","","774040.58"
"2025-03-25","2025-03-22","SF FuneralFDC0000000686W250322","","126.5","","774167.08"
"2025-03-25","2025-03-22","SF FuneralF815685       250322","","126.5","","774293.58"
"2025-03-25","2025-03-22","SF FuneralF1062655      250322","","126.5","","774420.08"
"2025-03-25","2025-03-22","SF FuneralFDC0000000NLY9250322","","31.63","","774451.71"
"2025-03-25","2025-03-22","SF FuneralF1117993      250322","","31.63","","774483.34"
"2025-03-25","2025-03-22","SF FuneralF1124375      250322","","126.5","","774609.84"
"2025-03-25","2025-03-17","SF FuneralFDC00000006P9Z250317","","63.25","","774673.09"
"2025-03-25","2025-03-22","SF FuneralFDC000000060T5250322","","126.5","","774799.59"
"2025-03-25","2025-03-22","SF FuneralFDC00000007JQ2250322","","126.5","","774926.09"
"2025-03-25","2025-03-22","SF FuneralFDC00000007QR2250322","","126.5","","775052.59"
"2025-03-25","2025-03-22","SF FuneralFDC00000008BC1250321","","126.5","","775179.09"
"2025-03-25","2025-03-22","SF FuneralF830932       250322","","126.5","","775305.59"
"2025-03-25","2025-03-22","SF FuneralF1116109      250323","","126.5","","775432.09"
"2025-03-25","2025-03-24","SF FuneralF1079340      250324","","31.63","","775463.72"
"2025-03-25","2025-03-25","SF FuneralF1079178      250325","","31.63","","775495.35"
"2025-03-25","2025-03-22","SF FuneralF831025       250322","","126.5","","775621.85"
"2025-03-25","2025-03-24","SF FuneralFDC00000007CJG250324","","126.5","","775748.35"
"2025-03-25","2025-03-24","SF FuneralF844670       250322","","126.5","","775874.85"
"2025-03-25","2025-03-24","SF FuneralF989694       250324","","126.5","","776001.35"
"2025-03-25","2025-03-25","SF FuneralFDC00000006WBT250325","","191.5","","776192.85"
"2025-03-25","2025-03-25","SF FuneralF817558       250325","","126.5","","776319.35"
"2025-03-25","2025-03-25","SF FuneralF1074969      250325","","126.5","","776445.85"
"2025-03-25","2025-03-25","SF FuneralF1108107      250325","","126.5","","776572.35"
"2025-03-25","2025-03-22","SF FuneralFDC00000007JNH250321","","31.63","","776603.98"
"2025-03-25","2025-03-24","SF FuneralFDC00000006SV7250323","","31.63","","776635.61"
"2025-03-25","2025-03-25","SF FuneralFDC000000073QG250325","","31.63","","776667.24"
"2025-03-25","2025-03-20","SF FuneralF987078       250322","","126.5","","776793.74"
"2025-03-25","2025-03-20","SF FuneralF989856       250322","","126.5","","776920.24"
"2025-03-25","2025-03-22","SF FuneralFDC00000006096250322","","126.5","","777046.74"
"2025-03-25","2025-03-22","SF FuneralFDC0000000619J250322","","126.5","","777173.24"
"2025-03-25","2025-03-22","SF FuneralFDC0000000645Q250322","","126.5","","777299.74"
"2025-03-25","2025-03-22","SF FuneralFDC00000006GW0250322","","126.5","","777426.24"
"2025-03-25","2025-03-22","SF FuneralFDC00000006YGZ250322","","126.5","","777552.74"
"2025-03-25","2025-03-22","SF FuneralFDC000000072NN250322","","126.5","","777679.24"
"2025-03-25","2025-03-22","SF FuneralFDC000000075TV250322","","126.5","","777805.74"
"2025-03-25","2025-03-22","SF FuneralFDC000000075TY250322","","126.5","","777932.24"
"2025-03-25","2025-03-22","SF FuneralFDC00000007N5J250322","","126.5","","778058.74"
"2025-03-25","2025-03-22","SF FuneralFDC00000007VVZ250322","","126.5","","778185.24"
"2025-03-25","2025-03-22","SF FuneralFDC000000080FN250322","","126.5","","778311.74"
"2025-03-25","2025-03-22","SF FuneralFDC000000080FS250322","","126.5","","778438.24"
"2025-03-25","2025-03-22","SF FuneralF799881       250322","","126.5","","778564.74"
"2025-03-25","2025-03-22","SF FuneralFDC00000008GMS250322","","126.5","","778691.24"
"2025-03-25","2025-03-22","SF FuneralF821281       250322","","126.5","","778817.74"
"2025-03-25","2025-03-22","SF FuneralF821631       250322","","126.5","","778944.24"
"2025-03-25","2025-03-22","SF FuneralF829479       250322","","126.5","","779070.74"
"2025-03-25","2025-03-22","SF FuneralF831048       250322","","126.5","","779197.24"
"2025-03-25","2025-03-22","SF FuneralF832509       250322","","126.5","","779323.74"
"2025-03-25","2025-03-22","SF FuneralFDC0000000DQHZ250322","","126.5","","779450.24"
"2025-03-25","2025-03-22","SF FuneralF1054624      250322","","126.5","","779576.74"
"2025-03-25","2025-03-22","SF FuneralFDC0000000K6R0250322","","126.5","","779703.24"
"2025-03-25","2025-03-22","SF FuneralF1085295      250322","","126.5","","779829.74"
"2025-03-25","2025-03-22","SF FuneralF1117284      250322","","126.5","","779956.24"
"2025-03-25","2025-03-22","SF FuneralF1120200      250322","","126.5","","780082.74"
"2025-03-25","2025-03-22","SF FuneralF1128377      250322","","126.5","","780209.24"
"2025-03-25","2025-03-22","SF FuneralF1129250      250322","","126.5","","780335.74"
"2025-03-25","2025-03-22","SF FuneralF1134898      250322","","126.5","","780462.24"
"2025-03-25","2025-03-24","SF FuneralF843027       250324","","126.5","","780588.74"
"2025-03-25","2025-03-25","SF FuneralFDC000000068Z6250325","","126.5","","780715.24"
"2025-03-25","2025-03-25","SF FuneralFDC00000007279250325","","126.5","","780841.74"
"2025-03-25","2025-03-25","SF FuneralFDC0000000HZS6250325","","63.25","","780904.99"
"2025-03-25","2025-03-25","SF FuneralF1075251      250325","","126.5","","781031.49"
"2025-03-25","2025-03-25","SF FuneralF1084293      250325","","126.5","","781157.99"
"2025-03-25","2025-03-25","SF FuneralFDC0000000N37K250325","","126.5","","781284.49"
"2025-03-25","2025-03-17","SF FuneralFDC00000005ZV9250316","","126.5","","781410.99"
"2025-03-25","2025-03-17","SF FuneralFDC00000005ZVK250316","","126.5","","781537.49"
"2025-03-25","2025-03-17","SF FuneralFDC0000000649N250317","","126.5","","781663.99"
"2025-03-25","2025-03-20","SF FuneralFDC0000000HCPT250320","","126.5","","781790.49"
"2025-03-25","2025-03-22","SF FuneralFDC00000003HNP250322","","220","","782010.49"
"2025-03-25","2025-03-22","SF FuneralFDC00000003HVM250321","","220","","782230.49"
"2025-03-25","2025-03-22","SF FuneralFDC00000006V0K250322","","126.5","","782356.99"
"2025-03-25","2025-03-22","SF FuneralFDC00000006ZLZ250322","","126.5","","782483.49"
"2025-03-25","2025-03-22","SF FuneralFDC00000006ZQN250322","","126.5","","782609.99"
"2025-03-25","2025-03-22","SF FuneralFDC0000000757R250322","","126.5","","782736.49"
"2025-03-25","2025-03-22","SF FuneralF805567       250322","","126.5","","782862.99"
"2025-03-25","2025-03-22","SF FuneralF815578       250322","","126.5","","782989.49"
"2025-03-25","2025-03-22","SF FuneralFDC0000000B0Z9250322","","126.5","","783115.99"
"2025-03-25","2025-03-22","SF FuneralF818332       250322","","126.5","","783242.49"
"2025-03-25","2025-03-22","SF FuneralF827616       250322","","126.5","","783368.99"
"2025-03-25","2025-03-22","SF FuneralF831879       250322","","126.5","","783495.49"
"2025-03-25","2025-03-22","SF FuneralF841747       250322","","126.5","","783621.99"
"2025-03-25","2025-03-22","SF FuneralFDC0000000LB10250322","","126.5","","783748.49"
"2025-03-25","2025-03-22","SF FuneralF1083724      250322","","126.5","","783874.99"
"2025-03-25","2025-03-22","SF FuneralF1110380      250322","","126.5","","784001.49"
"2025-03-25","2025-03-22","SF FuneralF1112433      250322","","126.5","","784127.99"
"2025-03-25","2025-03-22","SF FuneralF1115897      250322","","126.5","","784254.49"
"2025-03-25","2025-03-22","SF FuneralF1128974      250322","","126.5","","784380.99"
"2025-03-25","2025-03-22","SF FuneralF1135077      250322","","126.5","","784507.49"
"2025-03-25","2025-03-24","SF FuneralFDC00000006WGQ250324","","126.5","","784633.99"
"2025-03-25","2025-03-25","SF FuneralFDC0000000LCST250325","","126.5","","784760.49"
"2025-03-25","2025-03-22","SF FuneralF1131773      250322","","126.5","","784886.99"
"2025-03-25","2025-03-22","SF FuneralF1134633      250322","","126.5","","785013.49"
"2025-03-25","2025-03-24","SF FuneralF831674       250324","","126.5","","785139.99"
"2025-03-25","2025-03-25","SF FuneralF1127895      250325","","126.5","","785266.49"
"2025-03-25","2025-03-22","Rev SF FuneralFDC00000006Y9P250322","","-126.5","","785139.99"
"2025-03-25","2025-03-22","Rev SF FuneralFDC0000000CKHP250322","","-126.5","","785013.49"
"2025-03-25","2025-01-13","Rev SF FuneralFDC00000003MLH250112","","-220","","784793.49"
"2025-03-25","2025-03-13","Rev SF FuneralFDC00000006W0Z250313","","-126.5","","784666.99"
"2025-03-25","2025-03-22","Rev SF FuneralFDC0000000773W250321","","-126.5","","784540.49"
"2025-03-25","2025-03-22","Rev SF FuneralFDC000000037LR250322","","-220","","784320.49"
"2025-03-25","2025-03-22","Rev SF FuneralFDC000000037LS250322","","-220","","784100.49"
"2025-03-25","2025-03-22","Rev SF FuneralFDC00000003GQF250321","","-220","","783880.49"
"2025-03-25","2025-03-22","Rev SF FuneralFDC0000000NFTV250322","","-126.5","","783753.99"
"2025-03-25","2025-03-22","Rev SF FuneralFDC00000006V60250322","","-126.5","","783627.49"
"2025-03-25","2025-03-24","Rev SF FuneralFDC00000007N2Y250324","","-126.5","","783500.99"
"2025-03-25","2025-03-22","Rev SF FuneralFDC00000006W6N250322","","-126.5","","783374.49"
"2025-03-25","2025-03-22","Rev SF FuneralFDC00000006W6P250322","","-126.5","","783247.99"
"2025-03-25","2025-03-22","Rev SF FuneralFDC0000000KSYY250322","","-126.5","","783121.49"
"2025-03-25","2025-03-25","Rev SF FuneralFDC0000000N8G1250325","","-31.63","","783089.86"
"2025-03-25","2025-03-25","Rev SF FuneralFDC000000082V5250325","","-126.5","","782963.36"
"2025-03-25","2025-03-25","Rev SF FuneralFDC0000000HZS6250325","","-63.25","","782900.11"
"2025-03-25","2025-03-25","Rev SF FuneralFDC00000005WF7250325","","-126.5","","782773.61"
"2025-03-25","2025-02-21","Rev SF FuneralFDC00000006Z5Z250221","","-126.5","","782647.11"
"2025-03-25","2025-03-25","Rev SF FuneralFDC0000000LPJZ250325","","-191.5","","782455.61"
"2025-03-25","2025-03-25","Rev SF FuneralFDC000000072Q2250325","","-126.5","","782329.11"
"2025-03-25","2025-03-24","Rev SF FuneralFDC000000069C5250324","","-31.63","","782297.48"
"2025-03-25","2025-03-25","Rev SF FuneralFDC0000000HVZS250325","","-126.5","","782170.98"
"2025-03-25","2025-03-22","Rev SF FuneralFDC00000007QP1250321","","-126.5","","782044.48"
"2025-03-25","2025-03-22","Rev SF FuneralFDC00000006PS8250322","","-126.5","","781917.98"
"2025-03-25","2025-03-22","Rev SF FuneralFDC00000006PSD250322","","-126.5","","781791.48"
"2025-03-25","2025-03-22","Rev SF FuneralFDC00000006Z5Z250321","","-126.5","","781664.98"
"2025-03-25","2024-11-12","Rev SF FuneralFDC00000003MLH241112","","-220","","781444.98"
"2025-03-25","2025-03-22","Rev SF FuneralFDC00000006T86250322","","-126.5","","781318.48"
"2025-03-25","2025-03-22","Rev SF FuneralFDC00000006WL5250322","","-126.5","","781191.98"
"2025-03-25","2025-03-12","Rev SF FuneralFDC00000003MLH250312","","-220","","780971.98"
"2025-03-25","2025-03-22","Rev SF FuneralFDC0000000MS44250322","","-126.5","","780845.48"
"2025-03-25","2025-03-22","Rev SF FuneralFDC0000000630S250322","","-126.5","","780718.98"
"2025-03-25","2025-02-21","Rev SF FuneralFDC0000000HSSY250222","","-126.5","","780592.48"
"2025-03-25","2024-12-11","Rev SF FuneralFDC00000007ZWC241222","","-126.5","","780465.98"
"2025-03-25","2025-03-24","Rev SF FuneralFDC00000006XCF250324","","-126.5","","780339.48"
"2025-03-25","2024-12-12","Rev SF FuneralFDC00000003MLH241212","","-220","","780119.48"
"2025-03-25","2025-03-19","Rev SF FuneralFDC00000009F2S250319","","-126.5","","779992.98"
"2025-03-25","2025-03-18","Rev SF FuneralFDC0000000B379250318","","-63.25","","779929.73"
"2025-03-25","2025-03-20","Rev SF FuneralFDC0000000HSSY250322","","-126.5","","779803.23"
"2025-03-25","2025-03-22","Rev SF FuneralFDC000000069RG250322","","-126.5","","779676.73"
"2025-03-25","2025-03-22","Rev SF FuneralFDC00000008RHF250322","","-126.5","","779550.23"
"2025-03-25","2025-03-22","Rev SF FuneralFDC00000006YGZ250322","","-126.5","","779423.73"
"2025-03-25","2025-03-22","Rev SF FuneralFDC0000000757R250322","","-126.5","","779297.23"
"2025-03-25","2025-03-22","Rev SF FuneralFDC000000076RT250322","","-126.5","","779170.73"
"2025-03-25","2025-03-22","Rev SF FuneralFDC000000076RZ250322","","-126.5","","779044.23"
"2025-03-25","2025-03-18","Rev SF FuneralFDC0000000PFVZ250318","","-126.5","","778917.73"
"2025-03-25","2025-03-20","Rev SF FuneralFDC00000007JZ0250320","","-126.5","","778791.23"
"2025-03-25","2025-03-24","Rev SF FuneralFDC0000000JRDD250324","","-126.5","","778664.73"
"2025-03-25","2024-10-12","Rev SF FuneralFDC00000003MLH241012","","-220","","778444.73"
"2025-03-25","2025-03-24","Rev SF FuneralFDC0000000NC8P250324","","-126.5","","778318.23"
"2025-03-25","2025-03-24","Rev SF FuneralFDC0000000N7NV250324","","-126.5","","778191.73"
"2025-03-25","2025-03-20","Rev SF FuneralFDC0000000JXK7250321","","-31.63","","778160.1"
"2025-03-25","2025-03-20","Rev SF FuneralFDC0000000K7CQ250321","","-31.63","","778128.47"
"2025-03-25","2025-03-22","Rev SF FuneralFDC00000008NYM250321","","-31.63","","778096.84"
"2025-03-25","2025-03-22","Rev SF FuneralFDC0000000QC5G250322","","-126.5","","777970.34"
"2025-03-25","2025-03-22","Rev SF FuneralFDC00000008ZMS250322","","-126.5","","777843.84"
"2025-03-25","2025-03-22","Rev SF FuneralFDC00000002X18250322","","-220","","777623.84"
"2025-03-25","2025-03-22","Rev SF FuneralFDC0000000BHZJ250322","","-126.5","","777497.34"
"2025-03-25","2025-03-22","Rev SF FuneralFDC000000057TS250322","","-126.5","","777370.84"
"2025-03-25","2025-03-22","Rev SF FuneralFDC0000000NFC3250322","","-126.5","","777244.34"
"2025-03-25","2025-03-22","Rev SF FuneralFDC00000005XWT250322","","-126.5","","777117.84"
"2025-03-25","2025-03-22","Rev SF FuneralFDC0000000837Q250322","","-126.5","","776991.34"
"2025-03-25","2025-03-22","Rev SF FuneralFDC0000000KWVL250322","","-126.5","","776864.84"
"2025-03-25","2025-03-25","Rev SF FuneralFDC0000000PW05250325","","-126.5","","776738.34"
"2025-03-25","2025-03-22","Rev SF FuneralFDC0000000NPS6250322","","-126.5","","776611.84"
"2025-03-25","2025-03-22","SF FuneralF811431       250322","","126.5","","776738.34"
"2025-03-25","2025-03-22","SF FuneralFDC000000064FZ250322","","126.5","","776864.84"
"2025-03-25","2025-03-22","SF FuneralFDC00000007C1G250322","","256.5","","777121.34"
"2025-03-25","2025-03-22","SF FuneralF805801       250322","","126.5","","777247.84"
"2025-03-25","2025-03-22","SF FuneralFDC00000008W3W250322","","126.5","","777374.34"
"2025-03-25","2025-03-22","SF FuneralF805869       250322","","126.5","","777500.84"
"2025-03-25","2025-03-22","SF FuneralF796307       250322","","126.5","","777627.34"
"2025-03-25","2025-03-22","SF FuneralF780624       250322","","126.5","","777753.84"
"2025-03-25","2025-03-22","SF FuneralF812710       250322","","126.5","","777880.34"
"2025-03-25","2025-03-22","SF FuneralF818771       250322","","126.5","","778006.84"
"2025-03-25","2025-03-22","SF FuneralF787442       250322","","126.5","","778133.34"
"2025-03-25","2025-03-22","SF FuneralF838832       250322","","126.5","","778259.84"
"2025-03-25","2025-03-22","SF FuneralF841143       250322","","126.5","","778386.34"
"2025-03-25","2025-03-22","SF FuneralFDC0000000K5TZ250322","","126.5","","778512.84"
"2025-03-25","2025-03-22","SF FuneralF1059343      250322","","126.5","","778639.34"
"2025-03-25","2025-03-22","SF FuneralF1061780      250322","","126.5","","778765.84"
"2025-03-25","2025-03-22","SF FuneralFDC0000000LCB2250322","","126.5","","778892.34"
"2025-03-25","2025-03-22","SF FuneralF1100804      250322","","126.5","","779018.84"
"2025-03-25","2025-03-22","SF FuneralF1108294      250322","","126.5","","779145.34"
"2025-03-25","2025-03-22","SF FuneralF1117973      250322","","126.5","","779271.84"
"2025-03-25","2025-03-22","SF FuneralF1120627      250322","","126.5","","779398.34"
"2025-03-25","2025-03-22","SF FuneralF1122836      250322","","126.5","","779524.84"
"2025-03-25","2025-03-22","SF FuneralF1127782      250322","","126.5","","779651.34"
"2025-03-25","2025-03-22","SF FuneralF1131693      250322","","126.5","","779777.84"
"2025-03-25","2025-03-22","SF FuneralF1133530      250322","","126.5","","779904.34"
"2025-03-25","2025-03-25","SF FuneralFDC000000061NF250325","","31.63","","779935.97"
"2025-03-25","2025-03-25","SF FuneralFDC00000009DYR250325","","126.5","","780062.47"
"2025-03-25","2025-03-25","SF FuneralF844728       250325","","31.63","","780094.1"
"2025-03-25","2025-03-22","SF FuneralFDC000000061DK250322","","126.5","","780220.6"
"2025-03-25","2025-03-22","SF FuneralFDC00000006PGX250321","","126.5","","780347.1"
"2025-03-25","2025-03-22","SF FuneralF813156       250322","","126.5","","780473.6"
"2025-03-25","2025-03-22","SF FuneralFDC0000000B8R0250322","","126.5","","780600.1"
"2025-03-25","2025-03-22","SF FuneralFDC0000000BB0P250322","","126.5","","780726.6"
"2025-03-25","2025-03-22","SF FuneralF798992       250322","","191.5","","780918.1"
"2025-03-25","2025-03-22","SF FuneralF1133219      250322","","126.5","","781044.6"
"2025-03-25","2025-03-24","SF FuneralF843497       250322","","126.5","","781171.1"
"2025-03-25","2025-03-24","SF FuneralF1122758      250324","","126.5","","781297.6"
"2025-03-25","2025-03-25","SF FuneralFDC00000007TPG250325","","126.5","","781424.1"
"2025-03-25","2025-03-20","SF FuneralF989231       250322","","126.5","","781550.6"
"2025-03-25","2025-03-20","SF FuneralF989522       250322","","126.5","","781677.1"
"2025-03-25","2025-03-22","SF FuneralFDC000000063G0250322","","126.5","","781803.6"
"2025-03-25","2025-03-22","SF FuneralF1084633      250322","","126.5","","781930.1"
"2025-03-25","2025-03-22","SF FuneralF1132452      250322","","126.5","","782056.6"
"2025-03-25","2025-03-22","SF FuneralF1134382      250322","","126.5","","782183.1"
"2025-03-25","2025-03-24","SF FuneralFDC000000061P1250323","","126.5","","782309.6"
"2025-03-25","2025-03-24","SF FuneralF829880       250324","","126.5","","782436.1"
"2025-03-25","2025-03-25","Rev SF FuneralFDC00000007TPG250325","","-126.5","","782309.6"
"2025-03-26","2025-03-24","SF FuneralF832096       250323","","31.63","","782341.23"
"2025-03-26","2025-03-24","SF FuneralF1108567      250324","","31.63","","782372.86"
"2025-03-26","2025-03-24","SF FuneralF1118416      250324","","31.63","","782404.49"
"2025-03-26","2025-03-25","SF FuneralF1132209      250325","","31.63","","782436.12"
"2025-03-26","2025-03-22","SF FuneralF1127843      250322","","31.63","","782467.75"
"2025-03-26","2025-03-24","SF FuneralFDC00000005RR7250324","","31.63","","782499.38"
"2025-03-26","2025-03-25","SF FuneralF814338       250325","","31.63","","782531.01"
"2025-03-26","2025-03-25","SF FuneralF1080249      250325","","31.63","","782562.64"
"2025-03-26","2025-03-20","SF FuneralF987397       250322","","126.5","","782689.14"
"2025-03-26","2025-03-20","SF FuneralF987412       250322","","126.5","","782815.64"
"2025-03-26","2025-03-20","SF FuneralF987619       250322","","126.5","","782942.14"
"2025-03-26","2025-03-20","SF FuneralFDC0000000J3N8250322","","126.5","","783068.64"
"2025-03-26","2025-03-22","SF FuneralFDC000000030NZ250322","","220","","783288.64"
"2025-03-26","2025-03-22","SF FuneralFDC0000000601K250322","","126.5","","783415.14"
"2025-03-26","2025-03-22","SF FuneralFDC00000008LFM250321","","126.5","","783541.64"
"2025-03-26","2025-03-22","SF FuneralF829911       250322","","126.5","","783668.14"
"2025-03-26","2025-03-22","SF FuneralF1083678      250322","","126.5","","783794.64"
"2025-03-26","2025-03-22","SF FuneralF1110120      250322","","126.5","","783921.14"
"2025-03-26","2025-03-22","SF FuneralF1123564      250322","","126.5","","784047.64"
"2025-03-26","2025-03-22","SF FuneralF1125426      250322","","126.5","","784174.14"
"2025-03-26","2025-03-22","SF FuneralF1130673      250322","","126.5","","784300.64"
"2025-03-26","2025-03-22","SF FuneralF1133279      250322","","126.5","","784427.14"
"2025-03-26","2025-03-22","SF FuneralFDC0000000QD97250322","","126.5","","784553.64"
"2025-03-26","2025-03-22","SF FuneralF1133639      250322","","126.5","","784680.14"
"2025-03-26","2025-03-24","SF FuneralF993933       250324","","126.5","","784806.64"
"2025-03-26","2025-03-25","SF FuneralFDC000000087TS250325","","126.5","","784933.14"
"2025-03-26","2025-03-25","SF FuneralF1066366      250325","","126.5","","785059.64"
"2025-03-26","2025-03-25","SF FuneralF1084442      250325","","126.5","","785186.14"
"2025-03-26","2025-03-19","SF FuneralF844621       250319","","126.5","","785312.64"
"2025-03-26","2025-03-22","SF FuneralFDC00000005R8B250322","","126.5","","785439.14"
"2025-03-26","2025-03-22","SF FuneralFDC00000005ZHX250322","","126.5","","785565.64"
"2025-03-26","2025-03-22","SF FuneralFDC000000061VY250322","","126.5","","785692.14"
"2025-03-26","2025-03-22","SF FuneralFDC0000000659F250322","","126.5","","785818.64"
"2025-03-26","2025-03-22","SF FuneralFDC00000006TBH250322","","126.5","","785945.14"
"2025-03-26","2025-03-22","SF FuneralFDC00000006WYN250322","","126.5","","786071.64"
"2025-03-26","2025-03-22","SF FuneralFDC00000006X07250322","","126.5","","786198.14"
"2025-03-26","2025-03-22","SF FuneralFDC0000000700C250322","","126.5","","786324.64"
"2025-03-26","2025-03-22","SF FuneralFDC00000007054250322","","126.5","","786451.14"
"2025-03-26","2025-03-22","SF FuneralFDC000000077TS250322","","126.5","","786577.64"
"2025-03-26","2025-03-22","SF FuneralFDC00000007BW6250322","","126.5","","786704.14"
"2025-03-26","2025-03-22","SF FuneralFDC000000081FM250322","","126.5","","786830.64"
"2025-03-26","2025-03-22","SF FuneralFDC000000087KD250322","","126.5","","786957.14"
"2025-03-26","2025-03-22","SF FuneralF800917       250322","","126.5","","787083.64"
"2025-03-26","2025-03-22","SF FuneralF792189       250322","","126.5","","787210.14"
"2025-03-26","2025-03-22","SF FuneralF823752       250322","","126.5","","787336.64"
"2025-03-26","2025-03-22","SF FuneralF828391       250322","","126.5","","787463.14"
"2025-03-26","2025-03-22","SF FuneralF828782       250322","","126.5","","787589.64"
"2025-03-26","2025-03-22","SF FuneralFDC0000000C1H4250322","","126.5","","787716.14"
"2025-03-26","2025-03-22","SF FuneralF1017577      250322","","126.5","","787842.64"
"2025-03-26","2025-03-22","SF FuneralF1022113      250322","","126.5","","787969.14"
"2025-03-26","2025-03-22","SF FuneralF1054532      250322","","126.5","","788095.64"
"2025-03-26","2025-03-22","SF FuneralF815536       250322","","321.5","","788417.14"
"2025-03-26","2025-03-22","SF FuneralF1073198      250322","","126.5","","788543.64"
"2025-03-26","2025-03-22","SF FuneralF1073749      250322","","126.5","","788670.14"
"2025-03-26","2025-03-22","SF FuneralF1074667      250322","","126.5","","788796.64"
"2025-03-26","2025-03-22","SF FuneralFDC0000000LLT3250323","","126.5","","788923.14"
"2025-03-26","2025-03-22","SF FuneralF1083610      250322","","126.5","","789049.64"
"2025-03-26","2025-03-22","SF FuneralF1084304      250322","","126.5","","789176.14"
"2025-03-26","2025-03-22","SF FuneralF1108117      250322","","126.5","","789302.64"
"2025-03-26","2025-03-22","SF FuneralF1108575      250322","","126.5","","789429.14"
"2025-03-26","2025-03-22","SF FuneralFDC0000000MK28250322","","126.5","","789555.64"
"2025-03-26","2025-03-22","SF FuneralF1110479      250322","","126.5","","789682.14"
"2025-03-26","2025-03-22","SF FuneralFDC0000000NCC5250322","","126.5","","789808.64"
"2025-03-26","2025-03-22","SF FuneralF1120824      250322","","126.5","","789935.14"
"2025-03-26","2025-03-22","SF FuneralF1123117      250322","","126.5","","790061.64"
"2025-03-26","2025-03-22","SF FuneralF1124785      250322","","126.5","","790188.14"
"2025-03-26","2025-03-22","SF FuneralF1127369      250322","","126.5","","790314.64"
"2025-03-26","2025-03-22","SF FuneralF1127872      250322","","126.5","","790441.14"
"2025-03-26","2025-03-22","SF FuneralF1130311      250322","","126.5","","790567.64"
"2025-03-26","2025-03-22","SF FuneralF1131987      250322","","126.5","","790694.14"
"2025-03-26","2025-03-22","SF FuneralFDC0000000Q9QQ250322","","126.5","","790820.64"
"2025-03-26","2025-03-22","SF FuneralF1133738      250322","","126.5","","790947.14"
"2025-03-26","2025-03-24","SF FuneralFDC00000005W9P250323","","126.5","","791073.64"
"2025-03-26","2025-03-24","SF FuneralFDC00000006Z09250324","","126.5","","791200.14"
"2025-03-26","2025-03-24","SF FuneralFDC00000007QR9250323","","126.5","","791326.64"
"2025-03-26","2025-03-24","SF FuneralFDC0000000F72V250324","","126.5","","791453.14"
"2025-03-26","2025-03-24","SF FuneralFDC0000000GYS5250322","","126.5","","791579.64"
"2025-03-26","2025-03-24","SF FuneralF1133734      250324","","126.5","","791706.14"
"2025-03-26","2025-03-25","SF FuneralFDC00000006WJ6250325","","126.5","","791832.64"
"2025-03-26","2025-03-25","SF FuneralFDC00000006WKT250325","","126.5","","791959.14"
"2025-03-26","2025-03-25","SF FuneralF840708       250325","","126.5","","792085.64"
"2025-03-26","2025-03-25","SF FuneralF847362       250325","","63.25","","792148.89"
"2025-03-26","2025-03-25","SF FuneralF1120336      250325","","126.5","","792275.39"
"2025-03-26","2025-03-25","SF FuneralF1067015      250325","","126.5","","792401.89"
"2025-03-26","2025-03-20","SF FuneralFDC00000007CVJ250320","","126.5","","792528.39"
"2025-03-26","2025-03-20","SF FuneralF987343       250322","","126.5","","792654.89"
"2025-03-26","2025-03-22","SF FuneralFDC000000063VN250322","","256.5","","792911.39"
"2025-03-26","2025-03-22","SF FuneralF801859       250322","","126.5","","793037.89"
"2025-03-26","2025-03-22","SF FuneralF1052784      250322","","126.5","","793164.39"
"2025-03-26","2025-03-22","SF FuneralF1061756      250322","","126.5","","793290.89"
"2025-03-26","2025-03-22","SF FuneralF1084930      250322","","126.5","","793417.39"
"2025-03-26","2025-03-22","SF FuneralF1111984      250323","","126.5","","793543.89"
"2025-03-26","2025-03-22","SF FuneralF1116898      250322","","126.5","","793670.39"
"2025-03-26","2025-03-22","SF FuneralF1117021      250322","","126.5","","793796.89"
"2025-03-26","2025-03-22","SF FuneralFDC0000000QD93250322","","126.5","","793923.39"
"2025-03-26","2025-03-24","SF FuneralFDC000000084T2250323","","126.5","","794049.89"
"2025-03-26","2025-03-24","SF FuneralF1065665      250324","","126.5","","794176.39"
"2025-03-26","2025-03-24","SF FuneralF1130437      250324","","126.5","","794302.89"
"2025-03-26","2025-03-22","SF FuneralFDC00000005HJM250321","","31.63","","794334.52"
"2025-03-26","2025-03-22","SF FuneralFDC00000005MWG250322","","31.63","","794366.15"
"2025-03-26","2025-03-22","SF FuneralF1017512      250323","","31.63","","794397.78"
"2025-03-26","2025-03-22","SF FuneralFDC0000000P0VX250323","","31.63","","794429.41"
"2025-03-26","2025-03-22","SF FuneralFDC0000000P0VY250323","","31.63","","794461.04"
"2025-03-26","2025-03-22","SF FuneralFDC0000000P0W3250323","","31.63","","794492.67"
"2025-03-26","2025-03-22","SF FuneralF1122269      250323","","31.63","","794524.3"
"2025-03-26","2025-03-22","SF FuneralF1130776      250322","","31.63","","794555.93"
"2025-03-26","2025-03-24","SF FuneralFDC00000005RZQ250324","","31.63","","794587.56"
"2025-03-26","2025-03-24","SF FuneralF1122727      250324","","31.63","","794619.19"
"2025-03-26","2025-03-25","SF FuneralF798485       250325","","31.63","","794650.82"
"2025-03-26","2025-03-25","SF FuneralF1072724      250325","","31.63","","794682.45"
"2025-03-26","2025-03-17","SF FuneralF793327       250316","","63.25","","794745.7"
"2025-03-26","2025-03-20","SF FuneralFDC000000065X7250320","","126.5","","794872.2"
"2025-03-26","2025-03-20","SF FuneralF988326       250322","","126.5","","794998.7"
"2025-03-26","2025-03-20","SF FuneralF1124168      250320","","63.25","","795061.95"
"2025-03-26","2025-03-20","SF FuneralF1126961      250321","","63.25","","795125.2"
"2025-03-26","2025-03-22","SF FuneralFDC000000065HK250322","","126.5","","795251.7"
"2025-03-26","2025-03-22","SF FuneralFDC00000007543250322","","126.5","","795378.2"
"2025-03-26","2025-03-22","SF FuneralFDC00000007LMX250322","","126.5","","795504.7"
"2025-03-26","2025-03-22","SF FuneralFDC00000007NM0250322","","126.5","","795631.2"
"2025-03-26","2025-03-22","SF FuneralFDC00000009MWX250322","","63.25","","795694.45"
"2025-03-26","2025-03-22","SF FuneralF816113       250322","","126.5","","795820.95"
"2025-03-26","2025-03-22","SF FuneralF816132       250322","","126.5","","795947.45"
"2025-03-26","2025-03-22","SF FuneralF841190       250322","","126.5","","796073.95"
"2025-03-26","2025-03-22","SF FuneralF991823       250322","","126.5","","796200.45"
"2025-03-26","2025-03-22","SF FuneralF992099       250322","","126.5","","796326.95"
"2025-03-26","2025-03-22","SF FuneralF992584       250322","","126.5","","796453.45"
"2025-03-26","2025-03-22","SF FuneralFDC0000000JNC1250322","","126.5","","796579.95"
"2025-03-26","2025-03-22","SF FuneralF1020638      250322","","126.5","","796706.45"
"2025-03-26","2025-03-22","SF FuneralF1058689      250322","","126.5","","796832.95"
"2025-03-26","2025-03-22","SF FuneralF1068286      250323","","126.5","","796959.45"
"2025-03-26","2025-03-22","SF FuneralF1074689      250322","","126.5","","797085.95"
"2025-03-26","2025-03-22","SF FuneralF1109347      250322","","126.5","","797212.45"
"2025-03-26","2025-03-22","SF FuneralF1112389      250322","","126.5","","797338.95"
"2025-03-26","2025-03-22","SF FuneralFDC0000000N7HW250322","","126.5","","797465.45"
"2025-03-26","2025-03-22","SF FuneralF1116664      250322","","126.5","","797591.95"
"2025-03-26","2025-03-22","SF FuneralFDC0000000NKBT250322","","126.5","","797718.45"
"2025-03-26","2025-03-22","SF FuneralF1124181      250322","","126.5","","797844.95"
"2025-03-26","2025-03-22","SF FuneralF1124430      250322","","126.5","","797971.45"
"2025-03-26","2025-03-22","SF FuneralFDC0000000PDRC250322","","126.5","","798097.95"
"2025-03-26","2025-03-22","SF FuneralF1125491      250322","","126.5","","798224.45"
"2025-03-26","2025-03-22","SF FuneralF1125805      250322","","126.5","","798350.95"
"2025-03-26","2025-03-22","SF FuneralFDC0000000PVL2250322","","126.5","","798477.45"
"2025-03-26","2025-03-22","SF FuneralF1132460      250322","","126.5","","798603.95"
"2025-03-26","2025-03-22","SF FuneralF1132520      250322","","126.5","","798730.45"
"2025-03-26","2025-03-22","SF FuneralF1132814      250322","","126.5","","798856.95"
"2025-03-26","2025-03-22","SF FuneralF1133528      250322","","126.5","","798983.45"
"2025-03-26","2025-03-24","SF FuneralFDC000000042QS250324","","220","","799203.45"
"2025-03-26","2025-03-24","SF FuneralF801508       250323","","126.5","","799329.95"
"2025-03-26","2025-03-24","SF FuneralF801534       250323","","126.5","","799456.45"
"2025-03-26","2025-03-24","SF FuneralF808031       250324","","126.5","","799582.95"
"2025-03-26","2025-03-24","SF FuneralF821840       250324","","126.5","","799709.45"
"2025-03-26","2025-03-24","SF FuneralF844543       250322","","126.5","","799835.95"
"2025-03-26","2025-03-24","SF FuneralF992260       250324","","126.5","","799962.45"
"2025-03-26","2025-03-24","SF FuneralF1066140      250324","","126.5","","800088.95"
"2025-03-26","2025-03-24","SF FuneralF1134400      250324","","126.5","","800215.45"
"2025-03-26","2025-03-18","SF FuneralF1124327      250318","","126.5","","800341.95"
"2025-03-26","2025-03-20","SF FuneralF1061777      250321","","126.5","","800468.45"
"2025-03-26","2025-03-22","SF FuneralFDC0000000624H250322","","126.5","","800594.95"
"2025-03-26","2025-03-22","SF FuneralFDC00000006TJ7250322","","126.5","","800721.45"
"2025-03-26","2025-03-22","SF FuneralFDC00000006TS2250322","","126.5","","800847.95"
"2025-03-26","2025-03-22","SF FuneralF801292       250322","","126.5","","800974.45"
"2025-03-26","2025-03-22","SF FuneralF793001       250322","","126.5","","801100.95"
"2025-03-26","2025-03-22","SF FuneralF841617       250321","","126.5","","801227.45"
"2025-03-26","2025-03-22","SF FuneralFDC0000000K4ZG250323","","126.5","","801353.95"
"2025-03-26","2025-03-22","SF FuneralF1074714      250322","","126.5","","801480.45"
"2025-03-26","2025-03-22","SF FuneralF1123410      250322","","126.5","","801606.95"
"2025-03-26","2025-03-22","SF FuneralF1130051      250322","","126.5","","801733.45"
"2025-03-26","2025-03-22","SF FuneralF1133205      250322","","126.5","","801859.95"
"2025-03-26","2025-03-22","SF FuneralFDC0000000QCRH250322","","126.5","","801986.45"
"2025-03-26","2025-03-22","SF FuneralF1120414      250322","","126.5","","802112.95"
"2025-03-26","2025-03-24","SF FuneralFDC000000060CD250324","","126.5","","802239.45"
"2025-03-26","2025-03-24","SF FuneralF823527       250323","","126.5","","802365.95"
"2025-03-26","2025-03-24","SF FuneralF1083940      250324","","126.5","","802492.45"
"2025-03-26","2025-03-25","SF FuneralFDC00000006Y30250325","","126.5","","802618.95"
"2025-03-26","2025-03-25","SF FuneralFDC0000000JYCT250325","","126.5","","802745.45"
"2025-03-26","2025-03-25","SF FuneralF1059436      250325","","126.5","","802871.95"
"2025-03-26","2025-03-22","SF FuneralFDC000000030J1250322","","220","","803091.95"
"2025-03-26","2025-03-22","SF FuneralFDC000000062BW250322","","126.5","","803218.45"
"2025-03-26","2025-03-22","SF FuneralFDC000000080Y6250322","","126.5","","803344.95"
"2025-03-26","2025-03-22","SF FuneralF783581       250322","","126.5","","803471.45"
"2025-03-26","2025-03-22","SF FuneralF819677       250322","","126.5","","803597.95"
"2025-03-26","2025-03-22","SF FuneralF819782       250322","","126.5","","803724.45"
"2025-03-26","2025-03-22","SF FuneralF786759       250322","","126.5","","803850.95"
"2025-03-26","2025-03-22","SF FuneralFDC0000000D7JN250322","","126.5","","803977.45"
"2025-03-26","2025-03-22","SF FuneralF841152       250322","","126.5","","804103.95"
"2025-03-26","2025-03-22","SF FuneralF1055080      250322","","126.5","","804230.45"
"2025-03-26","2025-03-22","SF FuneralF1055125      250322","","126.5","","804356.95"
"2025-03-26","2025-03-22","SF FuneralF783490       250322","","126.5","","804483.45"
"2025-03-26","2025-03-22","SF FuneralFDC0000000P42Z250322","","126.5","","804609.95"
"2025-03-26","2025-03-22","SF FuneralF1126871      250322","","126.5","","804736.45"
"2025-03-26","2025-03-22","SF FuneralF1132500      250322","","126.5","","804862.95"
"2025-03-26","2025-03-24","SF FuneralF900788       250322","","126.5","","804989.45"
"2025-03-26","2025-03-24","SF FuneralF1128142      250324","","126.5","","805115.95"
"2025-03-26","2025-03-25","SF FuneralF806008       250325","","126.5","","805242.45"
"2025-03-26","2025-03-17","SF FuneralF1079118      250317","","63.25","","805305.7"
"2025-03-26","2025-03-20","SF FuneralF987393       250322","","126.5","","805432.2"
"2025-03-26","2025-03-20","SF FuneralF987627       250322","","126.5","","805558.7"
"2025-03-26","2025-03-22","SF FuneralFDC000000032Y3250322","","220","","805778.7"
"2025-03-26","2025-03-22","SF FuneralFDC000000077SJ250322","","126.5","","805905.2"
"2025-03-26","2025-03-22","SF FuneralFDC00000007M00250322","","126.5","","806031.7"
"2025-03-26","2025-03-22","SF FuneralFDC00000008HX7250322","","126.5","","806158.2"
"2025-03-26","2025-03-22","SF FuneralFDC0000000BD9L250322","","126.5","","806284.7"
"2025-03-26","2025-03-22","SF FuneralF1033699      250322","","126.5","","806411.2"
"2025-03-26","2025-03-22","SF FuneralF1054919      250322","","126.5","","806537.7"
"2025-03-26","2025-03-22","SF FuneralFDC0000000KDK3250322","","126.5","","806664.2"
"2025-03-26","2025-03-22","SF FuneralF1074594      250322","","126.5","","806790.7"
"2025-03-26","2025-03-22","SF FuneralF1108583      250322","","126.5","","806917.2"
"2025-03-26","2025-03-22","SF FuneralF1116809      250323","","126.5","","807043.7"
"2025-03-26","2025-03-22","SF FuneralF1129427      250323","","126.5","","807170.2"
"2025-03-26","2025-03-22","SF FuneralF1129525      250322","","126.5","","807296.7"
"2025-03-26","2025-03-24","SF FuneralFDC00000006M73250324","","126.5","","807423.2"
"2025-03-26","2025-03-24","SF FuneralFDC000000070S8250324","","126.5","","807549.7"
"2025-03-26","2025-03-24","SF FuneralF1068281      250324","","63.25","","807612.95"
"2025-03-26","2025-03-24","SF FuneralF1112118      250324","","126.5","","807739.45"
"2025-03-26","2025-03-25","SF FuneralFDC00000007FSR250325","","126.5","","807865.95"
"2025-03-26","2025-03-25","SF FuneralFDC00000007L59250325","","126.5","","807992.45"
"2025-03-26","2025-03-25","SF FuneralF814927       250325","","126.5","","808118.95"
"2025-03-26","2025-03-25","SF FuneralF1132463      250325","","126.5","","808245.45"
"2025-03-26","2025-03-22","SF FuneralFDC00000006RMY250322","","126.5","","808371.95"
"2025-03-26","2025-03-22","SF FuneralFDC00000002QS9250322","","220","","808591.95"
"2025-03-26","2025-03-22","SF FuneralFDC00000002VNJ250322","","220","","808811.95"
"2025-03-26","2025-03-22","SF FuneralFDC0000000641R250322","","126.5","","808938.45"
"2025-03-26","2025-03-22","SF FuneralFDC00000006CRV250322","","126.5","","809064.95"
"2025-03-26","2025-03-22","SF FuneralFDC000000071Y8250322","","126.5","","809191.45"
"2025-03-26","2025-03-22","SF FuneralFDC00000007TKX250322","","126.5","","809317.95"
"2025-03-26","2025-03-22","SF FuneralFDC00000007Y9T250322","","126.5","","809444.45"
"2025-03-26","2025-03-22","SF FuneralFDC000000081XL250322","","126.5","","809570.95"
"2025-03-26","2025-03-22","SF FuneralFDC0000000835F250322","","126.5","","809697.45"
"2025-03-26","2025-03-22","SF FuneralF805642       250322","","126.5","","809823.95"
"2025-03-26","2025-03-22","SF FuneralF809178       250322","","126.5","","809950.45"
"2025-03-26","2025-03-22","SF FuneralF816954       250322","","126.5","","810076.95"
"2025-03-26","2025-03-22","SF FuneralF819093       250322","","126.5","","810203.45"
"2025-03-26","2025-03-22","SF FuneralF820362       250322","","126.5","","810329.95"
"2025-03-26","2025-03-22","SF FuneralF823322       250322","","126.5","","810456.45"
"2025-03-26","2025-03-22","SF FuneralF841605       250322","","126.5","","810582.95"
"2025-03-26","2025-03-22","SF FuneralFDC0000000JH5D250322","","126.5","","810709.45"
"2025-03-26","2025-03-22","SF FuneralFDC0000000K3ZY250322","","126.5","","810835.95"
"2025-03-26","2025-03-22","SF FuneralF1054791      250322","","126.5","","810962.45"
"2025-03-26","2025-03-22","SF FuneralF1074785      250322","","31.63","","810994.08"
"2025-03-26","2025-03-22","SF FuneralF1079123      250322","","126.5","","811120.58"
"2025-03-26","2025-03-22","SF FuneralFDC0000000LXQZ250322","","126.5","","811247.08"
"2025-03-26","2025-03-22","SF FuneralF1102834      250323","","126.5","","811373.58"
"2025-03-26","2025-03-22","SF FuneralF1108649      250322","","126.5","","811500.08"
"2025-03-26","2025-03-22","SF FuneralFDC0000000P3N3250322","","126.5","","811626.58"
"2025-03-26","2025-03-22","SF FuneralFDC0000000P3XQ250322","","126.5","","811753.08"
"2025-03-26","2025-03-22","SF FuneralF1127619      250322","","126.5","","811879.58"
"2025-03-26","2025-03-22","SF FuneralF1128129      250322","","126.5","","812006.08"
"2025-03-26","2025-03-22","SF FuneralF1130718      250322","","126.5","","812132.58"
"2025-03-26","2025-03-22","SF FuneralF1131024      250322","","126.5","","812259.08"
"2025-03-26","2025-03-20","SF FuneralF992427       250320","","126.5","","812385.58"
"2025-03-26","2025-03-23","SF FuneralF804728       250323","","126.5","","812512.08"
"2025-03-26","2025-03-25","SF FuneralF803520       250325","","31.63","","812543.71"
"2025-03-26","2025-03-25","SF FuneralF822353       250325","","31.63","","812575.34"
"2025-03-26","2025-03-25","SF FuneralF832091       250325","","126.5","","812701.84"
"2025-03-26","2025-03-26","SF FuneralF794083       250326","","126.5","","812828.34"
"2025-03-26","2025-03-24","SF FuneralFDC00000008CZQ250323","","126.5","","812954.84"
"2025-03-26","2025-03-24","SF FuneralFDC00000008XSK250324","","126.5","","813081.34"
"2025-03-26","2025-03-24","SF FuneralF844752       250322","","126.5","","813207.84"
"2025-03-26","2025-03-24","SF FuneralF847307       250322","","126.5","","813334.34"
"2025-03-26","2025-03-24","SF FuneralF900810       250322","","126.5","","813460.84"
"2025-03-26","2025-03-20","SF FuneralF1033599      250321","","126.5","","813587.34"
"2025-03-26","2025-03-22","SF FuneralFDC000000062K7250322","","126.5","","813713.84"
"2025-03-26","2025-03-22","SF FuneralF805715       250322","","126.5","","813840.34"
"2025-03-26","2025-03-22","SF FuneralF1083643      250323","","126.5","","813966.84"
"2025-03-26","2025-03-22","SF FuneralF1085234      250322","","126.5","","814093.34"
"2025-03-26","2025-03-22","SF FuneralFDC0000000N4SP250323","","126.5","","814219.84"
"2025-03-26","2025-03-22","SF FuneralF1128886      250322","","126.5","","814346.34"
"2025-03-26","2025-03-23","SF FuneralF809947       250323","","126.5","","814472.84"
"2025-03-26","2025-03-23","SF FuneralF815217       250323","","126.5","","814599.34"
"2025-03-26","2025-03-23","SF FuneralF779060       250323","","213.31","","814812.65"
"2025-03-26","2025-03-23","SF FuneralF834536       250323","","126.5","","814939.15"
"2025-03-26","2025-03-24","SF FuneralFDC000000062LJ250323","","126.5","","815065.65"
"2025-03-26","2025-03-24","SF FuneralFDC0000000631B250323","","126.5","","815192.15"
"2025-03-26","2025-03-24","SF FuneralFDC0000000708R250323","","126.5","","815318.65"
"2025-03-26","2025-03-24","SF FuneralFDC00000007L5H250323","","126.5","","815445.15"
"2025-03-26","2025-03-24","SF FuneralF901297       250324","","31.63","","815476.78"
"2025-03-26","2025-03-24","SF FuneralF1067980      250324","","126.5","","815603.28"
"2025-03-26","2025-03-25","SF FuneralFDC00000007Q0F250325","","126.5","","815729.78"
"2025-03-26","2025-03-20","SF FuneralF987269       250321","","31.63","","815761.41"
"2025-03-26","2025-03-20","SF FuneralFDC0000000K8V4250320","","31.63","","815793.04"
"2025-03-26","2025-03-22","SF FuneralFDC00000007RD4250321","","31.63","","815824.67"
"2025-03-26","2025-03-22","SF FuneralFDC00000007W5M250321","","31.63","","815856.3"
"2025-03-26","2025-03-24","SF FuneralF812864       250323","","31.63","","815887.93"
"2025-03-26","2025-03-24","SF FuneralF834627       250323","","31.63","","815919.56"
"2025-03-26","2025-03-26","SF FuneralFDC000000035M1250326","","220","","816139.56"
"2025-03-26","2025-03-26","SF FuneralFDC000000074NN250326","","126.5","","816266.06"
"2025-03-26","2025-03-17","SF FuneralFDC000000063BR250316","","126.5","","816392.56"
"2025-03-26","2025-03-17","SF FuneralFDC00000009MKM250317","","126.5","","816519.06"
"2025-03-26","2025-03-17","SF FuneralF822308       250317","","63.25","","816582.31"
"2025-03-26","2025-03-17","SF FuneralF991264       250317","","63.25","","816645.56"
"2025-03-26","2025-03-18","SF FuneralFDC00000006FV8250318","","126.5","","816772.06"
"2025-03-26","2025-03-18","SF FuneralF814575       250318","","63.25","","816835.31"
"2025-03-26","2025-03-18","SF FuneralF1085175      250318","","63.25","","816898.56"
"2025-03-26","2025-03-24","SF FuneralFDC00000005G2Y250323","","126.5","","817025.06"
"2025-03-26","2025-03-24","SF FuneralFDC00000005GBV250323","","126.5","","817151.56"
"2025-03-26","2025-03-24","SF FuneralFDC00000005TTG250323","","191.5","","817343.06"
"2025-03-26","2025-03-24","SF FuneralFDC000000061P5250323","","126.5","","817469.56"
"2025-03-26","2025-03-24","SF FuneralFDC000000062RF250323","","126.5","","817596.06"
"2025-03-26","2025-03-24","SF FuneralFDC000000062RH250323","","126.5","","817722.56"
"2025-03-26","2025-03-24","SF FuneralFDC000000062X2250323","","126.5","","817849.06"
"2025-03-26","2025-03-24","SF FuneralFDC000000063HV250323","","126.5","","817975.56"
"2025-03-26","2025-03-24","SF FuneralFDC00000006BN0250323","","126.5","","818102.06"
"2025-03-26","2025-03-24","SF FuneralFDC00000006CQ7250323","","126.5","","818228.56"
"2025-03-26","2025-03-24","SF FuneralFDC00000006DR3250323","","126.5","","818355.06"
"2025-03-26","2025-03-24","SF FuneralFDC00000006FKG250323","","126.5","","818481.56"
"2025-03-26","2025-03-24","SF FuneralFDC00000006HSW250323","","126.5","","818608.06"
"2025-03-26","2025-03-24","SF FuneralFDC00000006SF6250323","","126.5","","818734.56"
"2025-03-26","2025-03-24","SF FuneralFDC00000006SFJ250323","","126.5","","818861.06"
"2025-03-26","2025-03-24","SF FuneralFDC00000006XCM250323","","126.5","","818987.56"
"2025-03-26","2025-03-24","SF FuneralFDC00000006XCN250323","","126.5","","819114.06"
"2025-03-26","2025-03-24","SF FuneralFDC00000006YFW250323","","126.5","","819240.56"
"2025-03-26","2025-03-24","SF FuneralFDC000000072D3250323","","126.5","","819367.06"
"2025-03-26","2025-03-24","SF FuneralFDC000000076MR250323","","126.5","","819493.56"
"2025-03-26","2025-03-24","SF FuneralFDC00000007CGY250324","","126.5","","819620.06"
"2025-03-26","2025-03-24","SF FuneralFDC00000007KGM250323","","126.5","","819746.56"
"2025-03-26","2025-03-24","SF FuneralFDC00000007N8Y250323","","126.5","","819873.06"
"2025-03-26","2025-03-24","SF FuneralFDC00000007QKB250323","","126.5","","819999.56"
"2025-03-26","2025-03-24","SF FuneralFDC00000007T0L250323","","126.5","","820126.06"
"2025-03-26","2025-03-24","SF FuneralF795069       250323","","126.5","","820252.56"
"2025-03-26","2025-03-24","SF FuneralFDC00000007YKN250323","","126.5","","820379.06"
"2025-03-26","2025-03-24","SF FuneralFDC000000081YW250323","","126.5","","820505.56"
"2025-03-26","2025-03-24","SF FuneralF797642       250323","","126.5","","820632.06"
"2025-03-26","2025-03-24","SF FuneralF797798       250323","","126.5","","820758.56"
"2025-03-26","2025-03-24","SF FuneralFDC000000083Q9250323","","126.5","","820885.06"
"2025-03-26","2025-03-24","SF FuneralFDC000000085ZS250323","","126.5","","821011.56"
"2025-03-26","2025-03-24","SF FuneralF801478       250323","","126.5","","821138.06"
"2025-03-26","2025-03-24","SF FuneralFDC00000008M3F250324","","126.5","","821264.56"
"2025-03-26","2025-03-24","SF FuneralF805487       250323","","126.5","","821391.06"
"2025-03-26","2025-03-24","SF FuneralF808158       250323","","126.5","","821517.56"
"2025-03-26","2025-03-24","SF FuneralF814090       250323","","126.5","","821644.06"
"2025-03-26","2025-03-24","SF FuneralF823087       250324","","126.5","","821770.56"
"2025-03-26","2025-03-24","SF FuneralF823548       250323","","126.5","","821897.06"
"2025-03-26","2025-03-24","SF FuneralF823700       250323","","126.5","","822023.56"
"2025-03-26","2025-03-24","SF FuneralFDC0000000DM55250323","","126.5","","822150.06"
"2025-03-26","2025-03-24","SF FuneralF794199       250323","","191.5","","822341.56"
"2025-03-26","2025-03-24","SF FuneralF844118       250322","","126.5","","822468.06"
"2025-03-26","2025-03-24","SF FuneralF847217       250324","","126.5","","822594.56"
"2025-03-26","2025-03-24","SF FuneralF847280       250323","","126.5","","822721.06"
"2025-03-26","2025-03-24","SF FuneralF900430       250322","","126.5","","822847.56"
"2025-03-26","2025-03-24","SF FuneralF987511       250324","","126.5","","822974.06"
"2025-03-26","2025-03-24","SF FuneralF991529       250324","","126.5","","823100.56"
"2025-03-26","2025-03-24","SF FuneralF993323       250324","","126.5","","823227.06"
"2025-03-26","2025-03-24","SF FuneralF1061854      250324","","126.5","","823353.56"
"2025-03-26","2025-03-24","SF FuneralF1061866      250324","","126.5","","823480.06"
"2025-03-26","2025-03-24","SF FuneralF1112516      250324","","126.5","","823606.56"
"2025-03-26","2025-03-20","SF FuneralFDC000000092ZX250320","","126.5","","823733.06"
"2025-03-26","2025-03-20","SF FuneralFDC0000000H39C250322","","126.5","","823859.56"
"2025-03-26","2025-03-20","SF FuneralFDC0000000HGS2250322","","126.5","","823986.06"
"2025-03-26","2025-03-20","SF FuneralF991029       250322","","126.5","","824112.56"
"2025-03-26","2025-03-20","SF FuneralFDC0000000PY8K250321","","126.5","","824239.06"
"2025-03-26","2025-03-20","SF FuneralF1120910      250321","","126.5","","824365.56"
"2025-03-26","2025-03-22","SF FuneralFDC000000062KX250322","","126.5","","824492.06"
"2025-03-26","2025-03-22","SF FuneralFDC000000062KZ250322","","126.5","","824618.56"
"2025-03-26","2025-03-22","SF FuneralFDC000000062L0250322","","126.5","","824745.06"
"2025-03-26","2025-03-22","SF FuneralFDC000000062LG250322","","126.5","","824871.56"
"2025-03-26","2025-03-22","SF FuneralFDC000000063K4250322","","126.5","","824998.06"
"2025-03-26","2025-03-22","SF FuneralFDC0000000657F250322","","126.5","","825124.56"
"2025-03-26","2025-03-22","SF FuneralFDC00000006D5H250322","","126.5","","825251.06"
"2025-03-26","2025-03-22","SF FuneralFDC00000006MKS250322","","126.5","","825377.56"
"2025-03-26","2025-03-22","SF FuneralFDC0000000711Y250322","","126.5","","825504.06"
"2025-03-26","2025-03-22","SF FuneralFDC000000078CS250322","","126.5","","825630.56"
"2025-03-26","2025-03-22","SF FuneralFDC00000007F1R250322","","126.5","","825757.06"
"2025-03-26","2025-03-22","SF FuneralFDC00000007VYV250322","","126.5","","825883.56"
"2025-03-26","2025-03-22","SF FuneralFDC00000007W6K250322","","126.5","","826010.06"
"2025-03-26","2025-03-22","SF FuneralFDC000000080K9250321","","126.5","","826136.56"
"2025-03-26","2025-03-22","SF FuneralFDC000000085JP250322","","126.5","","826263.06"
"2025-03-26","2025-03-22","SF FuneralF805904       250322","","126.5","","826389.56"
"2025-03-26","2025-03-22","SF FuneralF823630       250321","","126.5","","826516.06"
"2025-03-26","2025-03-22","SF FuneralF823659       250322","","126.5","","826642.56"
"2025-03-26","2025-03-22","SF FuneralF823933       250322","","126.5","","826769.06"
"2025-03-26","2025-03-22","SF FuneralF827892       250322","","126.5","","826895.56"
"2025-03-26","2025-03-22","SF FuneralF827981       250322","","126.5","","827022.06"
"2025-03-26","2025-03-22","SF FuneralFDC0000000C3SM250322","","126.5","","827148.56"
"2025-03-26","2025-03-22","SF FuneralF831324       250322","","126.5","","827275.06"
"2025-03-26","2025-03-22","SF FuneralF831480       250322","","126.5","","827401.56"
"2025-03-26","2025-03-22","SF FuneralF840568       250322","","126.5","","827528.06"
"2025-03-26","2025-03-22","SF FuneralF993871       250322","","126.5","","827654.56"
"2025-03-26","2025-03-22","SF FuneralF1052919      250322","","126.5","","827781.06"
"2025-03-26","2025-03-22","SF FuneralFDC0000000K5S1250323","","126.5","","827907.56"
"2025-03-26","2025-03-22","SF FuneralF1055117      250322","","126.5","","828034.06"
"2025-03-26","2025-03-22","SF FuneralFDC0000000KWDK250322","","126.5","","828160.56"
"2025-03-26","2025-03-22","SF FuneralF1066528      250322","","126.5","","828287.06"
"2025-03-26","2025-03-22","SF FuneralF1074424      250322","","126.5","","828413.56"
"2025-03-26","2025-03-22","SF FuneralF1074484      250323","","126.5","","828540.06"
"2025-03-26","2025-03-22","SF FuneralFDC0000000LJ53250323","","126.5","","828666.56"
"2025-03-26","2025-03-22","SF FuneralF1080528      250322","","126.5","","828793.06"
"2025-03-26","2025-03-22","SF FuneralFDC0000000LQRJ250323","","126.5","","828919.56"
"2025-03-26","2025-03-22","SF FuneralF1084862      250323","","126.5","","829046.06"
"2025-03-26","2025-03-22","SF FuneralF1084959      250323","","126.5","","829172.56"
"2025-03-26","2025-03-22","SF FuneralF1103905      250323","","126.5","","829299.06"
"2025-03-26","2025-03-22","SF FuneralF1108153      250323","","126.5","","829425.56"
"2025-03-26","2025-03-22","SF FuneralFDC0000000MJVX250322","","126.5","","829552.06"
"2025-03-26","2025-03-22","SF FuneralF1116808      250323","","126.5","","829678.56"
"2025-03-26","2025-03-22","SF FuneralF1117604      250323","","126.5","","829805.06"
"2025-03-26","2025-03-22","SF FuneralF1120304      250322","","126.5","","829931.56"
"2025-03-26","2025-03-22","SF FuneralF1123075      250323","","126.5","","830058.06"
"2025-03-26","2025-03-22","SF FuneralFDC0000000P3FH250322","","126.5","","830184.56"
"2025-03-26","2025-03-22","SF FuneralFDC0000000P4G0250322","","126.5","","830311.06"
"2025-03-26","2025-03-22","SF FuneralF1123570      250322","","126.5","","830437.56"
"2025-03-26","2025-03-22","SF FuneralF1124777      250322","","126.5","","830564.06"
"2025-03-26","2025-03-22","SF FuneralF1128049      250322","","126.5","","830690.56"
"2025-03-26","2025-03-22","SF FuneralF1131785      250322","","126.5","","830817.06"
"2025-03-26","2025-03-22","SF FuneralFDC0000000Q9ZD250323","","126.5","","830943.56"
"2025-03-26","2025-03-26","SF FuneralF1122926      250326","","31.63","","830975.19"
"2025-03-26","2025-03-25","SF FuneralFDC00000005YYS250325","","31.63","","831006.82"
"2025-03-26","2025-03-25","SF FuneralFDC000000069NH250325","","31.63","","831038.45"
"2025-03-26","2025-03-25","SF FuneralFDC000000061TT250325","","126.5","","831164.95"
"2025-03-26","2025-03-25","SF FuneralF815978       250325","","126.5","","831291.45"
"2025-03-26","2025-03-25","SF FuneralF817087       250325","","126.5","","831417.95"
"2025-03-26","2025-03-25","SF FuneralF831894       250325","","126.5","","831544.45"
"2025-03-26","2025-03-25","SF FuneralF833052       250325","","126.5","","831670.95"
"2025-03-26","2025-03-25","SF FuneralF840712       250325","","126.5","","831797.45"
"2025-03-26","2025-03-25","SF FuneralF986818       250325","","126.5","","831923.95"
"2025-03-26","2025-03-25","SF FuneralF991076       250325","","126.5","","832050.45"
"2025-03-26","2025-03-25","SF FuneralF993702       250325","","126.5","","832176.95"
"2025-03-26","2025-03-25","SF FuneralF1058676      250325","","126.5","","832303.45"
"2025-03-26","2025-03-25","SF FuneralFDC0000000KT9B250325","","126.5","","832429.95"
"2025-03-26","2025-03-25","SF FuneralF1084347      250325","","126.5","","832556.45"
"2025-03-26","2025-03-25","SF FuneralFDC0000000N5GP250325","","126.5","","832682.95"
"2025-03-26","2025-03-25","SF FuneralF1126248      250325","","126.5","","832809.45"
"2025-03-26","2025-03-25","SF FuneralF1127918      250325","","126.5","","832935.95"
"2025-03-26","2025-03-25","SF FuneralF1130612      250325","","126.5","","833062.45"
"2025-03-26","2025-03-26","SF FuneralFDC000000069PR250326","","126.5","","833188.95"
"2025-03-26","2025-03-26","SF FuneralFDC00000006J8V250326","","126.5","","833315.45"
"2025-03-26","2025-03-26","SF FuneralFDC00000006KRZ250326","","126.5","","833441.95"
"2025-03-26","2025-03-26","SF FuneralFDC00000007030250326","","126.5","","833568.45"
"2025-03-26","2025-03-26","SF FuneralFDC00000007PTW250326","","63.25","","833631.7"
"2025-03-26","2025-03-26","SF FuneralFDC00000007T46250326","","126.5","","833758.2"
"2025-03-26","2025-03-26","SF FuneralF802223       250326","","126.5","","833884.7"
"2025-03-26","2025-03-26","SF FuneralF808656       250326","","126.5","","834011.2"
"2025-03-26","2025-03-26","SF FuneralF811326       250326","","126.5","","834137.7"
"2025-03-26","2025-03-26","SF FuneralFDC00000009K6J250326","","126.5","","834264.2"
"2025-03-26","2025-03-26","SF FuneralFDC00000009TNH250326","","126.5","","834390.7"
"2025-03-26","2025-03-26","SF FuneralF786392       250326","","191.5","","834582.2"
"2025-03-26","2025-03-26","SF FuneralF827826       250326","","126.5","","834708.7"
"2025-03-26","2025-03-26","SF FuneralFDC0000000BNGL250326","","126.5","","834835.2"
"2025-03-26","2025-03-26","SF FuneralF830232       250326","","126.5","","834961.7"
"2025-03-26","2025-03-26","SF FuneralF831473       250326","","126.5","","835088.2"
"2025-03-26","2025-03-26","SF FuneralF832424       250326","","126.5","","835214.7"
"2025-03-26","2025-03-26","SF FuneralF981421       250326","","126.5","","835341.2"
"2025-03-26","2025-03-26","SF FuneralF993242       250326","","126.5","","835467.7"
"2025-03-26","2025-03-26","SF FuneralF993406       250326","","126.5","","835594.2"
"2025-03-26","2025-03-26","SF FuneralF1017593      250326","","126.5","","835720.7"
"2025-03-26","2025-03-26","SF FuneralF1055102      250326","","126.5","","835847.2"
"2025-03-26","2025-03-26","SF FuneralF1065827      250326","","63.25","","835910.45"
"2025-03-26","2025-03-26","SF FuneralF1102954      250326","","126.5","","836036.95"
"2025-03-26","2025-03-26","SF FuneralF1108096      250326","","126.5","","836163.45"
"2025-03-26","2025-03-26","SF FuneralF1124602      250326","","126.5","","836289.95"
"2025-03-26","2025-03-26","SF FuneralF1125457      250326","","126.5","","836416.45"
"2025-03-26","2025-03-20","SF FuneralF812547       250320","","126.5","","836542.95"
"2025-03-26","2025-03-20","SF FuneralF991321       250322","","126.5","","836669.45"
"2025-03-26","2025-03-20","SF FuneralF991566       250320","","126.5","","836795.95"
"2025-03-26","2025-03-22","SF FuneralFDC00000005DX4250322","","126.5","","836922.45"
"2025-03-26","2025-03-22","SF FuneralFDC000000065Z3250322","","126.5","","837048.95"
"2025-03-26","2025-03-22","SF FuneralFDC000000070D0250322","","126.5","","837175.45"
"2025-03-26","2025-03-22","SF FuneralFDC00000007M0H250322","","126.5","","837301.95"
"2025-03-26","2025-03-22","SF FuneralFDC000000084FG250322","","126.5","","837428.45"
"2025-03-26","2025-03-22","SF FuneralFDC000000085QH250322","","126.5","","837554.95"
"2025-03-26","2025-03-22","SF FuneralF809089       250322","","126.5","","837681.45"
"2025-03-26","2025-03-22","SF FuneralF811798       250322","","126.5","","837807.95"
"2025-03-26","2025-03-22","SF FuneralF819573       250322","","126.5","","837934.45"
"2025-03-26","2025-03-22","SF FuneralF831265       250322","","126.5","","838060.95"
"2025-03-26","2025-03-22","SF FuneralF831295       250322","","126.5","","838187.45"
"2025-03-26","2025-03-22","SF FuneralF840610       250322","","126.5","","838313.95"
"2025-03-26","2025-03-22","SF FuneralF842179       250322","","126.5","","838440.45"
"2025-03-26","2025-03-22","SF FuneralF1020601      250322","","31.63","","838472.08"
"2025-03-26","2025-03-22","SF FuneralF1052696      250322","","126.5","","838598.58"
"2025-03-26","2025-03-22","SF FuneralFDC0000000K5QR250323","","126.5","","838725.08"
"2025-03-26","2025-03-22","SF FuneralF1058763      250322","","126.5","","838851.58"
"2025-03-26","2025-03-22","SF FuneralF1075289      250322","","126.5","","838978.08"
"2025-03-26","2025-03-22","SF FuneralF1104260      250323","","63.25","","839041.33"
"2025-03-26","2025-03-22","SF FuneralF1108302      250323","","126.5","","839167.83"
"2025-03-26","2025-03-22","SF FuneralFDC0000000N7YR250322","","126.5","","839294.33"
"2025-03-26","2025-03-22","SF FuneralF1116813      250323","","126.5","","839420.83"
"2025-03-26","2025-03-22","SF FuneralF1117394      250323","","126.5","","839547.33"
"2025-03-26","2025-03-22","SF FuneralF1118004      250323","","126.5","","839673.83"
"2025-03-26","2025-03-22","SF FuneralF1120513      250323","","126.5","","839800.33"
"2025-03-26","2025-03-22","SF FuneralF1123080      250322","","126.5","","839926.83"
"2025-03-26","2025-03-22","SF FuneralFDC0000000P3MC250323","","126.5","","840053.33"
"2025-03-26","2025-03-22","SF FuneralF1124369      250323","","126.5","","840179.83"
"2025-03-26","2025-03-22","SF FuneralF1134408      250322","","126.5","","840306.33"
"2025-03-26","2025-03-22","SF FuneralFDC0000000QL6M250322","","126.5","","840432.83"
"2025-03-26","2025-03-22","SF FuneralF1135174      250322","","126.5","","840559.33"
"2025-03-26","2025-03-24","SF FuneralFDC00000005V2N250323","","213.31","","840772.64"
"2025-03-26","2025-03-24","SF FuneralFDC000000063H4250323","","126.5","","840899.14"
"2025-03-26","2025-03-24","SF FuneralFDC00000006JKX250323","","126.5","","841025.64"
"2025-03-26","2025-03-24","SF FuneralFDC00000006PKJ250323","","126.5","","841152.14"
"2025-03-26","2025-03-24","SF FuneralFDC00000006PL1250323","","126.5","","841278.64"
"2025-03-26","2025-03-24","SF FuneralFDC00000006YBG250323","","126.5","","841405.14"
"2025-03-26","2025-03-24","SF FuneralFDC000000070LP250323","","126.5","","841531.64"
"2025-03-26","2025-03-24","SF FuneralFDC000000079SZ250323","","126.5","","841658.14"
"2025-03-26","2025-03-24","SF FuneralFDC00000007NY0250323","","126.5","","841784.64"
"2025-03-26","2025-03-24","SF FuneralF799717       250323","","126.5","","841911.14"
"2025-03-26","2025-03-24","SF FuneralF801921       250323","","126.5","","842037.64"
"2025-03-26","2025-03-24","SF FuneralF815559       250324","","126.5","","842164.14"
"2025-03-26","2025-03-24","SF FuneralF1079258      250324","","126.5","","842290.64"
"2025-03-26","2025-03-24","SF FuneralF787291       250324","","126.5","","842417.14"
"2025-03-26","2025-03-25","SF FuneralFDC000000064BH250325","","126.5","","842543.64"
"2025-03-26","2025-03-25","SF FuneralFDC00000007RDL250325","","126.5","","842670.14"
"2025-03-26","2025-03-25","SF FuneralFDC00000008MZZ250325","","126.5","","842796.64"
"2025-03-26","2025-03-25","SF FuneralF991541       250325","","191.5","","842988.14"
"2025-03-26","2025-03-25","SF FuneralF1112210      250325","","126.5","","843114.64"
"2025-03-26","2025-03-25","SF FuneralF1118739      250325","","63.25","","843177.89"
"2025-03-26","2025-03-25","SF FuneralFDC0000000Q3NS250325","","126.5","","843304.39"
"2025-03-26","2025-03-26","SF FuneralFDC000000064C2250326","","126.5","","843430.89"
"2025-03-26","2025-03-26","SF FuneralF834027       250326","","126.5","","843557.39"
"2025-03-26","2025-03-26","SF FuneralF989005       250326","","126.5","","843683.89"
"2025-03-26","2025-03-26","SF FuneralF752995       250326","","220","","843903.89"
"2025-03-26","2025-03-26","SF FuneralF1125012      250326","","126.5","","844030.39"
"2025-03-26","2025-03-17","SF FuneralF1125045      250317","","126.5","","844156.89"
"2025-03-26","2025-03-17","SF FuneralFDC0000000Q4DG250317","","126.5","","844283.39"
"2025-03-26","2025-03-18","SF FuneralFDC00000007F8K250318","","63.25","","844346.64"
"2025-03-26","2025-03-20","SF FuneralF1127870      250321","","126.5","","844473.14"
"2025-03-26","2025-03-25","SF FuneralFDC00000006CJJ250325","","126.5","","844599.64"
"2025-03-26","2025-03-25","SF FuneralFDC00000006S26250325","","126.5","","844726.14"
"2025-03-26","2025-03-25","SF FuneralF818153       250325","","31.63","","844757.77"
"2025-03-26","2025-03-25","SF FuneralF1020870      250325","","126.5","","844884.27"
"2025-03-26","2025-03-22","SF FuneralFDC00000006S0Q250322","","126.5","","845010.77"
"2025-03-26","2025-03-22","SF FuneralFDC00000006S0X250322","","126.5","","845137.27"
"2025-03-26","2025-03-22","SF FuneralFDC00000006YFZ250322","","126.5","","845263.77"
"2025-03-26","2025-03-22","SF FuneralFDC00000006Z85250322","","126.5","","845390.27"
"2025-03-26","2025-03-22","SF FuneralFDC000000070QX250322","","126.5","","845516.77"
"2025-03-26","2025-03-22","SF FuneralFDC000000070R4250322","","126.5","","845643.27"
"2025-03-26","2025-03-22","SF FuneralFDC00000007B00250322","","126.5","","845769.77"
"2025-03-26","2025-03-22","SF FuneralFDC00000007CHH250322","","126.5","","845896.27"
"2025-03-26","2025-03-22","SF FuneralF804398       250322","","126.5","","846022.77"
"2025-03-26","2025-03-22","SF FuneralF805634       250322","","126.5","","846149.27"
"2025-03-26","2025-03-22","SF FuneralFDC0000000CWBN250322","","126.5","","846275.77"
"2025-03-26","2025-03-22","SF FuneralF1020532      250322","","126.5","","846402.27"
"2025-03-26","2025-03-22","SF FuneralFDC0000000JVB7250322","","126.5","","846528.77"
"2025-03-26","2025-03-22","SF FuneralF1073035      250322","","126.5","","846655.27"
"2025-03-26","2025-03-22","SF FuneralF1112411      250323","","126.5","","846781.77"
"2025-03-26","2025-03-22","SF FuneralFDC0000000NFD3250322","","126.5","","846908.27"
"2025-03-26","2025-03-22","SF FuneralF1122747      250322","","126.5","","847034.77"
"2025-03-26","2025-03-22","SF FuneralF1123134      250322","","126.5","","847161.27"
"2025-03-26","2025-03-22","SF FuneralFDC0000000PS33250322","","126.5","","847287.77"
"2025-03-26","2025-03-22","SF FuneralFDC0000000PS37250322","","126.5","","847414.27"
"2025-03-26","2025-03-22","SF FuneralF1129023      250323","","126.5","","847540.77"
"2025-03-26","2025-03-22","SF FuneralF1129532      250322","","126.5","","847667.27"
"2025-03-26","2025-03-22","SF FuneralF1133467      250322","","126.5","","847793.77"
"2025-03-26","2025-03-22","SF FuneralFDC0000000QGC7250322","","126.5","","847920.27"
"2025-03-26","2025-03-24","SF FuneralFDC0000000691S250323","","126.5","","848046.77"
"2025-03-26","2025-03-24","SF FuneralFDC00000006KG7250323","","126.5","","848173.27"
"2025-03-26","2025-03-24","SF FuneralFDC00000006P1B250323","","126.5","","848299.77"
"2025-03-26","2025-03-24","SF FuneralFDC00000006WJX250323","","126.5","","848426.27"
"2025-03-26","2025-03-24","SF FuneralFDC000000075F3250323","","126.5","","848552.77"
"2025-03-26","2025-03-24","SF FuneralFDC00000007KMD250323","","126.5","","848679.27"
"2025-03-26","2025-03-24","SF FuneralFDC000000081VT250323","","126.5","","848805.77"
"2025-03-26","2025-03-24","SF FuneralFDC000000081VY250323","","126.5","","848932.27"
"2025-03-26","2025-03-24","SF FuneralFDC000000081W4250323","","126.5","","849058.77"
"2025-03-26","2025-03-24","SF FuneralFDC000000086PD250323","","126.5","","849185.27"
"2025-03-26","2025-03-24","SF FuneralFDC00000009X3F250323","","126.5","","849311.77"
"2025-03-26","2025-03-24","SF FuneralF844726       250322","","126.5","","849438.27"
"2025-03-26","2025-03-24","SF FuneralF1120229      250324","","95.75","","849534.02"
"2025-03-26","2025-03-25","SF FuneralFDC00000006F1B250325","","126.5","","849660.52"
"2025-03-26","2025-03-25","SF FuneralF797213       250325","","31.63","","849692.15"
"2025-03-26","2025-03-20","SF FuneralFDC00000006C4W250320","","126.5","","849818.65"
"2025-03-26","2025-03-20","SF FuneralFDC0000000JG43250321","","31.63","","849850.28"
"2025-03-26","2025-03-22","SF FuneralFDC00000006K1J250322","","126.5","","849976.78"
"2025-03-26","2025-03-22","SF FuneralFDC00000006K1V250322","","126.5","","850103.28"
"2025-03-26","2025-03-22","SF FuneralFDC000000078RD250322","","126.5","","850229.78"
"2025-03-26","2025-03-22","SF FuneralF796597       250322","","126.5","","850356.28"
"2025-03-26","2025-03-22","SF FuneralFDC0000000B4NX250322","","126.5","","850482.78"
"2025-03-26","2025-03-22","SF FuneralF793229       250321","","343.31","","850826.09"
"2025-03-26","2025-03-22","SF FuneralF830013       250322","","126.5","","850952.59"
"2025-03-26","2025-03-22","SF FuneralF1017543      250322","","126.5","","851079.09"
"2025-03-26","2025-03-22","SF FuneralF1072715      250322","","126.5","","851205.59"
"2025-03-26","2025-03-22","SF FuneralF1112060      250322","","126.5","","851332.09"
"2025-03-26","2025-03-22","SF FuneralF1115116      250322","","126.5","","851458.59"
"2025-03-26","2025-03-22","SF FuneralFDC0000000NWRL250323","","126.5","","851585.09"
"2025-03-26","2025-03-22","SF FuneralF1123195      250323","","126.5","","851711.59"
"2025-03-26","2025-03-22","SF FuneralF1123387      250323","","126.5","","851838.09"
"2025-03-26","2025-03-22","SF FuneralF1127098      250323","","126.5","","851964.59"
"2025-03-26","2025-03-22","SF FuneralFDC0000000PXV3250323","","126.5","","852091.09"
"2025-03-26","2025-03-22","SF FuneralFDC0000000PXV4250323","","126.5","","852217.59"
"2025-03-26","2025-03-22","SF FuneralF1133328      250322","","126.5","","852344.09"
"2025-03-26","2025-03-22","SF FuneralF1135052      250322","","126.5","","852470.59"
"2025-03-26","2025-03-24","SF FuneralFDC000000056ZW250323","","126.5","","852597.09"
"2025-03-26","2025-03-24","SF FuneralFDC00000006ZTD250323","","126.5","","852723.59"
"2025-03-26","2025-03-24","SF FuneralFDC00000007MQ7250323","","126.5","","852850.09"
"2025-03-26","2025-03-24","SF FuneralF793413       250323","","126.5","","852976.59"
"2025-03-26","2025-03-24","SF FuneralF811628       250323","","126.5","","853103.09"
"2025-03-26","2025-03-24","SF FuneralFDC00000009YZC250323","","126.5","","853229.59"
"2025-03-26","2025-03-24","SF FuneralF833075       250323","","126.5","","853356.09"
"2025-03-26","2025-03-24","SF FuneralF833989       250324","","126.5","","853482.59"
"2025-03-26","2025-03-24","SF FuneralF1066274      250324","","31.63","","853514.22"
"2025-03-26","2025-03-26","SF FuneralF815129       250326","","126.5","","853640.72"
"2025-03-26","2025-03-26","SF FuneralFDC00000008L4K250326","","126.5","","853767.22"
"2025-03-26","2025-03-24","SF FuneralFDC00000005PQQ250324","","126.5","","853893.72"
"2025-03-26","2025-03-24","SF FuneralFDC000000062BN250324","","126.5","","854020.22"
"2025-03-26","2025-03-19","SF FuneralFDC0000000B0NN250319","","126.5","","854146.72"
"2025-03-26","2025-03-24","SF FuneralFDC0000000B723250324","","126.5","","854273.22"
"2025-03-26","2025-03-19","SF FuneralF1132911      250319","","31.63","","854304.85"
"2025-03-26","2025-03-20","SF FuneralF813417       250320","","126.5","","854431.35"
"2025-03-26","2025-03-22","SF FuneralF805952       250322","","126.5","","854557.85"
"2025-03-26","2025-03-22","SF FuneralF819632       250322","","126.5","","854684.35"
"2025-03-26","2025-03-22","SF FuneralF1066589      250322","","126.5","","854810.85"
"2025-03-26","2025-03-22","SF FuneralF1108398      250322","","126.5","","854937.35"
"2025-03-26","2025-03-24","SF FuneralFDC00000006200250323","","126.5","","855063.85"
"2025-03-26","2025-03-24","SF FuneralF819589       250323","","126.5","","855190.35"
"2025-03-26","2025-03-24","SF FuneralF834511       250323","","126.5","","855316.85"
"2025-03-26","2025-03-26","SF FuneralF1020629      250326","","126.5","","855443.35"
"2025-03-26","2025-03-26","SF FuneralF1132911      250326","","31.63","","855474.98"
"2025-03-26","2025-03-24","SF FuneralFDC000000061HC250323","","126.5","","855601.48"
"2025-03-26","2025-03-20","Rev SF FuneralFDC00000007CVJ250320","","-126.5","","855474.98"
"2025-03-26","2025-03-22","Rev SF FuneralFDC0000000B0Z9250322","","-126.5","","855348.48"
"2025-03-26","2025-03-22","Rev SF FuneralFDC0000000K3QC250322","","-126.5","","855221.98"
"2025-03-26","2025-03-22","Rev SF FuneralFDC0000000K3QT250322","","-126.5","","855095.48"
"2025-03-26","2025-03-22","Rev SF FuneralFDC000000080FS250322","","-126.5","","854968.98"
"2025-03-26","2025-03-22","Rev SF FuneralFDC0000000NCC5250322","","-126.5","","854842.48"
"2025-03-26","2025-03-22","Rev SF FuneralFDC0000000700C250322","","-126.5","","854715.98"
"2025-03-26","2025-03-22","Rev SF FuneralFDC00000003HNP250322","","-220","","854495.98"
"2025-03-26","2025-03-22","Rev SF FuneralFDC0000000941V250322","","-126.5","","854369.48"
"2025-03-26","2025-03-22","Rev SF FuneralFDC000000062BW250322","","-126.5","","854242.98"
"2025-03-26","2025-03-22","Rev SF FuneralFDC00000007VSR250322","","-126.5","","854116.48"
"2025-03-26","2025-03-22","Rev SF FuneralFDC00000006YD9250322","","-126.5","","853989.98"
"2025-03-26","2025-03-22","Rev SF FuneralFDC00000006WYR250322","","-126.5","","853863.48"
"2025-03-26","2025-03-22","Rev SF FuneralFDC00000006WYX250322","","-126.5","","853736.98"
"2025-03-26","2025-03-22","Rev SF FuneralFDC000000085JP250322","","-126.5","","853610.48"
"2025-03-26","2025-03-22","Rev SF FuneralFDC000000080Y6250322","","-126.5","","853483.98"
"2025-03-26","2025-03-22","Rev SF FuneralFDC0000000MK28250322","","-126.5","","853357.48"
"2025-03-26","2025-03-24","Rev SF FuneralFDC000000062X2250323","","-126.5","","853230.98"
"2025-03-26","2025-03-24","Rev SF FuneralFDC00000006WGQ250324","","-126.5","","853104.48"
"2025-03-26","2025-03-24","Rev SF FuneralFDC000000078PD250324","","-126.5","","852977.98"
"2025-03-26","2025-03-26","Rev SF FuneralFDC00000009K6J250326","","-126.5","","852851.48"
"2025-03-26","2025-03-25","Rev SF FuneralFDC0000000KT9B250325","","-126.5","","852724.98"
"2025-03-26","2025-03-25","Rev SF FuneralFDC0000000PWW4250325","","-126.5","","852598.48"
"2025-03-26","2025-01-24","Rev SF FuneralFDC0000000PJ0G250128","","-126.5","","852471.98"
"2025-03-26","2025-03-22","Rev SF FuneralFDC00000007W5M250321","","-31.63","","852440.35"
"2025-03-26","2025-03-22","SF FuneralF1084268      250322","","126.5","","852566.85"
"2025-03-26","2025-03-22","SF FuneralF801313       250321","","126.5","","852693.35"
"2025-03-26","2025-03-20","SF FuneralF1117623      250321","","126.5","","852819.85"
"2025-03-26","2025-03-22","SF FuneralFDC00000002WYD250322","","220","","853039.85"
"2025-03-26","2025-03-22","SF FuneralF1021565      250322","","126.5","","853166.35"
"2025-03-26","2025-03-22","SF FuneralF1033627      250322","","126.5","","853292.85"
"2025-03-26","2025-03-22","SF FuneralF1060053      250322","","126.5","","853419.35"
"2025-03-26","2025-03-22","SF FuneralF1084932      250322","","126.5","","853545.85"
"2025-03-26","2025-03-22","SF FuneralF1103826      250323","","126.5","","853672.35"
"2025-03-26","2025-03-22","SF FuneralFDC0000000QL8P250323","","126.5","","853798.85"
"2025-03-26","2025-03-22","SF FuneralFDC0000000QL8V250323","","126.5","","853925.35"
"2025-03-26","2025-03-24","SF FuneralFDC00000006H5S250323","","126.5","","854051.85"
"2025-03-26","2025-03-24","SF FuneralFDC00000006XRW250323","","63.25","","854115.1"
"2025-03-26","2025-03-24","SF FuneralFDC00000006ZZW250323","","126.5","","854241.6"
"2025-03-26","2025-03-24","SF FuneralFDC0000000731B250323","","126.5","","854368.1"
"2025-03-26","2025-03-24","SF FuneralF1103628      250324","","126.5","","854494.6"
"2025-03-26","2025-03-25","SF FuneralF901011       250325","","126.5","","854621.1"
"2025-03-26","2025-03-25","SF FuneralF1083840      250325","","126.5","","854747.6"
"2025-03-26","2025-03-25","SF FuneralFDC0000000PRPN250325","","126.5","","854874.1"
"2025-03-26","2025-03-26","SF FuneralFDC0000000774H250326","","126.5","","855000.6"
"2025-03-26","2025-03-26","SF FuneralF823589       250326","","126.5","","855127.1"
"2025-03-26","2025-03-26","SF FuneralF842405       250326","","126.5","","855253.6"
"2025-03-26","2025-03-26","SF FuneralF1017058      250326","","126.5","","855380.1"
"2025-03-26","2025-03-26","SF FuneralF1120885      250326","","126.5","","855506.6"
"2025-03-26","2025-03-17","SF FuneralF1052512      250317","","126.5","","855633.1"
"2025-03-26","2025-03-17","SF FuneralF1111577      250317","","126.5","","855759.6"
"2025-03-26","2025-03-22","SF FuneralFDC00000006TYL250322","","126.5","","855886.1"
"2025-03-26","2025-03-22","SF FuneralF802158       250322","","126.5","","856012.6"
"2025-03-26","2025-03-22","SF FuneralF803273       250322","","126.5","","856139.1"
"2025-03-26","2025-03-22","SF FuneralF807962       250322","","126.5","","856265.6"
"2025-03-26","2025-03-22","SF FuneralF812543       250322","","126.5","","856392.1"
"2025-03-26","2025-03-22","SF FuneralF827889       250322","","126.5","","856518.6"
"2025-03-26","2025-03-22","SF FuneralF992308       250322","","126.5","","856645.1"
"2025-03-26","2025-03-22","SF FuneralF1108258      250322","","126.5","","856771.6"
"2025-03-26","2025-03-22","SF FuneralF1108969      250322","","126.5","","856898.1"
"2025-03-26","2025-03-22","SF FuneralF1110243      250323","","126.5","","857024.6"
"2025-03-26","2025-03-22","SF FuneralF1112254      250323","","126.5","","857151.1"
"2025-03-26","2025-03-22","SF FuneralF1116009      250323","","126.5","","857277.6"
"2025-03-26","2025-03-22","SF FuneralF1120415      250322","","126.5","","857404.1"
"2025-03-26","2025-03-24","SF FuneralFDC00000006W7W250324","","126.5","","857530.6"
"2025-03-26","2025-03-24","SF FuneralF802334       250324","","126.5","","857657.1"
"2025-03-26","2025-03-25","SF FuneralFDC000000064LG250325","","126.5","","857783.6"
"2025-03-26","2025-03-25","SF FuneralFDC00000007KZR250325","","126.5","","857910.1"
"2025-03-26","2025-03-25","SF FuneralFDC00000007KZT250325","","126.5","","858036.6"
"2025-03-26","2025-03-25","SF FuneralFDC0000000HT6X250325","","126.5","","858163.1"
"2025-03-26","2025-03-25","SF FuneralF1132901      250325","","126.5","","858289.6"
"2025-03-26","2025-03-26","SF FuneralFDC00000008B9C250326","","126.5","","858416.1"
"2025-03-26","2025-03-26","SF FuneralF1016776      250326","","126.5","","858542.6"
"2025-03-26","2025-03-24","SF FuneralF803226       250324","","31.63","","858574.23"
"2025-03-26","2025-03-24","SF FuneralF1052812      250324","","31.63","","858605.86"
"2025-03-26","2025-03-25","SF FuneralFDC00000006H1Y250325","","31.63","","858637.49"
"2025-03-26","2025-03-25","SF FuneralF993770       250325","","31.63","","858669.12"
"2025-03-26","2025-03-25","SF FuneralF1132785      250325","","31.63","","858700.75"
"2025-03-26","2025-03-22","Rev SF FuneralFDC00000006GQ0250322","","-126.5","","858574.25"
"2025-03-26","2025-03-22","SF FuneralF1124371      250322","","126.5","","858700.75"
"2025-03-26","2025-03-24","SF FuneralF804332       250324","","126.5","","858827.25"
"2025-03-26","2025-03-25","SF FuneralFDC0000000Q3QL250325","","126.5","","858953.75"
"2025-03-26","2025-03-22","SF FuneralFDC0000000B43D250322","","126.5","","859080.25"
"2025-03-26","2025-03-22","SF FuneralF1065734      250322","","126.5","","859206.75"
"2025-03-26","2025-03-24","SF FuneralF1134027      250324","","31.63","","859238.38"
"2025-03-26","2025-03-25","SF FuneralF819196       250325","","31.63","","859270.01"
"2025-03-26","2025-03-25","SF FuneralF1112035      250325","","31.63","","859301.64"
"2025-03-26","2025-03-25","SF FuneralF1130740      250325","","126.5","","859428.14"
"2025-03-26","2025-03-17","SF FuneralFDC0000000786G250316","","126.5","","859554.64"
"2025-03-26","2025-03-17","SF FuneralF900413       250315","","126.5","","859681.14"
"2025-03-26","2025-03-17","SF FuneralF992185       250317","","126.5","","859807.64"
"2025-03-26","2025-03-22","SF FuneralFDC0000000713G250322","","126.5","","859934.14"
"2025-03-26","2025-03-22","SF FuneralF833338       250322","","126.5","","860060.64"
"2025-03-26","2025-03-22","SF FuneralFDC0000000KRKJ250322","","126.5","","860187.14"
"2025-03-26","2025-03-22","SF FuneralF1108054      250322","","126.5","","860313.64"
"2025-03-26","2025-03-22","SF FuneralF1127571      250322","","126.5","","860440.14"
"2025-03-26","2025-03-24","SF FuneralF787433       250324","","126.5","","860566.64"
"2025-03-26","2025-03-24","SF FuneralF813677       250323","","126.5","","860693.14"
"2025-03-26","2025-03-24","SF FuneralFDC0000000KFK0250324","","126.5","","860819.64"
"2025-03-26","2025-03-25","SF FuneralFDC000000062VW250325","","126.5","","860946.14"
"2025-03-26","2025-03-25","SF FuneralFDC00000006K1W250325","","126.5","","861072.64"
"2025-03-26","2025-03-25","SF FuneralFDC00000006K2B250325","","126.5","","861199.14"
"2025-03-26","2025-03-25","SF FuneralFDC00000006K2M250325","","126.5","","861325.64"
"2025-03-26","2025-03-25","SF FuneralFDC00000006K2X250325","","126.5","","861452.14"
"2025-03-26","2025-03-25","SF FuneralF1078559      250325","","126.5","","861578.64"
"2025-03-26","2025-03-17","Rev SF FuneralFDC00000005Q9X250317","","-126.5","","861452.14"
"2025-03-26","2025-03-24","SF FuneralFDC00000002X26250324","","220","","861672.14"
"2025-03-26","2025-03-22","SF FuneralFDC0000000798W250322","","126.5","","861798.64"
"2025-03-26","2025-03-25","SF FuneralFDC00000003HFV250325","","220","","862018.64"
"2025-03-26","2025-03-25","SF FuneralF1122763      250325","","126.5","","862145.14"
"2025-03-26","2025-03-26","SF FuneralF1084424      250326","","126.5","","862271.64"
"2025-03-26","2025-03-22","SF FuneralFDC00000005S20250322","","126.5","","862398.14"
"2025-03-26","2025-03-22","SF FuneralF797701       250322","","126.5","","862524.64"
"2025-03-26","2025-03-22","SF FuneralF840998       250322","","126.5","","862651.14"
"2025-03-26","2025-03-22","SF FuneralF1061879      250322","","191.5","","862842.64"
"2025-03-26","2025-03-22","SF FuneralF1074909      250323","","126.5","","862969.14"
"2025-03-26","2025-03-22","SF FuneralFDC0000000M30C250323","","126.5","","863095.64"
"2025-03-26","2025-03-24","SF FuneralFDC00000008JYB250324","","63.25","","863158.89"
"2025-03-26","2025-03-24","SF FuneralF823193       250324","","126.5","","863285.39"
"2025-03-26","2025-03-24","SF FuneralF831318       250324","","126.5","","863411.89"
"2025-03-26","2025-03-24","SF FuneralF843071       250324","","126.5","","863538.39"
"2025-03-26","2025-03-24","SF FuneralFDC0000000P4M6250324","","126.5","","863664.89"
"2025-03-26","2025-03-24","SF FuneralF1123401      250324","","126.5","","863791.39"
"2025-03-26","2025-03-24","SF FuneralF1131865      250324","","126.5","","863917.89"
"2025-03-26","2025-03-24","SF FuneralFDC0000000QDFP250324","","126.5","","864044.39"
"2025-03-26","2025-03-25","SF FuneralFDC00000003L92250325","","220","","864264.39"
"2025-03-26","2025-03-25","SF FuneralFDC000000062FD250325","","220","","864484.39"
"2025-03-26","2025-03-25","SF FuneralF823642       250325","","126.5","","864610.89"
"2025-03-26","2025-03-25","SF FuneralF1054763      250325","","126.5","","864737.39"
"2025-03-26","2025-03-26","SF FuneralF808993       250326","","126.5","","864863.89"
"2025-03-26","2025-03-26","SF FuneralFDC0000000MLBX250326","","126.5","","864990.39"
"2025-03-26","2025-03-20","SF FuneralF981670       250321","","31.63","","865022.02"
"2025-03-26","2025-03-24","SF FuneralFDC00000009G6B250323","","31.63","","865053.65"
"2025-03-26","2025-03-24","SF FuneralFDC00000009G6R250324","","31.63","","865085.28"
"2025-03-26","2025-03-24","SF FuneralF1132295      250324","","31.63","","865116.91"
"2025-03-26","2025-03-25","SF FuneralF1021235      250325","","31.63","","865148.54"
"2025-03-26","2025-03-20","SF FuneralF1124409      250321","","126.5","","865275.04"
"2025-03-26","2025-03-22","SF FuneralFDC000000072HD250322","","126.5","","865401.54"
"2025-03-26","2025-03-24","SF FuneralFDC00000005NKJ250324","","31.63","","865433.17"
"2025-03-26","2025-03-24","SF FuneralF799342       250323","","126.5","","865559.67"
"2025-03-26","2025-03-24","SF FuneralF1126134      250324","","126.5","","865686.17"
"2025-03-26","2025-03-24","SF FuneralF1131082      250324","","126.5","","865812.67"
"2025-03-26","2025-03-25","SF FuneralFDC00000007FMQ250325","","213.31","","866025.98"
"2025-03-26","2025-03-24","SF FuneralF1103763      250324","","126.5","","866152.48"
"2025-03-26","2025-03-22","SF FuneralFDC00000006JPK250322","","126.5","","866278.98"
"2025-03-26","2025-03-22","SF FuneralFDC00000006VHL250322","","126.5","","866405.48"
"2025-03-26","2025-03-22","SF FuneralFDC000000081JS250322","","126.5","","866531.98"
"2025-03-26","2025-03-22","SF FuneralFDC000000081JV250322","","126.5","","866658.48"
"2025-03-26","2025-03-22","SF FuneralF1129917      250323","","31.63","","866690.11"
"2025-03-26","2025-03-22","SF FuneralFDC0000000609Q250322","","126.5","","866816.61"
"2025-03-26","2025-03-22","SF FuneralFDC00000007LSC250322","","126.5","","866943.11"
"2025-03-26","2025-03-22","SF FuneralF840726       250322","","126.5","","867069.61"
"2025-03-26","2025-03-22","SF FuneralF1073696      250322","","126.5","","867196.11"
"2025-03-26","2025-03-24","SF FuneralFDC000000060D4250323","","126.5","","867322.61"
"2025-03-26","2025-03-25","SF FuneralF1131046      250325","","126.5","","867449.11"
"2025-03-26","2025-03-20","SF FuneralF989432       250321","","126.5","","867575.61"
"2025-03-26","2025-03-22","SF FuneralFDC00000005ZX3250322","","126.5","","867702.11"
"2025-03-26","2025-03-22","SF FuneralF831390       250322","","126.5","","867828.61"
"2025-03-26","2025-03-22","SF FuneralF1054722      250323","","63.25","","867891.86"
"2025-03-26","2025-03-22","SF FuneralF1054879      250322","","126.5","","868018.36"
"2025-03-26","2025-03-24","SF FuneralFDC00000006BPC250324","","126.5","","868144.86"
"2025-03-26","2025-03-24","SF FuneralF807982       250323","","126.5","","868271.36"
"2025-03-26","2025-03-24","SF FuneralFDC0000000PB42250324","","126.5","","868397.86"
"2025-03-26","2025-03-25","SF FuneralFDC0000000BD5B250325","","126.5","","868524.36"
"2025-03-26","2025-03-25","SF FuneralF987557       250325","","126.5","","868650.86"
"2025-03-26","2025-03-25","SF FuneralF1130060      250325","","63.25","","868714.11"
"2025-03-26","2025-03-25","SF FuneralF1130977      250325","","126.5","","868840.61"
"2025-03-26","2025-03-25","SF FuneralFDC0000000Q701250325","","126.5","","868967.11"
"2025-03-26","2025-03-20","SF FuneralFDC000000069VM250320","","126.5","","869093.61"
"2025-03-26","2025-03-20","SF FuneralF990824       250322","","126.5","","869220.11"
"2025-03-26","2025-03-22","SF FuneralFDC00000007JT0250322","","126.5","","869346.61"
"2025-03-26","2025-03-22","SF FuneralF811285       250322","","126.5","","869473.11"
"2025-03-26","2025-03-22","SF FuneralF819694       250322","","126.5","","869599.61"
"2025-03-26","2025-03-22","SF FuneralFDC0000000BYP5250322","","126.5","","869726.11"
"2025-03-26","2025-03-22","SF FuneralF832121       250322","","126.5","","869852.61"
"2025-03-26","2025-03-22","SF FuneralF833195       250322","","126.5","","869979.11"
"2025-03-26","2025-03-22","SF FuneralF1073403      250322","","126.5","","870105.61"
"2025-03-26","2025-03-22","SF FuneralF1080232      250323","","63.25","","870168.86"
"2025-03-26","2025-03-22","SF FuneralFDC0000000MJPL250322","","126.5","","870295.36"
"2025-03-26","2025-03-22","SF FuneralFDC0000000MLZD250323","","126.5","","870421.86"
"2025-03-26","2025-03-22","SF FuneralFDC0000000N0G9250322","","126.5","","870548.36"
"2025-03-26","2025-03-22","SF FuneralFDC0000000N0GY250322","","126.5","","870674.86"
"2025-03-26","2025-03-22","SF FuneralF1127627      250322","","126.5","","870801.36"
"2025-03-26","2025-03-24","SF FuneralFDC0000000502G250324","","31.63","","870832.99"
"2025-03-26","2025-03-24","SF FuneralF831662       250323","","126.5","","870959.49"
"2025-03-26","2025-03-24","SF FuneralFDC0000000P5RB250324","","126.5","","871085.99"
"2025-03-26","2025-03-25","SF FuneralFDC00000005L57250325","","31.63","","871117.62"
"2025-03-26","2025-03-25","SF FuneralFDC00000007TDQ250325","","126.5","","871244.12"
"2025-03-26","2025-03-25","SF FuneralF803694       250325","","126.5","","871370.62"
"2025-03-26","2025-03-25","SF FuneralF833557       250325","","63.25","","871433.87"
"2025-03-26","2025-03-25","SF FuneralF900614       250325","","126.5","","871560.37"
"2025-03-26","2025-03-25","SF FuneralF1016996      250325","","126.5","","871686.87"
"2025-03-26","2025-03-25","SF FuneralF1055118      250325","","126.5","","871813.37"
"2025-03-26","2025-03-25","SF FuneralFDC0000000NPJ3250325","","126.5","","871939.87"
"2025-03-26","2025-03-24","SF FuneralF1132453      250324","","31.63","","871971.5"
"2025-03-26","2025-03-24","Rev SF FuneralFDC00000006ZZW250323","","-126.5","","871845"
"2025-03-26","2025-03-24","Rev SF FuneralFDC000000076MR250323","","-126.5","","871718.5"
"2025-03-26","2025-03-24","Rev SF FuneralFDC000000062RH250323","","-126.5","","871592"
"2025-03-26","2025-03-22","Rev SF FuneralFDC00000007VYV250322","","-126.5","","871465.5"
"2025-03-26","2025-03-22","Rev SF FuneralFDC0000000D6PQ250322","","-126.5","","871339"
"2025-03-26","2025-03-24","Rev SF FuneralFDC0000000PRPK250324","","-126.5","","871212.5"
"2025-03-26","2025-03-22","Rev SF FuneralFDC00000005SKV250322","","-126.5","","871086"
"2025-03-26","2025-03-17","Rev SF FuneralFDC00000009MKM250317","","-126.5","","870959.5"
"2025-03-26","2025-03-22","Rev SF FuneralFDC00000005TFL250322","","-126.5","","870833"
"2025-03-26","2025-03-22","Rev SF FuneralFDC00000006RLZ250322","","-126.5","","870706.5"
"2025-03-26","2025-03-25","Rev SF FuneralFDC0000000HT6X250325","","-126.5","","870580"
"2025-03-26","2025-03-25","Rev SF FuneralFDC000000064LG250325","","-126.5","","870453.5"
"2025-03-26","2025-03-22","Rev SF FuneralFDC0000000PKLP250322","","-126.5","","870327"
"2025-03-26","2025-03-26","Rev SF FuneralFDC00000006J8V250326","","-126.5","","870200.5"
"2025-03-26","2025-03-22","Rev SF FuneralFDC00000008N5F250322","","-126.5","","870074"
"2025-03-26","2025-03-22","Rev SF FuneralFDC000000032Y3250322","","-220","","869854"
"2025-03-26","2025-03-22","Rev SF FuneralFDC000000062KZ250322","","-126.5","","869727.5"
"2025-03-26","2025-03-22","Rev SF FuneralFDC000000062L0250322","","-126.5","","869601"
"2025-03-26","2025-03-22","Rev SF FuneralFDC00000006MKS250322","","-126.5","","869474.5"
"2025-03-26","2025-03-22","Rev SF FuneralFDC00000005V39250322","","-126.5","","869348"
"2025-03-26","2025-03-22","Rev SF FuneralFDC00000005XG7250322","","-126.5","","869221.5"
"2025-03-26","2025-02-22","Rev SF FuneralFDC000000058N5250222","","-126.5","","869095"
"2025-03-26","2025-03-22","Rev SF FuneralFDC00000006VP2250322","","-126.5","","868968.5"
"2025-03-26","2025-03-22","Rev SF FuneralFDC0000000KWDK250322","","-126.5","","868842"
"2025-03-26","2025-03-22","Rev SF FuneralFDC0000000LJ53250323","","-126.5","","868715.5"
"2025-03-26","2025-03-25","Rev SF FuneralFDC0000000HN9N250325","","-31.63","","868683.87"
"2025-03-26","2025-03-24","Rev SF FuneralFDC0000000KFK0250324","","-126.5","","868557.37"
"2025-03-26","2025-02-22","Rev SF FuneralFDC00000005TFL250222","","-126.5","","868430.87"
"2025-03-26","2025-02-22","Rev SF FuneralFDC00000005V39250222","","-126.5","","868304.37"
"2025-03-26","2025-03-19","Rev SF FuneralFDC00000006PWT250319","","-126.5","","868177.87"
"2025-03-26","2025-02-19","Rev SF FuneralFDC00000007HMX250219","","-126.5","","868051.37"
"2025-03-26","2025-03-22","Rev SF FuneralFDC00000006VP1250322","","-126.5","","867924.87"
"2025-03-26","2025-03-22","Rev SF FuneralFDC000000062LG250322","","-126.5","","867798.37"
"2025-03-26","2024-12-11","Rev SF FuneralF1084347      241225","","-126.5","","867671.87"
"2025-03-26","2025-03-22","Rev SF FuneralFDC00000008V0C250321","","-126.5","","867545.37"
"2025-03-26","2025-02-12","Rev SF FuneralFDC0000000PY4R250212","","-126.5","","867418.87"
"2025-03-26","2025-03-26","SF FuneralFDC0000000KKBT250326","","95.75","","867514.62"
"2025-03-26","2025-03-22","SF FuneralF820280       250322","","126.5","","867641.12"
"2025-03-26","2025-03-22","SF FuneralF1079389      250322","","126.5","","867767.62"
"2025-03-26","2025-03-22","SF FuneralF1083875      250322","","126.5","","867894.12"
"2025-03-26","2025-03-26","SF FuneralF1060609      250326","","126.5","","868020.62"
"2025-03-26","2025-03-26","SF FuneralF1112302      250326","","126.5","","868147.12"
"2025-03-26","2025-03-23","SF FuneralF815982       250323","","126.5","","868273.62"
"2025-03-26","2025-03-24","SF FuneralFDC00000002XYZ250323","","55","","868328.62"
"2025-03-26","2025-03-24","SF FuneralF1129890      250324","","126.5","","868455.12"
"2025-03-26","2025-03-22","SF FuneralFDC000000067VB250321","","126.5","","868581.62"
"2025-03-26","2025-03-22","SF FuneralF798624       250322","","126.5","","868708.12"
"2025-03-26","2025-03-22","SF FuneralF815814       250322","","126.5","","868834.62"
"2025-03-26","2025-03-22","SF FuneralF832133       250322","","126.5","","868961.12"
"2025-03-26","2025-03-22","SF FuneralF1054651      250322","","126.5","","869087.62"
"2025-03-26","2025-03-22","SF FuneralF1059854      250322","","126.5","","869214.12"
"2025-03-26","2025-03-22","SF FuneralF1133175      250322","","126.5","","869340.62"
"2025-03-26","2025-03-22","SF FuneralFDC0000000JY24250323","","31.63","","869372.25"
"2025-03-26","2025-03-24","SF FuneralFDC000000042HH250323","","55","","869427.25"
"2025-03-26","2025-03-24","SF FuneralF900666       250324","","126.5","","869553.75"
"2025-03-26","2025-03-24","SF FuneralF1060467      250324","","126.5","","869680.25"
"2025-03-26","2025-03-25","SF FuneralF802429       250325","","126.5","","869806.75"
"2025-03-26","2025-03-25","SF FuneralFDC0000000JV80250325","","126.5","","869933.25"
"2025-03-26","2025-03-25","SF FuneralF1021366      250325","","126.5","","870059.75"
"2025-03-26","2025-03-26","SF FuneralFDC0000000M449250326","","126.5","","870186.25"
"2025-03-26","2025-03-25","SF FuneralFDC000000031YB250325","","220","","870406.25"
"2025-03-26","2025-01-24","Rev SF FuneralF1059377      250128","","-126.5","","870279.75"
"2025-03-26","2025-03-17","SF FuneralFDC00000006MWP250316","","63.25","","870343"
"2025-03-27","2025-03-22","SF FuneralFDC000000031K0250322","","220","","870563"
"2025-03-27","2025-03-22","SF FuneralFDC0000000855Y250321","","126.5","","870689.5"
"2025-03-27","2025-03-24","SF FuneralFDC00000005MZK250323","","126.5","","870816"
"2025-03-27","2025-03-24","SF FuneralFDC0000000LCXG250324","","126.5","","870942.5"
"2025-03-27","2025-03-19","SF FuneralFDC0000000H00Z250319","","126.5","","871069"
"2025-03-27","2025-03-19","SF FuneralF900778       250319","","126.5","","871195.5"
"2025-03-27","2025-03-22","SF FuneralFDC000000085C4250322","","126.5","","871322"
"2025-03-27","2025-03-22","SF FuneralF793215       250322","","126.5","","871448.5"
"2025-03-27","2025-03-22","SF FuneralF808276       250322","","126.5","","871575"
"2025-03-27","2025-03-22","SF FuneralF1115854      250322","","126.5","","871701.5"
"2025-03-27","2025-03-24","SF FuneralF1083670      250324","","126.5","","871828"
"2025-03-27","2025-03-25","SF FuneralFDC00000007YRL250325","","126.5","","871954.5"
"2025-03-27","2025-03-25","SF FuneralF827961       250325","","126.5","","872081"
"2025-03-27","2025-03-25","SF FuneralF843086       250325","","126.5","","872207.5"
"2025-03-27","2025-03-25","SF FuneralF793244       250325","","321.5","","872529"
"2025-03-27","2025-03-25","SF FuneralF987635       250325","","126.5","","872655.5"
"2025-03-27","2025-03-25","SF FuneralF991573       250325","","126.5","","872782"
"2025-03-27","2025-03-25","SF FuneralF992859       250325","","126.5","","872908.5"
"2025-03-27","2025-03-25","SF FuneralF1074842      250325","","126.5","","873035"
"2025-03-27","2025-03-25","SF FuneralF1120244      250325","","126.5","","873161.5"
"2025-03-27","2025-03-25","SF FuneralF1130830      250325","","126.5","","873288"
"2025-03-27","2025-03-26","SF FuneralF828132       250326","","126.5","","873414.5"
"2025-03-27","2025-03-26","SF FuneralF992367       250326","","126.5","","873541"
"2025-03-27","2025-03-26","SF FuneralF1078957      250326","","126.5","","873667.5"
"2025-03-27","2025-03-22","SF FuneralFDC0000000BHLR250322","","220","","873887.5"
"2025-03-27","2025-03-18","SF FuneralFDC00000007DNK250318","","63.25","","873950.75"
"2025-03-27","2025-03-19","SF FuneralF833678       250319","","451.5","","874402.25"
"2025-03-27","2025-03-20","SF FuneralF991404       250322","","126.5","","874528.75"
"2025-03-27","2025-03-20","SF FuneralF1059290      250321","","126.5","","874655.25"
"2025-03-27","2025-03-22","SF FuneralFDC00000003932250322","","220","","874875.25"
"2025-03-27","2025-03-22","SF FuneralFDC00000003JQF250321","","220","","875095.25"
"2025-03-27","2025-03-22","SF FuneralFDC00000003JQR250321","","220","","875315.25"
"2025-03-27","2025-03-22","SF FuneralFDC0000000610D250322","","126.5","","875441.75"
"2025-03-27","2025-03-22","SF FuneralFDC0000000678S250322","","126.5","","875568.25"
"2025-03-27","2025-03-22","SF FuneralFDC0000000678T250322","","126.5","","875694.75"
"2025-03-27","2025-03-22","SF FuneralFDC000000067N5250322","","126.5","","875821.25"
"2025-03-27","2025-03-22","SF FuneralFDC000000067N8250322","","126.5","","875947.75"
"2025-03-27","2025-03-22","SF FuneralFDC00000006JSG250321","","126.5","","876074.25"
"2025-03-27","2025-03-22","SF FuneralFDC00000006MTQ250321","","126.5","","876200.75"
"2025-03-27","2025-03-22","SF FuneralFDC00000006NKJ250322","","126.5","","876327.25"
"2025-03-27","2025-03-22","SF FuneralFDC00000007L7K250321","","126.5","","876453.75"
"2025-03-27","2025-03-22","SF FuneralF810118       250322","","126.5","","876580.25"
"2025-03-27","2025-03-22","SF FuneralF817171       250322","","126.5","","876706.75"
"2025-03-27","2025-03-22","SF FuneralF817708       250322","","126.5","","876833.25"
"2025-03-27","2025-03-22","SF FuneralF1052647      250322","","126.5","","876959.75"
"2025-03-27","2025-03-22","SF FuneralFDC0000000KGRJ250322","","126.5","","877086.25"
"2025-03-27","2025-03-22","SF FuneralF1060639      250322","","126.5","","877212.75"
"2025-03-27","2025-03-22","SF FuneralF844581       250322","","126.5","","877339.25"
"2025-03-27","2025-03-22","SF FuneralF1078499      250322","","126.5","","877465.75"
"2025-03-27","2025-03-22","SF FuneralF1095225      250323","","126.5","","877592.25"
"2025-03-27","2025-03-22","SF FuneralF1108335      250322","","126.5","","877718.75"
"2025-03-27","2025-03-22","SF FuneralF1117050      250323","","126.5","","877845.25"
"2025-03-27","2025-03-22","SF FuneralF1117923      250322","","126.5","","877971.75"
"2025-03-27","2025-03-22","SF FuneralF1120215      250323","","126.5","","878098.25"
"2025-03-27","2025-03-22","SF FuneralF1130212      250323","","126.5","","878224.75"
"2025-03-27","2025-03-24","SF FuneralFDC000000066G8250324","","126.5","","878351.25"
"2025-03-27","2025-03-24","SF FuneralFDC000000069NW250324","","126.5","","878477.75"
"2025-03-27","2025-03-24","SF FuneralFDC00000006KV4250323","","126.5","","878604.25"
"2025-03-27","2025-03-24","SF FuneralFDC00000006MRT250324","","126.5","","878730.75"
"2025-03-27","2025-03-24","SF FuneralFDC00000006N84250323","","126.5","","878857.25"
"2025-03-27","2025-03-24","SF FuneralFDC00000006Z1H250323","","126.5","","878983.75"
"2025-03-27","2025-03-24","SF FuneralFDC00000006Z5F250324","","126.5","","879110.25"
"2025-03-27","2025-03-24","SF FuneralFDC00000007B9D250323","","126.5","","879236.75"
"2025-03-27","2025-03-24","SF FuneralFDC00000007DM5250324","","126.5","","879363.25"
"2025-03-27","2025-03-24","SF FuneralFDC00000007MBZ250324","","126.5","","879489.75"
"2025-03-27","2025-03-24","SF FuneralF794288       250324","","126.5","","879616.25"
"2025-03-27","2025-03-24","SF FuneralFDC000000082NL250323","","126.5","","879742.75"
"2025-03-27","2025-03-24","SF FuneralF809717       250324","","63.25","","879806"
"2025-03-27","2025-03-24","SF FuneralF814386       250324","","126.5","","879932.5"
"2025-03-27","2025-03-24","SF FuneralF815872       250324","","126.5","","880059"
"2025-03-27","2025-03-24","SF FuneralF820801       250324","","126.5","","880185.5"
"2025-03-27","2025-03-24","SF FuneralF822342       250324","","126.5","","880312"
"2025-03-27","2025-03-24","SF FuneralF841696       250323","","126.5","","880438.5"
"2025-03-27","2025-03-24","SF FuneralF842646       250323","","126.5","","880565"
"2025-03-27","2025-03-24","SF FuneralFDC0000000J1YG250324","","126.5","","880691.5"
"2025-03-27","2025-03-24","SF FuneralF1055233      250324","","126.5","","880818"
"2025-03-27","2025-03-24","SF FuneralF1108732      250324","","126.5","","880944.5"
"2025-03-27","2025-03-24","SF FuneralF1112428      250324","","126.5","","881071"
"2025-03-27","2025-03-24","SF FuneralF1131887      250324","","126.5","","881197.5"
"2025-03-27","2025-03-24","SF FuneralF1134989      250324","","126.5","","881324"
"2025-03-27","2025-03-25","SF FuneralF779331       250325","","220","","881544"
"2025-03-27","2025-03-25","SF FuneralF782215       250325","","191.5","","881735.5"
"2025-03-27","2025-03-25","SF FuneralF1115976      250325","","126.5","","881862"
"2025-03-27","2025-03-25","SF FuneralF1129546      250325","","126.5","","881988.5"
"2025-03-27","2025-03-25","SF FuneralF1131847      250325","","126.5","","882115"
"2025-03-27","2025-03-25","SF FuneralFDC0000000QLH3250325","","63.25","","882178.25"
"2025-03-27","2025-03-26","SF FuneralFDC0000000LFLZ250326","","126.5","","882304.75"
"2025-03-27","2025-03-22","SF FuneralF815510       250321","","31.63","","882336.38"
"2025-03-27","2025-03-22","SF FuneralF1122295      250323","","31.63","","882368.01"
"2025-03-27","2025-03-24","SF FuneralFDC00000005LQV250324","","31.63","","882399.64"
"2025-03-27","2025-03-24","SF FuneralFDC00000005LS9250324","","31.63","","882431.27"
"2025-03-27","2025-03-24","SF FuneralFDC00000006RQ8250323","","31.63","","882462.9"
"2025-03-27","2025-03-24","SF FuneralF820769       250324","","31.63","","882494.53"
"2025-03-27","2025-03-24","SF FuneralF832990       250323","","31.63","","882526.16"
"2025-03-27","2025-03-25","SF FuneralFDC00000008YCZ250325","","31.63","","882557.79"
"2025-03-27","2025-03-25","SF FuneralF1123030      250325","","31.63","","882589.42"
"2025-03-27","2025-03-26","SF FuneralF1124138      250326","","31.63","","882621.05"
"2025-03-27","2025-03-17","SF FuneralFDC00000006GCJ250317","","126.5","","882747.55"
"2025-03-27","2025-03-20","SF FuneralF1118467      250320","","126.5","","882874.05"
"2025-03-27","2025-03-22","SF FuneralF805398       250322","","126.5","","883000.55"
"2025-03-27","2025-03-22","SF FuneralF815120       250322","","126.5","","883127.05"
"2025-03-27","2025-03-22","SF FuneralF831131       250322","","126.5","","883253.55"
"2025-03-27","2025-03-22","SF FuneralF838890       250322","","126.5","","883380.05"
"2025-03-27","2025-03-22","SF FuneralF1021782      250322","","126.5","","883506.55"
"2025-03-27","2025-03-22","SF FuneralF1083602      250323","","126.5","","883633.05"
"2025-03-27","2025-03-22","SF FuneralF1085055      250323","","126.5","","883759.55"
"2025-03-27","2025-03-24","SF FuneralFDC000000072K8250324","","63.25","","883822.8"
"2025-03-27","2025-03-24","SF FuneralFDC00000009XDL250324","","126.5","","883949.3"
"2025-03-27","2025-03-24","SF FuneralF823428       250324","","126.5","","884075.8"
"2025-03-27","2025-03-24","SF FuneralF847242       250324","","126.5","","884202.3"
"2025-03-27","2025-03-24","SF FuneralF988585       250324","","126.5","","884328.8"
"2025-03-27","2025-03-24","SF FuneralFDC0000000N7M9250324","","126.5","","884455.3"
"2025-03-27","2025-03-24","SF FuneralF1119767      250324","","126.5","","884581.8"
"2025-03-27","2025-03-24","SF FuneralFDC0000000PGQS250324","","126.5","","884708.3"
"2025-03-27","2025-03-24","SF FuneralFDC0000000PRG4250324","","126.5","","884834.8"
"2025-03-27","2025-03-24","SF FuneralFDC0000000PRG8250324","","126.5","","884961.3"
"2025-03-27","2025-03-24","SF FuneralF1133349      250324","","126.5","","885087.8"
"2025-03-27","2025-03-25","SF FuneralFDC00000005MTH250325","","220","","885307.8"
"2025-03-27","2025-03-25","SF FuneralFDC00000006ZY7250325","","126.5","","885434.3"
"2025-03-27","2025-03-25","SF FuneralF1112148      250325","","126.5","","885560.8"
"2025-03-27","2025-03-25","SF FuneralF1112340      250325","","126.5","","885687.3"
"2025-03-27","2025-03-25","SF FuneralFDC0000000NPVZ250325","","126.5","","885813.8"
"2025-03-27","2025-03-25","SF FuneralF1131627      250325","","126.5","","885940.3"
"2025-03-27","2025-03-26","SF FuneralFDC000000071CH250326","","126.5","","886066.8"
"2025-03-27","2025-03-26","SF FuneralF1128665      250326","","126.5","","886193.3"
"2025-03-27","2025-03-22","SF FuneralF1074576      250323","","31.63","","886224.93"
"2025-03-27","2025-03-22","SF FuneralF1079004      250323","","31.63","","886256.56"
"2025-03-27","2025-03-24","SF FuneralFDC0000000K09V250324","","31.63","","886288.19"
"2025-03-27","2025-03-24","SF FuneralF1079351      250324","","31.63","","886319.82"
"2025-03-27","2025-03-25","SF FuneralF1079331      250325","","31.63","","886351.45"
"2025-03-27","2025-03-22","SF FuneralFDC0000000JVCB250323","","31.63","","886383.08"
"2025-03-27","2025-03-22","SF FuneralF1054743      250323","","31.63","","886414.71"
"2025-03-27","2025-03-22","SF FuneralFDC0000000PZBG250323","","31.63","","886446.34"
"2025-03-27","2025-03-24","SF FuneralF834650       250323","","31.63","","886477.97"
"2025-03-27","2025-03-25","SF FuneralF1135546      250325","","31.63","","886509.6"
"2025-03-27","2025-03-22","SF FuneralF1117700      250323","","126.5","","886636.1"
"2025-03-27","2025-03-22","SF FuneralF1133723      250323","","126.5","","886762.6"
"2025-03-27","2025-03-25","SF FuneralFDC000000063TD250325","","126.5","","886889.1"
"2025-03-27","2025-03-25","SF FuneralFDC00000006G7M250325","","126.5","","887015.6"
"2025-03-27","2025-03-25","SF FuneralF1124825      250325","","126.5","","887142.1"
"2025-03-27","2025-03-25","SF FuneralF1129921      250325","","126.5","","887268.6"
"2025-03-27","2025-03-22","SF FuneralFDC0000000BRLV250322","","126.5","","887395.1"
"2025-03-27","2025-03-22","SF FuneralFDC0000000P47W250323","","126.5","","887521.6"
"2025-03-27","2025-03-22","SF FuneralF1123294      250323","","126.5","","887648.1"
"2025-03-27","2025-03-22","SF FuneralF1131591      250322","","126.5","","887774.6"
"2025-03-27","2025-03-26","SF FuneralF827626       250326","","126.5","","887901.1"
"2025-03-27","2025-03-22","SF FuneralFDC0000000LNR4250323","","31.63","","887932.73"
"2025-03-27","2025-03-22","SF FuneralF1120593      250323","","31.63","","887964.36"
"2025-03-27","2025-03-24","SF FuneralF814448       250323","","31.63","","887995.99"
"2025-03-27","2025-03-24","SF FuneralF820012       250324","","31.63","","888027.62"
"2025-03-27","2025-03-25","SF FuneralF816581       250325","","31.63","","888059.25"
"2025-03-27","2025-03-25","SF FuneralF1110079      250325","","31.63","","888090.88"
"2025-03-27","2025-03-20","SF FuneralFDC000000064MN250320","","126.5","","888217.38"
"2025-03-27","2025-03-20","SF FuneralF1110423      250321","","126.5","","888343.88"
"2025-03-27","2025-03-22","SF FuneralFDC00000003F7Y250322","","220","","888563.88"
"2025-03-27","2025-03-22","SF FuneralFDC00000005MT5250322","","220","","888783.88"
"2025-03-27","2025-03-22","SF FuneralFDC000000081HV250322","","126.5","","888910.38"
"2025-03-27","2025-03-22","SF FuneralF820957       250322","","126.5","","889036.88"
"2025-03-27","2025-03-22","SF FuneralF823489       250322","","126.5","","889163.38"
"2025-03-27","2025-03-22","SF FuneralFDC0000000DZGP250322","","126.5","","889289.88"
"2025-03-27","2025-03-22","SF FuneralFDC0000000DZGT250322","","126.5","","889416.38"
"2025-03-27","2025-03-22","SF FuneralF993092       250323","","126.5","","889542.88"
"2025-03-27","2025-03-22","SF FuneralF1054621      250322","","126.5","","889669.38"
"2025-03-27","2025-03-22","SF FuneralF1055288      250323","","126.5","","889795.88"
"2025-03-27","2025-03-22","SF FuneralF1061662      250322","","126.5","","889922.38"
"2025-03-27","2025-03-22","SF FuneralF1073142      250322","","126.5","","890048.88"
"2025-03-27","2025-03-22","SF FuneralFDC0000000L1SQ250322","","126.5","","890175.38"
"2025-03-27","2025-03-22","SF FuneralF1108312      250323","","126.5","","890301.88"
"2025-03-27","2025-03-22","SF FuneralF787835       250323","","126.5","","890428.38"
"2025-03-27","2025-03-22","SF FuneralF1115841      250323","","126.5","","890554.88"
"2025-03-27","2025-03-22","SF FuneralF1116712      250323","","126.5","","890681.38"
"2025-03-27","2025-03-22","SF FuneralF1117166      250322","","126.5","","890807.88"
"2025-03-27","2025-03-22","SF FuneralFDC0000000QF4V250323","","126.5","","890934.38"
"2025-03-27","2025-03-22","SF FuneralFDC0000000QF4W250323","","126.5","","891060.88"
"2025-03-27","2025-03-24","SF FuneralFDC000000080YP250323","","63.25","","891124.13"
"2025-03-27","2025-03-24","SF FuneralF805647       250323","","126.5","","891250.63"
"2025-03-27","2025-03-24","SF FuneralF805875       250323","","63.25","","891313.88"
"2025-03-27","2025-03-24","SF FuneralF805981       250324","","126.5","","891440.38"
"2025-03-27","2025-03-24","SF FuneralF820713       250324","","126.5","","891566.88"
"2025-03-27","2025-03-24","SF FuneralF840573       250323","","126.5","","891693.38"
"2025-03-27","2025-03-24","SF FuneralF1021258      250324","","126.5","","891819.88"
"2025-03-27","2025-03-24","SF FuneralFDC0000000JXV3250324","","126.5","","891946.38"
"2025-03-27","2025-03-24","SF FuneralF1132233      250324","","126.5","","892072.88"
"2025-03-27","2025-03-24","SF FuneralF1133463      250324","","126.5","","892199.38"
"2025-03-27","2025-03-25","SF FuneralFDC00000005ZDF250325","","126.5","","892325.88"
"2025-03-27","2025-03-25","SF FuneralF807966       250325","","126.5","","892452.38"
"2025-03-27","2025-03-25","SF FuneralF900916       250325","","126.5","","892578.88"
"2025-03-27","2025-03-25","SF FuneralF1108307      250325","","126.5","","892705.38"
"2025-03-27","2025-03-22","SF FuneralFDC0000000NXGF250322","","126.5","","892831.88"
"2025-03-27","2025-03-24","SF FuneralF1118033      250324","","31.63","","892863.51"
"2025-03-27","2025-03-25","SF FuneralFDC000000062H1250325","","126.5","","892990.01"
"2025-03-27","2025-03-26","SF FuneralFDC000000071CQ250326","","126.5","","893116.51"
"2025-03-27","2025-03-20","SF FuneralF1127968      250321","","126.5","","893243.01"
"2025-03-27","2025-03-24","SF FuneralFDC00000004CSK250324","","55","","893298.01"
"2025-03-27","2025-03-24","SF FuneralFDC00000004CSL250324","","55","","893353.01"
"2025-03-27","2025-03-24","SF FuneralFDC00000005LWP250323","","31.63","","893384.64"
"2025-03-27","2025-03-24","SF FuneralFDC00000007KKQ250324","","126.5","","893511.14"
"2025-03-27","2025-03-24","SF FuneralFDC00000007LPH250324","","191.5","","893702.64"
"2025-03-27","2025-03-24","SF FuneralF811743       250324","","126.5","","893829.14"
"2025-03-27","2025-03-24","SF FuneralF812202       250324","","31.63","","893860.77"
"2025-03-27","2025-03-24","SF FuneralFDC0000000CWBD250323","","31.63","","893892.4"
"2025-03-27","2025-03-24","SF FuneralF1060362      250324","","191.5","","894083.9"
"2025-03-27","2025-03-24","SF FuneralF1080229      250324","","126.5","","894210.4"
"2025-03-27","2025-03-24","SF FuneralF1120232      250324","","126.5","","894336.9"
"2025-03-27","2025-03-24","SF FuneralFDC0000000P12Y250324","","126.5","","894463.4"
"2025-03-27","2025-03-24","SF FuneralFDC0000000PJD9250324","","126.5","","894589.9"
"2025-03-27","2025-03-24","SF FuneralF1127889      250324","","126.5","","894716.4"
"2025-03-27","2025-03-24","SF FuneralF1131257      250324","","126.5","","894842.9"
"2025-03-27","2025-03-24","SF FuneralF1132491      250324","","126.5","","894969.4"
"2025-03-27","2025-03-25","SF FuneralFDC00000006V35250325","","126.5","","895095.9"
"2025-03-27","2025-03-25","SF FuneralFDC0000000873R250325","","126.5","","895222.4"
"2025-03-27","2025-03-25","SF FuneralF803854       250325","","63.25","","895285.65"
"2025-03-27","2025-03-25","SF FuneralF1085053      250325","","63.25","","895348.9"
"2025-03-27","2025-03-22","SF FuneralFDC0000000632S250322","","126.5","","895475.4"
"2025-03-27","2025-03-22","SF FuneralFDC00000007DGP250322","","126.5","","895601.9"
"2025-03-27","2025-03-22","SF FuneralFDC0000000888H250321","","126.5","","895728.4"
"2025-03-27","2025-03-22","SF FuneralFDC0000000888L250321","","126.5","","895854.9"
"2025-03-27","2025-03-22","SF FuneralF829997       250322","","126.5","","895981.4"
"2025-03-27","2025-03-22","SF FuneralF991808       250323","","126.5","","896107.9"
"2025-03-27","2025-03-22","SF FuneralF1061682      250322","","126.5","","896234.4"
"2025-03-27","2025-03-22","SF FuneralFDC0000000NSKT250323","","126.5","","896360.9"
"2025-03-27","2025-03-22","SF FuneralF1125279      250322","","126.5","","896487.4"
"2025-03-27","2025-03-24","SF FuneralFDC00000004V81250323","","220","","896707.4"
"2025-03-27","2025-03-24","SF FuneralFDC00000006HD2250323","","126.5","","896833.9"
"2025-03-27","2025-03-24","SF FuneralFDC000000074J4250324","","126.5","","896960.4"
"2025-03-27","2025-03-24","SF FuneralFDC00000007N87250324","","126.5","","897086.9"
"2025-03-27","2025-03-24","SF FuneralF843408       250322","","126.5","","897213.4"
"2025-03-27","2025-03-24","SF FuneralF990272       250324","","126.5","","897339.9"
"2025-03-27","2025-03-24","SF FuneralF1084644      250324","","126.5","","897466.4"
"2025-03-27","2025-03-24","SF FuneralF1103842      250324","","126.5","","897592.9"
"2025-03-27","2025-03-24","SF FuneralF1120655      250324","","31.63","","897624.53"
"2025-03-27","2025-03-24","SF FuneralF1124840      250324","","126.5","","897751.03"
"2025-03-27","2025-03-24","SF FuneralFDC0000000QL8N250324","","126.5","","897877.53"
"2025-03-27","2025-03-24","SF FuneralFDC0000000QL8T250324","","126.5","","898004.03"
"2025-03-27","2025-03-26","SF FuneralF823667       250326","","126.5","","898130.53"
"2025-03-27","2025-03-26","SF FuneralF828407       250326","","126.5","","898257.03"
"2025-03-27","2025-03-26","SF FuneralF1074661      250326","","126.5","","898383.53"
"2025-03-27","2025-03-22","SF FuneralF1021491      250323","","31.63","","898415.16"
"2025-03-27","2025-03-22","SF FuneralF1054627      250322","","126.5","","898541.66"
"2025-03-27","2025-03-23","SF FuneralF827721       250323","","126.5","","898668.16"
"2025-03-27","2025-03-17","SF FuneralFDC00000006YHX250316","","126.5","","898794.66"
"2025-03-27","2025-03-22","SF FuneralF800019       250322","","126.5","","898921.16"
"2025-03-27","2025-03-22","SF FuneralF1060910      250322","","126.5","","899047.66"
"2025-03-27","2025-03-22","SF FuneralF1112354      250323","","126.5","","899174.16"
"2025-03-27","2025-03-22","SF FuneralF1118795      250322","","126.5","","899300.66"
"2025-03-27","2025-03-24","SF FuneralFDC00000005P7P250324","","126.5","","899427.16"
"2025-03-27","2025-03-24","SF FuneralFDC00000005YV6250324","","63.25","","899490.41"
"2025-03-27","2025-03-24","SF FuneralFDC00000007KWX250324","","126.5","","899616.91"
"2025-03-27","2025-03-24","SF FuneralFDC00000007Z60250324","","126.5","","899743.41"
"2025-03-27","2025-03-24","SF FuneralFDC00000007Z6B250324","","126.5","","899869.91"
"2025-03-27","2025-03-24","SF FuneralFDC00000008JB6250324","","126.5","","899996.41"
"2025-03-27","2025-03-24","SF FuneralF806042       250324","","126.5","","900122.91"
"2025-03-27","2025-03-24","SF FuneralF819802       250324","","31.63","","900154.54"
"2025-03-27","2025-03-24","SF FuneralF830161       250324","","126.5","","900281.04"
"2025-03-27","2025-03-24","SF FuneralF834104       250324","","126.5","","900407.54"
"2025-03-27","2025-03-24","SF FuneralFDC0000000DVCF250324","","126.5","","900534.04"
"2025-03-27","2025-03-24","SF FuneralF988378       250324","","126.5","","900660.54"
"2025-03-27","2025-03-24","SF FuneralF841738       250324","","191.5","","900852.04"
"2025-03-27","2025-03-24","SF FuneralF1051762      250324","","126.5","","900978.54"
"2025-03-27","2025-03-24","SF FuneralF1074859      250324","","126.5","","901105.04"
"2025-03-27","2025-03-24","SF FuneralF1083939      250324","","126.5","","901231.54"
"2025-03-27","2025-03-24","SF FuneralF1103514      250324","","126.5","","901358.04"
"2025-03-27","2025-03-24","SF FuneralF1130526      250324","","126.5","","901484.54"
"2025-03-27","2025-03-24","SF FuneralF1130847      250324","","31.63","","901516.17"
"2025-03-27","2025-03-24","SF FuneralF1134072      250324","","31.63","","901547.8"
"2025-03-27","2025-03-24","SF FuneralF1134316      250324","","126.5","","901674.3"
"2025-03-27","2025-03-25","SF FuneralFDC00000006YL8250325","","126.5","","901800.8"
"2025-03-27","2025-03-25","SF FuneralF810426       250325","","31.63","","901832.43"
"2025-03-27","2025-03-25","SF FuneralF813503       250325","","31.63","","901864.06"
"2025-03-27","2025-03-27","SF FuneralFDC00000006BNS250327","","126.5","","901990.56"
"2025-03-27","2025-03-27","SF FuneralFDC00000008LDC250327","","126.5","","902117.06"
"2025-03-27","2025-03-27","SF FuneralF813959       250327","","126.5","","902243.56"
"2025-03-27","2025-03-27","SF FuneralF827821       250327","","126.5","","902370.06"
"2025-03-27","2025-03-27","SF FuneralF833243       250327","","126.5","","902496.56"
"2025-03-27","2025-03-27","SF FuneralF840895       250327","","126.5","","902623.06"
"2025-03-27","2025-03-27","SF FuneralF843243       250327","","126.5","","902749.56"
"2025-03-27","2025-03-27","SF FuneralF901489       250327","","126.5","","902876.06"
"2025-03-27","2025-03-27","SF FuneralF1073559      250327","","126.5","","903002.56"
"2025-03-27","2025-03-27","SF FuneralFDC0000000PCP4250327","","126.5","","903129.06"
"2025-03-27","2025-03-20","SF FuneralF990247       250321","","126.5","","903255.56"
"2025-03-27","2025-03-25","SF FuneralF1079171      250325","","126.5","","903382.06"
"2025-03-27","2025-03-25","SF FuneralF1127329      250325","","126.5","","903508.56"
"2025-03-27","2025-03-25","SF FuneralF1134877      250325","","126.5","","903635.06"
"2025-03-27","2025-03-25","SF FuneralF1135514      250325","","126.5","","903761.56"
"2025-03-27","2025-03-26","SF FuneralF1108332      250326","","126.5","","903888.06"
"2025-03-27","2025-03-27","SF FuneralFDC00000006J73250327","","126.5","","904014.56"
"2025-03-27","2025-03-27","SF FuneralFDC00000007QTL250327","","126.5","","904141.06"
"2025-03-27","2025-03-27","SF FuneralF818050       250327","","126.5","","904267.56"
"2025-03-27","2025-03-27","SF FuneralF827832       250327","","126.5","","904394.06"
"2025-03-27","2025-03-27","SF FuneralFDC0000000KPHL250327","","126.5","","904520.56"
"2025-03-27","2025-03-27","SF FuneralF1079635      250327","","126.5","","904647.06"
"2025-03-27","2025-03-27","SF FuneralF1102935      250327","","126.5","","904773.56"
"2025-03-27","2025-03-27","SF FuneralFDC0000000N823250327","","126.5","","904900.06"
"2025-03-27","2025-03-27","SF FuneralF1122713      250327","","126.5","","905026.56"
"2025-03-27","2025-03-27","SF FuneralF1134967      250327","","126.5","","905153.06"
"2025-03-27","2025-03-27","SF FuneralFDC000000069YV250327","","126.5","","905279.56"
"2025-03-27","2025-03-27","SF FuneralFDC00000008H5N250327","","126.5","","905406.06"
"2025-03-27","2025-03-27","SF FuneralF812337       250327","","126.5","","905532.56"
"2025-03-27","2025-03-27","SF FuneralFDC00000009DS8250327","","126.5","","905659.06"
"2025-03-27","2025-03-27","SF FuneralF832796       250327","","126.5","","905785.56"
"2025-03-27","2025-03-27","SF FuneralF1108246      250327","","126.5","","905912.06"
"2025-03-27","2025-03-27","SF FuneralF1110630      250327","","126.5","","906038.56"
"2025-03-27","2025-03-22","SF FuneralFDC000000032VH250321","","55","","906093.56"
"2025-03-27","2025-03-22","SF FuneralFDC00000005RS3250321","","31.63","","906125.19"
"2025-03-27","2025-03-22","SF FuneralFDC00000007VKH250322","","31.63","","906156.82"
"2025-03-27","2025-03-22","SF FuneralF812905       250321","","31.63","","906188.45"
"2025-03-27","2025-03-22","SF FuneralF818785       250321","","31.63","","906220.08"
"2025-03-27","2025-03-22","SF FuneralF822852       250322","","31.63","","906251.71"
"2025-03-27","2025-03-22","SF FuneralF1083744      250323","","126.5","","906378.21"
"2025-03-27","2025-03-24","SF FuneralFDC00000005N4P250324","","31.63","","906409.84"
"2025-03-27","2025-03-24","SF FuneralFDC000000067C7250324","","31.63","","906441.47"
"2025-03-27","2025-03-24","SF FuneralFDC00000008MY8250323","","31.63","","906473.1"
"2025-03-27","2025-03-24","SF FuneralFDC00000009958250324","","31.63","","906504.73"
"2025-03-27","2025-03-24","SF FuneralF811324       250324","","112.88","","906617.61"
"2025-03-27","2025-03-24","SF FuneralF818028       250324","","31.63","","906649.24"
"2025-03-27","2025-03-24","SF FuneralF843246       250321","","31.63","","906680.87"
"2025-03-27","2025-03-24","SF FuneralF1068000      250324","","31.63","","906712.5"
"2025-03-27","2025-03-24","SF FuneralF1130901      250324","","31.63","","906744.13"
"2025-03-27","2025-03-25","SF FuneralFDC00000008C95250325","","31.63","","906775.76"
"2025-03-27","2025-03-25","SF FuneralF809823       250325","","31.63","","906807.39"
"2025-03-27","2025-03-25","SF FuneralF823596       250325","","31.63","","906839.02"
"2025-03-27","2025-03-25","SF FuneralF828129       250325","","31.63","","906870.65"
"2025-03-27","2025-03-25","SF FuneralF799620       250325","","64.13","","906934.78"
"2025-03-27","2025-03-25","SF FuneralF1020683      250325","","31.63","","906966.41"
"2025-03-27","2025-03-27","SF FuneralFDC00000005N6M250327","","31.63","","906998.04"
"2025-03-27","2025-03-27","SF FuneralFDC00000005P8B250327","","31.63","","907029.67"
"2025-03-27","2025-03-27","SF FuneralFDC00000006Q3V250327","","31.63","","907061.3"
"2025-03-27","2025-03-27","SF FuneralFDC00000006ZNM250327","","31.63","","907092.93"
"2025-03-27","2025-03-27","SF FuneralF829020       250327","","31.63","","907124.56"
"2025-03-27","2025-03-27","SF FuneralF1085168      250327","","31.63","","907156.19"
"2025-03-27","2025-03-18","SF FuneralF829119       250318","","63.25","","907219.44"
"2025-03-27","2025-03-19","SF FuneralFDC0000000622N250319","","126.5","","907345.94"
"2025-03-27","2025-03-19","SF FuneralF844791       250319","","126.5","","907472.44"
"2025-03-27","2025-03-20","SF FuneralF790319       250320","","126.5","","907598.94"
"2025-03-27","2025-03-20","SF FuneralF991082       250322","","126.5","","907725.44"
"2025-03-27","2025-03-20","SF FuneralF1108392      250321","","126.5","","907851.94"
"2025-03-27","2025-03-22","SF FuneralFDC000000038N6250322","","220","","908071.94"
"2025-03-27","2025-03-22","SF FuneralFDC000000054MP250321","","126.5","","908198.44"
"2025-03-27","2025-03-22","SF FuneralFDC00000005N5S250321","","31.63","","908230.07"
"2025-03-27","2025-03-22","SF FuneralFDC0000000688W250322","","126.5","","908356.57"
"2025-03-27","2025-03-22","SF FuneralFDC00000007B19250322","","126.5","","908483.07"
"2025-03-27","2025-03-22","SF FuneralFDC00000007KBW250322","","126.5","","908609.57"
"2025-03-27","2025-03-22","SF FuneralFDC00000007TWL250322","","126.5","","908736.07"
"2025-03-27","2025-03-22","SF FuneralFDC00000008Z24250321","","126.5","","908862.57"
"2025-03-27","2025-03-22","SF FuneralF813583       250322","","126.5","","908989.07"
"2025-03-27","2025-03-22","SF FuneralF815008       250322","","126.5","","909115.57"
"2025-03-27","2025-03-22","SF FuneralF815500       250322","","126.5","","909242.07"
"2025-03-27","2025-03-22","SF FuneralF820884       250322","","126.5","","909368.57"
"2025-03-27","2025-03-22","SF FuneralF823944       250322","","126.5","","909495.07"
"2025-03-27","2025-03-22","SF FuneralF828655       250322","","126.5","","909621.57"
"2025-03-27","2025-03-22","SF FuneralF991596       250323","","126.5","","909748.07"
"2025-03-27","2025-03-22","SF FuneralF991688       250322","","126.5","","909874.57"
"2025-03-27","2025-03-22","SF FuneralFDC0000000J62Q250322","","126.5","","910001.07"
"2025-03-27","2025-03-22","SF FuneralF991896       250322","","126.5","","910127.57"
"2025-03-27","2025-03-22","SF FuneralF992669       250323","","126.5","","910254.07"
"2025-03-27","2025-03-22","SF FuneralF993775       250322","","126.5","","910380.57"
"2025-03-27","2025-03-22","SF FuneralF1055198      250322","","126.5","","910507.07"
"2025-03-27","2025-03-22","SF FuneralF1068055      250322","","126.5","","910633.57"
"2025-03-27","2025-03-22","SF FuneralF1083661      250322","","126.5","","910760.07"
"2025-03-27","2025-03-22","SF FuneralF1083664      250322","","126.5","","910886.57"
"2025-03-27","2025-03-22","SF FuneralF1083835      250323","","126.5","","911013.07"
"2025-03-27","2025-03-22","SF FuneralF1085147      250322","","126.5","","911139.57"
"2025-03-27","2025-03-22","SF FuneralF1085475      250322","","126.5","","911266.07"
"2025-03-27","2025-03-22","SF FuneralF1102905      250323","","126.5","","911392.57"
"2025-03-27","2025-03-22","SF FuneralF1108642      250322","","126.5","","911519.07"
"2025-03-27","2025-03-22","SF FuneralF1108790      250322","","126.5","","911645.57"
"2025-03-27","2025-03-22","SF FuneralF1114014      250322","","126.5","","911772.07"
"2025-03-27","2025-03-22","SF FuneralFDC0000000NB79250323","","126.5","","911898.57"
"2025-03-27","2025-03-22","SF FuneralFDC0000000NJ3J250322","","126.5","","912025.07"
"2025-03-27","2025-03-22","SF FuneralF1120434      250322","","126.5","","912151.57"
"2025-03-27","2025-03-22","SF FuneralF1120548      250322","","126.5","","912278.07"
"2025-03-27","2025-03-22","SF FuneralF1120686      250322","","126.5","","912404.57"
"2025-03-27","2025-03-22","SF FuneralF1121770      250322","","126.5","","912531.07"
"2025-03-27","2025-03-22","SF FuneralFDC0000000PJV9250322","","126.5","","912657.57"
"2025-03-27","2025-03-20","SF FuneralFDC0000000H9QJ250322","","126.5","","912784.07"
"2025-03-27","2025-03-20","SF FuneralF989577       250322","","126.5","","912910.57"
"2025-03-27","2025-03-24","SF FuneralFDC000000075T7250324","","126.5","","913037.07"
"2025-03-27","2025-03-24","SF FuneralFDC000000077HX250324","","126.5","","913163.57"
"2025-03-27","2025-03-24","SF FuneralFDC000000079BT250324","","126.5","","913290.07"
"2025-03-27","2025-03-24","SF FuneralF821252       250323","","126.5","","913416.57"
"2025-03-27","2025-03-24","SF FuneralF821685       250324","","126.5","","913543.07"
"2025-03-27","2025-03-24","SF FuneralF822058       250323","","126.5","","913669.57"
"2025-03-27","2025-03-24","SF FuneralF831376       250323","","126.5","","913796.07"
"2025-03-27","2025-03-24","SF FuneralF834154       250324","","126.5","","913922.57"
"2025-03-27","2025-03-24","SF FuneralFDC0000000J22Z250324","","126.5","","914049.07"
"2025-03-27","2025-03-24","SF FuneralF991539       250324","","126.5","","914175.57"
"2025-03-27","2025-03-24","SF FuneralFDC0000000JNDN250324","","126.5","","914302.07"
"2025-03-27","2025-03-24","SF FuneralF1060529      250324","","126.5","","914428.57"
"2025-03-27","2025-03-24","SF FuneralF1074695      250324","","126.5","","914555.07"
"2025-03-27","2025-03-24","SF FuneralF1078055      250324","","126.5","","914681.57"
"2025-03-27","2025-03-24","SF FuneralF1115046      250324","","126.5","","914808.07"
"2025-03-27","2025-03-24","SF FuneralF1118830      250324","","126.5","","914934.57"
"2025-03-27","2025-03-24","SF FuneralF1119905      250324","","126.5","","915061.07"
"2025-03-27","2025-03-24","SF FuneralF1120145      250324","","126.5","","915187.57"
"2025-03-27","2025-03-24","SF FuneralF1120189      250324","","126.5","","915314.07"
"2025-03-27","2025-03-24","SF FuneralF1127593      250324","","63.25","","915377.32"
"2025-03-27","2025-03-24","SF FuneralF1127730      250324","","126.5","","915503.82"
"2025-03-27","2025-03-24","SF FuneralF1127890      250324","","126.5","","915630.32"
"2025-03-27","2025-03-24","SF FuneralF1133493      250324","","126.5","","915756.82"
"2025-03-27","2025-03-25","SF FuneralFDC000000030F5250325","","220","","915976.82"
"2025-03-27","2025-03-25","SF FuneralFDC00000007V8S250325","","126.5","","916103.32"
"2025-03-27","2025-03-25","SF FuneralFDC0000000800S250325","","126.5","","916229.82"
"2025-03-27","2025-03-25","SF FuneralF815728       250325","","126.5","","916356.32"
"2025-03-27","2025-03-25","SF FuneralF827841       250325","","126.5","","916482.82"
"2025-03-27","2025-03-25","SF FuneralF831654       250325","","63.25","","916546.07"
"2025-03-27","2025-03-25","SF FuneralF841041       250325","","126.5","","916672.57"
"2025-03-27","2025-03-25","SF FuneralFDC0000000L5Z4250325","","63.25","","916735.82"
"2025-03-27","2025-03-25","SF FuneralF1116033      250325","","126.5","","916862.32"
"2025-03-27","2025-03-25","SF FuneralF1122731      250325","","126.5","","916988.82"
"2025-03-27","2025-03-25","SF FuneralF1127242      250325","","126.5","","917115.32"
"2025-03-27","2025-03-25","SF FuneralF1132280      250325","","126.5","","917241.82"
"2025-03-27","2025-03-25","SF FuneralF1134431      250325","","63.25","","917305.07"
"2025-03-27","2025-03-24","SF FuneralFDC000000030HX250324","","220","","917525.07"
"2025-03-27","2025-03-24","SF FuneralFDC00000005D9R250324","","126.5","","917651.57"
"2025-03-27","2025-03-24","SF FuneralFDC00000005P9W250324","","126.5","","917778.07"
"2025-03-27","2025-03-24","SF FuneralFDC0000000600R250324","","126.5","","917904.57"
"2025-03-27","2025-03-24","SF FuneralFDC0000000614B250324","","126.5","","918031.07"
"2025-03-27","2025-03-24","SF FuneralFDC0000000615C250324","","126.5","","918157.57"
"2025-03-27","2025-03-24","SF FuneralFDC00000006CNL250324","","126.5","","918284.07"
"2025-03-27","2025-03-24","SF FuneralFDC00000006L4X250324","","126.5","","918410.57"
"2025-03-27","2025-03-24","SF FuneralFDC00000006LCM250324","","126.5","","918537.07"
"2025-03-27","2025-03-24","SF FuneralFDC00000006R21250324","","126.5","","918663.57"
"2025-03-27","2025-03-24","SF FuneralFDC00000006RPR250324","","126.5","","918790.07"
"2025-03-27","2025-03-24","SF FuneralFDC00000006V8P250323","","126.5","","918916.57"
"2025-03-27","2025-03-24","SF FuneralFDC00000006VZC250324","","126.5","","919043.07"
"2025-03-27","2025-03-24","SF FuneralFDC00000006ZR8250323","","126.5","","919169.57"
"2025-03-27","2025-03-24","SF FuneralFDC00000006ZR9250323","","126.5","","919296.07"
"2025-03-27","2025-03-24","SF FuneralFDC000000074VZ250324","","126.5","","919422.57"
"2025-03-27","2025-03-24","SF FuneralFDC000000077PZ250323","","126.5","","919549.07"
"2025-03-27","2025-03-24","SF FuneralFDC00000007F0W250324","","126.5","","919675.57"
"2025-03-27","2025-03-24","SF FuneralFDC0000000867B250324","","126.5","","919802.07"
"2025-03-27","2025-03-24","SF FuneralFDC0000000867C250324","","126.5","","919928.57"
"2025-03-27","2025-03-24","SF FuneralF799519       250324","","126.5","","920055.07"
"2025-03-27","2025-03-24","SF FuneralFDC00000008JPT250324","","126.5","","920181.57"
"2025-03-27","2025-03-24","SF FuneralF802560       250324","","126.5","","920308.07"
"2025-03-27","2025-03-24","SF FuneralF803220       250323","","126.5","","920434.57"
"2025-03-27","2025-03-24","SF FuneralF809517       250323","","126.5","","920561.07"
"2025-03-27","2025-03-24","SF FuneralF812016       250324","","126.5","","920687.57"
"2025-03-27","2025-03-24","SF FuneralF813394       250324","","126.5","","920814.07"
"2025-03-27","2025-03-24","SF FuneralFDC00000009XRR250324","","126.5","","920940.57"
"2025-03-27","2025-03-24","SF FuneralF818902       250323","","126.5","","921067.07"
"2025-03-27","2025-03-24","SF FuneralF822253       250324","","126.5","","921193.57"
"2025-03-27","2025-03-24","SF FuneralF823421       250324","","126.5","","921320.07"
"2025-03-27","2025-03-24","SF FuneralF988694       250324","","126.5","","921446.57"
"2025-03-27","2025-03-24","SF FuneralFDC0000000HYZ4250324","","126.5","","921573.07"
"2025-03-27","2025-03-24","SF FuneralFDC0000000JCQP250324","","126.5","","921699.57"
"2025-03-27","2025-03-24","SF FuneralF1017430      250324","","126.5","","921826.07"
"2025-03-27","2025-03-24","SF FuneralF1054706      250324","","126.5","","921952.57"
"2025-03-27","2025-03-24","SF FuneralF1054992      250324","","126.5","","922079.07"
"2025-03-27","2025-03-24","SF FuneralF1059865      250324","","126.5","","922205.57"
"2025-03-27","2025-03-24","SF FuneralF1074651      250324","","126.5","","922332.07"
"2025-03-27","2025-03-24","SF FuneralF1084272      250324","","126.5","","922458.57"
"2025-03-27","2025-03-24","SF FuneralF1084839      250324","","126.5","","922585.07"
"2025-03-27","2025-03-24","SF FuneralF1108310      250324","","126.5","","922711.57"
"2025-03-27","2025-03-24","SF FuneralF1108360      250324","","126.5","","922838.07"
"2025-03-27","2025-03-24","SF FuneralF1114700      250324","","126.5","","922964.57"
"2025-03-27","2025-03-24","SF FuneralF1116007      250324","","126.5","","923091.07"
"2025-03-27","2025-03-24","SF FuneralF1117016      250324","","126.5","","923217.57"
"2025-03-27","2025-03-24","SF FuneralF1117359      250324","","126.5","","923344.07"
"2025-03-27","2025-03-24","SF FuneralFDC0000000NK40250324","","126.5","","923470.57"
"2025-03-27","2025-03-24","SF FuneralFDC0000000NL2F250324","","126.5","","923597.07"
"2025-03-27","2025-03-24","SF FuneralF1120632      250324","","126.5","","923723.57"
"2025-03-27","2025-03-24","SF FuneralF1120920      250324","","126.5","","923850.07"
"2025-03-27","2025-03-24","SF FuneralF1122581      250324","","126.5","","923976.57"
"2025-03-27","2025-03-24","SF FuneralF1122812      250324","","126.5","","924103.07"
"2025-03-27","2025-03-24","SF FuneralF1128784      250324","","126.5","","924229.57"
"2025-03-27","2025-03-24","SF FuneralF1130849      250324","","126.5","","924356.07"
"2025-03-27","2025-03-24","SF FuneralF1130878      250324","","126.5","","924482.57"
"2025-03-27","2025-03-24","SF FuneralFDC0000000Q3Z2250324","","126.5","","924609.07"
"2025-03-27","2025-03-24","SF FuneralFDC0000000Q4WP250324","","126.5","","924735.57"
"2025-03-27","2025-03-24","SF FuneralF1132335      250324","","126.5","","924862.07"
"2025-03-27","2025-03-24","SF FuneralFDC0000000Q8VD250324","","126.5","","924988.57"
"2025-03-27","2025-03-24","SF FuneralF1133515      250324","","126.5","","925115.07"
"2025-03-27","2025-03-24","SF FuneralF1133534      250324","","126.5","","925241.57"
"2025-03-27","2025-03-24","SF FuneralF1133733      250324","","126.5","","925368.07"
"2025-03-27","2025-03-26","SF FuneralFDC00000006553250326","","126.5","","925494.57"
"2025-03-27","2025-03-26","SF FuneralF810355       250326","","126.5","","925621.07"
"2025-03-27","2025-03-26","SF FuneralF813581       250326","","63.25","","925684.32"
"2025-03-27","2025-03-26","SF FuneralF991184       250326","","126.5","","925810.82"
"2025-03-27","2025-03-26","SF FuneralFDC0000000JGRR250326","","126.5","","925937.32"
"2025-03-27","2025-03-26","SF FuneralF1021946      250326","","126.5","","926063.82"
"2025-03-27","2025-03-27","SF FuneralFDC0000000372T250327","","220","","926283.82"
"2025-03-27","2025-03-27","SF FuneralFDC00000004BWJ250327","","220","","926503.82"
"2025-03-27","2025-03-27","SF FuneralFDC00000004HL9250327","","220","","926723.82"
"2025-03-27","2025-03-27","SF FuneralF803853       250327","","126.5","","926850.32"
"2025-03-27","2025-03-27","SF FuneralF832675       250327","","126.5","","926976.82"
"2025-03-27","2025-03-27","SF FuneralF841764       250327","","126.5","","927103.32"
"2025-03-27","2025-03-27","SF FuneralF842390       250327","","126.5","","927229.82"
"2025-03-27","2025-03-27","SF FuneralF842867       250327","","126.5","","927356.32"
"2025-03-27","2025-03-27","SF FuneralF992543       250327","","126.5","","927482.82"
"2025-03-27","2025-03-27","SF FuneralF1110652      250327","","63.25","","927546.07"
"2025-03-27","2025-03-27","SF FuneralF1113292      250327","","126.5","","927672.57"
"2025-03-27","2025-03-27","SF FuneralF1116105      250327","","126.5","","927799.07"
"2025-03-27","2025-03-27","SF FuneralF1119698      250327","","126.5","","927925.57"
"2025-03-27","2025-03-27","SF FuneralF1122057      250327","","126.5","","928052.07"
"2025-03-27","2025-03-27","SF FuneralF1122275      250327","","126.5","","928178.57"
"2025-03-27","2025-03-27","SF FuneralF1126851      250327","","126.5","","928305.07"
"2025-03-27","2025-03-27","SF FuneralFDC00000005F5Y250327","","126.5","","928431.57"
"2025-03-27","2025-03-27","SF FuneralFDC00000005HGX250327","","126.5","","928558.07"
"2025-03-27","2025-03-27","SF FuneralFDC00000005HR2250327","","126.5","","928684.57"
"2025-03-27","2025-03-27","SF FuneralFDC00000005J9P250327","","126.5","","928811.07"
"2025-03-27","2025-03-27","SF FuneralFDC00000005N77250327","","126.5","","928937.57"
"2025-03-27","2025-03-27","SF FuneralFDC00000005SNP250327","","126.5","","929064.07"
"2025-03-27","2025-03-27","SF FuneralFDC00000005ZZC250327","","126.5","","929190.57"
"2025-03-27","2025-03-27","SF FuneralFDC000000061W3250327","","126.5","","929317.07"
"2025-03-27","2025-03-27","SF FuneralFDC000000067Q3250327","","126.5","","929443.57"
"2025-03-27","2025-03-27","SF FuneralFDC00000006QQQ250327","","126.5","","929570.07"
"2025-03-27","2025-03-27","SF FuneralFDC00000006TK3250327","","126.5","","929696.57"
"2025-03-27","2025-03-27","SF FuneralFDC00000006TVB250327","","126.5","","929823.07"
"2025-03-27","2025-03-27","SF FuneralFDC000000072BP250327","","126.5","","929949.57"
"2025-03-27","2025-03-27","SF FuneralFDC00000007WKS250327","","126.5","","930076.07"
"2025-03-27","2025-03-27","SF FuneralFDC00000008K09250327","","126.5","","930202.57"
"2025-03-27","2025-03-27","SF FuneralFDC00000008QXW250327","","126.5","","930329.07"
"2025-03-27","2025-03-27","SF FuneralF808311       250327","","126.5","","930455.57"
"2025-03-27","2025-03-27","SF FuneralFDC00000009465250327","","126.5","","930582.07"
"2025-03-27","2025-03-27","SF FuneralFDC00000009C6F250327","","126.5","","930708.57"
"2025-03-27","2025-03-27","SF FuneralFDC00000009FPK250327","","126.5","","930835.07"
"2025-03-27","2025-03-27","SF FuneralFDC00000009G6V250327","","126.5","","930961.57"
"2025-03-27","2025-03-27","SF FuneralF815060       250327","","126.5","","931088.07"
"2025-03-27","2025-03-27","SF FuneralF815985       250327","","126.5","","931214.57"
"2025-03-27","2025-03-27","SF FuneralF816057       250327","","126.5","","931341.07"
"2025-03-27","2025-03-27","SF FuneralF820318       250327","","126.5","","931467.57"
"2025-03-27","2025-03-27","SF FuneralF821801       250327","","126.5","","931594.07"
"2025-03-27","2025-03-27","SF FuneralF822967       250327","","126.5","","931720.57"
"2025-03-27","2025-03-27","SF FuneralF827684       250327","","126.5","","931847.07"
"2025-03-27","2025-03-27","SF FuneralF798998       250327","","126.5","","931973.57"
"2025-03-27","2025-03-27","SF FuneralF827846       250327","","126.5","","932100.07"
"2025-03-27","2025-03-27","SF FuneralF827886       250327","","126.5","","932226.57"
"2025-03-27","2025-03-27","SF FuneralF830293       250327","","126.5","","932353.07"
"2025-03-27","2025-03-27","SF FuneralFDC0000000BW75250327","","126.5","","932479.57"
"2025-03-27","2025-03-27","SF FuneralF832992       250327","","126.5","","932606.07"
"2025-03-27","2025-03-27","SF FuneralF833929       250327","","126.5","","932732.57"
"2025-03-27","2025-03-27","SF FuneralF841084       250327","","126.5","","932859.07"
"2025-03-27","2025-03-27","SF FuneralF841968       250327","","126.5","","932985.57"
"2025-03-27","2025-03-27","SF FuneralF843773       250327","","126.5","","933112.07"
"2025-03-27","2025-03-27","SF FuneralF844554       250327","","126.5","","933238.57"
"2025-03-27","2025-03-27","SF FuneralF900937       250327","","126.5","","933365.07"
"2025-03-27","2025-03-27","SF FuneralF981468       250327","","126.5","","933491.57"
"2025-03-27","2025-03-27","SF FuneralF986670       250327","","126.5","","933618.07"
"2025-03-27","2025-03-27","SF FuneralF989143       250327","","126.5","","933744.57"
"2025-03-27","2025-03-27","SF FuneralFDC0000000JVB4250327","","126.5","","933871.07"
"2025-03-27","2025-03-27","SF FuneralF1021974      250327","","126.5","","933997.57"
"2025-03-27","2025-03-27","SF FuneralF1055149      250327","","126.5","","934124.07"
"2025-03-27","2025-03-27","SF FuneralFDC0000000K8MS250327","","126.5","","934250.57"
"2025-03-27","2025-03-27","SF FuneralF1059497      250327","","126.5","","934377.07"
"2025-03-27","2025-03-27","SF FuneralF1060038      250327","","126.5","","934503.57"
"2025-03-27","2025-03-27","SF FuneralF1060409      250327","","126.5","","934630.07"
"2025-03-27","2025-03-27","SF FuneralF1060520      250327","","126.5","","934756.57"
"2025-03-27","2025-03-27","SF FuneralF1060527      250327","","126.5","","934883.07"
"2025-03-27","2025-03-27","SF FuneralFDC0000000KQNN250327","","126.5","","935009.57"
"2025-03-27","2025-03-27","SF FuneralF1065732      250327","","126.5","","935136.07"
"2025-03-27","2025-03-27","SF FuneralF1072976      250327","","126.5","","935262.57"
"2025-03-27","2025-03-27","SF FuneralF1073048      250327","","126.5","","935389.07"
"2025-03-27","2025-03-27","SF FuneralF1074824      250327","","126.5","","935515.57"
"2025-03-27","2025-03-27","SF FuneralF1074957      250327","","126.5","","935642.07"
"2025-03-27","2025-03-27","SF FuneralF1078639      250327","","213.31","","935855.38"
"2025-03-27","2025-03-27","SF FuneralF1102874      250327","","126.5","","935981.88"
"2025-03-27","2025-03-27","SF FuneralF1103175      250327","","126.5","","936108.38"
"2025-03-27","2025-03-27","SF FuneralF1103732      250327","","126.5","","936234.88"
"2025-03-27","2025-03-27","SF FuneralF1109654      250327","","126.5","","936361.38"
"2025-03-27","2025-03-27","SF FuneralF1110420      250327","","126.5","","936487.88"
"2025-03-27","2025-03-27","SF FuneralF1112374      250327","","126.5","","936614.38"
"2025-03-27","2025-03-27","SF FuneralF1112510      250327","","126.5","","936740.88"
"2025-03-27","2025-03-27","SF FuneralF1113634      250327","","126.5","","936867.38"
"2025-03-27","2025-03-27","SF FuneralF1113760      250327","","126.5","","936993.88"
"2025-03-27","2025-03-27","SF FuneralF1114094      250327","","126.5","","937120.38"
"2025-03-27","2025-03-27","SF FuneralF1114198      250327","","126.5","","937246.88"
"2025-03-27","2025-03-27","SF FuneralF1114641      250327","","126.5","","937373.38"
"2025-03-27","2025-03-27","SF FuneralF1120870      250327","","126.5","","937499.88"
"2025-03-27","2025-03-27","SF FuneralF1121881      250327","","126.5","","937626.38"
"2025-03-27","2025-03-27","SF FuneralF1122324      250327","","126.5","","937752.88"
"2025-03-27","2025-03-27","SF FuneralF1122648      250327","","126.5","","937879.38"
"2025-03-27","2025-03-27","SF FuneralF1122999      250327","","126.5","","938005.88"
"2025-03-27","2025-03-27","SF FuneralF1122805      250327","","126.5","","938132.38"
"2025-03-27","2025-03-27","SF FuneralFDC0000000PL45250327","","126.5","","938258.88"
"2025-03-27","2025-03-27","SF FuneralF1128198      250327","","126.5","","938385.38"
"2025-03-27","2025-03-27","SF FuneralF1129056      250327","","126.5","","938511.88"
"2025-03-27","2025-03-27","SF FuneralF1133700      250327","","126.5","","938638.38"
"2025-03-27","2025-03-27","SF FuneralF1134830      250327","","126.5","","938764.88"
"2025-03-27","2025-03-25","SF FuneralFDC00000005KQR250325","","126.5","","938891.38"
"2025-03-27","2025-03-22","SF FuneralF813225       250322","","126.5","","939017.88"
"2025-03-27","2025-03-27","SF FuneralFDC00000005DRW250327","","126.5","","939144.38"
"2025-03-27","2025-03-27","SF FuneralFDC00000005GLQ250327","","126.5","","939270.88"
"2025-03-27","2025-03-27","SF FuneralF822542       250327","","126.5","","939397.38"
"2025-03-27","2025-03-27","SF FuneralF842626       250327","","126.5","","939523.88"
"2025-03-27","2025-03-27","SF FuneralF1115164      250327","","126.5","","939650.38"
"2025-03-27","2025-03-27","SF FuneralF1120818      250327","","126.5","","939776.88"
"2025-03-27","2025-03-27","SF FuneralF1123199      250327","","126.5","","939903.38"
"2025-03-27","2025-03-27","SF FuneralFDC0000000PLKJ250327","","126.5","","940029.88"
"2025-03-27","2025-03-22","SF FuneralF797046       250322","","126.5","","940156.38"
"2025-03-27","2025-03-22","SF FuneralF1129387      250323","","126.5","","940282.88"
"2025-03-27","2025-03-24","SF FuneralFDC00000006K42250324","","126.5","","940409.38"
"2025-03-27","2025-03-24","SF FuneralFDC00000008HSV250324","","126.5","","940535.88"
"2025-03-27","2025-03-24","SF FuneralF804478       250324","","126.5","","940662.38"
"2025-03-27","2025-03-24","SF FuneralF832531       250324","","126.5","","940788.88"
"2025-03-27","2025-03-24","SF FuneralF1052345      250324","","31.63","","940820.51"
"2025-03-27","2025-03-24","SF FuneralF1125864      250324","","126.5","","940947.01"
"2025-03-27","2025-03-24","SF FuneralF1130457      250324","","126.5","","941073.51"
"2025-03-27","2025-03-25","SF FuneralFDC00000007039250325","","126.5","","941200.01"
"2025-03-27","2025-03-27","SF FuneralFDC0000000NNVX250327","","126.5","","941326.51"
"2025-03-27","2025-03-27","SF FuneralFDC00000004JN5250327","","220","","941546.51"
"2025-03-27","2025-03-27","SF FuneralFDC00000004JZF250327","","220","","941766.51"
"2025-03-27","2025-03-27","SF FuneralFDC00000005KBW250327","","126.5","","941893.01"
"2025-03-27","2025-03-27","SF FuneralFDC00000006BJ1250327","","126.5","","942019.51"
"2025-03-27","2025-03-27","SF FuneralFDC000000085H3250327","","126.5","","942146.01"
"2025-03-27","2025-03-27","SF FuneralF802906       250327","","126.5","","942272.51"
"2025-03-27","2025-03-27","SF FuneralFDC00000009FH8250327","","126.5","","942399.01"
"2025-03-27","2025-03-27","SF FuneralF841857       250327","","126.5","","942525.51"
"2025-03-27","2025-03-27","SF FuneralF842384       250327","","126.5","","942652.01"
"2025-03-27","2025-03-27","SF FuneralF843296       250327","","126.5","","942778.51"
"2025-03-27","2025-03-27","SF FuneralF986850       250327","","126.5","","942905.01"
"2025-03-27","2025-03-27","SF FuneralF1074874      250327","","126.5","","943031.51"
"2025-03-27","2025-03-27","SF FuneralF1117181      250327","","126.5","","943158.01"
"2025-03-27","2025-03-27","SF FuneralFDC0000000QGDW250327","","126.5","","943284.51"
"2025-03-27","2025-03-22","SF FuneralFDC00000004C5S250322","","220","","943504.51"
"2025-03-27","2025-03-22","SF FuneralFDC00000007NC0250322","","126.5","","943631.01"
"2025-03-27","2025-03-22","SF FuneralF1061698      250322","","126.5","","943757.51"
"2025-03-27","2025-03-22","SF FuneralF1103935      250323","","31.63","","943789.14"
"2025-03-27","2025-03-22","SF FuneralF1112185      250322","","126.5","","943915.64"
"2025-03-27","2025-03-22","SF FuneralF1132917      250323","","31.63","","943947.27"
"2025-03-27","2025-03-22","SF FuneralFDC0000000QC3H250322","","126.5","","944073.77"
"2025-03-27","2025-03-24","SF FuneralFDC00000002WYL250324","","55","","944128.77"
"2025-03-27","2025-03-24","SF FuneralFDC00000003591250324","","55","","944183.77"
"2025-03-27","2025-03-24","SF FuneralFDC00000005XWN250324","","126.5","","944310.27"
"2025-03-27","2025-03-24","SF FuneralFDC00000006KRJ250324","","126.5","","944436.77"
"2025-03-27","2025-03-24","SF FuneralF805867       250324","","126.5","","944563.27"
"2025-03-27","2025-03-24","SF FuneralFDC00000009KV0250324","","126.5","","944689.77"
"2025-03-27","2025-03-24","SF FuneralFDC0000000CJ17250324","","126.5","","944816.27"
"2025-03-27","2025-03-24","SF FuneralF988640       250324","","126.5","","944942.77"
"2025-03-27","2025-03-24","SF FuneralF1110684      250324","","126.5","","945069.27"
"2025-03-27","2025-03-24","SF FuneralF1112559      250324","","126.5","","945195.77"
"2025-03-27","2025-03-24","SF FuneralF808184       250324","","126.5","","945322.27"
"2025-03-27","2025-03-24","SF FuneralF1120844      250324","","126.5","","945448.77"
"2025-03-27","2025-03-24","SF FuneralF1128679      250324","","126.5","","945575.27"
"2025-03-27","2025-03-24","SF FuneralF1129140      250324","","126.5","","945701.77"
"2025-03-27","2025-03-24","SF FuneralF1130917      250324","","126.5","","945828.27"
"2025-03-27","2025-03-25","SF FuneralF841131       250325","","126.5","","945954.77"
"2025-03-27","2025-03-25","SF FuneralF1084859      250325","","31.63","","945986.4"
"2025-03-27","2025-03-25","SF FuneralF1115031      250325","","31.63","","946018.03"
"2025-03-27","2025-03-25","SF FuneralF1120567      250325","","126.5","","946144.53"
"2025-03-27","2025-03-25","SF FuneralF1125736      250325","","126.5","","946271.03"
"2025-03-27","2025-03-25","SF FuneralF1126844      250325","","126.5","","946397.53"
"2025-03-27","2025-03-25","SF FuneralF1134720      250325","","126.5","","946524.03"
"2025-03-27","2025-03-26","SF FuneralF817757       250326","","126.5","","946650.53"
"2025-03-27","2025-03-20","SF FuneralFDC0000000HQ93250322","","126.5","","946777.03"
"2025-03-27","2025-03-22","SF FuneralFDC000000063K9250322","","126.5","","946903.53"
"2025-03-27","2025-03-22","SF FuneralFDC000000063TV250322","","126.5","","947030.03"
"2025-03-27","2025-03-22","SF FuneralF812963       250322","","126.5","","947156.53"
"2025-03-27","2025-03-24","SF FuneralFDC00000003S1L250324","","55","","947211.53"
"2025-03-27","2025-03-24","SF FuneralFDC00000005YF9250324","","126.5","","947338.03"
"2025-03-27","2025-03-24","SF FuneralFDC00000005Z3L250324","","31.63","","947369.66"
"2025-03-27","2025-03-24","SF FuneralFDC000000063P3250324","","126.5","","947496.16"
"2025-03-27","2025-03-24","SF FuneralFDC000000066DM250323","","126.5","","947622.66"
"2025-03-27","2025-03-24","SF FuneralFDC00000006XXP250324","","126.5","","947749.16"
"2025-03-27","2025-03-24","SF FuneralFDC00000007NXB250324","","126.5","","947875.66"
"2025-03-27","2025-03-23","SF FuneralF833459       250323","","126.5","","948002.16"
"2025-03-27","2025-03-24","SF FuneralF833802       250324","","126.5","","948128.66"
"2025-03-27","2025-03-24","SF FuneralF1016838      250324","","126.5","","948255.16"
"2025-03-27","2025-03-24","SF FuneralF1020845      250324","","126.5","","948381.66"
"2025-03-27","2025-03-24","SF FuneralF1108611      250324","","126.5","","948508.16"
"2025-03-27","2025-03-24","SF FuneralF1108830      250324","","126.5","","948634.66"
"2025-03-27","2025-03-24","SF FuneralF1114988      250324","","126.5","","948761.16"
"2025-03-27","2025-03-24","SF FuneralFDC0000000NW1Y250324","","126.5","","948887.66"
"2025-03-27","2025-03-24","SF FuneralF1122282      250324","","126.5","","949014.16"
"2025-03-27","2025-03-24","SF FuneralF1130995      250324","","126.5","","949140.66"
"2025-03-27","2025-03-25","SF FuneralF1113998      250325","","126.5","","949267.16"
"2025-03-27","2025-03-27","SF FuneralFDC00000006603250327","","126.5","","949393.66"
"2025-03-27","2025-03-27","SF FuneralFDC00000006VRW250327","","126.5","","949520.16"
"2025-03-27","2025-03-27","SF FuneralF802771       250327","","126.5","","949646.66"
"2025-03-27","2025-03-27","SF FuneralF843663       250327","","126.5","","949773.16"
"2025-03-27","2025-03-27","SF FuneralF1059402      250327","","126.5","","949899.66"
"2025-03-27","2025-03-27","SF FuneralF1066056      250327","","126.5","","950026.16"
"2025-03-27","2025-03-27","SF FuneralFDC0000000LMJP250327","","321.5","","950347.66"
"2025-03-27","2025-03-27","SF FuneralF1108678      250327","","126.5","","950474.16"
"2025-03-27","2025-03-27","SF FuneralFDC0000000MTN2250327","","126.5","","950600.66"
"2025-03-27","2025-03-27","SF FuneralFDC0000000MTN5250327","","126.5","","950727.16"
"2025-03-27","2025-03-27","SF FuneralF1125837      250327","","126.5","","950853.66"
"2025-03-27","2025-03-24","SF FuneralF831649       250323","","126.5","","950980.16"
"2025-03-27","2025-03-24","SF FuneralF1104007      250324","","126.5","","951106.66"
"2025-03-27","2025-03-27","SF FuneralFDC000000030KZ250327","","220","","951326.66"
"2025-03-27","2025-03-22","Rev SF FuneralFDC00000007RD4250321","","-31.63","","951295.03"
"2025-03-27","2025-03-22","Rev SF FuneralFDC0000000LNR4250323","","-31.63","","951263.4"
"2025-03-27","2025-03-24","Rev SF FuneralFDC00000005NT1250324","","-31.63","","951231.77"
"2025-03-27","2025-03-25","Rev SF FuneralFDC00000005L57250325","","-31.63","","951200.14"
"2025-03-27","2025-02-24","Rev SF FuneralFDC00000006ZZW250223","","-126.5","","951073.64"
"2025-03-27","2025-03-22","Rev SF FuneralFDC0000000L1SQ250322","","-126.5","","950947.14"
"2025-03-27","2025-03-22","Rev SF FuneralFDC0000000NXGF250322","","-126.5","","950820.64"
"2025-03-27","2025-03-22","Rev SF FuneralFDC0000000855Y250321","","-126.5","","950694.14"
"2025-03-27","2025-03-22","Rev SF FuneralFDC000000096MY250322","","-126.5","","950567.64"
"2025-03-27","2025-03-22","Rev SF FuneralFDC0000000KGRJ250322","","-126.5","","950441.14"
"2025-03-27","2025-03-22","Rev SF FuneralFDC0000000DZGT250322","","-126.5","","950314.64"
"2025-03-27","2025-03-22","Rev SF FuneralFDC00000006NKJ250322","","-126.5","","950188.14"
"2025-03-27","2025-03-24","Rev SF FuneralFDC00000008JYB250324","","-63.25","","950124.89"
"2025-03-27","2025-03-24","Rev SF FuneralFDC0000000614B250324","","-126.5","","949998.39"
"2025-03-27","2025-03-24","Rev SF FuneralFDC0000000615C250324","","-126.5","","949871.89"
"2025-03-27","2025-03-24","Rev SF FuneralFDC00000007MBZ250324","","-126.5","","949745.39"
"2025-03-27","2025-03-24","Rev SF FuneralFDC000000083Q9250323","","-126.5","","949618.89"
"2025-03-27","2025-03-24","Rev SF FuneralFDC0000000J1YG250324","","-126.5","","949492.39"
"2025-03-27","2025-03-24","Rev SF FuneralFDC000000075T7250324","","-126.5","","949365.89"
"2025-03-27","2025-03-25","Rev SF FuneralFDC0000000NPJ3250325","","-126.5","","949239.39"
"2025-03-27","2025-03-25","Rev SF FuneralFDC00000007YRL250325","","-126.5","","949112.89"
"2025-03-27","2025-03-25","Rev SF FuneralFDC0000000PRPN250325","","-126.5","","948986.39"
"2025-03-27","2025-03-25","Rev SF FuneralFDC0000000BD5B250325","","-126.5","","948859.89"
"2025-03-27","2025-03-26","Rev SF FuneralFDC000000071CQ250326","","-126.5","","948733.39"
"2025-03-27","2025-03-26","Rev SF FuneralFDC0000000JGRR250326","","-126.5","","948606.89"
"2025-03-27","2025-03-21","SF FuneralF815237       250321","","63.25","","948670.14"
"2025-03-27","2025-03-26","SF FuneralFDC00000008K0D250326","","126.5","","948796.64"
"2025-03-27","2025-03-24","SF FuneralFDC00000005XG9250324","","31.63","","948828.27"
"2025-03-27","2025-03-24","SF FuneralF988318       250324","","31.63","","948859.9"
"2025-03-27","2025-03-24","SF FuneralF1066299      250324","","31.63","","948891.53"
"2025-03-27","2025-03-24","SF FuneralF1117412      250324","","31.63","","948923.16"
"2025-03-27","2025-03-25","SF FuneralF980415       250325","","31.63","","948954.79"
"2025-03-27","2025-03-25","SF FuneralF993719       250325","","31.63","","948986.42"
"2025-03-27","2025-03-25","SF FuneralF1060838      250325","","31.63","","949018.05"
"2025-03-27","2025-03-22","SF FuneralFDC00000008PQM250322","","126.5","","949144.55"
"2025-03-27","2025-03-22","SF FuneralF822675       250322","","126.5","","949271.05"
"2025-03-27","2025-03-22","SF FuneralF1058826      250323","","126.5","","949397.55"
"2025-03-27","2025-03-22","SF FuneralF1065752      250322","","126.5","","949524.05"
"2025-03-27","2025-03-22","SF FuneralF1074483      250322","","126.5","","949650.55"
"2025-03-27","2025-03-22","SF FuneralF1131971      250323","","126.5","","949777.05"
"2025-03-27","2025-03-24","SF FuneralFDC00000006H5X250324","","126.5","","949903.55"
"2025-03-27","2025-03-24","SF FuneralFDC00000007MCS250323","","126.5","","950030.05"
"2025-03-27","2025-03-24","SF FuneralF810046       250324","","126.5","","950156.55"
"2025-03-27","2025-03-24","SF FuneralF815172       250324","","126.5","","950283.05"
"2025-03-27","2025-03-24","SF FuneralF819744       250323","","126.5","","950409.55"
"2025-03-27","2025-03-24","SF FuneralF831804       250323","","126.5","","950536.05"
"2025-03-27","2025-03-24","SF FuneralF981550       250324","","126.5","","950662.55"
"2025-03-27","2025-03-24","SF FuneralF993696       250324","","126.5","","950789.05"
"2025-03-27","2025-03-24","SF FuneralF1108561      250324","","126.5","","950915.55"
"2025-03-27","2025-03-24","SF FuneralF1112267      250324","","126.5","","951042.05"
"2025-03-27","2025-03-24","SF FuneralF1133989      250324","","126.5","","951168.55"
"2025-03-27","2025-03-25","SF FuneralFDC000000032RM250325","","220","","951388.55"
"2025-03-27","2025-03-25","SF FuneralFDC000000064M8250325","","126.5","","951515.05"
"2025-03-27","2025-03-25","SF FuneralFDC0000000800P250325","","126.5","","951641.55"
"2025-03-27","2025-03-25","SF FuneralFDC000000082D1250325","","126.5","","951768.05"
"2025-03-27","2025-03-25","SF FuneralF786678       250325","","343.31","","952111.36"
"2025-03-27","2025-03-25","SF FuneralF832942       250325","","126.5","","952237.86"
"2025-03-27","2025-03-25","SF FuneralF833279       250325","","126.5","","952364.36"
"2025-03-27","2025-03-25","SF FuneralF1108115      250325","","126.5","","952490.86"
"2025-03-27","2025-03-25","SF FuneralF1124528      250325","","126.5","","952617.36"
"2025-03-27","2025-03-25","SF FuneralF1131483      250325","","126.5","","952743.86"
"2025-03-27","2025-03-25","SF FuneralF1131732      250325","","126.5","","952870.36"
"2025-03-27","2025-03-26","SF FuneralFDC00000006386250326","","126.5","","952996.86"
"2025-03-27","2025-03-26","SF FuneralF804608       250326","","126.5","","953123.36"
"2025-03-27","2025-03-27","SF FuneralFDC0000000677F250327","","126.5","","953249.86"
"2025-03-27","2025-03-27","SF FuneralFDC00000006FN3250327","","126.5","","953376.36"
"2025-03-27","2025-03-27","SF FuneralFDC00000006ZP7250327","","126.5","","953502.86"
"2025-03-27","2025-03-27","SF FuneralFDC000000073K5250327","","126.5","","953629.36"
"2025-03-27","2025-03-27","SF FuneralF802532       250327","","126.5","","953755.86"
"2025-03-27","2025-03-27","SF FuneralF813053       250327","","126.5","","953882.36"
"2025-03-27","2025-03-27","SF FuneralFDC0000000GH0P250327","","126.5","","954008.86"
"2025-03-27","2025-03-27","SF FuneralF1108680      250327","","126.5","","954135.36"
"2025-03-27","2025-03-27","SF FuneralF1112434      250327","","126.5","","954261.86"
"2025-03-27","2025-03-27","SF FuneralF1116089      250327","","126.5","","954388.36"
"2025-03-27","2025-03-27","SF FuneralF1117621      250327","","126.5","","954514.86"
"2025-03-27","2025-03-27","SF FuneralF1120603      250327","","126.5","","954641.36"
"2025-03-27","2025-03-22","SF FuneralFDC00000005YMV250322","","126.5","","954767.86"
"2025-03-27","2025-03-22","SF FuneralFDC00000007LH0250322","","126.5","","954894.36"
"2025-03-27","2025-03-22","SF FuneralF1113980      250323","","126.5","","955020.86"
"2025-03-27","2025-03-24","SF FuneralFDC000000061JT250323","","126.5","","955147.36"
"2025-03-27","2025-03-24","SF FuneralFDC00000006Q8K250323","","126.5","","955273.86"
"2025-03-27","2025-03-24","SF FuneralF834476       250324","","126.5","","955400.36"
"2025-03-27","2025-03-24","SF FuneralF1114111      250324","","126.5","","955526.86"
"2025-03-27","2025-03-24","SF FuneralF797550       250324","","126.5","","955653.36"
"2025-03-27","2025-03-25","SF FuneralF992297       250325","","126.5","","955779.86"
"2025-03-27","2025-03-25","SF FuneralF1131075      250325","","126.5","","955906.36"
"2025-03-27","2025-03-25","SF FuneralF1134894      250325","","126.5","","956032.86"
"2025-03-27","2025-03-26","SF FuneralFDC000000033PX250326","","220","","956252.86"
"2025-03-27","2025-03-27","SF FuneralFDC00000005WZH250327","","220","","956472.86"
"2025-03-27","2025-03-27","SF FuneralFDC00000006D99250327","","126.5","","956599.36"
"2025-03-27","2025-03-27","SF FuneralF811927       250327","","126.5","","956725.86"
"2025-03-27","2025-03-27","SF FuneralF843163       250327","","126.5","","956852.36"
"2025-03-27","2025-03-27","SF FuneralF1112379      250327","","126.5","","956978.86"
"2025-03-27","2025-03-27","SF FuneralF1113149      250327","","126.5","","957105.36"
"2025-03-27","2025-03-27","SF FuneralF1120535      250327","","126.5","","957231.86"
"2025-03-27","2025-03-27","SF FuneralF1120861      250327","","126.5","","957358.36"
"2025-03-27","2025-03-22","Rev SF FuneralFDC0000000B4NX250322","","-126.5","","957231.86"
"2025-03-27","2025-03-22","Rev SF FuneralFDC00000003H19250322","","-220.01","","957011.85"
"2025-03-27","2025-03-22","SF FuneralFDC00000005GFY250322","","126.5","","957138.35"
"2025-03-27","2025-03-22","SF FuneralF805678       250322","","126.5","","957264.85"
"2025-03-27","2025-03-22","SF FuneralF805759       250322","","126.5","","957391.35"
"2025-03-27","2025-03-25","SF FuneralFDC00000007Q24250325","","126.5","","957517.85"
"2025-03-27","2025-03-25","SF FuneralF1016936      250325","","63.25","","957581.1"
"2025-03-27","2025-03-27","SF FuneralFDC00000006N8S250327","","126.5","","957707.6"
"2025-03-27","2025-03-27","SF FuneralF816209       250327","","126.5","","957834.1"
"2025-03-27","2025-03-27","SF FuneralF840687       250327","","126.5","","957960.6"
"2025-03-27","2025-03-24","SF FuneralFDC0000000811P250324","","126.5","","958087.1"
"2025-03-27","2025-03-25","SF FuneralFDC0000000ND1R250325","","31.63","","958118.73"
"2025-03-27","2025-03-25","SF FuneralFDC0000000ND1S250325","","31.63","","958150.36"
"2025-03-27","2025-03-27","SF FuneralFDC00000005CG9250327","","126.5","","958276.86"
"2025-03-27","2025-03-27","SF FuneralFDC000000069J2250327","","126.5","","958403.36"
"2025-03-27","2025-03-27","SF FuneralFDC00000006C5K250327","","126.5","","958529.86"
"2025-03-27","2025-03-27","SF FuneralFDC0000000DQW2250327","","126.5","","958656.36"
"2025-03-27","2025-03-27","SF FuneralFDC0000000L9YV250327","","126.5","","958782.86"
"2025-03-27","2025-03-20","SF FuneralF986734       250323","","126.5","","958909.36"
"2025-03-27","2025-03-20","SF FuneralF1126087      250321","","126.5","","959035.86"
"2025-03-27","2025-03-22","SF FuneralFDC00000005Z5P250322","","126.5","","959162.36"
"2025-03-27","2025-03-22","SF FuneralFDC000000060R3250322","","126.5","","959288.86"
"2025-03-27","2025-03-22","SF FuneralFDC00000008FKB250322","","126.5","","959415.36"
"2025-03-27","2025-03-22","SF FuneralF818548       250322","","126.5","","959541.86"
"2025-03-27","2025-03-22","SF FuneralF830001       250321","","63.25","","959605.11"
"2025-03-27","2025-03-22","SF FuneralF1117309      250322","","126.5","","959731.61"
"2025-03-27","2025-03-24","SF FuneralFDC0000000857H250323","","126.5","","959858.11"
"2025-03-27","2025-03-24","SF FuneralF778519       250324","","126.5","","959984.61"
"2025-03-27","2025-03-24","SF FuneralF830084       250324","","63.25","","960047.86"
"2025-03-27","2025-03-24","SF FuneralF1060513      250324","","126.5","","960174.36"
"2025-03-27","2025-03-24","SF FuneralFDC0000000N4K7250324","","126.5","","960300.86"
"2025-03-27","2025-03-24","SF FuneralF1126920      250324","","126.5","","960427.36"
"2025-03-27","2025-03-24","SF FuneralF1131794      250324","","126.5","","960553.86"
"2025-03-27","2025-03-25","SF FuneralFDC0000000621F250325","","126.5","","960680.36"
"2025-03-27","2025-03-25","SF FuneralFDC000000064FL250325","","126.5","","960806.86"
"2025-03-27","2025-03-25","SF FuneralFDC000000073KC250325","","126.5","","960933.36"
"2025-03-27","2025-03-25","SF FuneralFDC00000007PQS250325","","126.5","","961059.86"
"2025-03-27","2025-03-25","SF FuneralF831757       250325","","63.25","","961123.11"
"2025-03-27","2025-03-25","SF FuneralF989465       250325","","126.5","","961249.61"
"2025-03-27","2025-03-25","SF FuneralF1020917      250325","","63.25","","961312.86"
"2025-03-27","2025-03-25","SF FuneralF779557       250325","","191.5","","961504.36"
"2025-03-27","2025-03-25","SF FuneralF1122784      250325","","126.5","","961630.86"
"2025-03-27","2025-03-25","SF FuneralFDC0000000Q81W250325","","126.5","","961757.36"
"2025-03-27","2025-03-27","SF FuneralF831097       250327","","126.5","","961883.86"
"2025-03-27","2025-03-27","SF FuneralF1109072      250327","","126.5","","962010.36"
"2025-03-27","2025-03-27","SF FuneralF1128696      250327","","126.5","","962136.86"
"2025-03-27","2025-03-22","SF FuneralFDC000000032NM250322","","220","","962356.86"
"2025-03-27","2025-03-24","SF FuneralFDC00000006XFK250324","","31.63","","962388.49"
"2025-03-27","2025-03-25","SF FuneralFDC000000032JV250325","","220","","962608.49"
"2025-03-27","2025-03-25","SF FuneralF1065836      250325","","126.5","","962734.99"
"2025-03-27","2025-03-25","SF FuneralF1119033      250325","","63.25","","962798.24"
"2025-03-27","2025-03-25","SF FuneralF1132469      250325","","126.5","","962924.74"
"2025-03-27","2025-03-22","SF FuneralF1085336      250322","","126.5","","963051.24"
"2025-03-27","2025-03-22","SF FuneralF1108114      250322","","126.5","","963177.74"
"2025-03-27","2025-03-27","SF FuneralF1075212      250327","","126.5","","963304.24"
"2025-03-27","2025-03-20","SF FuneralFDC00000005Z44250320","","126.5","","963430.74"
"2025-03-27","2025-03-22","SF FuneralFDC00000007NMQ250322","","126.5","","963557.24"
"2025-03-27","2025-03-22","SF FuneralF842800       250321","","126.5","","963683.74"
"2025-03-27","2025-03-22","SF FuneralF1055038      250322","","126.5","","963810.24"
"2025-03-27","2025-03-24","SF FuneralFDC00000007990250324","","126.5","","963936.74"
"2025-03-27","2025-03-24","SF FuneralFDC00000007NMV250324","","126.5","","964063.24"
"2025-03-27","2025-03-24","SF FuneralF816306       250324","","126.5","","964189.74"
"2025-03-27","2025-03-24","SF FuneralF1118762      250324","","126.5","","964316.24"
"2025-03-27","2025-03-24","SF FuneralF1132067      250324","","63.25","","964379.49"
"2025-03-27","2025-03-26","SF FuneralFDC0000000KRGY250326","","126.5","","964505.99"
"2025-03-27","2025-03-27","SF FuneralF812623       250327","","126.5","","964632.49"
"2025-03-27","2025-03-27","SF FuneralF827816       250327","","126.5","","964758.99"
"2025-03-27","2025-03-27","SF FuneralF1066340      250327","","126.5","","964885.49"
"2025-03-27","2025-03-27","SF FuneralF1118918      250327","","126.5","","965011.99"
"2025-03-27","2025-03-22","SF FuneralFDC00000006JNP250322","","126.5","","965138.49"
"2025-03-27","2025-03-22","SF FuneralFDC00000006JNR250322","","126.5","","965264.99"
"2025-03-27","2025-03-22","SF FuneralF811741       250322","","126.5","","965391.49"
"2025-03-27","2025-03-22","SF FuneralF819859       250322","","126.5","","965517.99"
"2025-03-27","2025-03-22","SF FuneralF992247       250323","","126.5","","965644.49"
"2025-03-27","2025-03-22","SF FuneralF1055203      250322","","126.5","","965770.99"
"2025-03-27","2025-03-24","SF FuneralF799455       250323","","126.5","","965897.49"
"2025-03-27","2025-03-24","SF FuneralF820446       250324","","126.5","","966023.99"
"2025-03-27","2025-03-24","SF FuneralF1110362      250324","","31.63","","966055.62"
"2025-03-27","2025-03-24","SF FuneralF1113736      250324","","126.5","","966182.12"
"2025-03-27","2025-03-24","SF FuneralF1128984      250324","","126.5","","966308.62"
"2025-03-27","2025-03-24","SF FuneralF1124140      250324","","31.63","","966340.25"
"2025-03-27","2025-03-24","SF FuneralF1130649      250324","","31.63","","966371.88"
"2025-03-27","2025-03-25","SF FuneralFDC00000006MXW250325","","63.25","","966435.13"
"2025-03-27","2025-03-25","SF FuneralF805648       250325","","31.63","","966466.76"
"2025-03-27","2025-03-25","SF FuneralFDC0000000LN0Q250325","","126.5","","966593.26"
"2025-03-27","2025-03-25","SF FuneralF1080246      250325","","31.63","","966624.89"
"2025-03-27","2025-03-25","SF FuneralF1111675      250325","","31.63","","966656.52"
"2025-03-27","2025-03-26","SF FuneralFDC0000000LG2D250326","","31.63","","966688.15"
"2025-03-27","2025-03-26","SF FuneralF1078566      250326","","31.63","","966719.78"
"2025-03-27","2025-03-27","SF FuneralFDC00000005P86250327","","126.5","","966846.28"
"2025-03-27","2025-03-27","SF FuneralFDC00000006RVM250327","","126.5","","966972.78"
"2025-03-27","2025-03-27","SF FuneralFDC00000008SPQ250327","","126.5","","967099.28"
"2025-03-27","2025-03-27","SF FuneralFDC00000009LFL250327","","126.5","","967225.78"
"2025-03-27","2025-03-27","SF FuneralF900702       250327","","126.5","","967352.28"
"2025-03-27","2025-03-27","SF FuneralF1065674      250327","","126.5","","967478.78"
"2025-03-27","2025-03-20","SF FuneralF991576       250320","","126.5","","967605.28"
"2025-03-27","2025-03-22","SF FuneralF1131748      250322","","126.5","","967731.78"
"2025-03-27","2025-03-24","SF FuneralFDC00000006KTR250324","","126.5","","967858.28"
"2025-03-27","2025-03-24","SF FuneralFDC0000000DCSR250324","","126.5","","967984.78"
"2025-03-27","2025-03-24","SF FuneralFDC0000000DCVF250324","","126.5","","968111.28"
"2025-03-27","2025-03-24","SF FuneralF1135011      250324","","126.5","","968237.78"
"2025-03-27","2025-03-25","SF FuneralF1033956      250325","","126.5","","968364.28"
"2025-03-27","2025-03-25","SF FuneralF1127432      250325","","31.63","","968395.91"
"2025-03-27","2025-03-25","SF FuneralF1132939      250325","","126.5","","968522.41"
"2025-03-27","2025-03-27","SF FuneralF813495       250327","","126.5","","968648.91"
"2025-03-27","2025-03-27","SF FuneralF987960       250327","","126.5","","968775.41"
"2025-03-27","2025-03-27","SF FuneralF1122718      250327","","31.63","","968807.04"
"2025-03-27","2025-03-24","SF FuneralF1111332      250324","","31.63","","968838.67"
"2025-03-27","2025-03-24","SF FuneralF1125487      250324","","31.63","","968870.3"
"2025-03-27","2025-03-24","SF FuneralFDC000000060CT250323","","126.5","","968996.8"
"2025-03-27","2025-03-24","SF FuneralF1021004      250324","","31.63","","969028.43"
"2025-03-27","2025-03-25","SF FuneralF1079371      250325","","126.5","","969154.93"
"2025-03-27","2025-03-27","SF FuneralF1113910      250327","","126.5","","969281.43"
"2025-03-27","2025-03-18","SF FuneralF1117887      250318","","126.5","","969407.93"
"2025-03-27","2025-03-20","SF FuneralFDC00000005Y98250320","","126.5","","969534.43"
"2025-03-27","2025-03-22","SF FuneralFDC000000060CR250321","","126.5","","969660.93"
"2025-03-27","2025-03-22","SF FuneralFDC000000082WP250321","","126.5","","969787.43"
"2025-03-27","2025-03-22","SF FuneralF821169       250322","","126.5","","969913.93"
"2025-03-27","2025-03-22","SF FuneralF1068345      250323","","126.5","","970040.43"
"2025-03-27","2025-03-22","SF FuneralF1130914      250322","","126.5","","970166.93"
"2025-03-27","2025-03-22","SF FuneralF1132319      250323","","126.5","","970293.43"
"2025-03-27","2025-03-24","SF FuneralFDC000000066F0250323","","191.5","","970484.93"
"2025-03-27","2025-03-24","SF FuneralFDC00000006BXR250324","","126.5","","970611.43"
"2025-03-27","2025-03-24","SF FuneralFDC00000006Q6C250324","","126.5","","970737.93"
"2025-03-27","2025-03-24","SF FuneralFDC00000006TRY250324","","63.25","","970801.18"
"2025-03-27","2025-03-24","SF FuneralF805058       250323","","126.5","","970927.68"
"2025-03-27","2025-03-24","SF FuneralF812703       250323","","126.5","","971054.18"
"2025-03-27","2025-03-24","SF FuneralFDC0000000FBT9250322","","278.31","","971332.49"
"2025-03-27","2025-03-24","SF FuneralF990991       250324","","63.25","","971395.74"
"2025-03-27","2025-03-24","SF FuneralF1061017      250324","","126.5","","971522.24"
"2025-03-27","2025-03-24","SF FuneralF1074831      250324","","126.5","","971648.74"
"2025-03-27","2025-03-24","SF FuneralF1114025      250324","","126.5","","971775.24"
"2025-03-27","2025-03-24","SF FuneralF1115020      250324","","63.25","","971838.49"
"2025-03-27","2025-03-25","SF FuneralFDC00000005N64250325","","63.25","","971901.74"
"2025-03-27","2025-03-25","SF FuneralFDC00000006RZQ250325","","126.5","","972028.24"
"2025-03-27","2025-03-25","SF FuneralF808036       250325","","126.5","","972154.74"
"2025-03-27","2025-03-25","SF FuneralF1108894      250325","","126.5","","972281.24"
"2025-03-27","2025-03-25","SF FuneralF1127905      250325","","126.5","","972407.74"
"2025-03-27","2025-03-25","SF FuneralF1130722      250325","","126.5","","972534.24"
"2025-03-27","2025-03-25","SF FuneralF1131605      250325","","126.5","","972660.74"
"2025-03-27","2025-03-25","SF FuneralF1132193      250325","","126.5","","972787.24"
"2025-03-27","2025-03-26","SF FuneralFDC00000007R9P250326","","126.5","","972913.74"
"2025-03-27","2025-03-26","SF FuneralF833656       250326","","126.5","","973040.24"
"2025-03-27","2025-03-26","SF FuneralFDC0000000K7J2250326","","126.5","","973166.74"
"2025-03-27","2025-03-27","SF FuneralFDC00000005N5Q250327","","126.5","","973293.24"
"2025-03-27","2025-03-27","SF FuneralFDC0000000JD19250327","","126.5","","973419.74"
"2025-03-27","2025-03-27","SF FuneralF1114931      250327","","126.5","","973546.24"
"2025-03-27","2025-03-27","SF FuneralF1134350      250327","","126.5","","973672.74"
"2025-03-27","2025-03-27","SF FuneralF1134545      250327","","126.5","","973799.24"
"2025-03-27","2025-03-24","SF FuneralFDC00000004NQM250323","","31.63","","973830.87"
"2025-03-27","2025-03-24","SF FuneralFDC00000004NQP250323","","31.63","","973862.5"
"2025-03-27","2025-03-24","SF FuneralFDC000000070PX250324","","31.63","","973894.13"
"2025-03-27","2025-03-24","SF FuneralFDC00000007H6K250324","","31.63","","973925.76"
"2025-03-27","2025-03-24","SF FuneralF800626       250324","","31.63","","973957.39"
"2025-03-27","2025-03-24","SF FuneralFDC0000000918Q250324","","47.88","","974005.27"
"2025-03-27","2025-03-24","SF FuneralF843034       250324","","31.63","","974036.9"
"2025-03-27","2025-03-24","SF FuneralF1017630      250324","","31.63","","974068.53"
"2025-03-27","2025-03-24","SF FuneralF1060055      250324","","31.63","","974100.16"
"2025-03-27","2025-03-24","SF FuneralF1104295      250324","","31.63","","974131.79"
"2025-03-27","2025-03-24","SF FuneralF1117477      250324","","31.63","","974163.42"
"2025-03-27","2025-03-24","SF FuneralF1108848      250324","","31.63","","974195.05"
"2025-03-27","2025-03-25","SF FuneralFDC00000005H2H250325","","31.63","","974226.68"
"2025-03-27","2025-03-25","SF FuneralFDC00000007ZD3250325","","31.63","","974258.31"
"2025-03-27","2025-03-25","SF FuneralF815955       250325","","31.63","","974289.94"
"2025-03-27","2025-03-25","SF FuneralF831704       250325","","31.63","","974321.57"
"2025-03-27","2025-03-25","SF FuneralF834784       250325","","31.63","","974353.2"
"2025-03-27","2025-03-25","SF FuneralF1114433      250325","","31.63","","974384.83"
"2025-03-27","2025-03-25","SF FuneralF1135056      250325","","31.63","","974416.46"
"2025-03-27","2025-03-27","SF FuneralF1116989      250327","","31.63","","974448.09"
"2025-03-27","2025-03-22","SF FuneralFDC0000000DMGD250322","","516.5","","974964.59"
"2025-03-27","2025-03-22","SF FuneralF1073736      250322","","126.5","","975091.09"
"2025-03-27","2025-03-22","SF FuneralF1122775      250322","","126.5","","975217.59"
"2025-03-27","2025-03-22","SF FuneralF1131356      250322","","126.5","","975344.09"
"2025-03-27","2025-03-24","SF FuneralF900264       250322","","126.5","","975470.59"
"2025-03-27","2025-03-24","SF FuneralFDC0000000NX3Q250324","","126.5","","975597.09"
"2025-03-27","2025-03-25","SF FuneralFDC00000006QZC250325","","126.5","","975723.59"
"2025-03-27","2025-03-25","SF FuneralF1016929      250325","","63.25","","975786.84"
"2025-03-27","2025-03-26","SF FuneralFDC00000007R9K250326","","126.5","","975913.34"
"2025-03-27","2025-03-26","SF FuneralF815698       250326","","126.5","","976039.84"
"2025-03-27","2025-03-26","SF FuneralF1118417      250326","","126.5","","976166.34"
"2025-03-27","2025-03-26","SF FuneralF1128194      250326","","126.5","","976292.84"
"2025-03-27","2025-03-27","SF FuneralF841878       250327","","126.5","","976419.34"
"2025-03-27","2025-03-27","SF FuneralFDC0000000G072250327","","126.5","","976545.84"
"2025-03-27","2025-03-27","SF FuneralFDC0000000K55Q250327","","126.5","","976672.34"
"2025-03-27","2025-03-27","SF FuneralF1074548      250327","","126.5","","976798.84"
"2025-03-27","2025-03-27","SF FuneralF1128072      250327","","126.5","","976925.34"
"2025-03-27","2025-03-27","SF FuneralF1135566      250327","","126.5","","977051.84"
"2025-03-27","2025-03-24","Rev SF FuneralFDC00000007H6K250324","","-31.63","","977020.21"
"2025-03-27","2025-03-27","Rev SF FuneralFDC00000005P8B250327","","-31.63","","976988.58"
"2025-03-27","2025-03-22","Rev SF FuneralFDC000000032VH250321","","-55","","976933.58"
"2025-03-27","2025-03-22","Rev SF FuneralFDC00000005RS3250321","","-31.63","","976901.95"
"2025-03-27","2025-03-22","Rev SF FuneralFDC0000000J62Q250322","","-126.5","","976775.45"
"2025-03-27","2025-03-24","Rev SF FuneralFDC00000006L4X250324","","-126.5","","976648.95"
"2025-03-27","2025-03-24","Rev SF FuneralFDC00000006H5X250324","","-126.5","","976522.45"
"2025-03-27","2025-02-27","Rev SF FuneralFDC0000000JVB4250227","","-126.5","","976395.95"
"2025-03-27","2025-02-27","Rev SF FuneralFDC00000009LFL250227","","-126.5","","976269.45"
"2025-03-27","2024-12-11","Rev SF FuneralF1115841      241223","","-126.5","","976142.95"
"2025-03-27","2025-03-22","Rev SF FuneralFDC0000000NCQ5250322","","-126.5","","976016.45"
"2025-03-27","2025-03-24","Rev SF FuneralFDC0000000PGQS250324","","-126.5","","975889.95"
"2025-03-27","2025-02-27","Rev SF FuneralFDC00000005F5Y250227","","-126.5","","975763.45"
"2025-03-27","2025-03-22","Rev SF FuneralFDC0000000645Q250322","","-126.5","","975636.95"
"2025-03-27","2025-03-22","Rev SF FuneralFDC00000006JSG250321","","-126.5","","975510.45"
"2025-03-27","2025-03-22","Rev SF FuneralFDC00000006JNP250322","","-126.5","","975383.95"
"2025-03-27","2025-03-24","Rev SF FuneralFDC00000006ZR8250323","","-126.5","","975257.45"
"2025-03-27","2025-03-27","Rev SF FuneralFDC00000009G6V250327","","-126.5","","975130.95"
"2025-03-27","2025-03-25","Rev SF FuneralFDC000000064M8250325","","-126.5","","975004.45"
"2025-03-27","2025-03-27","Rev SF FuneralFDC0000000JVB4250327","","-126.5","","974877.95"
"2025-03-27","2025-03-27","Rev SF FuneralFDC00000006QQQ250327","","-126.5","","974751.45"
"2025-03-27","2025-03-26","Rev SF FuneralFDC0000000K7J2250326","","-126.5","","974624.95"
"2025-03-27","2025-03-26","Rev SF FuneralFDC0000000KRGY250326","","-126.5","","974498.45"
"2025-03-27","2025-03-27","Rev SF FuneralFDC00000009LFL250327","","-126.5","","974371.95"
"2025-03-27","2025-03-27","Rev SF FuneralFDC0000000JD19250327","","-126.5","","974245.45"
"2025-03-27","2025-03-27","Rev SF FuneralFDC00000006C5K250327","","-126.5","","974118.95"
"2025-03-27","2025-03-27","Rev SF FuneralFDC000000072BP250327","","-126.5","","973992.45"
"2025-03-27","2025-03-27","Rev SF FuneralFDC00000006D99250327","","-126.5","","973865.95"
"2025-03-27","2024-12-11","Rev SF FuneralF1084643      241227","","-126.5","","973739.45"
"2025-03-27","2025-03-27","Rev SF FuneralFDC00000005F5Y250327","","-126.5","","973612.95"
"2025-03-27","2025-03-27","Rev SF FuneralFDC0000000677F250327","","-126.5","","973486.45"
"2025-03-27","2025-03-27","Rev SF FuneralFDC0000000DQW2250327","","-126.5","","973359.95"
"2025-03-27","2025-03-24","Rev SF FuneralFDC0000000N4K7250324","","-126.5","","973233.45"
"2025-03-27","2025-02-22","Rev SF FuneralFDC0000000NCQ5250222","","-126.5","","973106.95"
"2025-03-27","2025-02-26","Rev SF FuneralFDC0000000K7J2250226","","-126.5","","972980.45"
"2025-03-27","2025-03-25","Rev SF FuneralFDC00000007PQS250325","","-126.5","","972853.95"
"2025-03-27","2025-03-22","Rev SF FuneralFDC00000007TWL250322","","-126.5","","972727.45"
"2025-03-27","2025-03-22","Rev SF FuneralFDC00000007MLR250321","","-126.5","","972600.95"
"2025-03-27","2025-03-24","Rev SF FuneralFDC0000000JCQP250324","","-126.5","","972474.45"
"2025-03-27","2025-03-25","Rev SF FuneralFDC0000000800P250325","","-126.5","","972347.95"
"2025-03-27","2025-03-25","Rev SF FuneralFDC0000000800S250325","","-126.5","","972221.45"
"2025-03-27","2025-03-25","Rev SF FuneralFDC000000082D1250325","","-126.5","","972094.95"
"2025-03-27","2025-03-22","Rev SF FuneralFDC0000000NB79250323","","-126.5","","971968.45"
"2025-03-27","2025-03-24","Rev SF FuneralFDC00000006ZR9250323","","-126.5","","971841.95"
"2025-03-27","2025-03-24","Rev SF FuneralFDC0000000867B250324","","-126.5","","971715.45"
"2025-03-27","2025-03-24","Rev SF FuneralFDC0000000867C250324","","-126.5","","971588.95"
"2025-03-27","2025-03-27","SF FuneralF1075224      250327","","126.5","","971715.45"
"2025-03-27","2025-03-25","SF FuneralF843011       250325","","63.25","","971778.7"
"2025-03-27","2025-03-25","SF FuneralFDC0000000QHS1250325","","31.63","","971810.33"
"2025-03-27","2025-03-25","SF FuneralFDC0000000QHS5250325","","31.63","","971841.96"
"2025-03-27","2025-03-24","SF FuneralFDC0000000KZ2C250324","","31.63","","971873.59"
"2025-03-27","2025-03-24","SF FuneralF1127535      250324","","63.25","","971936.84"
"2025-03-27","2025-03-23","SF FuneralF815224       250323","","126.5","","972063.34"
"2025-03-27","2025-03-24","SF FuneralF829978       250324","","63.25","","972126.59"
"2025-03-27","2025-03-24","SF FuneralF834614       250324","","31.63","","972158.22"
"2025-03-27","2025-03-24","SF FuneralF844339       250324","","31.63","","972189.85"
"2025-03-27","2025-03-24","SF FuneralF987492       250324","","31.63","","972221.48"
"2025-03-27","2025-03-24","SF FuneralF993435       250324","","126.5","","972347.98"
"2025-03-27","2025-03-24","SF FuneralF791581       250324","","47.88","","972395.86"
"2025-03-27","2025-03-24","SF FuneralF1100809      250324","","31.63","","972427.49"
"2025-03-27","2025-03-24","SF FuneralF1122010      250324","","126.5","","972553.99"
"2025-03-27","2025-03-24","SF FuneralF1131807      250324","","126.5","","972680.49"
"2025-03-27","2025-03-25","SF FuneralFDC00000003HX7250325","","220","","972900.49"
"2025-03-27","2025-03-25","SF FuneralFDC00000007LS5250325","","126.5","","973026.99"
"2025-03-27","2025-03-25","SF FuneralF795139       250325","","126.5","","973153.49"
"2025-03-27","2025-03-25","SF FuneralF981116       250325","","126.5","","973279.99"
"2025-03-27","2025-03-25","SF FuneralF986694       250325","","31.63","","973311.62"
"2025-03-27","2025-03-25","SF FuneralFDC0000000HQB5250325","","31.63","","973343.25"
"2025-03-27","2025-03-25","SF FuneralF1118809      250325","","31.63","","973374.88"
"2025-03-27","2025-03-25","SF FuneralF1118848      250325","","31.63","","973406.51"
"2025-03-27","2025-03-25","SF FuneralF990319       250325","","160.75","","973567.26"
"2025-03-27","2025-03-25","SF FuneralF1131796      250325","","31.63","","973598.89"
"2025-03-27","2025-03-25","SF FuneralF1131995      250325","","126.5","","973725.39"
"2025-03-27","2025-03-25","SF FuneralFDC0000000QM3Q250325","","126.5","","973851.89"
"2025-03-27","2025-03-24","SF FuneralFDC00000006RJX250324","","126.5","","973978.39"
"2025-03-27","2025-03-24","SF FuneralFDC000000079DD250324","","126.5","","974104.89"
"2025-03-27","2025-03-24","SF FuneralFDC00000007M01250324","","126.5","","974231.39"
"2025-03-27","2025-03-24","SF FuneralF833736       250323","","126.5","","974357.89"
"2025-03-27","2025-03-24","SF FuneralF1068032      250324","","63.25","","974421.14"
"2025-03-27","2025-03-24","SF FuneralFDC0000000N7TM250324","","126.5","","974547.64"
"2025-03-27","2025-03-25","SF FuneralFDC00000005FX1250325","","126.5","","974674.14"
"2025-03-27","2025-03-25","SF FuneralF809796       250325","","63.25","","974737.39"
"2025-03-27","2025-03-26","SF FuneralF992138       250326","","126.5","","974863.89"
"2025-03-27","2025-03-27","SF FuneralFDC00000006J5R250327","","126.5","","974990.39"
"2025-03-27","2025-03-27","SF FuneralF819975       250327","","126.5","","975116.89"
"2025-03-27","2025-03-27","SF FuneralF1062704      250327","","126.5","","975243.39"
"2025-03-27","2025-03-22","SF FuneralF1108324      250322","","126.5","","975369.89"
"2025-03-27","2025-03-22","SF FuneralF1111976      250322","","126.5","","975496.39"
"2025-03-27","2025-03-22","SF FuneralF1122270      250322","","126.5","","975622.89"
"2025-03-27","2025-03-27","SF FuneralFDC00000006YKF250327","","126.5","","975749.39"
"2025-03-27","2025-03-27","SF FuneralF830825       250327","","126.5","","975875.89"
"2025-03-27","2025-03-27","SF FuneralF842229       250327","","126.5","","976002.39"
"2025-03-27","2025-03-27","SF FuneralF1055326      250327","","126.5","","976128.89"
"2025-03-27","2025-03-27","SF FuneralF1078865      250327","","47.88","","976176.77"
"2025-03-27","2025-03-27","SF FuneralF1108788      250327","","126.5","","976303.27"
"2025-03-27","2025-03-27","SF FuneralF1110003      250327","","126.5","","976429.77"
"2025-03-27","2025-03-27","SF FuneralF1120826      250327","","126.5","","976556.27"
"2025-03-27","2025-03-27","SF FuneralF1121888      250327","","126.5","","976682.77"
"2025-03-27","2025-03-26","SF FuneralFDC00000008X5B250326","","31.63","","976714.4"
"2025-03-27","2025-03-26","SF FuneralF822661       250326","","126.5","","976840.9"
"2025-03-27","2025-03-26","SF FuneralF1108941      250326","","126.5","","976967.4"
"2025-03-27","2025-03-26","SF FuneralF1111944      250326","","126.5","","977093.9"
"2025-03-27","2025-03-22","Rev SF FuneralFDC00000006CW1250322","","-126.5","","976967.4"
"2025-03-27","2025-03-22","Rev SF FuneralFDC00000006CWM250322","","-126.5","","976840.9"
"2025-03-27","2025-03-22","Rev SF FuneralFDC00000006CZ4250322","","-126.5","","976714.4"
"2025-03-27","2025-02-22","Rev SF FuneralFDC00000006FZW250222","","-126.5","","976587.9"
"2025-03-27","2025-03-22","Rev SF FuneralFDC00000006FZW250322","","-126.5","","976461.4"
"2025-03-27","2025-03-22","Rev SF FuneralFDC00000008HY7250322","","-126.5","","976334.9"
"2025-03-27","2025-03-22","SF FuneralFDC00000008JLB250322","","126.5","","976461.4"
"2025-03-27","2025-03-22","SF FuneralF1084500      250322","","126.5","","976587.9"
"2025-03-27","2025-03-24","SF FuneralFDC0000000695T250324","","126.5","","976714.4"
"2025-03-27","2025-03-24","SF FuneralF1068049      250324","","126.5","","976840.9"
"2025-03-27","2025-03-25","SF FuneralF988913       250325","","31.63","","976872.53"
"2025-03-27","2025-03-25","SF FuneralF1055264      250325","","126.5","","976999.03"
"2025-03-27","2025-03-25","SF FuneralF1068029      250325","","31.63","","977030.66"
"2025-03-27","2025-03-27","SF FuneralFDC000000032DW250327","","220","","977250.66"
"2025-03-27","2025-03-27","SF FuneralF803249       250327","","126.5","","977377.16"
"2025-03-27","2025-03-27","SF FuneralF840809       250327","","126.5","","977503.66"
"2025-03-28","2025-03-28","SF FuneralFDC00000002R0W250328","","220","","977723.66"
"2025-03-28","2025-03-28","SF FuneralFDC00000003K14250328","","220","","977943.66"
"2025-03-28","2025-03-28","SF FuneralFDC00000005D1V250328","","220","","978163.66"
"2025-03-28","2025-03-28","SF FuneralF1118832      250328","","126.5","","978290.16"
"2025-03-28","2025-03-24","SF FuneralFDC000000074Y5250324","","55","","978345.16"
"2025-03-28","2025-03-24","SF FuneralF816565       250324","","31.63","","978376.79"
"2025-03-28","2025-03-24","SF FuneralF901184       250324","","31.63","","978408.42"
"2025-03-28","2025-03-24","SF FuneralF986655       250324","","31.63","","978440.05"
"2025-03-28","2025-03-24","SF FuneralF990276       250324","","31.63","","978471.68"
"2025-03-28","2025-03-24","SF FuneralF993678       250324","","31.63","","978503.31"
"2025-03-28","2025-03-24","SF FuneralF1016810      250324","","31.63","","978534.94"
"2025-03-28","2025-03-24","SF FuneralF1073147      250324","","31.63","","978566.57"
"2025-03-28","2025-03-24","SF FuneralFDC0000000N7Y7250324","","31.63","","978598.2"
"2025-03-28","2025-03-25","SF FuneralFDC00000003BTC250325","","55","","978653.2"
"2025-03-28","2025-03-25","SF FuneralFDC00000005PFJ250325","","31.63","","978684.83"
"2025-03-28","2025-03-25","SF FuneralFDC0000000BT1S250325","","31.63","","978716.46"
"2025-03-28","2025-03-25","SF FuneralFDC0000000J00M250325","","31.63","","978748.09"
"2025-03-28","2025-03-25","SF FuneralF1033680      250325","","31.63","","978779.72"
"2025-03-28","2025-03-25","SF FuneralF1110634      250325","","31.63","","978811.35"
"2025-03-28","2025-03-25","SF FuneralF1118865      250325","","31.63","","978842.98"
"2025-03-28","2025-03-25","SF FuneralF1123316      250325","","31.63","","978874.61"
"2025-03-28","2025-03-26","SF FuneralF800771       250326","","31.63","","978906.24"
"2025-03-28","2025-03-20","SF FuneralF1123231      250320","","126.5","","979032.74"
"2025-03-28","2025-03-22","SF FuneralFDC00000005NBQ250321","","126.5","","979159.24"
"2025-03-28","2025-03-22","SF FuneralFDC000000082KN250322","","126.5","","979285.74"
"2025-03-28","2025-03-22","SF FuneralFDC00000009H4P250322","","126.5","","979412.24"
"2025-03-28","2025-03-22","SF FuneralF813314       250322","","126.5","","979538.74"
"2025-03-28","2025-03-22","SF FuneralF819348       250322","","63.25","","979601.99"
"2025-03-28","2025-03-22","SF FuneralF1054784      250322","","126.5","","979728.49"
"2025-03-28","2025-03-22","SF FuneralF1060620      250322","","126.5","","979854.99"
"2025-03-28","2025-03-24","SF FuneralFDC00000002SMZ250324","","220","","980074.99"
"2025-03-28","2025-03-24","SF FuneralFDC00000007R5Z250324","","63.25","","980138.24"
"2025-03-28","2025-03-24","SF FuneralF843425       250324","","191.5","","980329.74"
"2025-03-28","2025-03-25","SF FuneralFDC00000003D2J250325","","110","","980439.74"
"2025-03-28","2025-03-25","SF FuneralFDC00000003JXZ250325","","220","","980659.74"
"2025-03-28","2025-03-25","SF FuneralF987501       250325","","126.5","","980786.24"
"2025-03-28","2025-03-25","SF FuneralF992323       250325","","126.5","","980912.74"
"2025-03-28","2025-03-25","SF FuneralF1020971      250325","","126.5","","981039.24"
"2025-03-28","2025-03-25","SF FuneralF1021355      250325","","126.5","","981165.74"
"2025-03-28","2025-03-25","SF FuneralF1055169      250325","","126.5","","981292.24"
"2025-03-28","2025-03-25","SF FuneralFDC0000000KFZP250325","","63.25","","981355.49"
"2025-03-28","2025-03-25","SF FuneralF1060528      250325","","63.25","","981418.74"
"2025-03-28","2025-03-25","SF FuneralF1130805      250325","","126.5","","981545.24"
"2025-03-28","2025-03-26","SF FuneralF802400       250326","","126.5","","981671.74"
"2025-03-28","2025-03-26","SF FuneralF1119769      250326","","126.5","","981798.24"
"2025-03-28","2025-03-27","SF FuneralFDC00000002XTX250327","","110","","981908.24"
"2025-03-28","2025-03-27","SF FuneralFDC000000066GF250327","","126.5","","982034.74"
"2025-03-28","2025-03-27","SF FuneralF987256       250327","","126.5","","982161.24"
"2025-03-28","2025-03-27","SF FuneralFDC0000000LTVB250327","","126.5","","982287.74"
"2025-03-28","2025-03-27","SF FuneralF1113324      250327","","126.5","","982414.24"
"2025-03-28","2025-03-18","SF FuneralF830994       250318","","63.25","","982477.49"
"2025-03-28","2025-03-20","SF FuneralF1129117      250321","","126.5","","982603.99"
"2025-03-28","2025-03-22","SF FuneralFDC000000075L7250321","","63.25","","982667.24"
"2025-03-28","2025-03-22","SF FuneralF794144       250322","","63.25","","982730.49"
"2025-03-28","2025-03-22","SF FuneralF992079       250323","","126.5","","982856.99"
"2025-03-28","2025-03-22","SF FuneralF1111756      250322","","126.5","","982983.49"
"2025-03-28","2025-03-24","SF FuneralFDC0000000708S250324","","126.5","","983109.99"
"2025-03-28","2025-03-24","SF FuneralFDC00000007092250324","","126.5","","983236.49"
"2025-03-28","2025-03-24","SF FuneralF809626       250324","","126.5","","983362.99"
"2025-03-28","2025-03-24","SF FuneralF981682       250324","","126.5","","983489.49"
"2025-03-28","2025-03-24","SF FuneralFDC0000000L76X250324","","126.5","","983615.99"
"2025-03-28","2025-03-24","SF FuneralF1074515      250324","","126.5","","983742.49"
"2025-03-28","2025-03-24","SF FuneralF1110330      250324","","63.25","","983805.74"
"2025-03-28","2025-03-24","SF FuneralF1134413      250324","","126.5","","983932.24"
"2025-03-28","2025-03-25","SF FuneralFDC000000067FT250325","","63.25","","983995.49"
"2025-03-28","2025-03-25","SF FuneralFDC000000075W6250325","","126.5","","984121.99"
"2025-03-28","2025-03-25","SF FuneralFDC00000007NZG250325","","126.5","","984248.49"
"2025-03-28","2025-03-25","SF FuneralF1016772      250325","","126.5","","984374.99"
"2025-03-28","2025-03-25","SF FuneralF1112245      250325","","126.5","","984501.49"
"2025-03-28","2025-03-25","SF FuneralF1130719      250325","","126.5","","984627.99"
"2025-03-28","2025-03-25","SF FuneralF1130945      250325","","126.5","","984754.49"
"2025-03-28","2025-03-27","SF FuneralFDC00000006KGR250327","","126.5","","984880.99"
"2025-03-28","2025-03-27","SF FuneralF828262       250327","","126.5","","985007.49"
"2025-03-28","2025-03-27","SF FuneralF1022023      250327","","126.5","","985133.99"
"2025-03-28","2025-03-27","SF FuneralF1058797      250327","","126.5","","985260.49"
"2025-03-28","2025-03-27","SF FuneralF1084871      250327","","126.5","","985386.99"
"2025-03-28","2025-03-27","SF FuneralF1110350      250327","","126.5","","985513.49"
"2025-03-28","2025-03-27","SF FuneralFDC0000000MQNT250327","","126.5","","985639.99"
"2025-03-28","2025-03-27","SF FuneralF1114328      250327","","126.5","","985766.49"
"2025-03-28","2025-03-27","SF FuneralFDC0000000QMHR250327","","126.5","","985892.99"
"2025-03-28","2025-03-24","SF FuneralFDC00000005NR4250324","","31.63","","985924.62"
"2025-03-28","2025-03-24","SF FuneralFDC00000007PP8250324","","31.63","","985956.25"
"2025-03-28","2025-03-24","SF FuneralFDC00000007WVJ250324","","31.63","","985987.88"
"2025-03-28","2025-03-24","SF FuneralFDC000000086PW250323","","31.63","","986019.51"
"2025-03-28","2025-03-24","SF FuneralF802251       250324","","31.63","","986051.14"
"2025-03-28","2025-03-24","SF FuneralF813361       250324","","31.63","","986082.77"
"2025-03-28","2025-03-24","SF FuneralF802331       250324","","31.63","","986114.4"
"2025-03-28","2025-03-24","SF FuneralF815144       250324","","31.63","","986146.03"
"2025-03-28","2025-03-24","SF FuneralF822865       250324","","31.63","","986177.66"
"2025-03-28","2025-03-24","SF FuneralF830431       250324","","31.63","","986209.29"
"2025-03-28","2025-03-24","SF FuneralF1072930      250324","","31.63","","986240.92"
"2025-03-28","2025-03-24","SF FuneralF1073218      250324","","31.63","","986272.55"
"2025-03-28","2025-03-24","SF FuneralF1102887      250324","","31.63","","986304.18"
"2025-03-28","2025-03-24","SF FuneralFDC0000000ML65250324","","31.63","","986335.81"
"2025-03-28","2025-03-24","SF FuneralF1115957      250324","","31.63","","986367.44"
"2025-03-28","2025-03-24","SF FuneralF1125116      250324","","31.63","","986399.07"
"2025-03-28","2025-03-24","SF FuneralF1128005      250324","","31.63","","986430.7"
"2025-03-28","2025-03-24","SF FuneralFDC0000000PYVQ250324","","31.63","","986462.33"
"2025-03-28","2025-03-24","SF FuneralF1129402      250324","","31.63","","986493.96"
"2025-03-28","2025-03-24","SF FuneralF1131037      250324","","31.63","","986525.59"
"2025-03-28","2025-03-24","SF FuneralF1132386      250324","","31.63","","986557.22"
"2025-03-28","2025-03-24","SF FuneralF1134076      250324","","31.63","","986588.85"
"2025-03-28","2025-03-25","SF FuneralFDC00000005P3L250325","","31.63","","986620.48"
"2025-03-28","2025-03-25","SF FuneralFDC00000005P3Q250325","","31.63","","986652.11"
"2025-03-28","2025-03-25","SF FuneralFDC00000005R1B250325","","31.63","","986683.74"
"2025-03-28","2025-03-25","SF FuneralFDC00000007DFS250325","","31.63","","986715.37"
"2025-03-28","2025-03-25","SF FuneralFDC000000088BV250325","","31.63","","986747"
"2025-03-28","2025-03-25","SF FuneralFDC00000008CVJ250325","","31.63","","986778.63"
"2025-03-28","2025-03-25","SF FuneralF802295       250325","","31.63","","986810.26"
"2025-03-28","2025-03-25","SF FuneralF814180       250325","","31.63","","986841.89"
"2025-03-28","2025-03-25","SF FuneralF821837       250325","","47.88","","986889.77"
"2025-03-28","2025-03-25","SF FuneralF830294       250325","","31.63","","986921.4"
"2025-03-28","2025-03-25","SF FuneralF987241       250325","","31.63","","986953.03"
"2025-03-28","2025-03-25","SF FuneralFDC0000000K22X250325","","31.63","","986984.66"
"2025-03-28","2025-03-25","SF FuneralF1066227      250325","","31.63","","987016.29"
"2025-03-28","2025-03-25","SF FuneralF1084842      250325","","31.63","","987047.92"
"2025-03-28","2025-03-25","SF FuneralF1102910      250325","","31.63","","987079.55"
"2025-03-28","2025-03-25","SF FuneralF1118352      250325","","31.63","","987111.18"
"2025-03-28","2025-03-25","SF FuneralF1123129      250325","","31.63","","987142.81"
"2025-03-28","2025-03-25","SF FuneralF1128820      250325","","31.63","","987174.44"
"2025-03-28","2025-03-25","SF FuneralF1130870      250325","","31.63","","987206.07"
"2025-03-28","2025-03-25","SF FuneralF1130942      250325","","31.63","","987237.7"
"2025-03-28","2025-03-25","SF FuneralF1133043      250325","","31.63","","987269.33"
"2025-03-28","2025-03-26","SF FuneralFDC0000000MLNC250326","","31.63","","987300.96"
"2025-03-28","2025-03-26","SF FuneralF1124144      250326","","31.63","","987332.59"
"2025-03-28","2025-03-26","SF FuneralF1124171      250326","","31.63","","987364.22"
"2025-03-28","2025-03-27","SF FuneralF805236       250327","","31.63","","987395.85"
"2025-03-28","2025-03-20","SF FuneralF797547       250320","","126.5","","987522.35"
"2025-03-28","2025-03-20","SF FuneralF1066525      250321","","126.5","","987648.85"
"2025-03-28","2025-03-24","SF FuneralF810250       250324","","31.63","","987680.48"
"2025-03-28","2025-03-24","SF FuneralF1072928      250324","","31.63","","987712.11"
"2025-03-28","2025-03-24","SF FuneralF1084032      250324","","31.63","","987743.74"
"2025-03-28","2025-03-24","SF FuneralF1112394      250324","","31.63","","987775.37"
"2025-03-28","2025-03-25","SF FuneralFDC00000007ZH7250325","","31.63","","987807"
"2025-03-28","2025-03-25","SF FuneralFDC0000000BMW2250325","","31.63","","987838.63"
"2025-03-28","2025-03-25","SF FuneralF1128762      250325","","31.63","","987870.26"
"2025-03-28","2025-03-25","SF FuneralF1131536      250325","","31.63","","987901.89"
"2025-03-28","2025-03-26","SF FuneralF1060919      250326","","31.63","","987933.52"
"2025-03-28","2025-03-20","SF FuneralFDC00000005M0Y250320","","126.5","","988060.02"
"2025-03-28","2025-03-20","SF FuneralFDC0000000L146250320","","126.5","","988186.52"
"2025-03-28","2025-03-20","SF FuneralF1132802      250321","","126.5","","988313.02"
"2025-03-28","2025-03-22","SF FuneralFDC000000032TY250322","","220","","988533.02"
"2025-03-28","2025-03-22","SF FuneralFDC00000006YY1250322","","126.5","","988659.52"
"2025-03-28","2025-03-22","SF FuneralF803777       250322","","126.5","","988786.02"
"2025-03-28","2025-03-22","SF FuneralFDC00000008NPF250322","","126.5","","988912.52"
"2025-03-28","2025-03-22","SF FuneralFDC0000000LJ18250322","","126.5","","989039.02"
"2025-03-28","2025-03-22","SF FuneralF1130482      250322","","126.5","","989165.52"
"2025-03-28","2025-03-24","SF FuneralFDC00000007MKJ250324","","126.5","","989292.02"
"2025-03-28","2025-03-24","SF FuneralFDC00000007Z7Y250323","","126.5","","989418.52"
"2025-03-28","2025-03-24","SF FuneralF815724       250324","","126.5","","989545.02"
"2025-03-28","2025-03-24","SF FuneralF831914       250324","","126.5","","989671.52"
"2025-03-28","2025-03-24","SF FuneralF833321       250324","","126.5","","989798.02"
"2025-03-28","2025-03-24","SF FuneralF1058727      250324","","126.5","","989924.52"
"2025-03-28","2025-03-24","SF FuneralF1115070      250324","","126.5","","990051.02"
"2025-03-28","2025-03-24","SF FuneralF1131783      250324","","126.5","","990177.52"
"2025-03-28","2025-03-24","SF FuneralF1132071      250324","","126.5","","990304.02"
"2025-03-28","2025-03-25","SF FuneralFDC00000006122250325","","126.5","","990430.52"
"2025-03-28","2025-03-25","SF FuneralFDC00000006MYN250325","","126.5","","990557.02"
"2025-03-28","2025-03-25","SF FuneralFDC00000007NXH250325","","126.5","","990683.52"
"2025-03-28","2025-03-25","SF FuneralFDC00000008JBY250325","","126.5","","990810.02"
"2025-03-28","2025-03-25","SF FuneralF823831       250325","","126.5","","990936.52"
"2025-03-28","2025-03-25","SF FuneralFDC0000000JZ2Z250325","","126.5","","991063.02"
"2025-03-28","2025-03-25","SF FuneralF1067884      250325","","126.5","","991189.52"
"2025-03-28","2025-03-25","SF FuneralF1067926      250325","","126.5","","991316.02"
"2025-03-28","2025-03-25","SF FuneralF1079262      250325","","126.5","","991442.52"
"2025-03-28","2025-03-25","SF FuneralF1112386      250325","","126.5","","991569.02"
"2025-03-28","2025-03-25","SF FuneralFDC0000000PSLJ250325","","126.5","","991695.52"
"2025-03-28","2025-03-25","SF FuneralF1130843      250325","","126.5","","991822.02"
"2025-03-28","2025-03-25","SF FuneralF1131085      250325","","126.5","","991948.52"
"2025-03-28","2025-03-26","SF FuneralFDC00000004BW6250326","","220","","992168.52"
"2025-03-28","2025-03-26","SF FuneralFDC000000070XZ250326","","126.5","","992295.02"
"2025-03-28","2025-03-26","SF FuneralFDC0000000JG8W250326","","126.5","","992421.52"
"2025-03-28","2025-03-27","SF FuneralF1017683      250327","","126.5","","992548.02"
"2025-03-28","2025-03-27","SF FuneralF1060976      250327","","126.5","","992674.52"
"2025-03-28","2025-03-27","SF FuneralF1102913      250327","","126.5","","992801.02"
"2025-03-28","2025-03-27","SF FuneralF1125059      250327","","126.5","","992927.52"
"2025-03-28","2025-03-22","SF FuneralFDC00000002W86250322","","220","","993147.52"
"2025-03-28","2025-03-22","SF FuneralFDC00000005D2X250322","","126.5","","993274.02"
"2025-03-28","2025-03-22","SF FuneralFDC00000007LR4250322","","126.5","","993400.52"
"2025-03-28","2025-03-22","SF FuneralFDC00000007MDC250322","","126.5","","993527.02"
"2025-03-28","2025-03-22","SF FuneralF802307       250322","","126.5","","993653.52"
"2025-03-28","2025-03-22","SF FuneralF803505       250321","","31.63","","993685.15"
"2025-03-28","2025-03-22","SF FuneralF992076       250322","","126.5","","993811.65"
"2025-03-28","2025-03-22","SF FuneralF1054562      250322","","126.5","","993938.15"
"2025-03-28","2025-03-22","SF FuneralF1054924      250323","","126.5","","994064.65"
"2025-03-28","2025-03-22","SF FuneralF1128055      250323","","31.63","","994096.28"
"2025-03-28","2025-03-26","SF FuneralFDC00000005V4Z250326","","31.63","","994127.91"
"2025-03-28","2025-03-26","SF FuneralFDC0000000JD8P250326","","126.5","","994254.41"
"2025-03-28","2025-03-26","SF FuneralF993814       250326","","126.5","","994380.91"
"2025-03-28","2025-03-26","SF FuneralF1108615      250326","","126.5","","994507.41"
"2025-03-28","2025-03-24","SF FuneralFDC000000063V4250324","","126.5","","994633.91"
"2025-03-28","2025-03-24","SF FuneralFDC00000006BK1250324","","31.63","","994665.54"
"2025-03-28","2025-03-24","SF FuneralFDC000000077VQ250323","","126.5","","994792.04"
"2025-03-28","2025-03-24","SF FuneralFDC00000007GXS250324","","31.63","","994823.67"
"2025-03-28","2025-03-24","SF FuneralFDC000000085JV250323","","126.5","","994950.17"
"2025-03-28","2025-03-24","SF FuneralF809870       250324","","63.25","","995013.42"
"2025-03-28","2025-03-24","SF FuneralF815515       250324","","126.5","","995139.92"
"2025-03-28","2025-03-24","SF FuneralF832143       250323","","126.5","","995266.42"
"2025-03-28","2025-03-24","SF FuneralF1085023      250324","","63.25","","995329.67"
"2025-03-28","2025-03-24","SF FuneralF1124593      250324","","126.5","","995456.17"
"2025-03-28","2025-03-27","SF FuneralF802199       250327","","126.5","","995582.67"
"2025-03-28","2025-03-27","SF FuneralF804542       250327","","126.5","","995709.17"
"2025-03-28","2025-03-27","SF FuneralF831967       250327","","126.5","","995835.67"
"2025-03-28","2025-03-27","SF FuneralF1084510      250327","","126.5","","995962.17"
"2025-03-28","2025-03-27","SF FuneralF1110763      250327","","31.63","","995993.8"
"2025-03-28","2025-03-27","SF FuneralF1113188      250327","","126.5","","996120.3"
"2025-03-28","2025-03-27","SF FuneralF1114492      250327","","126.5","","996246.8"
"2025-03-28","2025-03-27","SF FuneralFDC0000000NPZG250327","","126.5","","996373.3"
"2025-03-28","2025-03-27","SF FuneralF1127906      250327","","126.5","","996499.8"
"2025-03-28","2025-03-27","SF FuneralF1128168      250327","","126.5","","996626.3"
"2025-03-28","2025-03-20","SF FuneralFDC000000067MK250320","","126.5","","996752.8"
"2025-03-28","2025-03-20","SF FuneralFDC00000006NLK250320","","126.5","","996879.3"
"2025-03-28","2025-03-20","SF FuneralFDC00000007L23250320","","126.5","","997005.8"
"2025-03-28","2025-03-20","SF FuneralFDC0000000HTQF250323","","126.5","","997132.3"
"2025-03-28","2025-03-20","SF FuneralF988068       250322","","126.5","","997258.8"
"2025-03-28","2025-03-22","SF FuneralFDC000000039N2250322","","220","","997478.8"
"2025-03-28","2025-03-22","SF FuneralFDC00000005GLG250322","","126.5","","997605.3"
"2025-03-28","2025-03-22","SF FuneralFDC00000005XG2250322","","126.5","","997731.8"
"2025-03-28","2025-03-22","SF FuneralFDC00000006489250322","","126.5","","997858.3"
"2025-03-28","2025-03-22","SF FuneralFDC00000007CP5250322","","126.5","","997984.8"
"2025-03-28","2025-03-22","SF FuneralFDC00000007MLG250321","","220","","998204.8"
"2025-03-28","2025-03-22","SF FuneralF795589       250322","","126.5","","998331.3"
"2025-03-28","2025-03-22","SF FuneralF797281       250322","","126.5","","998457.8"
"2025-03-28","2025-03-22","SF FuneralF799644       250322","","126.5","","998584.3"
"2025-03-28","2025-03-22","SF FuneralF803347       250321","","126.5","","998710.8"
"2025-03-28","2025-03-22","SF FuneralF805248       250322","","126.5","","998837.3"
"2025-03-28","2025-03-22","SF FuneralFDC000000094ZN250322","","126.5","","998963.8"
"2025-03-28","2025-03-22","SF FuneralF811423       250322","","126.5","","999090.3"
"2025-03-28","2025-03-22","SF FuneralF812729       250322","","126.5","","999216.8"
"2025-03-28","2025-03-22","SF FuneralF818163       250322","","126.5","","999343.3"
"2025-03-28","2025-03-22","SF FuneralF821030       250322","","126.5","","999469.8"
"2025-03-28","2025-03-22","SF FuneralF823203       250322","","126.5","","999596.3"
"2025-03-28","2025-03-22","SF FuneralF823286       250322","","126.5","","999722.8"
"2025-03-28","2025-03-22","SF FuneralF827733       250322","","126.5","","999849.3"
"2025-03-28","2025-03-22","SF FuneralFDC0000000J995250323","","126.5","","999975.8"
"2025-03-28","2025-03-22","SF FuneralF1050780      250322","","126.5","","1000102.3"
"2025-03-28","2025-03-22","SF FuneralF1055158      250323","","126.5","","1000228.8"
"2025-03-28","2025-03-22","SF FuneralF1062660      250322","","126.5","","1000355.3"
"2025-03-28","2025-03-22","SF FuneralF1073845      250322","","126.5","","1000481.8"
"2025-03-28","2025-03-22","SF FuneralF1084330      250322","","126.5","","1000608.3"
"2025-03-28","2025-03-22","SF FuneralF1108110      250322","","126.5","","1000734.8"
"2025-03-28","2025-03-22","SF FuneralF1112253      250323","","126.5","","1000861.3"
"2025-03-28","2025-03-22","SF FuneralF1116743      250322","","126.5","","1000987.8"
"2025-03-28","2025-03-22","SF FuneralF1120700      250322","","126.5","","1001114.3"
"2025-03-28","2025-03-22","SF FuneralFDC0000000Q8TJ250322","","126.5","","1001240.8"
"2025-03-28","2025-03-22","SF FuneralF1060851      250322","","126.5","","1001367.3"
"2025-03-28","2025-03-22","SF FuneralF1133303      250322","","126.5","","1001493.8"
"2025-03-28","2025-03-24","SF FuneralFDC00000005PH9250324","","63.25","","1001557.05"
"2025-03-28","2025-03-24","SF FuneralFDC00000006328250324","","126.5","","1001683.55"
"2025-03-28","2025-03-24","SF FuneralFDC0000000652T250324","","126.5","","1001810.05"
"2025-03-28","2025-03-24","SF FuneralFDC000000067BV250324","","126.5","","1001936.55"
"2025-03-28","2025-03-24","SF FuneralFDC00000006N35250324","","126.5","","1002063.05"
"2025-03-28","2025-03-24","SF FuneralFDC00000006R1D250323","","126.5","","1002189.55"
"2025-03-28","2025-03-24","SF FuneralFDC00000007MF0250324","","126.5","","1002316.05"
"2025-03-28","2025-03-24","SF FuneralFDC00000007N8K250324","","126.5","","1002442.55"
"2025-03-28","2025-03-24","SF FuneralFDC00000007N8N250324","","126.5","","1002569.05"
"2025-03-28","2025-03-24","SF FuneralFDC0000000820X250324","","126.5","","1002695.55"
"2025-03-28","2025-03-24","SF FuneralF804198       250324","","63.25","","1002758.8"
"2025-03-28","2025-03-24","SF FuneralF805872       250324","","126.5","","1002885.3"
"2025-03-28","2025-03-24","SF FuneralF818873       250324","","126.5","","1003011.8"
"2025-03-28","2025-03-24","SF FuneralF821865       250324","","63.25","","1003075.05"
"2025-03-28","2025-03-24","SF FuneralF823486       250324","","126.5","","1003201.55"
"2025-03-28","2025-03-24","SF FuneralF832986       250324","","126.5","","1003328.05"
"2025-03-28","2025-03-24","SF FuneralF834043       250324","","63.25","","1003391.3"
"2025-03-28","2025-03-24","SF FuneralF1020636      250324","","126.5","","1003517.8"
"2025-03-28","2025-03-24","SF FuneralF1060760      250324","","63.25","","1003581.05"
"2025-03-28","2025-03-24","SF FuneralF1061830      250324","","126.5","","1003707.55"
"2025-03-28","2025-03-24","SF FuneralF1074819      250324","","126.5","","1003834.05"
"2025-03-28","2025-03-24","SF FuneralFDC0000000MD6N250324","","126.5","","1003960.55"
"2025-03-28","2025-03-24","SF FuneralFDC0000000MD6P250324","","126.5","","1004087.05"
"2025-03-28","2025-03-24","SF FuneralF1108874      250324","","126.5","","1004213.55"
"2025-03-28","2025-03-24","SF FuneralF1109596      250324","","126.5","","1004340.05"
"2025-03-28","2025-03-24","SF FuneralFDC0000000MSRY250324","","126.5","","1004466.55"
"2025-03-28","2025-03-24","SF FuneralF1112311      250324","","126.5","","1004593.05"
"2025-03-28","2025-03-24","SF FuneralF1113184      250324","","126.5","","1004719.55"
"2025-03-28","2025-03-24","SF FuneralF1113968      250324","","63.25","","1004782.8"
"2025-03-28","2025-03-24","SF FuneralF1114604      250324","","63.25","","1004846.05"
"2025-03-28","2025-03-24","SF FuneralF1120690      250324","","126.5","","1004972.55"
"2025-03-28","2025-03-24","SF FuneralF1124771      250324","","126.5","","1005099.05"
"2025-03-28","2025-03-24","SF FuneralF1126088      250324","","126.5","","1005225.55"
"2025-03-28","2025-03-24","SF FuneralF1129157      250324","","126.5","","1005352.05"
"2025-03-28","2025-03-24","SF FuneralF1130650      250324","","126.5","","1005478.55"
"2025-03-28","2025-03-24","SF FuneralF1131189      250324","","126.5","","1005605.05"
"2025-03-28","2025-03-24","SF FuneralF1132229      250324","","126.5","","1005731.55"
"2025-03-28","2025-03-24","SF FuneralF1132387      250324","","63.25","","1005794.8"
"2025-03-28","2025-03-24","SF FuneralF1133531      250324","","126.5","","1005921.3"
"2025-03-28","2025-03-24","SF FuneralF1133846      250324","","126.5","","1006047.8"
"2025-03-28","2025-03-24","SF FuneralF1134615      250324","","126.5","","1006174.3"
"2025-03-28","2025-03-24","SF FuneralF1134968      250324","","126.5","","1006300.8"
"2025-03-28","2025-03-26","SF FuneralFDC00000005XF6250326","","220","","1006520.8"
"2025-03-28","2025-03-26","SF FuneralFDC00000008385250326","","126.5","","1006647.3"
"2025-03-28","2025-03-26","SF FuneralF808230       250326","","126.5","","1006773.8"
"2025-03-28","2025-03-26","SF FuneralF812958       250326","","126.5","","1006900.3"
"2025-03-28","2025-03-26","SF FuneralF992457       250326","","126.5","","1007026.8"
"2025-03-28","2025-03-26","SF FuneralF992740       250326","","126.5","","1007153.3"
"2025-03-28","2025-03-26","SF FuneralF1022170      250326","","126.5","","1007279.8"
"2025-03-28","2025-03-26","SF FuneralFDC0000000MHMH250326","","126.5","","1007406.3"
"2025-03-28","2025-03-26","SF FuneralF1118245      250326","","126.5","","1007532.8"
"2025-03-28","2025-03-26","SF FuneralF1129170      250326","","126.5","","1007659.3"
"2025-03-28","2025-03-18","SF FuneralF823133       250318","","126.5","","1007785.8"
"2025-03-28","2025-03-18","SF FuneralF1017847      250318","","63.25","","1007849.05"
"2025-03-28","2025-03-19","SF FuneralF1021092      250319","","126.5","","1007975.55"
"2025-03-28","2025-03-25","SF FuneralFDC00000005GLS250325","","126.5","","1008102.05"
"2025-03-28","2025-03-25","SF FuneralFDC0000000635S250325","","126.5","","1008228.55"
"2025-03-28","2025-03-25","SF FuneralFDC00000006FBZ250325","","126.5","","1008355.05"
"2025-03-28","2025-03-25","SF FuneralFDC00000006JR9250325","","126.5","","1008481.55"
"2025-03-28","2025-03-25","SF FuneralFDC00000006WZ3250325","","126.5","","1008608.05"
"2025-03-28","2025-03-25","SF FuneralFDC00000007NMX250325","","126.5","","1008734.55"
"2025-03-28","2025-03-25","SF FuneralFDC00000007SC0250325","","126.5","","1008861.05"
"2025-03-28","2025-03-25","SF FuneralFDC00000007V1W250325","","126.5","","1008987.55"
"2025-03-28","2025-03-25","SF FuneralFDC00000008BSS250325","","63.25","","1009050.8"
"2025-03-28","2025-03-25","SF FuneralF816528       250325","","126.5","","1009177.3"
"2025-03-28","2025-03-25","SF FuneralF840754       250325","","126.5","","1009303.8"
"2025-03-28","2025-03-25","SF FuneralF989167       250325","","126.5","","1009430.3"
"2025-03-28","2025-03-25","SF FuneralF990777       250325","","63.25","","1009493.55"
"2025-03-28","2025-03-25","SF FuneralF992513       250325","","126.5","","1009620.05"
"2025-03-28","2025-03-25","SF FuneralF993355       250325","","126.5","","1009746.55"
"2025-03-28","2025-03-25","SF FuneralF1054827      250325","","126.5","","1009873.05"
"2025-03-28","2025-03-25","SF FuneralF779732       250325","","126.5","","1009999.55"
"2025-03-28","2025-03-25","SF FuneralF1054959      250325","","126.5","","1010126.05"
"2025-03-28","2025-03-25","SF FuneralF1054998      250325","","63.25","","1010189.3"
"2025-03-28","2025-03-25","SF FuneralF1079715      250325","","126.5","","1010315.8"
"2025-03-28","2025-03-25","SF FuneralF1085146      250325","","126.5","","1010442.3"
"2025-03-28","2025-03-25","SF FuneralF1103542      250325","","126.5","","1010568.8"
"2025-03-28","2025-03-25","SF FuneralF1112365      250325","","126.5","","1010695.3"
"2025-03-28","2025-03-25","SF FuneralF1115959      250325","","126.5","","1010821.8"
"2025-03-28","2025-03-25","SF FuneralF1116008      250325","","126.5","","1010948.3"
"2025-03-28","2025-03-25","SF FuneralF1116029      250325","","126.5","","1011074.8"
"2025-03-28","2025-03-25","SF FuneralF1120913      250325","","126.5","","1011201.3"
"2025-03-28","2025-03-25","SF FuneralF1127477      250325","","63.25","","1011264.55"
"2025-03-28","2025-03-25","SF FuneralF1130029      250325","","126.5","","1011391.05"
"2025-03-28","2025-03-25","SF FuneralF1130779      250325","","126.5","","1011517.55"
"2025-03-28","2025-03-25","SF FuneralFDC0000000Q53W250325","","126.5","","1011644.05"
"2025-03-28","2025-03-25","SF FuneralF1131780      250325","","126.5","","1011770.55"
"2025-03-28","2025-03-25","SF FuneralFDC0000000Q8C9250325","","126.5","","1011897.05"
"2025-03-28","2025-03-25","SF FuneralFDC0000000Q8ZZ250325","","126.5","","1012023.55"
"2025-03-28","2025-03-27","SF FuneralFDC00000003WD1250327","","220","","1012243.55"
"2025-03-28","2025-03-27","SF FuneralFDC00000006ZHS250327","","126.5","","1012370.05"
"2025-03-28","2025-03-27","SF FuneralFDC000000080X5250327","","126.5","","1012496.55"
"2025-03-28","2025-03-27","SF FuneralFDC000000086LY250327","","126.5","","1012623.05"
"2025-03-28","2025-03-27","SF FuneralFDC00000008CZV250327","","126.5","","1012749.55"
"2025-03-28","2025-03-27","SF FuneralF802138       250327","","126.5","","1012876.05"
"2025-03-28","2025-03-27","SF FuneralF808363       250327","","126.5","","1013002.55"
"2025-03-28","2025-03-27","SF FuneralF812416       250327","","126.5","","1013129.05"
"2025-03-28","2025-03-27","SF FuneralF813504       250327","","126.5","","1013255.55"
"2025-03-28","2025-03-27","SF FuneralF823415       250327","","126.5","","1013382.05"
"2025-03-28","2025-03-27","SF FuneralF823716       250327","","126.5","","1013508.55"
"2025-03-28","2025-03-27","SF FuneralF830961       250327","","126.5","","1013635.05"
"2025-03-28","2025-03-27","SF FuneralF831607       250327","","126.5","","1013761.55"
"2025-03-28","2025-03-27","SF FuneralF1052298      250327","","126.5","","1013888.05"
"2025-03-28","2025-03-27","SF FuneralF1066139      250327","","126.5","","1014014.55"
"2025-03-28","2025-03-27","SF FuneralFDC0000000L74B250327","","126.5","","1014141.05"
"2025-03-28","2025-03-27","SF FuneralF1078478      250327","","126.5","","1014267.55"
"2025-03-28","2025-03-27","SF FuneralF1108540      250327","","126.5","","1014394.05"
"2025-03-28","2025-03-27","SF FuneralF1112343      250327","","126.5","","1014520.55"
"2025-03-28","2025-03-27","SF FuneralF1112566      250327","","126.5","","1014647.05"
"2025-03-28","2025-03-27","SF FuneralF1118950      250327","","126.5","","1014773.55"
"2025-03-28","2025-03-27","SF FuneralF1123227      250327","","126.5","","1014900.05"
"2025-03-28","2025-03-27","SF FuneralF1126091      250327","","126.5","","1015026.55"
"2025-03-28","2025-03-27","SF FuneralF1127667      250327","","126.5","","1015153.05"
"2025-03-28","2025-03-27","SF FuneralF1128719      250327","","126.5","","1015279.55"
"2025-03-28","2025-03-25","SF FuneralFDC00000005NVT250325","","126.5","","1015406.05"
"2025-03-28","2025-03-25","SF FuneralFDC0000000630N250325","","126.5","","1015532.55"
"2025-03-28","2025-03-25","SF FuneralFDC00000006619250325","","126.5","","1015659.05"
"2025-03-28","2025-03-25","SF FuneralFDC00000006FTF250325","","126.5","","1015785.55"
"2025-03-28","2025-03-25","SF FuneralFDC00000006N7G250325","","126.5","","1015912.05"
"2025-03-28","2025-03-25","SF FuneralFDC000000072SM250325","","31.63","","1015943.68"
"2025-03-28","2025-03-25","SF FuneralFDC00000007KQW250325","","126.5","","1016070.18"
"2025-03-28","2025-03-25","SF FuneralFDC00000007SD6250325","","126.5","","1016196.68"
"2025-03-28","2025-03-25","SF FuneralF814465       250325","","31.63","","1016228.31"
"2025-03-28","2025-03-25","SF FuneralF828692       250325","","126.5","","1016354.81"
"2025-03-28","2025-03-25","SF FuneralF830046       250325","","63.25","","1016418.06"
"2025-03-28","2025-03-25","SF FuneralF830094       250325","","63.25","","1016481.31"
"2025-03-28","2025-03-25","SF FuneralF1022237      250325","","126.5","","1016607.81"
"2025-03-28","2025-03-25","SF FuneralF1052789      250325","","126.5","","1016734.31"
"2025-03-28","2025-03-25","SF FuneralF1112152      250325","","31.63","","1016765.94"
"2025-03-28","2025-03-25","SF FuneralF1114513      250325","","31.63","","1016797.57"
"2025-03-28","2025-03-25","SF FuneralF1115080      250325","","63.25","","1016860.82"
"2025-03-28","2025-03-25","SF FuneralF1125777      250325","","31.63","","1016892.45"
"2025-03-28","2025-03-25","SF FuneralFDC0000000PYFR250325","","126.5","","1017018.95"
"2025-03-28","2025-03-25","SF FuneralF1129544      250325","","126.5","","1017145.45"
"2025-03-28","2025-03-25","SF FuneralF1130277      250325","","31.63","","1017177.08"
"2025-03-28","2025-03-25","SF FuneralF1127370      250325","","126.5","","1017303.58"
"2025-03-28","2025-03-25","SF FuneralFDC0000000QFT7250325","","126.5","","1017430.08"
"2025-03-28","2025-03-25","SF FuneralF1133725      250325","","126.5","","1017556.58"
"2025-03-28","2025-03-22","SF FuneralFDC00000005FWB250322","","126.5","","1017683.08"
"2025-03-28","2025-03-22","SF FuneralFDC000000060BB250322","","126.5","","1017809.58"
"2025-03-28","2025-03-25","SF FuneralF1021427      250325","","63.25","","1017872.83"
"2025-03-28","2025-03-27","SF FuneralFDC00000006B0G250327","","126.5","","1017999.33"
"2025-03-28","2025-03-27","SF FuneralF1123281      250327","","126.5","","1018125.83"
"2025-03-28","2025-03-20","SF FuneralF987537       250322","","126.5","","1018252.33"
"2025-03-28","2025-03-24","SF FuneralFDC00000006GXV250324","","126.5","","1018378.83"
"2025-03-28","2025-03-24","SF FuneralFDC00000006TGL250323","","126.5","","1018505.33"
"2025-03-28","2025-03-24","SF FuneralFDC00000007BF1250324","","126.5","","1018631.83"
"2025-03-28","2025-03-24","SF FuneralF787309       250324","","191.5","","1018823.33"
"2025-03-28","2025-03-24","SF FuneralF786846       250324","","126.5","","1018949.83"
"2025-03-28","2025-03-24","SF FuneralF844765       250323","","126.5","","1019076.33"
"2025-03-28","2025-03-24","SF FuneralFDC0000000HS6H250324","","31.63","","1019107.96"
"2025-03-28","2025-03-24","SF FuneralF1111402      250324","","63.25","","1019171.21"
"2025-03-28","2025-03-24","SF FuneralF1112468      250324","","126.5","","1019297.71"
"2025-03-28","2025-03-24","SF FuneralFDC0000000PNWZ250324","","126.5","","1019424.21"
"2025-03-28","2025-03-24","SF FuneralF1133585      250324","","126.5","","1019550.71"
"2025-03-28","2025-03-23","SF FuneralF831958       250323","","126.5","","1019677.21"
"2025-03-28","2025-03-27","SF FuneralF813217       250327","","126.5","","1019803.71"
"2025-03-28","2025-03-27","SF FuneralF813322       250327","","126.5","","1019930.21"
"2025-03-28","2025-03-27","SF FuneralF830762       250327","","126.5","","1020056.71"
"2025-03-28","2025-03-27","SF FuneralF1079496      250327","","126.5","","1020183.21"
"2025-03-28","2025-03-27","SF FuneralFDC0000000MLKK250327","","126.5","","1020309.71"
"2025-03-28","2025-03-27","SF FuneralF1120309      250327","","126.5","","1020436.21"
"2025-03-28","2025-03-27","SF FuneralF1122826      250327","","126.5","","1020562.71"
"2025-03-28","2025-03-27","SF FuneralF1127469      250327","","126.5","","1020689.21"
"2025-03-28","2025-03-22","SF FuneralFDC00000008S7L250322","","126.5","","1020815.71"
"2025-03-28","2025-03-22","SF FuneralFDC0000000Q26R250322","","126.5","","1020942.21"
"2025-03-28","2025-03-22","SF FuneralF1130648      250322","","126.5","","1021068.71"
"2025-03-28","2025-03-22","SF FuneralF1133517      250322","","213.31","","1021282.02"
"2025-03-28","2025-03-26","SF FuneralF799032       250326","","126.5","","1021408.52"
"2025-03-28","2025-03-26","SF FuneralF991944       250326","","126.5","","1021535.02"
"2025-03-28","2025-03-26","SF FuneralF1059424      250326","","31.63","","1021566.65"
"2025-03-28","2025-03-25","SF FuneralFDC00000007423250325","","126.5","","1021693.15"
"2025-03-28","2025-03-25","SF FuneralFDC00000007DQ7250325","","126.5","","1021819.65"
"2025-03-28","2025-03-25","SF FuneralFDC00000007M4S250325","","126.5","","1021946.15"
"2025-03-28","2025-03-25","SF FuneralF797055       250325","","31.63","","1021977.78"
"2025-03-28","2025-03-25","SF FuneralF802690       250325","","126.5","","1022104.28"
"2025-03-28","2025-03-25","SF FuneralF816567       250325","","126.5","","1022230.78"
"2025-03-28","2025-03-25","SF FuneralFDC00000009WP2250325","","126.5","","1022357.28"
"2025-03-28","2025-03-25","SF FuneralFDC0000000ML7D250325","","31.63","","1022388.91"
"2025-03-28","2025-03-25","SF FuneralF1114013      250325","","126.5","","1022515.41"
"2025-03-28","2025-03-25","SF FuneralFDC0000000NN7N250325","","31.63","","1022547.04"
"2025-03-28","2025-03-25","SF FuneralF1120129      250325","","31.63","","1022578.67"
"2025-03-28","2025-03-25","SF FuneralF1128933      250325","","126.5","","1022705.17"
"2025-03-28","2025-03-25","SF FuneralF1123132      250325","","31.63","","1022736.8"
"2025-03-28","2025-03-25","SF FuneralF1132354      250325","","31.63","","1022768.43"
"2025-03-28","2025-03-25","SF FuneralF1134357      250325","","126.5","","1022894.93"
"2025-03-28","2025-03-28","SF FuneralFDC00000006GJM250328","","126.5","","1023021.43"
"2025-03-28","2025-03-28","SF FuneralFDC00000007QJV250328","","126.5","","1023147.93"
"2025-03-28","2025-03-28","SF FuneralF1073144      250328","","126.5","","1023274.43"
"2025-03-28","2025-03-28","SF FuneralF1122697      250328","","126.5","","1023400.93"
"2025-03-28","2025-03-28","SF FuneralFDC0000000589H250328","","126.5","","1023527.43"
"2025-03-28","2025-03-28","SF FuneralF811139       250328","","126.5","","1023653.93"
"2025-03-28","2025-03-28","SF FuneralF1117035      250328","","126.5","","1023780.43"
"2025-03-28","2025-03-28","SF FuneralF1129118      250328","","126.5","","1023906.93"
"2025-03-28","2025-03-27","SF FuneralFDC000000062KH250327","","126.5","","1024033.43"
"2025-03-28","2025-03-27","SF FuneralFDC00000006MHK250327","","126.5","","1024159.93"
"2025-03-28","2025-03-27","SF FuneralFDC000000071C9250327","","126.5","","1024286.43"
"2025-03-28","2025-03-27","SF FuneralF802160       250327","","126.5","","1024412.93"
"2025-03-28","2025-03-27","SF FuneralF810245       250327","","126.5","","1024539.43"
"2025-03-28","2025-03-27","SF FuneralFDC00000009LMP250327","","126.5","","1024665.93"
"2025-03-28","2025-03-27","SF FuneralF842484       250327","","126.5","","1024792.43"
"2025-03-28","2025-03-27","SF FuneralFDC0000000JJVZ250327","","126.5","","1024918.93"
"2025-03-28","2025-03-27","SF FuneralF1111363      250327","","126.5","","1025045.43"
"2025-03-28","2025-03-26","SF FuneralFDC000000035B7250326","","220","","1025265.43"
"2025-03-28","2025-03-26","SF FuneralF1074496      250326","","191.5","","1025456.93"
"2025-03-28","2025-03-26","SF FuneralF1120815      250326","","31.63","","1025488.56"
"2025-03-28","2025-03-20","SF FuneralF986678       250322","","213.31","","1025701.87"
"2025-03-28","2025-03-20","SF FuneralF987149       250322","","126.5","","1025828.37"
"2025-03-28","2025-03-28","SF FuneralFDC00000006DH3250328","","126.5","","1025954.87"
"2025-03-28","2025-03-28","SF FuneralF796377       250328","","126.5","","1026081.37"
"2025-03-28","2025-03-28","SF FuneralF832437       250328","","126.5","","1026207.87"
"2025-03-28","2025-03-28","SF FuneralF1022140      250328","","126.5","","1026334.37"
"2025-03-28","2025-03-28","SF FuneralF1115197      250328","","126.5","","1026460.87"
"2025-03-28","2025-03-28","SF FuneralF1115977      250328","","126.5","","1026587.37"
"2025-03-28","2025-03-28","SF FuneralF1132920      250328","","126.5","","1026713.87"
"2025-03-28","2025-03-25","SF FuneralFDC00000002RNL250325","","220","","1026933.87"
"2025-03-28","2025-03-25","SF FuneralFDC00000006NCC250325","","126.5","","1027060.37"
"2025-03-28","2025-03-25","SF FuneralFDC00000006P3F250325","","126.5","","1027186.87"
"2025-03-28","2025-03-25","SF FuneralFDC00000007CR3250325","","126.5","","1027313.37"
"2025-03-28","2025-03-25","SF FuneralFDC00000007NHV250325","","63.25","","1027376.62"
"2025-03-28","2025-03-25","SF FuneralF795445       250325","","126.5","","1027503.12"
"2025-03-28","2025-03-25","SF FuneralF813106       250325","","126.5","","1027629.62"
"2025-03-28","2025-03-25","SF FuneralF813412       250325","","126.5","","1027756.12"
"2025-03-28","2025-03-25","SF FuneralF812358       250325","","126.5","","1027882.62"
"2025-03-28","2025-03-25","SF FuneralFDC00000009VCF250325","","126.5","","1028009.12"
"2025-03-28","2025-03-25","SF FuneralF819921       250325","","126.5","","1028135.62"
"2025-03-28","2025-03-25","SF FuneralF828867       250325","","31.63","","1028167.25"
"2025-03-28","2025-03-25","SF FuneralF816143       250325","","126.5","","1028293.75"
"2025-03-28","2025-03-25","SF FuneralF1021297      250325","","126.5","","1028420.25"
"2025-03-28","2025-03-25","SF FuneralF1059394      250325","","63.25","","1028483.5"
"2025-03-28","2025-03-25","SF FuneralF1108822      250325","","126.5","","1028610"
"2025-03-28","2025-03-25","SF FuneralF1111588      250325","","31.63","","1028641.63"
"2025-03-28","2025-03-25","SF FuneralFDC0000000N8HR250325","","63.25","","1028704.88"
"2025-03-28","2025-03-25","SF FuneralF1116750      250325","","126.5","","1028831.38"
"2025-03-28","2025-03-25","SF FuneralF1118308      250325","","31.63","","1028863.01"
"2025-03-28","2025-03-25","SF FuneralF1119889      250325","","31.63","","1028894.64"
"2025-03-28","2025-03-25","SF FuneralF1120333      250325","","126.5","","1029021.14"
"2025-03-28","2025-03-25","SF FuneralF1124111      250325","","63.25","","1029084.39"
"2025-03-28","2025-03-25","SF FuneralF1127611      250325","","31.63","","1029116.02"
"2025-03-28","2025-03-25","SF FuneralF1129130      250325","","126.5","","1029242.52"
"2025-03-28","2025-03-25","SF FuneralF1130742      250325","","126.5","","1029369.02"
"2025-03-28","2025-03-25","SF FuneralF1133818      250325","","126.5","","1029495.52"
"2025-03-28","2025-03-24","SF FuneralF988329       250324","","126.5","","1029622.02"
"2025-03-28","2025-03-22","SF FuneralFDC000000071MW250322","","126.5","","1029748.52"
"2025-03-28","2025-03-22","SF FuneralFDC0000000783S250322","","191.5","","1029940.02"
"2025-03-28","2025-03-22","SF FuneralF808243       250322","","126.5","","1030066.52"
"2025-03-28","2025-03-22","SF FuneralF819847       250322","","126.5","","1030193.02"
"2025-03-28","2025-03-22","SF FuneralF1117998      250323","","31.63","","1030224.65"
"2025-03-28","2025-03-28","SF FuneralFDC000000072PT250328","","126.5","","1030351.15"
"2025-03-28","2025-03-28","SF FuneralF830967       250328","","126.5","","1030477.65"
"2025-03-28","2025-03-28","SF FuneralF844262       250328","","126.5","","1030604.15"
"2025-03-28","2025-03-28","SF FuneralFDC0000000M3LH250328","","126.5","","1030730.65"
"2025-03-28","2025-03-28","SF FuneralF1127920      250328","","126.5","","1030857.15"
"2025-03-28","2025-03-28","SF FuneralF1134370      250328","","126.5","","1030983.65"
"2025-03-28","2025-03-28","SF FuneralF1135502      250328","","126.5","","1031110.15"
"2025-03-28","2025-03-28","SF FuneralFDC00000005R18250328","","126.5","","1031236.65"
"2025-03-28","2025-03-28","SF FuneralF987285       250328","","126.5","","1031363.15"
"2025-03-28","2025-03-28","SF FuneralF1074705      250328","","126.5","","1031489.65"
"2025-03-28","2025-03-28","SF FuneralF1135028      250328","","126.5","","1031616.15"
"2025-03-28","2025-03-28","SF FuneralF810567       250328","","126.5","","1031742.65"
"2025-03-28","2025-03-28","SF FuneralF820823       250328","","126.5","","1031869.15"
"2025-03-28","2025-03-28","SF FuneralF1021761      250328","","126.5","","1031995.65"
"2025-03-28","2025-03-28","SF FuneralFDC0000000NPT3250328","","126.5","","1032122.15"
"2025-03-28","2025-03-28","SF FuneralFDC0000000PT0D250328","","126.5","","1032248.65"
"2025-03-28","2025-03-28","SF FuneralFDC000000067VF250328","","126.5","","1032375.15"
"2025-03-28","2025-03-28","SF FuneralF816303       250328","","126.5","","1032501.65"
"2025-03-28","2025-03-28","SF FuneralF901224       250328","","126.5","","1032628.15"
"2025-03-28","2025-03-28","SF FuneralF1083709      250328","","126.5","","1032754.65"
"2025-03-28","2025-03-28","SF FuneralF1108618      250328","","126.5","","1032881.15"
"2025-03-28","2025-03-20","SF FuneralFDC000000063WH250320","","126.5","","1033007.65"
"2025-03-28","2025-03-25","SF FuneralFDC0000000HLZ7250325","","126.5","","1033134.15"
"2025-03-28","2025-03-26","SF FuneralF808985       250326","","126.5","","1033260.65"
"2025-03-28","2025-03-27","SF FuneralF828460       250327","","126.5","","1033387.15"
"2025-03-28","2025-03-27","SF FuneralF833201       250327","","126.5","","1033513.65"
"2025-03-28","2025-03-22","SF FuneralFDC00000005XS3250321","","31.63","","1033545.28"
"2025-03-28","2025-03-24","SF FuneralFDC00000007GFX250323","","31.63","","1033576.91"
"2025-03-28","2025-03-24","SF FuneralFDC00000007GG1250323","","31.63","","1033608.54"
"2025-03-28","2025-03-24","SF FuneralFDC0000000F7T2250324","","31.63","","1033640.17"
"2025-03-28","2025-03-24","SF FuneralF1123291      250324","","31.63","","1033671.8"
"2025-03-28","2025-03-25","SF FuneralFDC000000051KX250325","","31.63","","1033703.43"
"2025-03-28","2025-03-25","SF FuneralFDC0000000690Q250325","","31.63","","1033735.06"
"2025-03-28","2025-03-25","SF FuneralFDC00000006SSB250325","","31.63","","1033766.69"
"2025-03-28","2025-03-25","SF FuneralFDC00000006ST9250325","","31.63","","1033798.32"
"2025-03-28","2025-03-25","SF FuneralFDC00000006STJ250325","","31.63","","1033829.95"
"2025-03-28","2025-03-25","SF FuneralFDC00000007FBC250325","","31.63","","1033861.58"
"2025-03-28","2025-03-25","SF FuneralFDC00000007WH2250325","","47.88","","1033909.46"
"2025-03-28","2025-03-25","SF FuneralF798846       250325","","31.63","","1033941.09"
"2025-03-28","2025-03-25","SF FuneralF799673       250325","","31.63","","1033972.72"
"2025-03-28","2025-03-25","SF FuneralF801219       250325","","31.63","","1034004.35"
"2025-03-28","2025-03-25","SF FuneralF802169       250325","","31.63","","1034035.98"
"2025-03-28","2025-03-25","SF FuneralFDC00000008M07250325","","31.63","","1034067.61"
"2025-03-28","2025-03-25","SF FuneralFDC00000008M09250325","","31.63","","1034099.24"
"2025-03-28","2025-03-25","SF FuneralF805662       250325","","31.63","","1034130.87"
"2025-03-28","2025-03-25","SF FuneralF811275       250325","","31.63","","1034162.5"
"2025-03-28","2025-03-25","SF FuneralF822125       250325","","31.63","","1034194.13"
"2025-03-28","2025-03-25","SF FuneralF827812       250325","","31.63","","1034225.76"
"2025-03-28","2025-03-25","SF FuneralF832888       250325","","31.63","","1034257.39"
"2025-03-28","2025-03-25","SF FuneralF833515       250325","","31.63","","1034289.02"
"2025-03-28","2025-03-25","SF FuneralF833824       250325","","31.63","","1034320.65"
"2025-03-28","2025-03-25","SF FuneralF834203       250325","","31.63","","1034352.28"
"2025-03-28","2025-03-25","SF FuneralF986709       250325","","31.63","","1034383.91"
"2025-03-28","2025-03-25","SF FuneralF988236       250325","","31.63","","1034415.54"
"2025-03-28","2025-03-25","SF FuneralF992519       250325","","31.63","","1034447.17"
"2025-03-28","2025-03-25","SF FuneralF1021467      250325","","31.63","","1034478.8"
"2025-03-28","2025-03-25","SF FuneralF1066647      250325","","31.63","","1034510.43"
"2025-03-28","2025-03-25","SF FuneralFDC0000000L215250325","","31.63","","1034542.06"
"2025-03-28","2025-03-25","SF FuneralF1073297      250325","","31.63","","1034573.69"
"2025-03-28","2025-03-25","SF FuneralF1073828      250325","","31.63","","1034605.32"
"2025-03-28","2025-03-25","SF FuneralF1074647      250325","","31.63","","1034636.95"
"2025-03-28","2025-03-25","SF FuneralF1083692      250325","","31.63","","1034668.58"
"2025-03-28","2025-03-25","SF FuneralF1084860      250325","","31.63","","1034700.21"
"2025-03-28","2025-03-25","SF FuneralF1112349      250325","","31.63","","1034731.84"
"2025-03-28","2025-03-25","SF FuneralFDC0000000NBRM250325","","31.63","","1034763.47"
"2025-03-28","2025-03-25","SF FuneralFDC0000000NRQK250325","","31.63","","1034795.1"
"2025-03-28","2025-03-25","SF FuneralF1120226      250325","","31.63","","1034826.73"
"2025-03-28","2025-03-25","SF FuneralF1121908      250325","","31.63","","1034858.36"
"2025-03-28","2025-03-25","SF FuneralF1123497      250325","","31.63","","1034889.99"
"2025-03-28","2025-03-25","SF FuneralF1124052      250325","","31.63","","1034921.62"
"2025-03-28","2025-03-25","SF FuneralF1126072      250325","","31.63","","1034953.25"
"2025-03-28","2025-03-25","SF FuneralF1126086      250325","","31.63","","1034984.88"
"2025-03-28","2025-03-25","SF FuneralF1127480      250325","","31.63","","1035016.51"
"2025-03-28","2025-03-25","SF FuneralF1127528      250325","","31.63","","1035048.14"
"2025-03-28","2025-03-25","SF FuneralF1127719      250325","","31.63","","1035079.77"
"2025-03-28","2025-03-25","SF FuneralF1127863      250325","","31.63","","1035111.4"
"2025-03-28","2025-03-25","SF FuneralF1131484      250325","","31.63","","1035143.03"
"2025-03-28","2025-03-25","SF FuneralF1131495      250325","","31.63","","1035174.66"
"2025-03-28","2025-03-25","SF FuneralF1131696      250325","","31.63","","1035206.29"
"2025-03-28","2025-03-25","SF FuneralF1132381      250325","","31.63","","1035237.92"
"2025-03-28","2025-03-25","SF FuneralF1132895      250325","","31.63","","1035269.55"
"2025-03-28","2025-03-25","SF FuneralF1133704      250325","","31.63","","1035301.18"
"2025-03-28","2025-03-25","SF FuneralF1133759      250325","","31.63","","1035332.81"
"2025-03-28","2025-03-25","SF FuneralF1134525      250325","","31.63","","1035364.44"
"2025-03-28","2025-03-26","SF FuneralFDC00000006J82250326","","31.63","","1035396.07"
"2025-03-28","2025-03-28","SF FuneralFDC00000005SMZ250328","","126.5","","1035522.57"
"2025-03-28","2025-03-28","SF FuneralF812708       250328","","126.5","","1035649.07"
"2025-03-28","2025-03-27","SF FuneralF1016768      250327","","31.63","","1035680.7"
"2025-03-28","2025-03-28","SF FuneralFDC0000000HVXH250329","","31.63","","1035712.33"
"2025-03-28","2025-03-28","SF FuneralF1079509      250328","","31.63","","1035743.96"
"2025-03-28","2025-03-28","SF FuneralF1079664      250328","","31.63","","1035775.59"
"2025-03-28","2025-03-28","SF FuneralF1131198      250328","","31.63","","1035807.22"
"2025-03-28","2025-03-28","SF FuneralFDC000000039M8250328","","220","","1036027.22"
"2025-03-28","2025-03-28","SF FuneralFDC00000005S6H250328","","126.5","","1036153.72"
"2025-03-28","2025-03-28","SF FuneralFDC00000005W0P250328","","126.5","","1036280.22"
"2025-03-28","2025-03-28","SF FuneralFDC000000062CK250328","","126.5","","1036406.72"
"2025-03-28","2025-03-28","SF FuneralFDC000000065Z0250328","","126.5","","1036533.22"
"2025-03-28","2025-03-28","SF FuneralFDC000000069W3250328","","126.5","","1036659.72"
"2025-03-28","2025-03-28","SF FuneralFDC00000006D77250328","","126.5","","1036786.22"
"2025-03-28","2025-03-28","SF FuneralFDC00000006GXN250328","","126.5","","1036912.72"
"2025-03-28","2025-03-28","SF FuneralFDC00000006HJW250328","","126.5","","1037039.22"
"2025-03-28","2025-03-28","SF FuneralFDC00000006KFV250328","","126.5","","1037165.72"
"2025-03-28","2025-03-28","SF FuneralFDC00000006MK0250328","","126.5","","1037292.22"
"2025-03-28","2025-03-28","SF FuneralFDC0000000718W250328","","126.5","","1037418.72"
"2025-03-28","2025-03-28","SF FuneralFDC0000000828T250328","","126.5","","1037545.22"
"2025-03-28","2025-03-28","SF FuneralFDC000000082KD250328","","126.5","","1037671.72"
"2025-03-28","2025-03-28","SF FuneralFDC000000088Q6250328","","126.5","","1037798.22"
"2025-03-28","2025-03-28","SF FuneralFDC000000088Q7250328","","126.5","","1037924.72"
"2025-03-28","2025-03-28","SF FuneralF799850       250328","","126.5","","1038051.22"
"2025-03-28","2025-03-28","SF FuneralF799934       250328","","126.5","","1038177.72"
"2025-03-28","2025-03-28","SF FuneralF800145       250328","","126.5","","1038304.22"
"2025-03-28","2025-03-28","SF FuneralFDC00000008CY5250328","","126.5","","1038430.72"
"2025-03-28","2025-03-28","SF FuneralFDC00000008CYQ250328","","126.5","","1038557.22"
"2025-03-28","2025-03-28","SF FuneralF803213       250328","","126.5","","1038683.72"
"2025-03-28","2025-03-28","SF FuneralFDC00000008W95250328","","126.5","","1038810.22"
"2025-03-28","2025-03-28","SF FuneralF806002       250328","","126.5","","1038936.72"
"2025-03-28","2025-03-28","SF FuneralF808163       250328","","126.5","","1039063.22"
"2025-03-28","2025-03-28","SF FuneralF808784       250328","","126.5","","1039189.72"
"2025-03-28","2025-03-28","SF FuneralF809909       250328","","126.5","","1039316.22"
"2025-03-28","2025-03-28","SF FuneralFDC0000000972P250328","","126.5","","1039442.72"
"2025-03-28","2025-03-28","SF FuneralF815818       250328","","126.5","","1039569.22"
"2025-03-28","2025-03-28","SF FuneralF821696       250328","","126.5","","1039695.72"
"2025-03-28","2025-03-28","SF FuneralF821937       250328","","126.5","","1039822.22"
"2025-03-28","2025-03-28","SF FuneralF833448       250328","","126.5","","1039948.72"
"2025-03-28","2025-03-28","SF FuneralFDC0000000GXXY250328","","126.5","","1040075.22"
"2025-03-28","2025-03-28","SF FuneralF980484       250328","","126.5","","1040201.72"
"2025-03-28","2025-03-28","SF FuneralF990833       250328","","63.25","","1040264.97"
"2025-03-28","2025-03-28","SF FuneralFDC0000000JMVM250328","","63.25","","1040328.22"
"2025-03-28","2025-03-28","SF FuneralF1020886      250328","","126.5","","1040454.72"
"2025-03-28","2025-03-28","SF FuneralF1021062      250328","","126.5","","1040581.22"
"2025-03-28","2025-03-28","SF FuneralFDC0000000JWGS250328","","126.5","","1040707.72"
"2025-03-28","2025-03-28","SF FuneralF1022052      250328","","126.5","","1040834.22"
"2025-03-28","2025-03-28","SF FuneralF1065771      250328","","126.5","","1040960.72"
"2025-03-28","2025-03-28","SF FuneralF1065992      250328","","126.5","","1041087.22"
"2025-03-28","2025-03-28","SF FuneralFDC0000000LT3Q250328","","126.5","","1041213.72"
"2025-03-28","2025-03-28","SF FuneralF1084689      250328","","126.5","","1041340.22"
"2025-03-28","2025-03-28","SF FuneralF1085240      250328","","126.5","","1041466.72"
"2025-03-28","2025-03-28","SF FuneralF1085493      250328","","126.5","","1041593.22"
"2025-03-28","2025-03-28","SF FuneralF1102841      250328","","126.5","","1041719.72"
"2025-03-28","2025-03-28","SF FuneralF1103630      250328","","126.5","","1041846.22"
"2025-03-28","2025-03-28","SF FuneralF1108594      250328","","126.5","","1041972.72"
"2025-03-28","2025-03-28","SF FuneralFDC0000000MFWX250328","","126.5","","1042099.22"
"2025-03-28","2025-03-28","SF FuneralF1108654      250328","","126.5","","1042225.72"
"2025-03-28","2025-03-28","SF FuneralF1110093      250328","","126.5","","1042352.22"
"2025-03-28","2025-03-28","SF FuneralFDC0000000MM2D250328","","126.5","","1042478.72"
"2025-03-28","2025-03-28","SF FuneralFDC0000000MM2M250328","","126.5","","1042605.22"
"2025-03-28","2025-03-28","SF FuneralF1110370      250328","","126.5","","1042731.72"
"2025-03-28","2025-03-28","SF FuneralFDC0000000MNC2250328","","126.5","","1042858.22"
"2025-03-28","2025-03-28","SF FuneralF1111315      250328","","126.5","","1042984.72"
"2025-03-28","2025-03-28","SF FuneralFDC0000000MQNQ250328","","126.5","","1043111.22"
"2025-03-28","2025-03-28","SF FuneralFDC0000000N3SL250328","","126.5","","1043237.72"
"2025-03-28","2025-03-28","SF FuneralF1115882      250328","","126.5","","1043364.22"
"2025-03-28","2025-03-28","SF FuneralF1116749      250328","","126.5","","1043490.72"
"2025-03-28","2025-03-28","SF FuneralF1118106      250328","","126.5","","1043617.22"
"2025-03-28","2025-03-28","SF FuneralF1118105      250328","","126.5","","1043743.72"
"2025-03-28","2025-03-28","SF FuneralFDC0000000NN5J250328","","126.5","","1043870.22"
"2025-03-28","2025-03-28","SF FuneralF1118390      250328","","126.5","","1043996.72"
"2025-03-28","2025-03-28","SF FuneralF1125108      250328","","126.5","","1044123.22"
"2025-03-28","2025-03-28","SF FuneralF1125420      250328","","126.5","","1044249.72"
"2025-03-28","2025-03-28","SF FuneralF1127428      250328","","126.5","","1044376.22"
"2025-03-28","2025-03-28","SF FuneralF1127811      250328","","126.5","","1044502.72"
"2025-03-28","2025-03-28","SF FuneralF1127854      250328","","126.5","","1044629.22"
"2025-03-28","2025-03-28","SF FuneralF1127883      250328","","126.5","","1044755.72"
"2025-03-28","2025-03-28","SF FuneralF1128334      250328","","126.5","","1044882.22"
"2025-03-28","2025-03-28","SF FuneralF1132123      250328","","126.5","","1045008.72"
"2025-03-28","2025-03-28","SF FuneralF1133147      250328","","126.5","","1045135.22"
"2025-03-28","2025-03-28","SF FuneralF1133560      250328","","126.5","","1045261.72"
"2025-03-28","2025-03-28","SF FuneralF1134004      250328","","126.5","","1045388.22"
"2025-03-28","2025-03-28","SF FuneralF1134005      250328","","126.5","","1045514.72"
"2025-03-28","2025-03-28","SF FuneralFDC0000000QLNQ250328","","126.5","","1045641.22"
"2025-03-28","2025-03-28","SF FuneralFDC000000032VH250328","","55","","1045696.22"
"2025-03-28","2025-03-28","SF FuneralFDC00000005QCT250328","","31.63","","1045727.85"
"2025-03-28","2025-03-28","SF FuneralFDC00000005XS3250328","","31.63","","1045759.48"
"2025-03-28","2025-03-28","SF FuneralFDC00000007Q48250328","","31.63","","1045791.11"
"2025-03-28","2025-03-28","SF FuneralFDC0000000B37Y250328","","31.63","","1045822.74"
"2025-03-28","2025-03-28","SF FuneralF988945       250330","","31.63","","1045854.37"
"2025-03-28","2025-03-28","SF FuneralF989273       250330","","31.63","","1045886"
"2025-03-28","2025-03-28","SF FuneralFDC0000000J2XM250330","","31.63","","1045917.63"
"2025-03-28","2025-03-28","SF FuneralF1033620      250328","","31.63","","1045949.26"
"2025-03-28","2025-03-28","SF FuneralF1033704      250328","","31.63","","1045980.89"
"2025-03-28","2025-03-28","SF FuneralF1065649      250328","","31.63","","1046012.52"
"2025-03-28","2025-03-28","SF FuneralF1119753      250328","","31.63","","1046044.15"
"2025-03-28","2025-03-28","SF FuneralF1122941      250328","","31.63","","1046075.78"
"2025-03-28","2025-03-28","SF FuneralFDC0000000PK3S250328","","31.63","","1046107.41"
"2025-03-28","2025-03-28","SF FuneralFDC0000000Q9Z0250328","","31.63","","1046139.04"
"2025-03-28","2025-03-28","SF FuneralF1132933      250328","","31.63","","1046170.67"
"2025-03-28","2025-03-24","SF FuneralFDC00000006J7G250324","","126.5","","1046297.17"
"2025-03-28","2025-03-24","SF FuneralFDC000000080XP250324","","126.5","","1046423.67"
"2025-03-28","2025-03-24","SF FuneralF816487       250324","","126.5","","1046550.17"
"2025-03-28","2025-03-24","SF FuneralF818774       250323","","126.5","","1046676.67"
"2025-03-28","2025-03-24","SF FuneralF843031       250323","","126.5","","1046803.17"
"2025-03-28","2025-03-24","SF FuneralF843997       250322","","126.5","","1046929.67"
"2025-03-28","2025-03-24","SF FuneralF847467       250322","","126.5","","1047056.17"
"2025-03-28","2025-03-24","SF FuneralF986873       250324","","126.5","","1047182.67"
"2025-03-28","2025-03-24","SF FuneralF986887       250324","","126.5","","1047309.17"
"2025-03-28","2025-03-24","SF FuneralF987064       250324","","126.5","","1047435.67"
"2025-03-28","2025-03-24","SF FuneralFDC0000000HT78250324","","126.5","","1047562.17"
"2025-03-28","2025-03-24","SF FuneralF987883       250324","","126.5","","1047688.67"
"2025-03-28","2025-03-24","SF FuneralF990149       250324","","126.5","","1047815.17"
"2025-03-28","2025-03-24","SF FuneralF993751       250324","","126.5","","1047941.67"
"2025-03-28","2025-03-24","SF FuneralF1017122      250324","","126.5","","1048068.17"
"2025-03-28","2025-03-24","SF FuneralF1021299      250324","","126.5","","1048194.67"
"2025-03-28","2025-03-24","SF FuneralF1055228      250324","","126.5","","1048321.17"
"2025-03-28","2025-03-24","SF FuneralF1061853      250324","","126.5","","1048447.67"
"2025-03-28","2025-03-24","SF FuneralFDC0000000MK0D250324","","126.5","","1048574.17"
"2025-03-28","2025-03-24","SF FuneralF1110179      250324","","126.5","","1048700.67"
"2025-03-28","2025-03-24","SF FuneralF1112404      250324","","126.5","","1048827.17"
"2025-03-28","2025-03-24","SF FuneralF1113132      250324","","126.5","","1048953.67"
"2025-03-28","2025-03-24","SF FuneralF1113588      250324","","126.5","","1049080.17"
"2025-03-28","2025-03-24","SF FuneralF1113737      250324","","126.5","","1049206.67"
"2025-03-28","2025-03-24","SF FuneralF1113782      250324","","126.5","","1049333.17"
"2025-03-28","2025-03-24","SF FuneralF1113947      250324","","126.5","","1049459.67"
"2025-03-28","2025-03-24","SF FuneralF1131294      250324","","126.5","","1049586.17"
"2025-03-28","2025-03-24","SF FuneralF1134719      250324","","126.5","","1049712.67"
"2025-03-28","2025-03-26","SF FuneralFDC00000005GGW250326","","126.5","","1049839.17"
"2025-03-28","2025-03-26","SF FuneralFDC00000006DGL250326","","126.5","","1049965.67"
"2025-03-28","2025-03-26","SF FuneralFDC00000006WCL250326","","126.5","","1050092.17"
"2025-03-28","2025-03-26","SF FuneralFDC00000006WCW250326","","126.5","","1050218.67"
"2025-03-28","2025-03-26","SF FuneralFDC00000006WCZ250326","","126.5","","1050345.17"
"2025-03-28","2025-03-26","SF FuneralFDC00000006X9Y250326","","126.5","","1050471.67"
"2025-03-28","2025-03-26","SF FuneralFDC00000007ZQR250326","","126.5","","1050598.17"
"2025-03-28","2025-03-26","SF FuneralF809353       250326","","126.5","","1050724.67"
"2025-03-28","2025-03-26","SF FuneralF827594       250326","","126.5","","1050851.17"
"2025-03-28","2025-03-26","SF FuneralF829467       250326","","126.5","","1050977.67"
"2025-03-28","2025-03-26","SF FuneralF830065       250326","","126.5","","1051104.17"
"2025-03-28","2025-03-26","SF FuneralF832030       250326","","126.5","","1051230.67"
"2025-03-28","2025-03-26","SF FuneralF840857       250326","","126.5","","1051357.17"
"2025-03-28","2025-03-26","SF FuneralF840898       250326","","126.5","","1051483.67"
"2025-03-28","2025-03-26","SF FuneralF988892       250326","","126.5","","1051610.17"
"2025-03-28","2025-03-26","SF FuneralF992088       250326","","126.5","","1051736.67"
"2025-03-28","2025-03-26","SF FuneralF992851       250326","","126.5","","1051863.17"
"2025-03-28","2025-03-26","SF FuneralF993391       250326","","126.5","","1051989.67"
"2025-03-28","2025-03-26","SF FuneralF994056       250326","","126.5","","1052116.17"
"2025-03-28","2025-03-26","SF FuneralF1017461      250326","","126.5","","1052242.67"
"2025-03-28","2025-03-26","SF FuneralF1074810      250326","","126.5","","1052369.17"
"2025-03-28","2025-03-26","SF FuneralFDC0000000LGVG250326","","126.5","","1052495.67"
"2025-03-28","2025-03-26","SF FuneralFDC0000000LSVT250326","","126.5","","1052622.17"
"2025-03-28","2025-03-26","SF FuneralF1104136      250326","","126.5","","1052748.67"
"2025-03-28","2025-03-26","SF FuneralFDC0000000N319250326","","126.5","","1052875.17"
"2025-03-28","2025-03-26","SF FuneralFDC0000000NLGP250326","","126.5","","1053001.67"
"2025-03-28","2025-03-26","SF FuneralF1123084      250326","","126.5","","1053128.17"
"2025-03-28","2025-03-26","SF FuneralFDC0000000P5Q2250326","","126.5","","1053254.67"
"2025-03-28","2025-03-26","SF FuneralFDC0000000P753250326","","213.31","","1053467.98"
"2025-03-28","2025-03-26","SF FuneralFDC0000000PP1Z250326","","126.5","","1053594.48"
"2025-03-28","2025-03-26","SF FuneralF1133541      250326","","126.5","","1053720.98"
"2025-03-28","2025-03-27","SF FuneralFDC00000002XFJ250327","","220","","1053940.98"
"2025-03-28","2025-03-27","SF FuneralFDC00000005W2B250327","","126.5","","1054067.48"
"2025-03-28","2025-03-27","SF FuneralFDC00000006D4Q250327","","126.5","","1054193.98"
"2025-03-28","2025-03-27","SF FuneralFDC00000006VQP250327","","126.5","","1054320.48"
"2025-03-28","2025-03-27","SF FuneralFDC00000007225250327","","126.5","","1054446.98"
"2025-03-28","2025-03-27","SF FuneralF803250       250327","","126.5","","1054573.48"
"2025-03-28","2025-03-27","SF FuneralF813584       250327","","126.5","","1054699.98"
"2025-03-28","2025-03-27","SF FuneralF813999       250327","","126.5","","1054826.48"
"2025-03-28","2025-03-27","SF FuneralF821741       250327","","126.5","","1054952.98"
"2025-03-28","2025-03-27","SF FuneralFDC0000000BH67250327","","126.5","","1055079.48"
"2025-03-28","2025-03-27","SF FuneralF823054       250327","","126.5","","1055205.98"
"2025-03-28","2025-03-27","SF FuneralFDC0000000BP0W250327","","126.5","","1055332.48"
"2025-03-28","2025-03-27","SF FuneralFDC0000000BP51250327","","126.5","","1055458.98"
"2025-03-28","2025-03-27","SF FuneralF831129       250327","","126.5","","1055585.48"
"2025-03-28","2025-03-27","SF FuneralF840731       250327","","126.5","","1055711.98"
"2025-03-28","2025-03-27","SF FuneralF842789       250327","","126.5","","1055838.48"
"2025-03-28","2025-03-27","SF FuneralF842820       250327","","126.5","","1055964.98"
"2025-03-28","2025-03-27","SF FuneralF1020939      250327","","126.5","","1056091.48"
"2025-03-28","2025-03-27","SF FuneralF1055165      250327","","126.5","","1056217.98"
"2025-03-28","2025-03-27","SF FuneralFDC0000000KFLJ250327","","256.5","","1056474.48"
"2025-03-28","2025-03-27","SF FuneralF1068020      250327","","126.5","","1056600.98"
"2025-03-28","2025-03-27","SF FuneralF1073411      250327","","126.5","","1056727.48"
"2025-03-28","2025-03-27","SF FuneralF1074792      250327","","126.5","","1056853.98"
"2025-03-28","2025-03-27","SF FuneralF1078436      250327","","126.5","","1056980.48"
"2025-03-28","2025-03-27","SF FuneralF1078883      250327","","126.5","","1057106.98"
"2025-03-28","2025-03-27","SF FuneralF1108616      250327","","126.5","","1057233.48"
"2025-03-28","2025-03-27","SF FuneralF1112482      250327","","126.5","","1057359.98"
"2025-03-28","2025-03-27","SF FuneralF1112486      250327","","126.5","","1057486.48"
"2025-03-28","2025-03-27","SF FuneralF1112553      250327","","126.5","","1057612.98"
"2025-03-28","2025-03-27","SF FuneralF1113187      250327","","126.5","","1057739.48"
"2025-03-28","2025-03-27","SF FuneralF1120321      250327","","126.5","","1057865.98"
"2025-03-28","2025-03-27","SF FuneralF1127676      250327","","126.5","","1057992.48"
"2025-03-28","2025-03-27","SF FuneralF1128128      250327","","126.5","","1058118.98"
"2025-03-28","2025-03-28","SF FuneralFDC0000000594M250328","","126.5","","1058245.48"
"2025-03-28","2025-03-28","SF FuneralFDC00000005DKN250328","","126.5","","1058371.98"
"2025-03-28","2025-03-28","SF FuneralFDC00000005DPJ250328","","126.5","","1058498.48"
"2025-03-28","2025-03-28","SF FuneralFDC00000005DZJ250328","","126.5","","1058624.98"
"2025-03-28","2025-03-28","SF FuneralFDC00000005HG0250328","","126.5","","1058751.48"
"2025-03-28","2025-03-28","SF FuneralFDC00000005MG9250328","","126.5","","1058877.98"
"2025-03-28","2025-03-28","SF FuneralFDC00000005RMM250328","","220","","1059097.98"
"2025-03-28","2025-03-28","SF FuneralFDC00000005RMX250328","","126.5","","1059224.48"
"2025-03-28","2025-03-28","SF FuneralFDC00000005SZJ250328","","126.5","","1059350.98"
"2025-03-28","2025-03-28","SF FuneralFDC00000005X36250328","","126.5","","1059477.48"
"2025-03-28","2025-03-28","SF FuneralFDC00000005X3L250328","","220","","1059697.48"
"2025-03-28","2025-03-28","SF FuneralFDC000000060NQ250328","","126.5","","1059823.98"
"2025-03-28","2025-03-28","SF FuneralFDC000000063HM250328","","126.5","","1059950.48"
"2025-03-28","2025-03-28","SF FuneralFDC000000063T7250328","","126.5","","1060076.98"
"2025-03-28","2025-03-28","SF FuneralFDC000000064F4250328","","126.5","","1060203.48"
"2025-03-28","2025-03-28","SF FuneralFDC000000067RK250328","","126.5","","1060329.98"
"2025-03-28","2025-03-28","SF FuneralFDC0000000687P250328","","126.5","","1060456.48"
"2025-03-28","2025-03-28","SF FuneralFDC000000068GB250328","","126.5","","1060582.98"
"2025-03-28","2025-03-28","SF FuneralFDC00000006CSH250328","","126.5","","1060709.48"
"2025-03-28","2025-03-28","SF FuneralFDC00000006FTZ250328","","126.5","","1060835.98"
"2025-03-28","2025-03-28","SF FuneralFDC00000006XXD250328","","126.5","","1060962.48"
"2025-03-28","2025-03-28","SF FuneralFDC00000006ZYQ250328","","126.5","","1061088.98"
"2025-03-28","2025-03-28","SF FuneralFDC0000000728R250328","","126.5","","1061215.48"
"2025-03-28","2025-03-28","SF FuneralFDC000000073D2250328","","126.5","","1061341.98"
"2025-03-28","2025-03-28","SF FuneralFDC0000000763Q250328","","126.5","","1061468.48"
"2025-03-28","2025-03-28","SF FuneralFDC0000000764B250328","","126.5","","1061594.98"
"2025-03-28","2025-03-28","SF FuneralFDC00000007CLK250328","","126.5","","1061721.48"
"2025-03-28","2025-03-28","SF FuneralFDC00000007F6Z250328","","126.5","","1061847.98"
"2025-03-28","2025-03-28","SF FuneralFDC00000007RZ3250328","","126.5","","1061974.48"
"2025-03-28","2025-03-28","SF FuneralFDC00000007T63250328","","126.5","","1062100.98"
"2025-03-28","2025-03-28","SF FuneralFDC00000007VM6250328","","126.5","","1062227.48"
"2025-03-28","2025-03-28","SF FuneralFDC000000080W5250328","","126.5","","1062353.98"
"2025-03-28","2025-03-28","SF FuneralFDC000000081KJ250328","","126.5","","1062480.48"
"2025-03-28","2025-03-28","SF FuneralFDC000000083RT250328","","126.5","","1062606.98"
"2025-03-28","2025-03-28","SF FuneralF798192       250328","","126.5","","1062733.48"
"2025-03-28","2025-03-28","SF FuneralFDC00000008Z2L250328","","126.5","","1062859.98"
"2025-03-28","2025-03-28","SF FuneralF808560       250328","","126.5","","1062986.48"
"2025-03-28","2025-03-28","SF FuneralF814574       250328","","126.5","","1063112.98"
"2025-03-28","2025-03-28","SF FuneralF816011       250328","","126.5","","1063239.48"
"2025-03-28","2025-03-28","SF FuneralF817312       250328","","126.5","","1063365.98"
"2025-03-28","2025-03-28","SF FuneralF818537       250328","","126.5","","1063492.48"
"2025-03-28","2025-03-28","SF FuneralF818846       250328","","126.5","","1063618.98"
"2025-03-28","2025-03-28","SF FuneralF819216       250328","","126.5","","1063745.48"
"2025-03-28","2025-03-28","SF FuneralF819835       250328","","126.5","","1063871.98"
"2025-03-28","2025-03-28","SF FuneralF820024       250328","","126.5","","1063998.48"
"2025-03-28","2025-03-28","SF FuneralF817373       250328","","126.5","","1064124.98"
"2025-03-28","2025-03-28","SF FuneralF821028       250328","","126.5","","1064251.48"
"2025-03-28","2025-03-28","SF FuneralF822466       250328","","126.5","","1064377.98"
"2025-03-28","2025-03-28","SF FuneralFDC0000000CL62250328","","126.5","","1064504.48"
"2025-03-28","2025-03-28","SF FuneralF833046       250328","","126.5","","1064630.98"
"2025-03-28","2025-03-28","SF FuneralF833644       250328","","126.5","","1064757.48"
"2025-03-28","2025-03-28","SF FuneralFDC0000000CV8Z250328","","126.5","","1064883.98"
"2025-03-28","2025-03-28","SF FuneralF834975       250328","","126.5","","1065010.48"
"2025-03-28","2025-03-28","SF FuneralF900714       250328","","126.5","","1065136.98"
"2025-03-28","2025-03-28","SF FuneralF900842       250330","","63.25","","1065200.23"
"2025-03-28","2025-03-28","SF FuneralF981106       250328","","126.5","","1065326.73"
"2025-03-28","2025-03-28","SF FuneralF788809       250328","","256.5","","1065583.23"
"2025-03-28","2025-03-28","SF FuneralF987526       250328","","126.5","","1065709.73"
"2025-03-28","2025-03-28","SF FuneralF988257       250329","","126.5","","1065836.23"
"2025-03-28","2025-03-28","SF FuneralF990259       250330","","126.5","","1065962.73"
"2025-03-28","2025-03-28","SF FuneralF1020901      250328","","126.5","","1066089.23"
"2025-03-28","2025-03-28","SF FuneralFDC0000000KRM2250328","","126.5","","1066215.73"
"2025-03-28","2025-03-28","SF FuneralF1066136      250328","","126.5","","1066342.23"
"2025-03-28","2025-03-28","SF FuneralFDC0000000KY4F250328","","126.5","","1066468.73"
"2025-03-28","2025-03-28","SF FuneralFDC0000000KZ1N250328","","126.5","","1066595.23"
"2025-03-28","2025-03-28","SF FuneralFDC0000000L11W250328","","126.5","","1066721.73"
"2025-03-28","2025-03-28","SF FuneralF1075292      250328","","126.5","","1066848.23"
"2025-03-28","2025-03-28","SF FuneralF1079342      250328","","126.5","","1066974.73"
"2025-03-28","2025-03-28","SF FuneralF1079387      250328","","126.5","","1067101.23"
"2025-03-28","2025-03-28","SF FuneralF1083694      250328","","126.5","","1067227.73"
"2025-03-28","2025-03-28","SF FuneralFDC0000000LTGV250328","","126.5","","1067354.23"
"2025-03-28","2025-03-28","SF FuneralF1103860      250328","","126.5","","1067480.73"
"2025-03-28","2025-03-28","SF FuneralFDC0000000M6M1250328","","126.5","","1067607.23"
"2025-03-28","2025-03-28","SF FuneralFDC0000000M8C6250328","","126.5","","1067733.73"
"2025-03-28","2025-03-28","SF FuneralFDC0000000ND0M250328","","126.5","","1067860.23"
"2025-03-28","2025-03-28","SF FuneralF1115923      250328","","126.5","","1067986.73"
"2025-03-28","2025-03-28","SF FuneralF1116065      250328","","126.5","","1068113.23"
"2025-03-28","2025-03-28","SF FuneralF1117337      250328","","126.5","","1068239.73"
"2025-03-28","2025-03-28","SF FuneralF1117977      250328","","126.5","","1068366.23"
"2025-03-28","2025-03-28","SF FuneralF1117982      250328","","126.5","","1068492.73"
"2025-03-28","2025-03-28","SF FuneralFDC0000000NQH5250328","","126.5","","1068619.23"
"2025-03-28","2025-03-28","SF FuneralF1119023      250328","","126.5","","1068745.73"
"2025-03-28","2025-03-28","SF FuneralF1119032      250328","","126.5","","1068872.23"
"2025-03-28","2025-03-28","SF FuneralF1125081      250328","","126.5","","1068998.73"
"2025-03-28","2025-03-28","SF FuneralF1126856      250328","","126.5","","1069125.23"
"2025-03-28","2025-03-28","SF FuneralF1128724      250328","","126.5","","1069251.73"
"2025-03-28","2025-03-28","SF FuneralF1128875      250328","","126.5","","1069378.23"
"2025-03-28","2025-03-28","SF FuneralF1129307      250328","","126.5","","1069504.73"
"2025-03-28","2025-03-28","SF FuneralF1129311      250328","","126.5","","1069631.23"
"2025-03-28","2025-03-28","SF FuneralFDC0000000PYJQ250328","","126.5","","1069757.73"
"2025-03-28","2025-03-28","SF FuneralF1129884      250328","","126.5","","1069884.23"
"2025-03-28","2025-03-28","SF FuneralFDC0000000PZPX250328","","126.5","","1070010.73"
"2025-03-28","2025-03-28","SF FuneralF1130273      250328","","126.5","","1070137.23"
"2025-03-28","2025-03-28","SF FuneralF1133518      250328","","126.5","","1070263.73"
"2025-03-28","2025-03-28","SF FuneralFDC0000000QFJ6250328","","126.5","","1070390.23"
"2025-03-28","2025-03-28","SF FuneralF1133827      250328","","126.5","","1070516.73"
"2025-03-28","2025-03-28","SF FuneralFDC0000000QGHX250328","","126.5","","1070643.23"
"2025-03-28","2025-03-28","SF FuneralFDC0000000QHMF250328","","126.5","","1070769.73"
"2025-03-28","2025-03-28","SF FuneralFDC0000000QJK2250328","","126.5","","1070896.23"
"2025-03-28","2025-03-28","SF FuneralFDC0000000QK9R250328","","126.5","","1071022.73"
"2025-03-28","2025-03-28","SF FuneralFDC0000000QK9S250328","","126.5","","1071149.23"
"2025-03-28","2025-03-25","SF FuneralFDC00000005LGY250325","","126.5","","1071275.73"
"2025-03-28","2025-03-25","SF FuneralFDC00000005W77250325","","126.5","","1071402.23"
"2025-03-28","2025-03-25","SF FuneralFDC00000005X62250325","","126.5","","1071528.73"
"2025-03-28","2025-03-25","SF FuneralFDC00000005ZFX250325","","126.5","","1071655.23"
"2025-03-28","2025-03-25","SF FuneralFDC000000062D3250325","","126.5","","1071781.73"
"2025-03-28","2025-03-25","SF FuneralFDC00000006DSH250325","","126.5","","1071908.23"
"2025-03-28","2025-03-25","SF FuneralFDC00000006P88250325","","63.25","","1071971.48"
"2025-03-28","2025-03-25","SF FuneralFDC00000006RB3250325","","126.5","","1072097.98"
"2025-03-28","2025-03-25","SF FuneralFDC00000006WH1250325","","126.5","","1072224.48"
"2025-03-28","2025-03-25","SF FuneralFDC0000000775D250325","","126.5","","1072350.98"
"2025-03-28","2025-03-25","SF FuneralFDC00000007D6D250325","","126.5","","1072477.48"
"2025-03-28","2025-03-25","SF FuneralFDC00000007FRN250325","","220","","1072697.48"
"2025-03-28","2025-03-25","SF FuneralFDC00000007L17250325","","126.5","","1072823.98"
"2025-03-28","2025-03-25","SF FuneralFDC00000007PN2250325","","126.5","","1072950.48"
"2025-03-28","2025-03-25","SF FuneralFDC00000007Q10250325","","126.5","","1073076.98"
"2025-03-28","2025-03-25","SF FuneralFDC00000007RN8250325","","126.5","","1073203.48"
"2025-03-28","2025-03-25","SF FuneralF794564       250325","","63.25","","1073266.73"
"2025-03-28","2025-03-25","SF FuneralFDC00000007SP3250325","","126.5","","1073393.23"
"2025-03-28","2025-03-25","SF FuneralFDC00000007VNM250325","","126.5","","1073519.73"
"2025-03-28","2025-03-25","SF FuneralFDC00000007XQN250325","","126.5","","1073646.23"
"2025-03-28","2025-03-25","SF FuneralFDC000000081DM250325","","126.5","","1073772.73"
"2025-03-28","2025-03-25","SF FuneralFDC000000087HW250325","","126.5","","1073899.23"
"2025-03-28","2025-03-25","SF FuneralFDC00000008M1T250325","","126.5","","1074025.73"
"2025-03-28","2025-03-25","SF FuneralF804243       250325","","126.5","","1074152.23"
"2025-03-28","2025-03-25","SF FuneralF804883       250325","","126.5","","1074278.73"
"2025-03-28","2025-03-25","SF FuneralF802368       250325","","126.5","","1074405.23"
"2025-03-28","2025-03-25","SF FuneralFDC00000009618250325","","126.5","","1074531.73"
"2025-03-28","2025-03-25","SF FuneralF811307       250325","","126.5","","1074658.23"
"2025-03-28","2025-03-25","SF FuneralF806016       250325","","126.5","","1074784.73"
"2025-03-28","2025-03-25","SF FuneralF815962       250325","","126.5","","1074911.23"
"2025-03-28","2025-03-25","SF FuneralF816505       250325","","126.5","","1075037.73"
"2025-03-28","2025-03-25","SF FuneralF816575       250325","","126.5","","1075164.23"
"2025-03-28","2025-03-25","SF FuneralF817679       250325","","126.5","","1075290.73"
"2025-03-28","2025-03-25","SF FuneralF818304       250325","","126.5","","1075417.23"
"2025-03-28","2025-03-25","SF FuneralF818886       250325","","126.5","","1075543.73"
"2025-03-28","2025-03-25","SF FuneralF822630       250325","","63.25","","1075606.98"
"2025-03-28","2025-03-25","SF FuneralF822823       250325","","63.25","","1075670.23"
"2025-03-28","2025-03-25","SF FuneralF823399       250325","","126.5","","1075796.73"
"2025-03-28","2025-03-25","SF FuneralF798847       250325","","126.5","","1075923.23"
"2025-03-28","2025-03-25","SF FuneralF823481       250325","","126.5","","1076049.73"
"2025-03-28","2025-03-25","SF FuneralFDC0000000BL9M250325","","126.5","","1076176.23"
"2025-03-28","2025-03-25","SF FuneralF829846       250325","","126.5","","1076302.73"
"2025-03-28","2025-03-25","SF FuneralF830076       250325","","63.25","","1076365.98"
"2025-03-28","2025-03-25","SF FuneralF830100       250325","","63.25","","1076429.23"
"2025-03-28","2025-03-25","SF FuneralF830225       250325","","126.5","","1076555.73"
"2025-03-28","2025-03-25","SF FuneralF831840       250325","","126.5","","1076682.23"
"2025-03-28","2025-03-25","SF FuneralF840527       250325","","126.5","","1076808.73"
"2025-03-28","2025-03-25","SF FuneralF840977       250325","","126.5","","1076935.23"
"2025-03-28","2025-03-25","SF FuneralF900889       250325","","126.5","","1077061.73"
"2025-03-28","2025-03-25","SF FuneralF981133       250325","","126.5","","1077188.23"
"2025-03-28","2025-03-25","SF FuneralF981764       250325","","126.5","","1077314.73"
"2025-03-28","2025-03-25","SF FuneralF987227       250325","","126.5","","1077441.23"
"2025-03-28","2025-03-25","SF FuneralF990192       250325","","126.5","","1077567.73"
"2025-03-28","2025-03-25","SF FuneralF991773       250325","","126.5","","1077694.23"
"2025-03-28","2025-03-25","SF FuneralF992479       250325","","63.25","","1077757.48"
"2025-03-28","2025-03-25","SF FuneralF993898       250325","","63.25","","1077820.73"
"2025-03-28","2025-03-25","SF FuneralFDC0000000JHG8250325","","126.5","","1077947.23"
"2025-03-28","2025-03-25","SF FuneralF774903       250325","","126.5","","1078073.73"
"2025-03-28","2025-03-25","SF FuneralF1020834      250325","","126.5","","1078200.23"
"2025-03-28","2025-03-25","SF FuneralF1034023      250325","","126.5","","1078326.73"
"2025-03-28","2025-03-25","SF FuneralF1050670      250325","","126.5","","1078453.23"
"2025-03-28","2025-03-25","SF FuneralF987109       250325","","126.5","","1078579.73"
"2025-03-28","2025-03-25","SF FuneralF1052710      250325","","63.25","","1078642.98"
"2025-03-28","2025-03-25","SF FuneralF1060174      250325","","126.5","","1078769.48"
"2025-03-28","2025-03-25","SF FuneralF1060636      250325","","63.25","","1078832.73"
"2025-03-28","2025-03-25","SF FuneralF1060758      250325","","126.5","","1078959.23"
"2025-03-28","2025-03-25","SF FuneralF1060859      250325","","63.25","","1079022.48"
"2025-03-28","2025-03-25","SF FuneralF1066606      250325","","126.5","","1079148.98"
"2025-03-28","2025-03-25","SF FuneralFDC0000000KZ5V250325","","126.5","","1079275.48"
"2025-03-28","2025-03-25","SF FuneralF1068200      250325","","63.25","","1079338.73"
"2025-03-28","2025-03-25","SF FuneralF1073028      250325","","126.5","","1079465.23"
"2025-03-28","2025-03-25","SF FuneralF1073735      250325","","63.25","","1079528.48"
"2025-03-28","2025-03-25","SF FuneralF1078509      250325","","63.25","","1079591.73"
"2025-03-28","2025-03-25","SF FuneralF1079188      250325","","63.25","","1079654.98"
"2025-03-28","2025-03-25","SF FuneralF1080231      250325","","126.5","","1079781.48"
"2025-03-28","2025-03-25","SF FuneralF1085096      250325","","126.5","","1079907.98"
"2025-03-28","2025-03-25","SF FuneralF1085352      250325","","126.5","","1080034.48"
"2025-03-28","2025-03-25","SF FuneralF1110051      250325","","126.5","","1080160.98"
"2025-03-28","2025-03-25","SF FuneralF1112232      250325","","126.5","","1080287.48"
"2025-03-28","2025-03-25","SF FuneralF1112251      250325","","126.5","","1080413.98"
"2025-03-28","2025-03-25","SF FuneralF1112438      250325","","126.5","","1080540.48"
"2025-03-28","2025-03-25","SF FuneralFDC0000000N2L7250325","","63.25","","1080603.73"
"2025-03-28","2025-03-25","SF FuneralF1112459      250325","","63.25","","1080666.98"
"2025-03-28","2025-03-25","SF FuneralF1113595      250325","","126.5","","1080793.48"
"2025-03-28","2025-03-25","SF FuneralF1114553      250325","","63.25","","1080856.73"
"2025-03-28","2025-03-25","SF FuneralF1114885      250325","","126.5","","1080983.23"
"2025-03-28","2025-03-25","SF FuneralF1115024      250325","","126.5","","1081109.73"
"2025-03-28","2025-03-25","SF FuneralFDC0000000NHHD250325","","126.5","","1081236.23"
"2025-03-28","2025-03-25","SF FuneralF1116917      250325","","126.5","","1081362.73"
"2025-03-28","2025-03-25","SF FuneralF1116934      250325","","126.5","","1081489.23"
"2025-03-28","2025-03-25","SF FuneralF1118433      250325","","126.5","","1081615.73"
"2025-03-28","2025-03-25","SF FuneralF1119681      250325","","63.25","","1081678.98"
"2025-03-28","2025-03-25","SF FuneralF1119864      250325","","63.25","","1081742.23"
"2025-03-28","2025-03-25","SF FuneralF1120278      250325","","126.5","","1081868.73"
"2025-03-28","2025-03-25","SF FuneralFDC0000000P19V250325","","126.5","","1081995.23"
"2025-03-28","2025-03-25","SF FuneralF1080397      250325","","63.25","","1082058.48"
"2025-03-28","2025-03-25","SF FuneralF1123903      250325","","126.5","","1082184.98"
"2025-03-28","2025-03-25","SF FuneralF1125294      250325","","126.5","","1082311.48"
"2025-03-28","2025-03-25","SF FuneralF1126881      250325","","126.5","","1082437.98"
"2025-03-28","2025-03-25","SF FuneralFDC0000000PSD7250325","","126.5","","1082564.48"
"2025-03-28","2025-03-25","SF FuneralF1127817      250325","","126.5","","1082690.98"
"2025-03-28","2025-03-25","SF FuneralF1128117      250325","","126.5","","1082817.48"
"2025-03-28","2025-03-25","SF FuneralF1128919      250325","","126.5","","1082943.98"
"2025-03-28","2025-03-25","SF FuneralF1130365      250325","","126.5","","1083070.48"
"2025-03-28","2025-03-25","SF FuneralF1130506      250325","","126.5","","1083196.98"
"2025-03-28","2025-03-25","SF FuneralF1130601      250325","","126.5","","1083323.48"
"2025-03-28","2025-03-25","SF FuneralF1130829      250325","","126.5","","1083449.98"
"2025-03-28","2025-03-25","SF FuneralF1130979      250325","","126.5","","1083576.48"
"2025-03-28","2025-03-25","SF FuneralFDC0000000Q3TQ250325","","126.5","","1083702.98"
"2025-03-28","2025-03-25","SF FuneralF1130980      250325","","126.5","","1083829.48"
"2025-03-28","2025-03-25","SF FuneralF1131005      250325","","63.25","","1083892.73"
"2025-03-28","2025-03-25","SF FuneralFDC0000000Q41H250325","","126.5","","1084019.23"
"2025-03-28","2025-03-25","SF FuneralFDC0000000Q5XZ250325","","126.5","","1084145.73"
"2025-03-28","2025-03-25","SF FuneralFDC0000000Q6VY250325","","126.5","","1084272.23"
"2025-03-28","2025-03-25","SF FuneralFDC0000000Q6W2250325","","126.5","","1084398.73"
"2025-03-28","2025-03-25","SF FuneralF1132048      250325","","126.5","","1084525.23"
"2025-03-28","2025-03-25","SF FuneralF1132292      250325","","126.5","","1084651.73"
"2025-03-28","2025-03-25","SF FuneralF1132377      250325","","126.5","","1084778.23"
"2025-03-28","2025-03-25","SF FuneralFDC0000000Q8DY250325","","126.5","","1084904.73"
"2025-03-28","2025-03-25","SF FuneralF1132417      250325","","126.5","","1085031.23"
"2025-03-28","2025-03-25","SF FuneralF1133717      250325","","126.5","","1085157.73"
"2025-03-28","2025-03-25","SF FuneralFDC0000000QJ47250325","","126.5","","1085284.23"
"2025-03-28","2025-03-20","SF FuneralFDC00000006BZ7250320","","126.5","","1085410.73"
"2025-03-28","2025-03-20","SF FuneralF840770       250320","","126.5","","1085537.23"
"2025-03-28","2025-03-20","SF FuneralF844601       250320","","126.5","","1085663.73"
"2025-03-28","2025-03-20","SF FuneralF844637       250320","","126.5","","1085790.23"
"2025-03-28","2025-03-20","SF FuneralFDC0000000HQ1N250323","","126.5","","1085916.73"
"2025-03-28","2025-03-20","SF FuneralFDC0000000HQ1V250323","","126.5","","1086043.23"
"2025-03-28","2025-03-20","SF FuneralF988915       250322","","126.5","","1086169.73"
"2025-03-28","2025-03-20","SF FuneralF1066702      250321","","126.5","","1086296.23"
"2025-03-28","2025-03-24","SF FuneralFDC00000003GV3250324","","220","","1086516.23"
"2025-03-28","2025-03-24","SF FuneralFDC00000006CXF250323","","126.5","","1086642.73"
"2025-03-28","2025-03-24","SF FuneralFDC00000006XQB250324","","126.5","","1086769.23"
"2025-03-28","2025-03-24","SF FuneralFDC0000000744S250324","","126.5","","1086895.73"
"2025-03-28","2025-03-24","SF FuneralFDC00000007F71250324","","63.25","","1086958.98"
"2025-03-28","2025-03-24","SF FuneralFDC00000007L4Z250324","","126.5","","1087085.48"
"2025-03-28","2025-03-24","SF FuneralFDC00000007NPQ250324","","126.5","","1087211.98"
"2025-03-28","2025-03-24","SF FuneralFDC00000007Z7F250324","","126.5","","1087338.48"
"2025-03-28","2025-03-24","SF FuneralF781998       250323","","126.5","","1087464.98"
"2025-03-28","2025-03-24","SF FuneralF814731       250324","","126.5","","1087591.48"
"2025-03-28","2025-03-19","SF FuneralFDC00000006CWS250319","","126.5","","1087717.98"
"2025-03-28","2025-03-19","SF FuneralF1017784      250319","","126.5","","1087844.48"
"2025-03-28","2025-03-19","SF FuneralFDC0000000PW89250319","","126.5","","1087970.98"
"2025-03-28","2025-03-19","SF FuneralFDC0000000PW8D250319","","126.5","","1088097.48"
"2025-03-28","2025-03-19","SF FuneralF1128842      250319","","126.5","","1088223.98"
"2025-03-28","2025-03-22","SF FuneralFDC000000039M7250322","","220","","1088443.98"
"2025-03-28","2025-03-22","SF FuneralFDC00000003DZ8250322","","220","","1088663.98"
"2025-03-28","2025-03-22","SF FuneralFDC00000005XMQ250322","","126.5","","1088790.48"
"2025-03-28","2025-03-22","SF FuneralFDC00000005YCK250321","","126.5","","1088916.98"
"2025-03-28","2025-03-22","SF FuneralFDC00000005ZTF250322","","126.5","","1089043.48"
"2025-03-28","2025-03-22","SF FuneralFDC0000000717F250322","","126.5","","1089169.98"
"2025-03-28","2025-03-22","SF FuneralFDC000000072QC250322","","126.5","","1089296.48"
"2025-03-28","2025-03-22","SF FuneralFDC000000073BN250322","","126.5","","1089422.98"
"2025-03-28","2025-03-22","SF FuneralFDC00000007CP6250322","","126.5","","1089549.48"
"2025-03-28","2025-03-22","SF FuneralFDC00000007LQ4250322","","126.5","","1089675.98"
"2025-03-28","2025-03-22","SF FuneralFDC00000008BSZ250322","","126.5","","1089802.48"
"2025-03-28","2025-03-22","SF FuneralF804225       250322","","126.5","","1089928.98"
"2025-03-28","2025-03-22","SF FuneralFDC00000008XWQ250322","","126.5","","1090055.48"
"2025-03-28","2025-03-22","SF FuneralF808717       250322","","126.5","","1090181.98"
"2025-03-28","2025-03-22","SF FuneralFDC00000009PC6250322","","126.5","","1090308.48"
"2025-03-28","2025-03-22","SF FuneralFDC00000009SL5250322","","126.5","","1090434.98"
"2025-03-28","2025-03-22","SF FuneralFDC0000000BDL5250322","","126.5","","1090561.48"
"2025-03-28","2025-03-22","SF FuneralF823357       250322","","126.5","","1090687.98"
"2025-03-28","2025-03-22","SF FuneralFDC0000000BL9R250322","","126.5","","1090814.48"
"2025-03-28","2025-03-22","SF FuneralFDC0000000CTKT250322","","126.5","","1090940.98"
"2025-03-28","2025-03-22","SF FuneralF840761       250321","","126.5","","1091067.48"
"2025-03-28","2025-03-22","SF FuneralF991797       250322","","126.5","","1091193.98"
"2025-03-28","2025-03-22","SF FuneralF1017838      250322","","126.5","","1091320.48"
"2025-03-28","2025-03-22","SF FuneralF1021125      250322","","126.5","","1091446.98"
"2025-03-28","2025-03-22","SF FuneralF1050827      250322","","126.5","","1091573.48"
"2025-03-28","2025-03-22","SF FuneralF1054960      250322","","126.5","","1091699.98"
"2025-03-28","2025-03-22","SF FuneralF1059294      250323","","126.5","","1091826.48"
"2025-03-28","2025-03-22","SF FuneralF1061550      250322","","126.5","","1091952.98"
"2025-03-28","2025-03-22","SF FuneralF1061616      250322","","126.5","","1092079.48"
"2025-03-28","2025-03-22","SF FuneralF1061955      250322","","126.5","","1092205.98"
"2025-03-28","2025-03-22","SF FuneralFDC0000000KR0G250322","","126.5","","1092332.48"
"2025-03-28","2025-03-22","SF FuneralF1073547      250322","","126.5","","1092458.98"
"2025-03-28","2025-03-22","SF FuneralF1074690      250322","","126.5","","1092585.48"
"2025-03-28","2025-03-22","SF FuneralFDC0000000LR68250322","","126.5","","1092711.98"
"2025-03-28","2025-03-22","SF FuneralF1083806      250322","","126.5","","1092838.48"
"2025-03-28","2025-03-22","SF FuneralF1116788      250322","","126.5","","1092964.98"
"2025-03-28","2025-03-22","SF FuneralFDC0000000P1SV250322","","126.5","","1093091.48"
"2025-03-28","2025-03-22","SF FuneralF1124214      250322","","126.5","","1093217.98"
"2025-03-28","2025-03-22","SF FuneralFDC0000000PRPR250322","","191.5","","1093409.48"
"2025-03-28","2025-03-22","SF FuneralFDC0000000Q6QQ250322","","126.5","","1093535.98"
"2025-03-28","2025-03-22","SF FuneralF1132044      250322","","126.5","","1093662.48"
"2025-03-28","2025-03-27","SF FuneralFDC00000005WRS250327","","126.5","","1093788.98"
"2025-03-28","2025-03-28","SF FuneralFDC00000005P6V250328","","126.5","","1093915.48"
"2025-03-28","2025-03-28","SF FuneralFDC00000005WQG250328","","126.5","","1094041.98"
"2025-03-28","2025-03-28","SF FuneralFDC00000005ZVT250328","","126.5","","1094168.48"
"2025-03-28","2025-03-28","SF FuneralFDC000000068Q2250328","","126.5","","1094294.98"
"2025-03-28","2025-03-28","SF FuneralFDC00000006CGF250328","","126.5","","1094421.48"
"2025-03-28","2025-03-28","SF FuneralFDC000000071VH250328","","126.5","","1094547.98"
"2025-03-28","2025-03-28","SF FuneralFDC000000071VP250328","","126.5","","1094674.48"
"2025-03-28","2025-03-28","SF FuneralF803505       250328","","31.63","","1094706.11"
"2025-03-28","2025-03-28","SF FuneralF816077       250328","","126.5","","1094832.61"
"2025-03-28","2025-03-28","SF FuneralF816648       250328","","126.5","","1094959.11"
"2025-03-28","2025-03-28","SF FuneralF817939       250328","","126.5","","1095085.61"
"2025-03-28","2025-03-28","SF FuneralF1084563      250328","","126.5","","1095212.11"
"2025-03-28","2025-03-28","SF FuneralF1125699      250328","","126.5","","1095338.61"
"2025-03-28","2025-03-28","SF FuneralF1127440      250328","","126.5","","1095465.11"
"2025-03-28","2025-03-28","SF FuneralF1131921      250328","","31.63","","1095496.74"
"2025-03-28","2025-03-28","SF FuneralF1134728      250328","","126.5","","1095623.24"
"2025-03-28","2025-03-28","SF FuneralF1134817      250328","","31.63","","1095654.87"
"2025-03-28","2025-03-18","SF FuneralF1115104      250318","","63.25","","1095718.12"
"2025-03-28","2025-03-20","SF FuneralF987226       250322","","126.5","","1095844.62"
"2025-03-28","2025-03-22","SF FuneralFDC00000002SR6250322","","220","","1096064.62"
"2025-03-28","2025-03-22","SF FuneralFDC000000031H0250322","","220","","1096284.62"
"2025-03-28","2025-03-22","SF FuneralFDC00000007L3K250322","","126.5","","1096411.12"
"2025-03-28","2025-03-22","SF FuneralFDC00000007NRS250322","","126.5","","1096537.62"
"2025-03-28","2025-03-22","SF FuneralFDC000000085CS250322","","126.5","","1096664.12"
"2025-03-28","2025-03-22","SF FuneralFDC0000000DJ12250322","","126.5","","1096790.62"
"2025-03-28","2025-03-22","SF FuneralFDC0000000DJ18250322","","126.5","","1096917.12"
"2025-03-28","2025-03-22","SF FuneralFDC0000000DJ1Q250322","","126.5","","1097043.62"
"2025-03-28","2025-03-22","SF FuneralF1054856      250322","","126.5","","1097170.12"
"2025-03-28","2025-03-22","SF FuneralFDC0000000LB1K250322","","126.5","","1097296.62"
"2025-03-28","2025-03-22","SF FuneralF1108337      250322","","126.5","","1097423.12"
"2025-03-28","2025-03-22","SF FuneralFDC0000000NHM7250322","","126.5","","1097549.62"
"2025-03-28","2025-03-22","SF FuneralF1133053      250322","","126.5","","1097676.12"
"2025-03-28","2025-03-22","SF FuneralFDC0000000QFNC250322","","126.5","","1097802.62"
"2025-03-28","2025-03-24","SF FuneralFDC000000072XR250324","","126.5","","1097929.12"
"2025-03-28","2025-03-24","SF FuneralFDC000000077L1250324","","63.25","","1097992.37"
"2025-03-28","2025-03-24","SF FuneralFDC000000077LG250324","","110","","1098102.37"
"2025-03-28","2025-03-24","SF FuneralFDC00000007R6J250324","","63.25","","1098165.62"
"2025-03-28","2025-03-24","SF FuneralF833473       250324","","126.5","","1098292.12"
"2025-03-28","2025-03-24","SF FuneralF1059470      250324","","126.5","","1098418.62"
"2025-03-28","2025-03-24","SF FuneralF1078470      250324","","126.5","","1098545.12"
"2025-03-28","2025-03-24","SF FuneralF1080529      250324","","31.63","","1098576.75"
"2025-03-28","2025-03-24","SF FuneralF1120193      250324","","126.5","","1098703.25"
"2025-03-28","2025-03-24","SF FuneralFDC0000000Q5DS250324","","126.5","","1098829.75"
"2025-03-28","2025-03-24","SF FuneralF1133650      250324","","126.5","","1098956.25"
"2025-03-28","2025-03-24","SF FuneralF1133709      250324","","31.63","","1098987.88"
"2025-03-28","2025-03-25","SF FuneralFDC00000002Y4M250325","","55","","1099042.88"
"2025-03-28","2025-03-25","SF FuneralFDC000000030ZQ250325","","260","","1099302.88"
"2025-03-28","2025-03-25","SF FuneralFDC00000006FWT250325","","126.5","","1099429.38"
"2025-03-28","2025-03-25","SF FuneralFDC00000006T39250325","","31.63","","1099461.01"
"2025-03-28","2025-03-25","SF FuneralFDC00000006WKK250325","","31.63","","1099492.64"
"2025-03-28","2025-03-25","SF FuneralFDC00000006X91250325","","31.63","","1099524.27"
"2025-03-28","2025-03-25","SF FuneralF798261       250325","","126.5","","1099650.77"
"2025-03-28","2025-03-25","SF FuneralFDC000000085J9250325","","126.5","","1099777.27"
"2025-03-28","2025-03-25","SF FuneralFDC00000008851250325","","31.63","","1099808.9"
"2025-03-28","2025-03-25","SF FuneralF821545       250325","","47.88","","1099856.78"
"2025-03-28","2025-03-25","SF FuneralF981653       250325","","63.25","","1099920.03"
"2025-03-28","2025-03-25","SF FuneralF990136       250325","","126.5","","1100046.53"
"2025-03-28","2025-03-25","SF FuneralF990255       250325","","31.63","","1100078.16"
"2025-03-28","2025-03-25","SF FuneralFDC0000000JVV6250325","","126.5","","1100204.66"
"2025-03-28","2025-03-25","SF FuneralF1052659      250325","","31.63","","1100236.29"
"2025-03-28","2025-03-25","SF FuneralF1073225      250325","","126.5","","1100362.79"
"2025-03-28","2025-03-25","SF FuneralF1074554      250325","","126.5","","1100489.29"
"2025-03-28","2025-03-25","SF FuneralF1080280      250325","","63.25","","1100552.54"
"2025-03-28","2025-03-25","SF FuneralF1080286      250325","","31.63","","1100584.17"
"2025-03-28","2025-03-25","SF FuneralF1084274      250325","","126.5","","1100710.67"
"2025-03-28","2025-03-25","SF FuneralF1114485      250325","","63.25","","1100773.92"
"2025-03-28","2025-03-25","SF FuneralF1118176      250325","","126.5","","1100900.42"
"2025-03-28","2025-03-25","SF FuneralF1122598      250325","","63.25","","1100963.67"
"2025-03-28","2025-03-25","SF FuneralFDC0000000PK12250325","","126.5","","1101090.17"
"2025-03-28","2025-03-25","SF FuneralF1128927      250325","","126.5","","1101216.67"
"2025-03-28","2025-03-25","SF FuneralFDC0000000Q03C250325","","126.5","","1101343.17"
"2025-03-28","2025-03-25","SF FuneralF1127539      250325","","126.5","","1101469.67"
"2025-03-28","2025-03-25","SF FuneralF1130915      250325","","126.5","","1101596.17"
"2025-03-28","2025-03-25","SF FuneralF1132261      250325","","126.5","","1101722.67"
"2025-03-28","2025-03-25","SF FuneralF1132378      250325","","31.63","","1101754.3"
"2025-03-28","2025-03-25","SF FuneralFDC0000000QL8F250325","","126.5","","1101880.8"
"2025-03-28","2025-03-26","SF FuneralFDC000000058ZY250326","","126.5","","1102007.3"
"2025-03-28","2025-03-26","SF FuneralFDC000000068W1250326","","126.5","","1102133.8"
"2025-03-28","2025-03-26","SF FuneralF1022243      250326","","126.5","","1102260.3"
"2025-03-28","2025-03-26","SF FuneralF1052723      250326","","126.5","","1102386.8"
"2025-03-28","2025-03-27","SF FuneralFDC000000084KT250327","","126.5","","1102513.3"
"2025-03-28","2025-03-27","SF FuneralF803522       250327","","126.5","","1102639.8"
"2025-03-28","2025-03-27","SF FuneralF812840       250327","","126.5","","1102766.3"
"2025-03-28","2025-03-27","SF FuneralF840947       250327","","126.5","","1102892.8"
"2025-03-28","2025-03-27","SF FuneralF1083804      250327","","126.5","","1103019.3"
"2025-03-28","2025-03-27","SF FuneralF1119674      250327","","126.5","","1103145.8"
"2025-03-28","2025-03-27","SF FuneralF1129381      250327","","126.5","","1103272.3"
"2025-03-28","2025-03-28","SF FuneralFDC0000000628F250328","","31.63","","1103303.93"
"2025-03-28","2025-03-28","SF FuneralFDC0000000660N250328","","126.5","","1103430.43"
"2025-03-28","2025-03-28","SF FuneralFDC00000006FNM250328","","126.5","","1103556.93"
"2025-03-28","2025-03-28","SF FuneralFDC00000006N9F250328","","126.5","","1103683.43"
"2025-03-28","2025-03-28","SF FuneralFDC00000006P6D250328","","31.63","","1103715.06"
"2025-03-28","2025-03-28","SF FuneralFDC000000071YJ250328","","126.5","","1103841.56"
"2025-03-28","2025-03-28","SF FuneralFDC000000071YM250328","","126.5","","1103968.06"
"2025-03-28","2025-03-28","SF FuneralFDC00000007615250328","","126.5","","1104094.56"
"2025-03-28","2025-03-28","SF FuneralFDC00000007627250328","","126.5","","1104221.06"
"2025-03-28","2025-03-28","SF FuneralFDC0000000762Z250328","","126.5","","1104347.56"
"2025-03-28","2025-03-28","SF FuneralFDC0000000770C250328","","126.5","","1104474.06"
"2025-03-28","2025-03-28","SF FuneralFDC0000000783B250328","","126.5","","1104600.56"
"2025-03-28","2025-03-28","SF FuneralFDC000000079KW250328","","126.5","","1104727.06"
"2025-03-28","2025-03-28","SF FuneralFDC00000007QL9250328","","126.5","","1104853.56"
"2025-03-28","2025-03-28","SF FuneralFDC000000082NV250328","","126.5","","1104980.06"
"2025-03-28","2025-03-28","SF FuneralF810002       250328","","126.5","","1105106.56"
"2025-03-28","2025-03-28","SF FuneralF816819       250328","","126.5","","1105233.06"
"2025-03-28","2025-03-28","SF FuneralF818052       250328","","126.5","","1105359.56"
"2025-03-28","2025-03-28","SF FuneralF821761       250328","","126.5","","1105486.06"
"2025-03-28","2025-03-28","SF FuneralF901052       250328","","126.5","","1105612.56"
"2025-03-28","2025-03-28","SF FuneralF981556       250328","","126.5","","1105739.06"
"2025-03-28","2025-03-28","SF FuneralF987216       250328","","126.5","","1105865.56"
"2025-03-28","2025-03-28","SF FuneralFDC0000000J1C1250328","","126.5","","1105992.06"
"2025-03-28","2025-03-28","SF FuneralF993837       250328","","31.63","","1106023.69"
"2025-03-28","2025-03-28","SF FuneralF1033539      250328","","126.5","","1106150.19"
"2025-03-28","2025-03-28","SF FuneralFDC0000000LXMN250328","","126.5","","1106276.69"
"2025-03-28","2025-03-28","SF FuneralF1104255      250328","","31.63","","1106308.32"
"2025-03-28","2025-03-28","SF FuneralF1107997      250328","","126.5","","1106434.82"
"2025-03-28","2025-03-28","SF FuneralF1108067      250328","","126.5","","1106561.32"
"2025-03-28","2025-03-28","SF FuneralF1111579      250328","","126.5","","1106687.82"
"2025-03-28","2025-03-28","SF FuneralFDC0000000NFC1250328","","126.5","","1106814.32"
"2025-03-28","2025-03-28","SF FuneralF1118340      250328","","63.25","","1106877.57"
"2025-03-28","2025-03-28","SF FuneralF1120302      250328","","126.5","","1107004.07"
"2025-03-28","2025-03-28","SF FuneralF1128672      250328","","31.63","","1107035.7"
"2025-03-28","2025-03-28","SF FuneralF1133797      250328","","126.5","","1107162.2"
"2025-03-28","2025-03-26","SF FuneralF819839       250326","","126.5","","1107288.7"
"2025-03-28","2025-03-26","SF FuneralF843713       250326","","126.5","","1107415.2"
"2025-03-28","2025-03-26","SF FuneralF993496       250326","","126.5","","1107541.7"
"2025-03-28","2025-03-26","SF FuneralF1122015      250326","","126.5","","1107668.2"
"2025-03-28","2025-03-26","SF FuneralF1123483      250326","","126.5","","1107794.7"
"2025-03-28","2025-03-27","SF FuneralFDC00000006F50250327","","126.5","","1107921.2"
"2025-03-28","2025-03-27","SF FuneralFDC00000009NQQ250327","","126.5","","1108047.7"
"2025-03-28","2025-03-27","SF FuneralF823892       250327","","126.5","","1108174.2"
"2025-03-28","2025-03-27","SF FuneralF829612       250327","","126.5","","1108300.7"
"2025-03-28","2025-03-27","SF FuneralF830978       250327","","126.5","","1108427.2"
"2025-03-28","2025-03-27","SF FuneralF843193       250327","","126.5","","1108553.7"
"2025-03-28","2025-03-27","SF FuneralF1020994      250327","","126.5","","1108680.2"
"2025-03-28","2025-03-27","SF FuneralF1055000      250327","","126.5","","1108806.7"
"2025-03-28","2025-03-27","SF FuneralF1104053      250327","","126.5","","1108933.2"
"2025-03-28","2025-03-27","SF FuneralF1114332      250327","","126.5","","1109059.7"
"2025-03-28","2025-03-27","SF FuneralFDC0000000NJPF250327","","126.5","","1109186.2"
"2025-03-28","2025-03-27","SF FuneralF1118347      250327","","126.5","","1109312.7"
"2025-03-28","2025-03-27","SF FuneralF1118988      250327","","126.5","","1109439.2"
"2025-03-28","2025-03-27","SF FuneralF1122774      250327","","126.5","","1109565.7"
"2025-03-28","2025-03-28","SF FuneralFDC0000000684Y250328","","126.5","","1109692.2"
"2025-03-28","2025-03-28","SF FuneralFDC00000006FH3250328","","126.5","","1109818.7"
"2025-03-28","2025-03-28","SF FuneralFDC00000006W33250328","","126.5","","1109945.2"
"2025-03-28","2025-03-28","SF FuneralFDC000000073C1250328","","126.5","","1110071.7"
"2025-03-28","2025-03-28","SF FuneralFDC00000007XMB250328","","126.5","","1110198.2"
"2025-03-28","2025-03-28","SF FuneralFDC00000008CZH250328","","126.5","","1110324.7"
"2025-03-28","2025-03-28","SF FuneralF805909       250328","","126.5","","1110451.2"
"2025-03-28","2025-03-28","SF FuneralF809907       250328","","126.5","","1110577.7"
"2025-03-28","2025-03-28","SF FuneralF810063       250328","","126.5","","1110704.2"
"2025-03-28","2025-03-28","SF FuneralF812634       250328","","126.5","","1110830.7"
"2025-03-28","2025-03-28","SF FuneralFDC00000009TTN250328","","126.5","","1110957.2"
"2025-03-28","2025-03-28","SF FuneralFDC00000009VTM250328","","126.5","","1111083.7"
"2025-03-28","2025-03-28","SF FuneralF821662       250328","","126.5","","1111210.2"
"2025-03-28","2025-03-28","SF FuneralF822235       250328","","126.5","","1111336.7"
"2025-03-28","2025-03-28","SF FuneralF829800       250328","","63.25","","1111399.95"
"2025-03-28","2025-03-28","SF FuneralF833506       250328","","126.5","","1111526.45"
"2025-03-28","2025-03-28","SF FuneralF842597       250328","","126.5","","1111652.95"
"2025-03-28","2025-03-28","SF FuneralF980379       250328","","31.63","","1111684.58"
"2025-03-28","2025-03-28","SF FuneralF986659       250328","","126.5","","1111811.08"
"2025-03-28","2025-03-28","SF FuneralFDC0000000HXFN250328","","126.5","","1111937.58"
"2025-03-28","2025-03-28","SF FuneralFDC0000000HZ62250328","","126.5","","1112064.08"
"2025-03-28","2025-03-28","SF FuneralF1050824      250328","","126.5","","1112190.58"
"2025-03-28","2025-03-28","SF FuneralF1066270      250328","","126.5","","1112317.08"
"2025-03-28","2025-03-28","SF FuneralF1084874      250328","","126.5","","1112443.58"
"2025-03-28","2025-03-28","SF FuneralF1108554      250328","","126.5","","1112570.08"
"2025-03-28","2025-03-28","SF FuneralF1128027      250328","","126.5","","1112696.58"
"2025-03-28","2025-03-28","SF FuneralF1128343      250328","","126.5","","1112823.08"
"2025-03-28","2025-03-28","SF FuneralF1132255      250328","","31.63","","1112854.71"
"2025-03-28","2025-03-28","SF FuneralF1133571      250328","","126.5","","1112981.21"
"2025-03-28","2025-03-19","SF FuneralFDC0000000P3M3250319","","126.5","","1113107.71"
"2025-03-28","2025-03-20","SF FuneralFDC00000006M01250320","","126.5","","1113234.21"
"2025-03-28","2025-03-20","SF FuneralF991769       250320","","126.5","","1113360.71"
"2025-03-28","2025-03-22","SF FuneralFDC00000002VCY250322","","220","","1113580.71"
"2025-03-28","2025-03-22","SF FuneralFDC000000061SP250322","","126.5","","1113707.21"
"2025-03-28","2025-03-22","SF FuneralFDC00000006CVD250322","","126.5","","1113833.71"
"2025-03-28","2025-03-22","SF FuneralFDC0000000853Z250322","","126.5","","1113960.21"
"2025-03-28","2025-03-22","SF FuneralFDC00000008MPF250322","","126.5","","1114086.71"
"2025-03-28","2025-03-22","SF FuneralF819753       250322","","126.5","","1114213.21"
"2025-03-28","2025-03-22","SF FuneralF841958       250321","","126.5","","1114339.71"
"2025-03-28","2025-03-22","SF FuneralF1054968      250322","","126.5","","1114466.21"
"2025-03-28","2025-03-22","SF FuneralF1066222      250322","","126.5","","1114592.71"
"2025-03-28","2025-03-22","SF FuneralFDC0000000LX0Y250323","","126.5","","1114719.21"
"2025-03-28","2025-03-22","SF FuneralF1129206      250322","","126.5","","1114845.71"
"2025-03-28","2025-03-22","SF FuneralF1133540      250323","","126.5","","1114972.21"
"2025-03-28","2025-03-24","SF FuneralFDC00000003HQP250324","","220","","1115192.21"
"2025-03-28","2025-03-24","SF FuneralFDC00000006XL3250324","","126.5","","1115318.71"
"2025-03-28","2025-03-24","SF FuneralFDC000000074VY250324","","126.5","","1115445.21"
"2025-03-28","2025-03-24","SF FuneralFDC00000007KQJ250324","","126.5","","1115571.71"
"2025-03-28","2025-03-24","SF FuneralFDC00000008MKX250324","","31.63","","1115603.34"
"2025-03-28","2025-03-24","SF FuneralF847274       250324","","126.5","","1115729.84"
"2025-03-28","2025-03-24","SF FuneralF1021167      250324","","126.5","","1115856.34"
"2025-03-28","2025-03-24","SF FuneralF1083780      250324","","126.5","","1115982.84"
"2025-03-28","2025-03-24","SF FuneralF1113168      250324","","126.5","","1116109.34"
"2025-03-28","2025-03-24","SF FuneralF1121905      250324","","126.5","","1116235.84"
"2025-03-28","2025-03-24","SF FuneralF1123277      250324","","31.63","","1116267.47"
"2025-03-28","2025-03-25","SF FuneralFDC00000002QF4250325","","55","","1116322.47"
"2025-03-28","2025-03-25","SF FuneralFDC00000005PVX250325","","220","","1116542.47"
"2025-03-28","2025-03-25","SF FuneralFDC00000006312250325","","126.5","","1116668.97"
"2025-03-28","2025-03-25","SF FuneralFDC00000006C1T250325","","126.5","","1116795.47"
"2025-03-28","2025-03-25","SF FuneralFDC000000077YM250325","","126.5","","1116921.97"
"2025-03-28","2025-03-25","SF FuneralFDC000000079VJ250325","","126.5","","1117048.47"
"2025-03-28","2025-03-25","SF FuneralFDC00000007MX8250325","","220","","1117268.47"
"2025-03-28","2025-03-25","SF FuneralFDC00000007QW8250325","","126.5","","1117394.97"
"2025-03-28","2025-03-25","SF FuneralF794159       250325","","126.5","","1117521.47"
"2025-03-28","2025-03-25","SF FuneralF794834       250325","","63.25","","1117584.72"
"2025-03-28","2025-03-25","SF FuneralF805320       250325","","126.5","","1117711.22"
"2025-03-28","2025-03-25","SF FuneralFDC00000009383250325","","31.63","","1117742.85"
"2025-03-28","2025-03-25","SF FuneralF812003       250325","","126.5","","1117869.35"
"2025-03-28","2025-03-25","SF FuneralF815888       250325","","126.5","","1117995.85"
"2025-03-28","2025-03-25","SF FuneralF844721       250325","","126.5","","1118122.35"
"2025-03-28","2025-03-25","SF FuneralF981656       250325","","126.5","","1118248.85"
"2025-03-28","2025-03-25","SF FuneralF990180       250325","","31.63","","1118280.48"
"2025-03-28","2025-03-25","SF FuneralF993846       250325","","126.5","","1118406.98"
"2025-03-28","2025-03-25","SF FuneralF1022073      250325","","126.5","","1118533.48"
"2025-03-28","2025-03-25","SF FuneralF1061069      250325","","31.63","","1118565.11"
"2025-03-28","2025-03-25","SF FuneralFDC0000000KPCR250325","","126.5","","1118691.61"
"2025-03-28","2025-03-25","SF FuneralF1078209      250325","","31.63","","1118723.24"
"2025-03-28","2025-03-25","SF FuneralF1084552      250325","","126.5","","1118849.74"
"2025-03-28","2025-03-25","SF FuneralF1118892      250325","","31.63","","1118881.37"
"2025-03-28","2025-03-25","SF FuneralF1120389      250325","","126.5","","1119007.87"
"2025-03-28","2025-03-25","SF FuneralF1127985      250325","","63.25","","1119071.12"
"2025-03-28","2025-03-25","SF FuneralF1128226      250325","","126.5","","1119197.62"
"2025-03-28","2025-03-25","SF FuneralF1131657      250325","","31.63","","1119229.25"
"2025-03-28","2025-03-25","SF FuneralF1132986      250325","","126.5","","1119355.75"
"2025-03-28","2025-03-26","SF FuneralFDC0000000QH5V250326","","126.5","","1119482.25"
"2025-03-28","2025-03-22","SF FuneralF805482       250322","","126.5","","1119608.75"
"2025-03-28","2025-03-25","SF FuneralF1113963      250325","","31.63","","1119640.38"
"2025-03-28","2025-03-26","Rev SF FuneralFDC0000000LGVG250326","","-126.5","","1119513.88"
"2025-03-28","2025-03-26","Rev SF FuneralFDC0000000LSVT250326","","-126.5","","1119387.38"
"2025-03-28","2025-03-26","Rev SF FuneralFDC0000000JG8W250326","","-126.5","","1119260.88"
"2025-03-28","2025-03-28","Rev SF FuneralFDC00000005X3L250328","","-220","","1119040.88"
"2025-03-28","2025-03-27","Rev SF FuneralFDC00000006B0G250327","","-126.5","","1118914.38"
"2025-03-28","2025-03-27","Rev SF FuneralFDC0000000K55Q250327","","-126.5","","1118787.88"
"2025-03-28","2025-03-27","Rev SF FuneralFDC0000000G072250327","","-126.5","","1118661.38"
"2025-03-28","2025-03-27","Rev SF FuneralFDC00000009465250327","","-126.5","","1118534.88"
"2025-03-28","2025-03-25","Rev SF FuneralFDC00000005PFJ250325","","-31.63","","1118503.25"
"2025-03-28","2025-03-22","Rev SF FuneralFDC00000008Z24250321","","-126.5","","1118376.75"
"2025-03-28","2025-03-22","Rev SF FuneralFDC0000000LH7P250322","","-126.5","","1118250.25"
"2025-03-28","2025-03-22","Rev SF FuneralFDC000000067N5250322","","-126.5","","1118123.75"
"2025-03-28","2025-03-22","Rev SF FuneralFDC000000067N8250322","","-126.5","","1117997.25"
"2025-03-28","2025-03-22","Rev SF FuneralFDC0000000LJ18250322","","-126.5","","1117870.75"
"2025-03-28","2025-03-22","Rev SF FuneralFDC00000008NPF250322","","-126.5","","1117744.25"
"2025-03-28","2025-03-22","Rev SF FuneralFDC00000005Z5P250322","","-126.5","","1117617.75"
"2025-03-28","2025-03-22","Rev SF FuneralFDC00000009H4P250322","","-126.5","","1117491.25"
"2025-03-28","2025-03-22","Rev SF FuneralFDC00000005FWB250322","","-126.5","","1117364.75"
"2025-03-28","2025-03-22","Rev SF FuneralFDC00000006YY1250322","","-126.5","","1117238.25"
"2025-03-28","2025-03-24","Rev SF FuneralFDC00000007F71250324","","-63.25","","1117175"
"2025-03-28","2025-03-24","Rev SF FuneralFDC00000007R5Z250324","","-63.25","","1117111.75"
"2025-03-28","2025-03-24","Rev SF FuneralFDC00000007092250324","","-126.5","","1116985.25"
"2025-03-28","2025-03-24","Rev SF FuneralFDC00000007B9D250323","","-126.5","","1116858.75"
"2025-03-28","2025-03-24","Rev SF FuneralFDC0000000HT78250324","","-126.5","","1116732.25"
"2025-03-28","2025-03-25","Rev SF FuneralFDC00000003D2J250325","","-110","","1116622.25"
"2025-03-28","2025-03-25","Rev SF FuneralFDC00000005N64250325","","-63.25","","1116559"
"2025-03-28","2025-03-25","Rev SF FuneralFDC00000006RB3250325","","-126.5","","1116432.5"
"2025-03-28","2025-03-25","Rev SF FuneralFDC0000000PSD7250325","","-126.5","","1116306"
"2025-03-28","2025-03-25","Rev SF FuneralFDC0000000JZ2Z250325","","-126.5","","1116179.5"
"2025-03-28","2025-03-22","SF FuneralF1022251      250322","","126.5","","1116306"
"2025-03-28","2025-03-22","SF FuneralF1111328      250323","","126.5","","1116432.5"
"2025-03-28","2025-03-24","SF FuneralFDC00000006Q80250324","","31.63","","1116464.13"
"2025-03-28","2025-03-25","SF FuneralF822587       250325","","31.63","","1116495.76"
"2025-03-28","2025-03-25","SF FuneralF1020866      250325","","126.5","","1116622.26"
"2025-03-28","2025-03-27","SF FuneralF1060538      250327","","126.5","","1116748.76"
"2025-03-28","2025-03-27","SF FuneralF1075307      250327","","126.5","","1116875.26"
"2025-03-28","2025-03-22","SF FuneralFDC00000007H25250322","","126.5","","1117001.76"
"2025-03-28","2025-03-22","SF FuneralF805275       250321","","31.63","","1117033.39"
"2025-03-28","2025-03-22","SF FuneralF1111595      250323","","31.63","","1117065.02"
"2025-03-28","2025-03-25","SF FuneralF831226       250325","","31.63","","1117096.65"
"2025-03-28","2025-03-25","SF FuneralF841781       250325","","31.63","","1117128.28"
"2025-03-28","2025-03-25","SF FuneralFDC0000000NTBQ250325","","31.63","","1117159.91"
"2025-03-28","2025-03-25","SF FuneralF1120133      250325","","31.63","","1117191.54"
"2025-03-28","2025-03-25","SF FuneralF1127482      250325","","31.63","","1117223.17"
"2025-03-28","2025-03-25","SF FuneralF1128951      250325","","31.63","","1117254.8"
"2025-03-28","2025-03-25","SF FuneralF1131798      250325","","31.63","","1117286.43"
"2025-03-28","2025-03-28","SF FuneralF805275       250328","","31.63","","1117318.06"
"2025-03-28","2025-03-28","SF FuneralF841714       250328","","31.63","","1117349.69"
"2025-03-28","2025-03-28","SF FuneralFDC0000000HXHK250328","","47.88","","1117397.57"
"2025-03-28","2025-03-28","SF FuneralF1022106      250328","","31.63","","1117429.2"
"2025-03-28","2025-03-28","SF FuneralFDC0000000JXK7250328","","31.63","","1117460.83"
"2025-03-28","2025-03-28","SF FuneralF1125111      250328","","31.63","","1117492.46"
"2025-03-28","2025-03-22","SF FuneralF840847       250322","","126.5","","1117618.96"
"2025-03-28","2025-03-24","SF FuneralFDC00000006MW9250324","","126.5","","1117745.46"
"2025-03-28","2025-03-24","SF FuneralFDC00000006ZT3250324","","126.5","","1117871.96"
"2025-03-28","2025-03-24","SF FuneralF1033945      250324","","126.5","","1117998.46"
"2025-03-28","2025-03-24","SF FuneralF1132404      250324","","126.5","","1118124.96"
"2025-03-28","2025-03-25","SF FuneralFDC00000007333250325","","63.25","","1118188.21"
"2025-03-28","2025-03-25","SF FuneralF828499       250325","","63.25","","1118251.46"
"2025-03-28","2025-03-25","SF FuneralF990512       250325","","126.5","","1118377.96"
"2025-03-28","2025-03-25","SF FuneralF991428       250325","","63.25","","1118441.21"
"2025-03-28","2025-03-25","SF FuneralF992412       250325","","126.5","","1118567.71"
"2025-03-28","2025-03-25","SF FuneralF1115894      250325","","126.5","","1118694.21"
"2025-03-28","2025-03-25","SF FuneralF1120575      250325","","126.5","","1118820.71"
"2025-03-28","2025-03-25","SF FuneralF1130838      250325","","126.5","","1118947.21"
"2025-03-28","2025-03-25","SF FuneralF1131792      250325","","126.5","","1119073.71"
"2025-03-28","2025-03-25","SF FuneralF1132267      250325","","126.5","","1119200.21"
"2025-03-28","2025-03-25","SF FuneralF1133753      250325","","126.5","","1119326.71"
"2025-03-28","2025-03-25","SF FuneralF1135064      250325","","63.25","","1119389.96"
"2025-03-28","2025-03-27","SF FuneralFDC00000005GBC250327","","126.5","","1119516.46"
"2025-03-28","2025-03-27","SF FuneralFDC0000000671W250327","","126.5","","1119642.96"
"2025-03-28","2025-03-28","SF FuneralFDC00000006KZ0250328","","126.5","","1119769.46"
"2025-03-28","2025-03-28","SF FuneralF980274       250328","","126.5","","1119895.96"
"2025-03-28","2025-03-28","SF FuneralF1108558      250328","","126.5","","1120022.46"
"2025-03-28","2025-03-28","SF FuneralF1128063      250328","","126.5","","1120148.96"
"2025-03-28","2025-03-20","SF FuneralF981088       250323","","126.5","","1120275.46"
"2025-03-28","2025-03-20","SF FuneralFDC0000000JTLM250321","","126.5","","1120401.96"
"2025-03-28","2025-03-20","SF FuneralF1125983      250320","","126.5","","1120528.46"
"2025-03-28","2025-03-22","SF FuneralF800657       250322","","126.5","","1120654.96"
"2025-03-28","2025-03-22","SF FuneralF841744       250321","","126.5","","1120781.46"
"2025-03-28","2025-03-22","SF FuneralF993654       250322","","126.5","","1120907.96"
"2025-03-28","2025-03-22","SF FuneralF1102936      250322","","126.5","","1121034.46"
"2025-03-28","2025-03-24","SF FuneralF811439       250324","","126.5","","1121160.96"
"2025-03-28","2025-03-24","SF FuneralF823488       250324","","126.5","","1121287.46"
"2025-03-28","2025-03-24","SF FuneralF1054908      250324","","126.5","","1121413.96"
"2025-03-28","2025-03-25","SF FuneralFDC00000007LRY250325","","126.5","","1121540.46"
"2025-03-28","2025-03-25","SF FuneralFDC00000007LS3250325","","126.5","","1121666.96"
"2025-03-28","2025-03-25","SF FuneralFDC00000007RGL250325","","126.5","","1121793.46"
"2025-03-28","2025-03-25","SF FuneralF802320       250325","","126.5","","1121919.96"
"2025-03-28","2025-03-25","SF FuneralFDC00000008K9P250325","","126.5","","1122046.46"
"2025-03-28","2025-03-25","SF FuneralF805847       250325","","126.5","","1122172.96"
"2025-03-28","2025-03-25","SF FuneralF805896       250325","","126.5","","1122299.46"
"2025-03-28","2025-03-25","SF FuneralF831931       250325","","126.5","","1122425.96"
"2025-03-28","2025-03-25","SF FuneralF990253       250325","","63.25","","1122489.21"
"2025-03-28","2025-03-25","SF FuneralF992084       250325","","126.5","","1122615.71"
"2025-03-28","2025-03-25","SF FuneralF993175       250325","","126.5","","1122742.21"
"2025-03-28","2025-03-25","SF FuneralF1067947      250325","","63.25","","1122805.46"
"2025-03-28","2025-03-25","SF FuneralF1079157      250325","","63.25","","1122868.71"
"2025-03-28","2025-03-25","SF FuneralF1108347      250325","","126.5","","1122995.21"
"2025-03-28","2025-03-25","SF FuneralF1120277      250325","","126.5","","1123121.71"
"2025-03-28","2025-03-25","SF FuneralF1132246      250325","","126.5","","1123248.21"
"2025-03-28","2025-03-27","SF FuneralFDC00000006B5S250327","","126.5","","1123374.71"
"2025-03-28","2025-03-27","SF FuneralFDC00000006BBY250327","","126.5","","1123501.21"
"2025-03-28","2025-03-27","SF FuneralFDC00000006BCQ250327","","126.5","","1123627.71"
"2025-03-28","2025-03-27","SF FuneralFDC00000008LZ1250327","","126.5","","1123754.21"
"2025-03-28","2025-03-27","SF FuneralF840793       250327","","126.5","","1123880.71"
"2025-03-28","2025-03-27","SF FuneralF842463       250327","","126.5","","1124007.21"
"2025-03-28","2025-03-27","SF FuneralF842760       250327","","126.5","","1124133.71"
"2025-03-28","2025-03-27","SF FuneralFDC0000000KZCY250327","","126.5","","1124260.21"
"2025-03-28","2025-03-27","SF FuneralFDC0000000NJSC250327","","126.5","","1124386.71"
"2025-03-28","2025-03-27","SF FuneralFDC0000000P19M250327","","126.5","","1124513.21"
"2025-03-28","2025-03-27","SF FuneralF1122594      250327","","126.5","","1124639.71"
"2025-03-28","2025-03-28","SF FuneralFDC00000005SV9250328","","220","","1124859.71"
"2025-03-28","2025-03-28","SF FuneralFDC000000068FF250328","","126.5","","1124986.21"
"2025-03-28","2025-03-28","SF FuneralFDC00000006W54250328","","126.5","","1125112.71"
"2025-03-28","2025-03-28","SF FuneralFDC000000085P7250328","","126.5","","1125239.21"
"2025-03-28","2025-03-28","SF FuneralF799581       250328","","126.5","","1125365.71"
"2025-03-28","2025-03-28","SF FuneralFDC00000008Y26250328","","126.5","","1125492.21"
"2025-03-28","2025-03-28","SF FuneralF808621       250328","","126.5","","1125618.71"
"2025-03-28","2025-03-28","SF FuneralFDC00000009XG8250328","","126.5","","1125745.21"
"2025-03-28","2025-03-28","SF FuneralF820061       250328","","126.5","","1125871.71"
"2025-03-28","2025-03-28","SF FuneralF900986       250328","","126.5","","1125998.21"
"2025-03-28","2025-03-28","SF FuneralFDC0000000HTZ4250329","","126.5","","1126124.71"
"2025-03-28","2025-03-28","SF FuneralFDC0000000HYW8250328","","63.25","","1126187.96"
"2025-03-28","2025-03-28","SF FuneralF1021247      250328","","126.5","","1126314.46"
"2025-03-28","2025-03-28","SF FuneralF1126251      250328","","126.5","","1126440.96"
"2025-03-28","2025-03-28","SF FuneralF1127104      250328","","126.5","","1126567.46"
"2025-03-28","2025-03-28","SF FuneralF1133820      250328","","126.5","","1126693.96"
"2025-03-28","2025-03-22","SF FuneralFDC000000072Z0250322","","126.5","","1126820.46"
"2025-03-28","2025-03-22","SF FuneralFDC0000000N2XK250323","","63.25","","1126883.71"
"2025-03-28","2025-03-22","SF FuneralF1112492      250322","","126.5","","1127010.21"
"2025-03-28","2025-03-22","SF FuneralF1130913      250322","","126.5","","1127136.71"
"2025-03-28","2025-03-22","SF FuneralF1134183      250323","","126.5","","1127263.21"
"2025-03-28","2025-03-24","SF FuneralFDC0000000619Z250324","","126.5","","1127389.71"
"2025-03-28","2025-03-24","SF FuneralF1125438      250324","","126.5","","1127516.21"
"2025-03-28","2025-03-24","SF FuneralF1125954      250324","","126.5","","1127642.71"
"2025-03-28","2025-03-25","SF FuneralFDC00000007LKN250325","","126.5","","1127769.21"
"2025-03-28","2025-03-25","SF FuneralFDC00000007SPD250325","","126.5","","1127895.71"
"2025-03-28","2025-03-25","SF FuneralFDC00000007T8N250325","","126.5","","1128022.21"
"2025-03-28","2025-03-27","SF FuneralFDC000000060W6250327","","126.5","","1128148.71"
"2025-03-28","2025-03-27","SF FuneralFDC000000072QK250327","","126.5","","1128275.21"
"2025-03-28","2025-03-27","SF FuneralF821294       250327","","126.5","","1128401.71"
"2025-03-28","2025-03-27","SF FuneralF1078500      250327","","126.5","","1128528.21"
"2025-03-28","2025-03-28","SF FuneralF820816       250328","","126.5","","1128654.71"
"2025-03-28","2025-03-28","RTC-SFTAV2022756550","","220","","1128874.71"
"2025-03-28","2025-03-22","SF FuneralF1078534      250322","","126.5","","1129001.21"
"2025-03-28","2025-03-24","SF FuneralF1108463      250324","","126.5","","1129127.71"
"2025-03-28","2025-03-25","SF FuneralFDC00000007YL6250325","","126.5","","1129254.21"
"2025-03-28","2025-03-25","SF FuneralF800205       250325","","31.63","","1129285.84"
"2025-03-28","2025-03-25","SF FuneralF1067978      250325","","31.63","","1129317.47"
"2025-03-28","2025-03-25","SF FuneralF1130346      250325","","31.63","","1129349.1"
"2025-03-28","2025-03-26","SF FuneralFDC0000000H86X250326","","126.5","","1129475.6"
"2025-03-28","2025-03-26","SF FuneralF1120299      250326","","126.5","","1129602.1"
"2025-03-28","2025-03-27","SF FuneralF821777       250327","","126.5","","1129728.6"
"2025-03-28","2025-03-27","SF FuneralF1058629      250327","","126.5","","1129855.1"
"2025-03-28","2025-03-28","SF FuneralF1129393      250328","","126.5","","1129981.6"
"2025-03-28","2025-03-28","SF FuneralF1134799      250328","","126.5","","1130108.1"
"2025-03-28","2025-03-20","SF FuneralF1065652      250321","","126.5","","1130234.6"
"2025-03-28","2025-03-22","SF FuneralF808852       250322","","126.5","","1130361.1"
"2025-03-28","2025-03-22","SF FuneralF1115929      250322","","126.5","","1130487.6"
"2025-03-28","2025-03-24","SF FuneralFDC000000073PV250324","","126.5","","1130614.1"
"2025-03-28","2025-03-24","SF FuneralF847454       250322","","126.5","","1130740.6"
"2025-03-28","2025-03-24","SF FuneralF1133578      250324","","126.5","","1130867.1"
"2025-03-28","2025-03-25","SF FuneralFDC00000005MFC250325","","126.5","","1130993.6"
"2025-03-28","2025-03-25","SF FuneralFDC00000008M9V250325","","126.5","","1131120.1"
"2025-03-28","2025-03-25","SF FuneralF809985       250325","","126.5","","1131246.6"
"2025-03-28","2025-03-25","SF FuneralF1078565      250325","","126.5","","1131373.1"
"2025-03-28","2025-03-25","SF FuneralF1084020      250325","","126.5","","1131499.6"
"2025-03-28","2025-03-25","SF FuneralFDC0000000NYPL250325","","126.5","","1131626.1"
"2025-03-28","2025-03-25","SF FuneralFDC0000000Q0MD250325","","126.5","","1131752.6"
"2025-03-28","2025-03-25","SF FuneralFDC0000000Q2M3250325","","126.5","","1131879.1"
"2025-03-28","2025-03-25","SF FuneralF1132892      250325","","63.25","","1131942.35"
"2025-03-28","2025-03-26","SF FuneralF993733       250326","","126.5","","1132068.85"
"2025-03-28","2025-03-26","SF FuneralF1022000      250326","","126.5","","1132195.35"
"2025-03-28","2025-03-27","SF FuneralFDC000000068WX250327","","126.5","","1132321.85"
"2025-03-28","2025-03-27","SF FuneralF803670       250327","","126.5","","1132448.35"
"2025-03-28","2025-03-27","SF FuneralF832656       250327","","126.5","","1132574.85"
"2025-03-28","2025-03-27","SF FuneralF1075024      250327","","126.5","","1132701.35"
"2025-03-28","2025-03-27","SF FuneralF1078536      250327","","126.5","","1132827.85"
"2025-03-28","2025-03-28","SF FuneralFDC000000035X1250328","","220","","1133047.85"
"2025-03-28","2025-03-28","SF FuneralFDC000000069Q9250328","","126.5","","1133174.35"
"2025-03-28","2025-03-28","SF FuneralF797113       250328","","126.5","","1133300.85"
"2025-03-28","2025-03-28","SF FuneralFDC0000000J3CL250330","","126.5","","1133427.35"
"2025-03-28","2025-03-28","SF FuneralF1108653      250328","","126.5","","1133553.85"
"2025-03-28","2025-03-28","SF FuneralFDC0000000PJM1250328","","126.5","","1133680.35"
"2025-03-28","2025-03-22","SF FuneralFDC00000005XNC250322","","31.63","","1133711.98"
"2025-03-28","2025-03-25","SF FuneralF833363       250325","","31.63","","1133743.61"
"2025-03-28","2025-03-25","SF FuneralF989270       250325","","31.63","","1133775.24"
"2025-03-28","2025-03-25","SF FuneralF1017666      250325","","31.63","","1133806.87"
"2025-03-28","2025-03-25","SF FuneralF1130733      250325","","31.63","","1133838.5"
"2025-03-28","2025-03-25","SF FuneralF1134975      250325","","31.63","","1133870.13"
"2025-03-28","2025-03-28","SF FuneralF1131924      250328","","31.63","","1133901.76"
"2025-03-28","2025-03-20","SF FuneralFDC0000000HY4J250322","","126.5","","1134028.26"
"2025-03-28","2025-03-20","SF FuneralFDC0000000HY4N250322","","126.5","","1134154.76"
"2025-03-28","2025-03-20","SF FuneralF991266       250322","","126.5","","1134281.26"
"2025-03-28","2025-03-22","SF FuneralF804120       250322","","126.5","","1134407.76"
"2025-03-28","2025-03-22","SF FuneralF1120822      250323","","126.5","","1134534.26"
"2025-03-28","2025-03-25","SF FuneralFDC00000006042250325","","63.25","","1134597.51"
"2025-03-28","2025-03-25","SF FuneralFDC0000000HX1F250325","","63.25","","1134660.76"
"2025-03-28","2025-03-25","SF FuneralF1074872      250325","","63.25","","1134724.01"
"2025-03-28","2025-03-25","SF FuneralF1110073      250325","","63.25","","1134787.26"
"2025-03-28","2025-03-27","SF FuneralFDC0000000N2ZY250327","","126.5","","1134913.76"
"2025-03-28","2025-03-27","SF FuneralFDC0000000N9GX250327","","126.5","","1135040.26"
"2025-03-28","2025-03-28","SF FuneralFDC000000064BV250328","","126.5","","1135166.76"
"2025-03-28","2025-03-28","SF FuneralF900834       250328","","126.5","","1135293.26"
"2025-03-28","2025-03-28","SF FuneralF1112474      250328","","63.25","","1135356.51"
"2025-03-28","2025-03-28","SF FuneralF1131285      250328","","126.5","","1135483.01"
"2025-03-28","2025-03-22","SF FuneralFDC00000003JVX250321","","220","","1135703.01"
"2025-03-28","2025-03-22","SF FuneralF1083728      250323","","126.5","","1135829.51"
"2025-03-28","2025-03-24","SF FuneralF1022110      250324","","126.5","","1135956.01"
"2025-03-28","2025-03-24","SF FuneralF1073039      250324","","126.5","","1136082.51"
"2025-03-28","2025-03-25","SF FuneralF803604       250325","","126.5","","1136209.01"
"2025-03-28","2025-03-25","SF FuneralF1065831      250325","","63.25","","1136272.26"
"2025-03-28","2025-03-26","SF FuneralFDC00000006B87250326","","126.5","","1136398.76"
"2025-03-28","2025-03-27","SF FuneralFDC00000005GJ0250327","","126.5","","1136525.26"
"2025-03-28","2025-03-27","SF FuneralFDC00000005NT8250327","","126.5","","1136651.76"
"2025-03-28","2025-03-27","SF FuneralF813644       250327","","126.5","","1136778.26"
"2025-03-28","2025-03-28","SF FuneralF812499       250328","","63.25","","1136841.51"
"2025-03-28","2025-03-28","SF FuneralF1084921      250328","","126.5","","1136968.01"
"2025-03-28","2025-03-28","SF FuneralF1132978      250328","","126.5","","1137094.51"
"2025-03-28","2025-03-22","SF FuneralFDC00000007DYW250322","","126.5","","1137221.01"
"2025-03-28","2025-03-22","SF FuneralFDC0000000DFMZ250322","","126.5","","1137347.51"
"2025-03-28","2025-03-22","SF FuneralF1120353      250322","","126.5","","1137474.01"
"2025-03-28","2025-03-22","SF FuneralFDC0000000P9RR250322","","126.5","","1137600.51"
"2025-03-28","2025-03-24","SF FuneralFDC000000061CF250323","","126.5","","1137727.01"
"2025-03-28","2025-03-24","SF FuneralFDC0000000640K250324","","126.5","","1137853.51"
"2025-03-28","2025-03-24","SF FuneralFDC00000007R58250324","","126.5","","1137980.01"
"2025-03-28","2025-03-24","SF FuneralFDC00000008JY9250324","","63.25","","1138043.26"
"2025-03-28","2025-03-24","SF FuneralF841226       250324","","126.5","","1138169.76"
"2025-03-28","2025-03-25","SF FuneralFDC00000005P7W250325","","126.5","","1138296.26"
"2025-03-28","2025-03-25","SF FuneralFDC000000061PC250325","","126.5","","1138422.76"
"2025-03-28","2025-03-25","SF FuneralF802141       250325","","126.5","","1138549.26"
"2025-03-28","2025-03-25","SF FuneralFDC00000008JX9250325","","126.5","","1138675.76"
"2025-03-28","2025-03-25","SF FuneralF809352       250325","","126.5","","1138802.26"
"2025-03-28","2025-03-25","SF FuneralF830783       250325","","63.25","","1138865.51"
"2025-03-28","2025-03-25","SF FuneralF988054       250325","","126.5","","1138992.01"
"2025-03-28","2025-03-25","SF FuneralF992474       250325","","63.25","","1139055.26"
"2025-03-28","2025-03-25","SF FuneralFDC0000000JYX1250325","","126.5","","1139181.76"
"2025-03-28","2025-03-25","SF FuneralF1120589      250325","","126.5","","1139308.26"
"2025-03-28","2025-03-25","SF FuneralF1128669      250325","","126.5","","1139434.76"
"2025-03-28","2025-03-26","SF FuneralF813112       250326","","126.5","","1139561.26"
"2025-03-28","2025-03-26","SF FuneralF989762       250326","","126.5","","1139687.76"
"2025-03-28","2025-03-26","SF FuneralF991933       250326","","126.5","","1139814.26"
"2025-03-28","2025-03-27","SF FuneralF798379       250327","","126.5","","1139940.76"
"2025-03-28","2025-03-27","SF FuneralF818891       250327","","126.5","","1140067.26"
"2025-03-28","2025-03-27","SF FuneralF1116908      250327","","126.5","","1140193.76"
"2025-03-28","2025-03-27","SF FuneralF1127928      250327","","126.5","","1140320.26"
"2025-03-28","2025-03-28","SF FuneralF817283       250328","","126.5","","1140446.76"
"2025-03-28","2025-03-28","SF FuneralF1123173      250328","","126.5","","1140573.26"
"2025-03-28","2025-03-28","SF FuneralF1129318      250328","","126.5","","1140699.76"
"2025-03-28","2025-03-28","SF FuneralF1134497      250328","","126.5","","1140826.26"
"2025-03-28","2025-03-25","SF FuneralFDC00000003V68250325","","55","","1140881.26"
"2025-03-28","2025-03-25","SF FuneralFDC00000005X2M250325","","31.63","","1140912.89"
"2025-03-28","2025-03-25","SF FuneralFDC00000008G43250325","","31.63","","1140944.52"
"2025-03-28","2025-03-25","SF FuneralF819158       250325","","31.63","","1140976.15"
"2025-03-28","2025-03-25","SF FuneralF990591       250325","","31.63","","1141007.78"
"2025-03-28","2025-03-25","SF FuneralF991480       250325","","31.63","","1141039.41"
"2025-03-28","2025-03-25","SF FuneralF1066029      250325","","31.63","","1141071.04"
"2025-03-28","2025-03-25","SF FuneralF1067990      250325","","31.63","","1141102.67"
"2025-03-28","2025-03-25","SF FuneralF1118420      250325","","31.63","","1141134.3"
"2025-03-28","2025-03-25","SF FuneralF1122761      250325","","31.63","","1141165.93"
"2025-03-28","2025-03-25","SF FuneralF1129064      250325","","31.63","","1141197.56"
"2025-03-28","2025-03-28","SF FuneralF1084400      250328","","31.63","","1141229.19"
"2025-03-28","2025-03-28","SF FuneralF1114116      250328","","31.63","","1141260.82"
"2025-03-28","2025-03-20","SF FuneralF900813       250320","","126.5","","1141387.32"
"2025-03-28","2025-03-20","SF FuneralF981785       250322","","126.5","","1141513.82"
"2025-03-28","2025-03-22","SF FuneralF805969       250321","","126.5","","1141640.32"
"2025-03-28","2025-03-25","SF FuneralFDC00000005GGL250325","","63.25","","1141703.57"
"2025-03-28","2025-03-25","SF FuneralFDC000000068B0250325","","126.5","","1141830.07"
"2025-03-28","2025-03-25","SF FuneralF1128356      250325","","126.5","","1141956.57"
"2025-03-28","2025-03-26","SF FuneralF1016673      250326","","126.5","","1142083.07"
"2025-03-28","2025-03-27","SF FuneralFDC00000009BR8250327","","126.5","","1142209.57"
"2025-03-28","2025-03-27","SF FuneralF829549       250327","","126.5","","1142336.07"
"2025-03-28","2025-03-27","SF FuneralF1055057      250327","","126.5","","1142462.57"
"2025-03-28","2025-03-27","SF FuneralF1055103      250327","","126.5","","1142589.07"
"2025-03-28","2025-03-27","SF FuneralF1075294      250327","","126.5","","1142715.57"
"2025-03-28","2025-03-27","SF FuneralF1120936      250327","","126.5","","1142842.07"
"2025-03-28","2025-03-27","SF FuneralF1128999      250327","","126.5","","1142968.57"
"2025-03-28","2025-03-28","SF FuneralFDC0000000637L250328","","126.5","","1143095.07"
"2025-03-28","2025-03-28","SF FuneralFDC0000000673Y250328","","126.5","","1143221.57"
"2025-03-28","2025-03-28","SF FuneralFDC0000000787V250328","","126.5","","1143348.07"
"2025-03-28","2025-03-28","SF FuneralF821669       250328","","126.5","","1143474.57"
"2025-03-28","2025-03-28","SF FuneralF831940       250328","","126.5","","1143601.07"
"2025-03-28","2025-03-28","SF FuneralF1108544      250328","","126.5","","1143727.57"
"2025-03-28","2025-03-28","SF FuneralF1116119      250328","","126.5","","1143854.07"
"2025-03-28","2025-03-28","SF FuneralF1117374      250328","","126.5","","1143980.57"
"2025-03-28","2025-03-28","SF FuneralF1118769      250328","","126.5","","1144107.07"
"2025-03-28","2025-03-28","SF FuneralFDC0000000QGHJ250328","","191.5","","1144298.57"
"2025-03-28","2025-03-28","SF FuneralFDC0000000QH9T250328","","126.5","","1144425.07"
"2025-03-28","2025-03-28","SF FuneralF1134385      250328","","126.5","","1144551.57"
"2025-03-28","2025-03-22","SF FuneralFDC00000006DDM250322","","126.5","","1144678.07"
"2025-03-28","2025-03-22","SF FuneralFDC00000007LPJ250322","","126.5","","1144804.57"
"2025-03-28","2025-03-22","SF FuneralFDC0000000951Q250322","","126.5","","1144931.07"
"2025-03-28","2025-03-22","SF FuneralF818322       250321","","63.25","","1144994.32"
"2025-03-28","2025-03-24","SF FuneralF820309       250324","","126.5","","1145120.82"
"2025-03-28","2025-03-25","SF FuneralFDC00000005P4K250325","","31.63","","1145152.45"
"2025-03-28","2025-03-25","SF FuneralFDC0000000666V250325","","126.5","","1145278.95"
"2025-03-28","2025-03-25","SF FuneralFDC00000006CWD250325","","55","","1145333.95"
"2025-03-28","2025-03-25","SF FuneralFDC00000006N7L250325","","126.5","","1145460.45"
"2025-03-28","2025-03-25","SF FuneralF989085       250325","","31.63","","1145492.08"
"2025-03-28","2025-03-25","SF FuneralF1114002      250325","","126.5","","1145618.58"
"2025-03-28","2025-03-28","SF FuneralFDC000000065RV250328","","126.5","","1145745.08"
"2025-03-28","2025-03-28","SF FuneralF800764       250328","","126.5","","1145871.58"
"2025-03-28","2025-03-28","SF FuneralF808326       250328","","126.5","","1145998.08"
"2025-03-28","2025-03-28","SF FuneralF824007       250328","","126.5","","1146124.58"
"2025-03-28","2025-03-28","SF FuneralF1084279      250328","","126.5","","1146251.08"
"2025-03-28","2025-03-28","SF FuneralFDC0000000MJ04250328","","126.5","","1146377.58"
"2025-03-28","2025-03-22","SF FuneralFDC00000006MXC250322","","126.5","","1146504.08"
"2025-03-28","2025-03-22","SF FuneralFDC000000081JG250322","","126.5","","1146630.58"
"2025-03-28","2025-03-24","SF FuneralF811461       250324","","126.5","","1146757.08"
"2025-03-28","2025-03-24","SF FuneralF782628       250324","","256.5","","1147013.58"
"2025-03-28","2025-03-24","SF FuneralF1125275      250324","","126.5","","1147140.08"
"2025-03-28","2025-03-25","SF FuneralFDC000000030DF250325","","55","","1147195.08"
"2025-03-28","2025-03-25","SF FuneralF816802       250325","","31.63","","1147226.71"
"2025-03-28","2025-03-25","SF FuneralFDC0000000FC19250325","","126.5","","1147353.21"
"2025-03-28","2025-03-27","SF FuneralFDC000000056Q8250327","","31.05","","1147384.26"
"2025-03-28","2025-03-27","SF FuneralF798590       250327","","126.5","","1147510.76"
"2025-03-28","2025-03-27","SF FuneralF841844       250327","","126.5","","1147637.26"
"2025-03-28","2025-03-27","SF FuneralF980979       250327","","126.5","","1147763.76"
"2025-03-28","2025-03-28","SF FuneralFDC00000003VP8250328","","220","","1147983.76"
"2025-03-28","2025-03-28","SF FuneralF791097       250328","","126.5","","1148110.26"
"2025-03-28","2025-03-28","SF FuneralF831829       250328","","126.5","","1148236.76"
"2025-03-28","2025-03-27","SF FuneralF829530       250327","","126.5","","1148363.26"
"2025-03-28","2025-03-27","SF FuneralF843075       250327","","126.5","","1148489.76"
"2025-03-28","2025-03-26","SF FuneralF986653       250326","","126.5","","1148616.26"
"2025-03-28","2025-03-22","SF FuneralF1084868      250322","","126.5","","1148742.76"
"2025-03-28","2025-03-25","SF FuneralFDC00000007LG1250325","","31.63","","1148774.39"
"2025-03-28","2025-03-25","SF FuneralFDC00000007MYY250325","","126.5","","1148900.89"
"2025-03-28","2025-03-25","SF FuneralF813413       250325","","126.5","","1149027.39"
"2025-03-28","2025-03-25","SF FuneralF1132860      250325","","126.5","","1149153.89"
"2025-03-28","2025-03-28","SF FuneralFDC000000065XM250328","","126.5","","1149280.39"
"2025-03-28","2025-03-28","SF FuneralFDC00000006MTF250328","","126.5","","1149406.89"
"2025-03-28","2025-03-28","SF FuneralFDC000000085V8250328","","126.5","","1149533.39"
"2025-03-28","2024-11-23","Rev SF FuneralFDC0000000NSKT241123","","-126.5","","1149406.89"
"2025-03-28","2025-03-22","Rev SF FuneralFDC0000000NSKT250323","","-126.5","","1149280.39"
"2025-03-28","2025-01-23","Rev SF FuneralFDC0000000NSKT250123","","-126.5","","1149153.89"
"2025-03-28","2024-12-11","Rev SF FuneralFDC0000000NSKT241223","","-126.5","","1149027.39"
"2025-03-28","2025-02-22","Rev SF FuneralFDC0000000NSKT250223","","-126.5","","1148900.89"
"2025-03-28","2025-03-25","SF FuneralFDC000000073P4250325","","31.63","","1148932.52"
"2025-03-28","2025-03-25","SF FuneralFDC000000078FZ250325","","31.63","","1148964.15"
"2025-03-28","2025-03-25","SF FuneralFDC00000007YH4250325","","31.63","","1148995.78"
"2025-03-28","2025-03-25","SF FuneralF812125       250325","","31.63","","1149027.41"
"2025-03-28","2025-03-25","SF FuneralF813552       250325","","31.63","","1149059.04"
"2025-03-28","2025-03-25","SF FuneralF1020608      250325","","31.63","","1149090.67"
"2025-03-28","2025-03-25","SF FuneralF1085179      250325","","31.63","","1149122.3"
"2025-03-28","2025-03-25","SF FuneralF1113987      250325","","31.63","","1149153.93"
"2025-03-28","2025-03-25","SF FuneralF1116010      250325","","31.63","","1149185.56"
"2025-03-28","2025-03-25","SF FuneralFDC0000000NT58250325","","31.63","","1149217.19"
"2025-03-28","2025-03-28","SF FuneralFDC0000000HBD0250328","","31.63","","1149248.82"
"2025-03-28","2025-03-28","SF FuneralF1078056      250328","","31.63","","1149280.45"
"2025-03-28","2025-03-22","SF FuneralFDC0000000600Z250322","","126.5","","1149406.95"
"2025-03-28","2025-03-22","SF FuneralF1117300      250322","","126.5","","1149533.45"
"2025-03-28","2025-03-22","SF FuneralF1124544      250322","","126.5","","1149659.95"
"2025-03-28","2025-03-22","SF FuneralF1128043      250322","","126.5","","1149786.45"
"2025-03-28","2025-03-22","SF FuneralF1130932      250322","","126.5","","1149912.95"
"2025-03-28","2025-03-24","SF FuneralFDC00000002WKR250324","","220","","1150132.95"
"2025-03-28","2025-03-24","SF FuneralFDC00000006RN5250324","","126.5","","1150259.45"
"2025-03-28","2025-03-24","SF FuneralFDC0000000831X250323","","63.25","","1150322.7"
"2025-03-28","2025-03-24","SF FuneralFDC0000000832F250323","","63.25","","1150385.95"
"2025-03-28","2025-03-24","SF FuneralF802288       250324","","126.5","","1150512.45"
"2025-03-28","2025-03-24","SF FuneralF802315       250324","","126.5","","1150638.95"
"2025-03-28","2025-03-25","SF FuneralF823118       250325","","63.25","","1150702.2"
"2025-03-28","2025-03-25","SF FuneralFDC0000000KB9R250325","","126.5","","1150828.7"
"2025-03-28","2025-03-25","SF FuneralF1120220      250325","","63.25","","1150891.95"
"2025-03-28","2025-03-25","SF FuneralF1132374      250325","","63.25","","1150955.2"
"2025-03-28","2025-03-26","SF FuneralFDC00000007P1V250326","","126.5","","1151081.7"
"2025-03-28","2025-03-27","SF FuneralFDC00000005RQQ250327","","220","","1151301.7"
"2025-03-28","2025-03-27","SF FuneralFDC000000097KT250327","","126.5","","1151428.2"
"2025-03-28","2025-03-27","SF FuneralFDC0000000FJKR250327","","126.5","","1151554.7"
"2025-03-28","2025-03-27","SF FuneralFDC0000000KFJS250327","","321.5","","1151876.2"
"2025-03-28","2025-03-27","SF FuneralFDC0000000LCT7250327","","126.5","","1152002.7"
"2025-03-28","2025-03-27","SF FuneralF1114226      250327","","126.5","","1152129.2"
"2025-03-28","2025-03-27","SF FuneralF1122919      250327","","126.5","","1152255.7"
"2025-03-28","2025-03-28","SF FuneralFDC000000069KD250328","","126.5","","1152382.2"
"2025-03-28","2025-03-28","SF FuneralFDC000000077N9250328","","126.5","","1152508.7"
"2025-03-28","2025-03-28","SF FuneralF834733       250328","","126.5","","1152635.2"
"2025-03-28","2025-03-28","SF FuneralF1103742      250328","","126.5","","1152761.7"
"2025-03-28","2025-03-28","SF FuneralF1124773      250328","","126.5","","1152888.2"
"2025-03-28","2025-03-22","SF FuneralFDC00000005X1Q250322","","220","","1153108.2"
"2025-03-28","2025-03-22","SF FuneralFDC00000006Z1J250322","","126.5","","1153234.7"
"2025-03-28","2025-03-22","SF FuneralFDC00000007LKX250322","","126.5","","1153361.2"
"2025-03-28","2025-03-22","SF FuneralF801328       250322","","126.5","","1153487.7"
"2025-03-28","2025-03-22","SF FuneralF801361       250322","","126.5","","1153614.2"
"2025-03-28","2025-03-22","SF FuneralF1055263      250322","","126.5","","1153740.7"
"2025-03-28","2025-03-22","SF FuneralFDC0000000NYNQ250323","","126.5","","1153867.2"
"2025-03-28","2025-03-22","SF FuneralFDC0000000NYP1250323","","126.5","","1153993.7"
"2025-03-28","2025-03-22","SF FuneralF1134532      250322","","126.5","","1154120.2"
"2025-03-28","2025-03-24","SF FuneralF831939       250324","","126.5","","1154246.7"
"2025-03-28","2025-03-24","SF FuneralF785041       250322","","321.5","","1154568.2"
"2025-03-28","2025-03-24","SF FuneralF1020934      250324","","126.5","","1154694.7"
"2025-03-28","2025-03-24","SF FuneralF1058838      250324","","126.5","","1154821.2"
"2025-03-28","2025-03-24","SF FuneralF1096643      250324","","126.5","","1154947.7"
"2025-03-28","2025-03-24","SF FuneralF1119011      250324","","126.5","","1155074.2"
"2025-03-28","2025-03-24","SF FuneralF1132350      250324","","126.5","","1155200.7"
"2025-03-28","2025-03-25","SF FuneralFDC00000007VD0250325","","126.5","","1155327.2"
"2025-03-28","2025-03-25","SF FuneralFDC0000000804X250325","","126.5","","1155453.7"
"2025-03-28","2025-03-25","SF FuneralFDC00000008T9H250325","","126.5","","1155580.2"
"2025-03-28","2025-03-25","SF FuneralF832100       250325","","126.5","","1155706.7"
"2025-03-28","2025-03-25","SF FuneralF981132       250325","","126.5","","1155833.2"
"2025-03-28","2025-03-25","SF FuneralF1068058      250325","","63.25","","1155896.45"
"2025-03-28","2025-03-25","SF FuneralF1108985      250325","","126.5","","1156022.95"
"2025-03-28","2025-03-25","SF FuneralF1114745      250325","","63.25","","1156086.2"
"2025-03-28","2025-03-25","SF FuneralF1120149      250325","","63.25","","1156149.45"
"2025-03-28","2025-03-25","SF FuneralF1125183      250325","","126.5","","1156275.95"
"2025-03-28","2025-03-25","SF FuneralF1131019      250325","","63.25","","1156339.2"
"2025-03-28","2025-03-25","SF FuneralF1131670      250325","","126.5","","1156465.7"
"2025-03-28","2025-03-25","SF FuneralFDC0000000Q7SH250325","","126.5","","1156592.2"
"2025-03-28","2025-03-26","SF FuneralF799304       250326","","126.5","","1156718.7"
"2025-03-28","2025-03-26","SF FuneralF988427       250326","","126.5","","1156845.2"
"2025-03-28","2025-03-26","SF FuneralF992508       250326","","126.5","","1156971.7"
"2025-03-28","2025-03-26","SF FuneralF1073401      250326","","126.5","","1157098.2"
"2025-03-28","2025-03-27","SF FuneralFDC00000006C6L250327","","126.5","","1157224.7"
"2025-03-28","2025-03-27","SF FuneralFDC00000006CPQ250327","","126.5","","1157351.2"
"2025-03-28","2025-03-27","SF FuneralFDC000000083HX250327","","126.5","","1157477.7"
"2025-03-28","2025-03-27","SF FuneralF805984       250327","","126.5","","1157604.2"
"2025-03-28","2025-03-27","SF FuneralF788124       250327","","126.5","","1157730.7"
"2025-03-28","2025-03-27","SF FuneralF832725       250327","","126.5","","1157857.2"
"2025-03-28","2025-03-27","SF FuneralF1108309      250327","","126.5","","1157983.7"
"2025-03-28","2025-03-28","SF FuneralFDC000000067LH250328","","126.5","","1158110.2"
"2025-03-28","2025-03-28","SF FuneralF808597       250328","","126.5","","1158236.7"
"2025-03-28","2025-03-28","SF FuneralF987170       250328","","126.5","","1158363.2"
"2025-03-28","2025-03-28","SF FuneralF987953       250328","","126.5","","1158489.7"
"2025-03-28","2025-03-28","SF FuneralF1103614      250328","","126.5","","1158616.2"
"2025-03-28","2025-03-28","SF FuneralFDC0000000NJMS250328","","126.5","","1158742.7"
"2025-03-28","2025-03-28","SF FuneralF1125504      250328","","126.5","","1158869.2"
"2025-03-28","2025-03-28","SF FuneralF1127831      250328","","126.5","","1158995.7"
"2025-03-28","2025-03-28","SF FuneralF1130232      250328","","126.5","","1159122.2"
"2025-03-28","2025-03-28","SF FuneralF1134396      250328","","126.5","","1159248.7"
"2025-03-28","2025-03-28","SF FuneralF1134649      250328","","126.5","","1159375.2"
"2025-03-28","2025-03-28","SF FuneralF1134777      250328","","126.5","","1159501.7"
"2025-03-28","2025-03-25","SF FuneralF798676       250325","","31.63","","1159533.33"
"2025-03-28","2025-03-25","SF FuneralF811790       250325","","31.63","","1159564.96"
"2025-03-28","2025-03-25","SF FuneralF991415       250325","","31.63","","1159596.59"
"2025-03-28","2025-03-25","SF FuneralF1062646      250325","","31.63","","1159628.22"
"2025-03-28","2025-03-25","SF FuneralFDC0000000LVMD250325","","31.63","","1159659.85"
"2025-03-28","2025-03-25","SF FuneralF1132989      250325","","31.63","","1159691.48"
"2025-03-28","2025-03-28","SF FuneralF1080183      250328","","31.63","","1159723.11"
"2025-03-28","2025-03-28","SF FuneralF1111672      250328","","31.63","","1159754.74"
"2025-03-28","2025-03-22","SF FuneralFDC00000007FP0250322","","126.5","","1159881.24"
"2025-03-28","2025-03-22","SF FuneralF840792       250322","","126.5","","1160007.74"
"2025-03-28","2025-03-22","SF FuneralF1117884      250322","","126.5","","1160134.24"
"2025-03-28","2025-03-22","SF FuneralF1118891      250322","","126.5","","1160260.74"
"2025-03-28","2025-03-24","SF FuneralF1079049      250324","","126.5","","1160387.24"
"2025-03-28","2025-03-24","SF FuneralF1113979      250324","","63.25","","1160450.49"
"2025-03-28","2025-03-25","SF FuneralFDC00000007R7R250325","","126.5","","1160576.99"
"2025-03-28","2025-03-25","SF FuneralFDC00000007VFN250325","","126.5","","1160703.49"
"2025-03-28","2025-03-25","SF FuneralF1114524      250325","","126.5","","1160829.99"
"2025-03-28","2025-03-25","SF FuneralF1124768      250325","","63.25","","1160893.24"
"2025-03-28","2025-03-25","SF FuneralF1131021      250325","","126.5","","1161019.74"
"2025-03-28","2025-03-26","SF FuneralF820185       250326","","256.5","","1161276.24"
"2025-03-28","2025-03-26","SF FuneralF1033625      250326","","126.5","","1161402.74"
"2025-03-28","2025-03-26","SF FuneralF1066067      250326","","126.5","","1161529.24"
"2025-03-28","2025-03-26","SF FuneralF1120542      250326","","126.5","","1161655.74"
"2025-03-28","2025-03-27","SF FuneralFDC00000005C1C250327","","126.5","","1161782.24"
"2025-03-28","2025-03-27","SF FuneralFDC00000005T5M250327","","220","","1162002.24"
"2025-03-28","2025-03-27","SF FuneralFDC00000005TYG250327","","126.5","","1162128.74"
"2025-03-28","2025-03-27","SF FuneralFDC0000000659D250327","","126.5","","1162255.24"
"2025-03-28","2025-03-27","SF FuneralFDC00000006D6D250327","","126.5","","1162381.74"
"2025-03-28","2025-03-27","SF FuneralFDC00000006DGC250327","","126.5","","1162508.24"
"2025-03-28","2025-03-27","SF FuneralFDC00000006K5G250327","","126.5","","1162634.74"
"2025-03-28","2025-03-27","SF FuneralFDC000000073XW250327","","126.5","","1162761.24"
"2025-03-28","2025-03-27","SF FuneralF802549       250327","","126.5","","1162887.74"
"2025-03-28","2025-03-27","SF FuneralF828861       250327","","126.5","","1163014.24"
"2025-03-28","2025-03-27","SF FuneralF842261       250327","","126.5","","1163140.74"
"2025-03-28","2025-03-27","SF FuneralFDC0000000FT33250327","","126.5","","1163267.24"
"2025-03-28","2025-03-27","SF FuneralFDC0000000H9BG250327","","126.5","","1163393.74"
"2025-03-28","2025-03-27","SF FuneralF1073543      250327","","126.5","","1163520.24"
"2025-03-28","2025-03-27","SF FuneralFDC0000000LCT3250327","","126.5","","1163646.74"
"2025-03-28","2025-03-27","SF FuneralFDC0000000LTGX250327","","126.5","","1163773.24"
"2025-03-28","2025-03-27","SF FuneralF1108145      250327","","126.5","","1163899.74"
"2025-03-28","2025-03-27","SF FuneralFDC0000000MF9J250327","","126.5","","1164026.24"
"2025-03-28","2025-03-27","SF FuneralFDC0000000QMLQ250327","","126.5","","1164152.74"
"2025-03-28","2025-03-27","SF FuneralFDC0000000QMLS250327","","126.5","","1164279.24"
"2025-03-28","2025-03-28","SF FuneralFDC000000067KY250328","","126.5","","1164405.74"
"2025-03-28","2025-03-28","SF FuneralFDC000000077YT250328","","126.5","","1164532.24"
"2025-03-28","2025-03-28","SF FuneralFDC000000079C7250328","","126.5","","1164658.74"
"2025-03-28","2025-03-28","SF FuneralF818385       250328","","126.5","","1164785.24"
"2025-03-28","2025-03-28","SF FuneralF829758       250328","","126.5","","1164911.74"
"2025-03-28","2025-03-28","SF FuneralF832657       250328","","126.5","","1165038.24"
"2025-03-28","2025-03-28","SF FuneralF834685       250328","","126.5","","1165164.74"
"2025-03-28","2025-03-28","SF FuneralF988072       250328","","126.5","","1165291.24"
"2025-03-28","2025-03-28","SF FuneralFDC0000000KS13250328","","126.5","","1165417.74"
"2025-03-28","2025-03-28","SF FuneralFDC0000000L90R250328","","126.5","","1165544.24"
"2025-03-28","2025-03-28","SF FuneralF1118533      250328","","126.5","","1165670.74"
"2025-03-28","2025-03-28","SF FuneralF1120843      250328","","126.5","","1165797.24"
"2025-03-28","2025-03-28","SF FuneralF1127829      250328","","126.5","","1165923.74"
"2025-03-28","2025-03-28","SF FuneralF1128870      250328","","126.5","","1166050.24"
"2025-03-28","2025-03-28","SF FuneralFDC0000000PWXG250328","","126.5","","1166176.74"
"2025-03-28","2025-03-25","Rev SF FuneralFDC0000000Q3TQ250325","","-126.5","","1166050.24"
"2025-03-28","2025-03-25","Rev SF FuneralFDC00000007RN8250325","","-126.5","","1165923.74"
"2025-03-28","2025-03-25","Rev SF FuneralFDC00000009618250325","","-126.5","","1165797.24"
"2025-03-28","2025-03-26","Rev SF FuneralFDC0000000P5Q2250326","","-126.5","","1165670.74"
"2025-03-28","2025-03-26","Rev SF FuneralFDC00000005XF6250326","","-220","","1165450.74"
"2025-03-28","2025-03-22","Rev SF FuneralFDC00000005MT5250322","","-220","","1165230.74"
"2025-03-28","2025-03-28","Rev SF FuneralFDC000000077N9250328","","-126.5","","1165104.24"
"2025-03-28","2025-03-28","Rev SF FuneralFDC00000007CLK250328","","-126.5","","1164977.74"
"2025-03-28","2025-03-28","Rev SF FuneralFDC00000005MG9250328","","-126.5","","1164851.24"
"2025-03-28","2025-03-28","Rev SF FuneralFDC00000005RMM250328","","-220","","1164631.24"
"2025-03-28","2025-03-24","Rev SF FuneralFDC00000006XQB250324","","-126.5","","1164504.74"
"2025-03-28","2025-03-11","Rev SF FuneralFDC00000006WM3250311","","-126.5","","1164378.24"
"2025-03-28","2025-03-22","Rev SF FuneralFDC0000000Q6QQ250322","","-126.5","","1164251.74"
"2025-03-28","2025-01-24","Rev SF FuneralF840731       250127","","-126.5","","1164125.24"
"2025-03-28","2025-03-28","Rev SF FuneralFDC00000005S6H250328","","-126.5","","1163998.74"
"2025-03-28","2025-03-28","Rev SF FuneralFDC0000000L90R250328","","-126.5","","1163872.24"
"2025-03-28","2025-03-19","Rev SF FuneralFDC0000000PW8D250319","","-126.5","","1163745.74"
"2025-03-28","2025-03-28","Rev SF FuneralFDC000000082KD250328","","-126.5","","1163619.24"
"2025-03-28","2025-03-26","Rev SF FuneralFDC00000009TNH250326","","-126.5","","1163492.74"
"2025-03-28","2025-03-20","Rev SF FuneralFDC0000000JTLM250321","","-126.5","","1163366.24"
"2025-03-28","2025-03-22","Rev SF FuneralFDC00000007DYW250322","","-126.5","","1163239.74"
"2025-03-28","2025-03-27","Rev SF FuneralFDC00000006KGR250327","","-126.5","","1163113.24"
"2025-03-28","2025-03-27","Rev SF FuneralFDC00000006BCQ250327","","-126.5","","1162986.74"
"2025-03-28","2025-03-27","Rev SF FuneralFDC0000000H9BG250327","","-126.5","","1162860.24"
"2025-03-28","2025-03-22","Rev SF FuneralFDC000000061B7250322","","-126.5","","1162733.74"
"2025-03-28","2025-03-27","Rev SF FuneralFDC00000009BR8250327","","-126.5","","1162607.24"
"2025-03-28","2025-03-25","Rev SF FuneralFDC00000006WH1250325","","-126.5","","1162480.74"
"2025-03-28","2025-03-28","Rev SF FuneralFDC00000005SV9250328","","-220","","1162260.74"
"2025-03-28","2025-03-25","Rev SF FuneralFDC00000005GLS250325","","-126.5","","1162134.24"
"2025-03-28","2025-03-28","Rev SF FuneralFDC0000000MM2D250328","","-126.5","","1162007.74"
"2025-03-28","2025-03-28","Rev SF FuneralFDC00000005SZJ250328","","-126.5","","1161881.24"
"2025-03-28","2025-03-28","Rev SF FuneralFDC0000000MM2M250328","","-126.5","","1161754.74"
"2025-03-28","2025-03-28","Rev SF FuneralFDC000000067KY250328","","-126.5","","1161628.24"
"2025-03-28","2025-03-28","Rev SF FuneralFDC0000000N3SL250328","","-126.5","","1161501.74"
"2025-03-28","2025-03-28","Rev SF FuneralFDC00000006KZ0250328","","-126.5","","1161375.24"
"2025-03-28","2025-03-28","Rev SF FuneralFDC000000067LH250328","","-126.5","","1161248.74"
"2025-03-28","2025-03-28","Rev SF FuneralFDC00000006KFV250328","","-126.5","","1161122.24"
"2025-03-28","2025-03-28","Rev SF FuneralFDC00000008W95250328","","-126.5","","1160995.74"
"2025-03-28","2025-03-28","Rev SF FuneralFDC000000067RK250328","","-126.5","","1160869.24"
"2025-03-28","2025-03-27","Rev SF FuneralFDC00000006BBY250327","","-126.5","","1160742.74"
"2025-03-28","2025-03-24","Rev SF FuneralFDC00000006RN5250324","","-126.5","","1160616.24"
"2025-03-28","2025-03-25","Rev SF FuneralFDC00000006DSH250325","","-126.5","","1160489.74"
"2025-03-28","2025-03-22","Rev SF FuneralFDC00000008XWQ250322","","-126.5","","1160363.24"
"2025-03-28","2025-03-24","Rev SF FuneralFDC0000000640K250324","","-126.5","","1160236.74"
"2025-03-28","2025-03-22","Rev SF FuneralFDC00000007ZW7250322","","-126.5","","1160110.24"
"2025-03-28","2025-03-22","Rev SF FuneralFDC00000008BSZ250322","","-126.5","","1159983.74"
"2025-03-28","2025-03-22","Rev SF FuneralFDC0000000LLT3250323","","-126.5","","1159857.24"
"2025-03-28","2025-03-22","Rev SF FuneralFDC000000080YV250322","","-126.5","","1159730.74"
"2025-03-28","2025-03-22","Rev SF FuneralFDC0000000617L250322","","-126.5","","1159604.24"
"2025-03-28","2025-03-28","Rev SF FuneralFDC000000032VH250328","","-55","","1159549.24"
"2025-03-28","2025-03-28","Rev SF FuneralFDC0000000JXK7250328","","-31.63","","1159517.61"
"2025-03-28","2025-03-24","Rev SF FuneralFDC00000007GFX250323","","-31.63","","1159485.98"
"2025-03-28","2025-03-24","Rev SF FuneralFDC00000007GG1250323","","-31.63","","1159454.35"
"2025-03-28","2025-03-24","Rev SF FuneralFDC00000005WTC250324","","-55","","1159399.35"
"2025-03-28","2025-03-25","Rev SF FuneralFDC00000006STJ250325","","-31.63","","1159367.72"
"2025-03-28","2025-03-25","Rev SF FuneralFDC00000008C95250325","","-31.63","","1159336.09"
"2025-03-28","2025-03-28","Rev SF FuneralFDC0000000B37Y250328","","-31.63","","1159304.46"
"2025-03-28","2025-03-28","Fee-Teller Transactions","","-11.91","","1159292.55"
"2025-03-28","2025-03-28","Dep-Cash-SFTAP20241108037","","126.5","11.91","1159419.05"
"2025-03-28","2025-03-24","SF FuneralF1120799      250324","","126.5","","1159545.55"
"2025-03-28","2025-03-27","SF FuneralF1108326      250327","","126.5","","1159672.05"
"2025-03-28","2025-03-27","SF FuneralF1117198      250327","","126.5","","1159798.55"
"2025-03-28","2025-03-25","SF FuneralF801331       250325","","31.63","","1159830.18"
"2025-03-28","2025-03-25","SF FuneralF1060278      250325","","126.5","","1159956.68"
"2025-03-28","2025-03-25","SF FuneralF1075090      250325","","126.5","","1160083.18"
"2025-03-28","2025-03-25","SF FuneralF1084970      250325","","126.5","","1160209.68"
"2025-03-28","2025-03-25","SF FuneralF1122862      250325","","31.63","","1160241.31"
"2025-03-28","2025-03-25","SF FuneralF1125013      250325","","126.5","","1160367.81"
"2025-03-28","2025-03-25","SF FuneralF1131281      250325","","126.5","","1160494.31"
"2025-03-28","2025-03-22","SF FuneralFDC00000005Y6G250322","","126.5","","1160620.81"
"2025-03-28","2025-03-22","SF FuneralF813432       250322","","126.5","","1160747.31"
"2025-03-28","2025-03-22","SF FuneralFDC0000000B43F250322","","126.5","","1160873.81"
"2025-03-28","2025-03-22","SF FuneralF819997       250322","","126.5","","1161000.31"
"2025-03-28","2025-03-22","SF FuneralF823566       250322","","126.5","","1161126.81"
"2025-03-28","2025-03-22","SF FuneralF831792       250321","","31.63","","1161158.44"
"2025-03-28","2025-03-22","SF FuneralFDC0000000DDX5250322","","126.5","","1161284.94"
"2025-03-28","2025-03-22","SF FuneralF841318       250322","","126.5","","1161411.44"
"2025-03-28","2025-03-25","SF FuneralF818397       250325","","126.5","","1161537.94"
"2025-03-28","2025-03-25","SF FuneralF833023       250325","","126.5","","1161664.44"
"2025-03-28","2025-03-25","SF FuneralFDC0000000DDQR250325","","126.5","","1161790.94"
"2025-03-28","2025-03-25","SF FuneralF840732       250325","","126.5","","1161917.44"
"2025-03-28","2025-03-25","SF FuneralF1054618      250325","","31.63","","1161949.07"
"2025-03-28","2025-03-25","SF FuneralF1068068      250325","","63.25","","1162012.32"
"2025-03-28","2025-03-25","SF FuneralF1068168      250325","","126.5","","1162138.82"
"2025-03-28","2025-03-25","SF FuneralF1132482      250325","","126.5","","1162265.32"
"2025-03-28","2025-03-27","SF FuneralFDC000000056YX250327","","126.5","","1162391.82"
"2025-03-28","2025-03-27","SF FuneralFDC000000085LB250327","","126.5","","1162518.32"
"2025-03-28","2025-03-27","SF FuneralF842107       250327","","126.5","","1162644.82"
"2025-03-28","2025-03-27","SF FuneralF1020954      250327","","126.5","","1162771.32"
"2025-03-28","2025-03-27","SF FuneralF1120130      250327","","126.5","","1162897.82"
"2025-03-28","2025-03-28","SF FuneralFDC00000006Y2R250328","","126.5","","1163024.32"
"2025-03-28","2025-03-28","SF FuneralFDC0000000711R250328","","126.5","","1163150.82"
"2025-03-28","2025-03-28","SF FuneralF831792       250328","","31.63","","1163182.45"
"2025-03-28","2025-03-28","SF FuneralF1060267      250328","","126.5","","1163308.95"
"2025-03-28","2025-03-26","SF FuneralF1020960      250326","","63.25","","1163372.2"
"2025-03-28","2025-03-28","SF FuneralFDC00000005G7P250328","","126.5","","1163498.7"
"2025-03-28","2025-03-28","SF FuneralF805682       250328","","126.5","","1163625.2"
"2025-03-28","2025-03-28","SF FuneralF843119       250328","","126.5","","1163751.7"
"2025-03-28","2025-03-28","SF FuneralF1067006      250328","","126.5","","1163878.2"
"2025-03-28","2025-03-28","SF FuneralF1118280      250328","","126.5","","1164004.7"
"2025-03-28","2025-03-28","SF FuneralF1125855      250328","","126.5","","1164131.2"
"2025-03-28","2025-03-28","SF FuneralF1129847      250328","","126.5","","1164257.7"
"2025-03-28","2025-03-28","SF FuneralF1134068      250328","","126.5","","1164384.2"
"2025-03-28","2025-03-28","SF FuneralF1135034      250328","","126.5","","1164510.7"
"2025-03-28","2025-03-22","SF FuneralF805804       250322","","126.5","","1164637.2"
"2025-03-28","2025-03-22","SF FuneralF991686       250322","","126.5","","1164763.7"
"2025-03-28","2025-03-22","SF FuneralF1060581      250323","","126.5","","1164890.2"
"2025-03-28","2025-03-22","SF FuneralF1078327      250322","","126.5","","1165016.7"
"2025-03-28","2025-03-22","SF FuneralF1083958      250323","","126.5","","1165143.2"
"2025-03-28","2025-03-22","SF FuneralF1118265      250323","","126.5","","1165269.7"
"2025-03-28","2025-03-22","SF FuneralF1118554      250323","","126.5","","1165396.2"
"2025-03-28","2025-03-22","SF FuneralF1120384      250322","","126.5","","1165522.7"
"2025-03-28","2025-03-22","SF FuneralF1127768      250322","","126.5","","1165649.2"
"2025-03-28","2025-03-27","SF FuneralF829709       250327","","126.5","","1165775.7"
"2025-03-28","2025-03-27","SF FuneralF831002       250327","","126.5","","1165902.2"
"2025-03-28","2025-03-27","SF FuneralF831014       250327","","126.5","","1166028.7"
"2025-03-28","2025-03-27","SF FuneralF843960       250327","","126.5","","1166155.2"
"2025-03-28","2025-03-27","SF FuneralF1016868      250327","","126.5","","1166281.7"
"2025-03-28","2025-03-27","SF FuneralF1120819      250327","","126.5","","1166408.2"
"2025-03-28","2025-03-24","SF FuneralFDC00000006CWF250323","","126.5","","1166534.7"
"2025-03-28","2025-03-24","SF FuneralF1085166      250324","","126.5","","1166661.2"
"2025-03-28","2025-03-24","SF FuneralF1125174      250324","","126.5","","1166787.7"
"2025-03-28","2025-03-24","SF FuneralF1127550      250324","","126.5","","1166914.2"
"2025-03-28","2025-03-21","SF FuneralF842194       250321","","126.5","","1167040.7"
"2025-03-28","2025-03-25","SF FuneralFDC0000000892D250325","","31.63","","1167072.33"
"2025-03-28","2025-03-25","SF FuneralFDC00000008C4Y250325","","63.25","","1167135.58"
"2025-03-28","2025-03-25","SF FuneralF806032       250325","","31.63","","1167167.21"
"2025-03-28","2025-03-25","SF FuneralF809001       250325","","126.5","","1167293.71"
"2025-03-28","2025-03-25","SF FuneralF809435       250325","","31.63","","1167325.34"
"2025-03-28","2025-03-25","SF FuneralF811757       250325","","126.5","","1167451.84"
"2025-03-28","2025-03-25","SF FuneralFDC00000009H46250325","","31.63","","1167483.47"
"2025-03-28","2025-03-25","SF FuneralFDC00000009LMY250325","","126.5","","1167609.97"
"2025-03-28","2025-03-25","SF FuneralF827942       250325","","126.5","","1167736.47"
"2025-03-28","2025-03-25","SF FuneralFDC0000000J23L250325","","31.63","","1167768.1"
"2025-03-28","2025-03-25","SF FuneralF1052200      250325","","31.63","","1167799.73"
"2025-03-28","2025-03-25","SF FuneralF843649       250325","","31.63","","1167831.36"
"2025-03-28","2025-03-25","SF FuneralF1061075      250325","","31.63","","1167862.99"
"2025-03-28","2025-03-25","SF FuneralF1068023      250325","","31.63","","1167894.62"
"2025-03-28","2025-03-25","SF FuneralF1111658      250325","","63.25","","1167957.87"
"2025-03-28","2025-03-25","SF FuneralF1116035      250325","","126.5","","1168084.37"
"2025-03-28","2025-03-25","SF FuneralF1117702      250325","","31.63","","1168116"
"2025-03-28","2025-03-25","SF FuneralF1120757      250325","","126.5","","1168242.5"
"2025-03-28","2025-03-25","SF FuneralF820999       250325","","31.63","","1168274.13"
"2025-03-28","2025-03-25","SF FuneralF1125142      250325","","31.63","","1168305.76"
"2025-03-28","2025-03-25","SF FuneralF1130345      250325","","31.63","","1168337.39"
"2025-03-28","2025-03-25","SF FuneralF1133731      250325","","31.63","","1168369.02"
"2025-03-28","2025-03-22","SF FuneralF992485       250322","","126.5","","1168495.52"
"2025-03-28","2025-03-24","SF FuneralF833060       250324","","126.5","","1168622.02"
"2025-03-28","2025-03-24","SF FuneralF840921       250324","","126.5","","1168748.52"
"2025-03-28","2025-03-25","SF FuneralF841235       250325","","126.5","","1168875.02"
"2025-03-28","2025-03-25","SF FuneralF1130930      250325","","126.5","","1169001.52"
"2025-03-28","2025-03-25","SF FuneralFDC0000000Q3YH250325","","126.5","","1169128.02"
"2025-03-28","2025-03-25","SF FuneralFDC0000000Q3YM250325","","191.5","","1169319.52"
"2025-03-28","2025-03-26","SF FuneralF819111       250326","","31.63","","1169351.15"
"2025-03-28","2025-03-26","SF FuneralF993324       250326","","126.5","","1169477.65"
"2025-03-28","2025-03-27","SF FuneralF829782       250327","","126.5","","1169604.15"
"2025-03-28","2025-03-28","SF FuneralFDC000000077Y7250328","","126.5","","1169730.65"
"2025-03-28","2025-03-28","SF FuneralF1050845      250328","","126.5","","1169857.15"
"2025-03-28","2025-03-28","Rev SF FuneralFDC00000006Y2R250328","","-126.5","","1169730.65"
"2025-03-29","2025-03-22","SF FuneralFDC000000063B4250322","","126.5","","1169857.15"
"2025-03-29","2025-03-22","SF FuneralF811335       250322","","126.5","","1169983.65"
"2025-03-29","2025-03-22","SF FuneralF1052646      250322","","126.5","","1170110.15"
"2025-03-29","2025-03-22","SF FuneralF1066049      250322","","126.5","","1170236.65"
"2025-03-29","2025-03-22","SF FuneralF1117250      250322","","126.5","","1170363.15"
"2025-03-29","2025-03-22","SF FuneralF1129087      250322","","126.5","","1170489.65"
"2025-03-29","2025-03-26","SF FuneralFDC00000007B1L250326","","126.5","","1170616.15"
"2025-03-29","2025-03-26","SF FuneralF992126       250326","","126.5","","1170742.65"
"2025-03-29","2025-03-26","SF FuneralF1108259      250326","","126.5","","1170869.15"
"2025-03-29","2025-03-24","SF FuneralF801948       250324","","126.5","","1170995.65"
"2025-03-29","2025-03-24","SF FuneralF831659       250324","","126.5","","1171122.15"
"2025-03-29","2025-03-24","SF FuneralF834709       250324","","63.25","","1171185.4"
"2025-03-29","2025-03-24","SF FuneralF1118919      250324","","126.5","","1171311.9"
"2025-03-29","2025-03-25","SF FuneralFDC00000003HGD250325","","220","","1171531.9"
"2025-03-29","2025-03-25","SF FuneralF832776       250325","","63.25","","1171595.15"
"2025-03-29","2025-03-25","SF FuneralF1016973      250325","","31.63","","1171626.78"
"2025-03-29","2025-03-25","SF FuneralF1022184      250325","","31.63","","1171658.41"
"2025-03-29","2025-03-25","SF FuneralF1022241      250325","","126.5","","1171784.91"
"2025-03-29","2025-03-25","SF FuneralF1079490      250325","","126.5","","1171911.41"
"2025-03-29","2025-03-25","SF FuneralF1080308      250325","","126.5","","1172037.91"
"2025-03-29","2025-03-25","SF FuneralF1110349      250325","","31.63","","1172069.54"
"2025-03-29","2025-03-25","SF FuneralF1113997      250325","","126.5","","1172196.04"
"2025-03-29","2025-03-25","SF FuneralF1117618      250325","","126.5","","1172322.54"
"2025-03-29","2025-03-25","SF FuneralF1120837      250325","","191.5","","1172514.04"
"2025-03-29","2025-03-25","SF FuneralF1127818      250325","","31.63","","1172545.67"
"2025-03-29","2025-03-25","SF FuneralF1120557      250325","","126.5","","1172672.17"
"2025-03-29","2025-03-25","SF FuneralFDC0000000Q3YF250325","","126.5","","1172798.67"
"2025-03-29","2025-03-25","SF FuneralF1132455      250325","","126.5","","1172925.17"
"2025-03-29","2025-03-28","SF FuneralFDC000000062VZ250328","","126.5","","1173051.67"
"2025-03-29","2025-03-28","SF FuneralFDC00000006CJL250328","","126.5","","1173178.17"
"2025-03-29","2025-03-28","SF FuneralFDC000000072YM250328","","126.5","","1173304.67"
"2025-03-29","2025-03-28","SF FuneralFDC000000079ZD250328","","126.5","","1173431.17"
"2025-03-29","2025-03-28","SF FuneralF798583       250328","","31.63","","1173462.8"
"2025-03-29","2025-03-28","SF FuneralF830867       250328","","126.5","","1173589.3"
"2025-03-29","2025-03-28","SF FuneralF1108704      250328","","126.5","","1173715.8"
"2025-03-29","2025-03-28","SF FuneralF1111682      250328","","126.5","","1173842.3"
"2025-03-29","2025-03-28","SF FuneralFDC0000000P05J250328","","126.5","","1173968.8"
"2025-03-29","2025-03-28","SF FuneralF1128150      250328","","126.5","","1174095.3"
"2025-03-29","2025-03-28","SF FuneralF1133714      250328","","126.5","","1174221.8"
"2025-03-29","2025-03-28","SF FuneralF1134533      250328","","126.5","","1174348.3"
"2025-03-29","2025-03-28","SF FuneralFDC0000000QLHP250328","","126.5","","1174474.8"
"2025-03-29","2025-03-24","SF FuneralF1128771      250324","","126.5","","1174601.3"
"2025-03-29","2025-03-29","SF FuneralFDC00000007B0G250329","","126.5","","1174727.8"
"2025-03-29","2025-03-25","SF FuneralFDC000000064P9250325","","31.63","","1174759.43"
"2025-03-29","2025-03-25","SF FuneralF1073379      250325","","31.63","","1174791.06"
"2025-03-29","2025-03-25","SF FuneralF1073746      250325","","31.63","","1174822.69"
"2025-03-29","2025-03-25","SF FuneralF739720       250325","","64.13","","1174886.82"
"2025-03-29","2025-03-24","SF FuneralF808988       250324","","31.63","","1174918.45"
"2025-03-29","2025-03-25","SF FuneralFDC00000006Y7S250325","","31.63","","1174950.08"
"2025-03-29","2025-03-25","SF FuneralF805200       250325","","31.63","","1174981.71"
"2025-03-29","2025-03-25","SF FuneralF833123       250325","","31.63","","1175013.34"
"2025-03-29","2025-03-25","SF FuneralF1050698      250325","","31.63","","1175044.97"
"2025-03-29","2025-03-25","SF FuneralF1068027      250325","","31.63","","1175076.6"
"2025-03-29","2025-03-25","SF FuneralF1074598      250325","","31.63","","1175108.23"
"2025-03-29","2025-03-25","SF FuneralF1118962      250325","","31.63","","1175139.86"
"2025-03-29","2025-03-27","SF FuneralF828917       250327","","126.5","","1175266.36"
"2025-03-29","2025-03-27","SF FuneralF780539       250327","","365.12","","1175631.48"
"2025-03-29","2025-03-27","SF FuneralF1060191      250327","","126.5","","1175757.98"
"2025-03-29","2025-03-27","SF FuneralF1111282      250327","","126.5","","1175884.48"
"2025-03-29","2025-03-27","SF FuneralF1114389      250327","","126.5","","1176010.98"
"2025-03-29","2025-03-27","SF FuneralF1115163      250327","","126.5","","1176137.48"
"2025-03-29","2025-03-27","SF FuneralF1116078      250327","","126.5","","1176263.98"
"2025-03-29","2025-03-27","SF FuneralF1123182      250327","","126.5","","1176390.48"
"2025-03-29","2025-03-25","SF FuneralFDC00000007343250325","","126.5","","1176516.98"
"2025-03-29","2025-03-25","SF FuneralF988057       250325","","126.5","","1176643.48"
"2025-03-29","2025-03-25","SF FuneralF988975       250325","","126.5","","1176769.98"
"2025-03-29","2025-03-25","SF FuneralF1021955      250325","","63.25","","1176833.23"
"2025-03-29","2025-03-25","SF FuneralF1120296      250325","","126.5","","1176959.73"
"2025-03-29","2025-03-25","SF FuneralF1131055      250325","","126.5","","1177086.23"
"2025-03-29","2025-03-25","SF FuneralFDC0000000QGBP250325","","126.5","","1177212.73"
"2025-03-29","2025-03-26","SF FuneralF813598       250326","","126.5","","1177339.23"
"2025-03-29","2025-03-26","SF FuneralF842446       250326","","126.5","","1177465.73"
"2025-03-29","2025-03-26","SF FuneralF992356       250326","","126.5","","1177592.23"
"2025-03-29","2025-03-26","SF FuneralF993570       250326","","126.5","","1177718.73"
"2025-03-29","2025-03-26","SF FuneralF993666       250326","","126.5","","1177845.23"
"2025-03-29","2025-03-26","SF FuneralF1016815      250326","","126.5","","1177971.73"
"2025-03-29","2025-03-26","SF FuneralF1020969      250326","","126.5","","1178098.23"
"2025-03-29","2025-03-26","SF FuneralF1059431      250326","","126.5","","1178224.73"
"2025-03-29","2025-03-26","SF FuneralFDC0000000NJ6M250326","","126.5","","1178351.23"
"2025-03-29","2025-03-26","SF FuneralF1122742      250326","","126.5","","1178477.73"
"2025-03-29","2025-03-27","SF FuneralFDC00000005W51250327","","126.5","","1178604.23"
"2025-03-29","2025-03-27","SF FuneralFDC000000076M7250327","","126.5","","1178730.73"
"2025-03-29","2025-03-27","SF FuneralF786966       250327","","126.5","","1178857.23"
"2025-03-29","2025-03-27","SF FuneralF812127       250327","","126.5","","1178983.73"
"2025-03-29","2025-03-27","SF FuneralFDC00000009FRN250327","","126.5","","1179110.23"
"2025-03-29","2025-03-27","SF FuneralF819027       250327","","126.5","","1179236.73"
"2025-03-29","2025-03-27","SF FuneralF1079485      250327","","126.5","","1179363.23"
"2025-03-29","2025-03-27","SF FuneralF1112508      250327","","126.5","","1179489.73"
"2025-03-29","2025-03-27","SF FuneralFDC0000000NBR0250327","","126.5","","1179616.23"
"2025-03-29","2025-03-27","SF FuneralFDC0000000NHCZ250327","","126.5","","1179742.73"
"2025-03-29","2025-03-27","SF FuneralFDC0000000NHD0250327","","126.5","","1179869.23"
"2025-03-29","2025-03-27","SF FuneralF1120879      250327","","126.5","","1179995.73"
"2025-03-29","2025-03-27","SF FuneralFDC0000000P0RR250327","","126.5","","1180122.23"
"2025-03-29","2025-03-27","SF FuneralFDC0000000P3YP250327","","126.5","","1180248.73"
"2025-03-29","2025-03-27","SF FuneralFDC0000000P3YR250327","","126.5","","1180375.23"
"2025-03-29","2025-03-27","SF FuneralF1134416      250327","","126.5","","1180501.73"
"2025-03-29","2025-03-28","SF FuneralFDC000000069N7250328","","126.5","","1180628.23"
"2025-03-29","2025-03-28","SF FuneralFDC00000006WL2250328","","126.5","","1180754.73"
"2025-03-29","2025-03-28","SF FuneralFDC00000006ZCZ250328","","126.5","","1180881.23"
"2025-03-29","2025-03-28","SF FuneralFDC000000076JB250328","","126.5","","1181007.73"
"2025-03-29","2025-03-28","SF FuneralFDC00000008W79250328","","126.5","","1181134.23"
"2025-03-29","2025-03-28","SF FuneralF980892       250328","","126.5","","1181260.73"
"2025-03-29","2025-03-28","SF FuneralFDC0000000HQMZ250328","","126.5","","1181387.23"
"2025-03-29","2025-03-28","SF FuneralF988871       250329","","126.5","","1181513.73"
"2025-03-29","2025-03-28","SF FuneralF788642       250328","","126.5","","1181640.23"
"2025-03-29","2025-03-28","SF FuneralF1110539      250328","","126.5","","1181766.73"
"2025-03-29","2025-03-28","SF FuneralF1133567      250328","","126.5","","1181893.23"
"2025-03-29","2025-03-28","SF FuneralF1135304      250328","","63.25","","1181956.48"
"2025-03-29","2025-03-25","SF FuneralF1078528      250325","","63.25","","1182019.73"
"2025-03-29","2025-03-25","SF FuneralF1078541      250325","","126.5","","1182146.23"
"2025-03-29","2025-03-26","SF FuneralFDC00000007H1F250326","","126.5","","1182272.73"
"2025-03-29","2025-03-26","SF FuneralF1083845      250326","","126.5","","1182399.23"
"2025-03-29","2025-03-26","SF FuneralF1122569      250326","","126.5","","1182525.73"
"2025-03-29","2025-03-27","SF FuneralFDC0000000F5C8250327","","126.5","","1182652.23"
"2025-03-29","2025-03-27","SF FuneralF900699       250327","","126.5","","1182778.73"
"2025-03-29","2025-03-27","SF FuneralF1075141      250327","","126.5","","1182905.23"
"2025-03-29","2025-03-27","SF FuneralF1084890      250327","","126.5","","1183031.73"
"2025-03-29","2025-03-27","SF FuneralF1114941      250327","","126.5","","1183158.23"
"2025-03-29","2025-03-28","SF FuneralFDC000000068K8250328","","126.5","","1183284.73"
"2025-03-29","2025-03-28","SF FuneralF819922       250328","","126.5","","1183411.23"
"2025-03-29","2025-03-28","SF FuneralFDC0000000LTTB250328","","126.5","","1183537.73"
"2025-03-29","2025-03-28","SF FuneralF1129508      250328","","126.5","","1183664.23"
"2025-03-29","2025-03-20","SF FuneralFDC0000000BJ1W250320","","126.5","","1183790.73"
"2025-03-29","2025-03-22","SF FuneralFDC000000030P2250322","","220","","1184010.73"
"2025-03-29","2025-03-22","SF FuneralFDC000000062BS250322","","126.5","","1184137.23"
"2025-03-29","2025-03-22","SF FuneralFDC000000062PC250322","","126.5","","1184263.73"
"2025-03-29","2025-03-22","SF FuneralFDC00000007LYP250322","","126.5","","1184390.23"
"2025-03-29","2025-03-22","SF FuneralFDC00000007M48250322","","126.5","","1184516.73"
"2025-03-29","2025-03-22","SF FuneralF802870       250322","","126.5","","1184643.23"
"2025-03-29","2025-03-22","SF FuneralFDC0000000BJ5F250322","","126.5","","1184769.73"
"2025-03-29","2025-03-22","SF FuneralF991753       250322","","126.5","","1184896.23"
"2025-03-29","2025-03-22","SF FuneralF1061976      250322","","126.5","","1185022.73"
"2025-03-29","2025-03-22","SF FuneralF1116017      250322","","126.5","","1185149.23"
"2025-03-29","2025-03-22","SF FuneralF1124760      250323","","126.5","","1185275.73"
"2025-03-29","2025-03-22","SF FuneralF1130918      250322","","126.5","","1185402.23"
"2025-03-29","2025-03-24","SF FuneralFDC000000063H3250324","","126.5","","1185528.73"
"2025-03-29","2025-03-24","SF FuneralFDC00000006D2N250324","","126.5","","1185655.23"
"2025-03-29","2025-03-24","SF FuneralF798445       250323","","126.5","","1185781.73"
"2025-03-29","2025-03-24","SF FuneralF832212       250323","","126.5","","1185908.23"
"2025-03-29","2025-03-24","SF FuneralF1020978      250324","","126.5","","1186034.73"
"2025-03-29","2025-03-24","SF FuneralF1110347      250324","","126.5","","1186161.23"
"2025-03-29","2025-03-24","SF FuneralF1113638      250324","","126.5","","1186287.73"
"2025-03-29","2025-03-24","SF FuneralF1131743      250324","","126.5","","1186414.23"
"2025-03-29","2025-03-24","SF FuneralF1133782      250324","","126.5","","1186540.73"
"2025-03-29","2025-03-25","SF FuneralFDC00000006ZHR250325","","126.5","","1186667.23"
"2025-03-29","2025-03-25","SF FuneralFDC000000070HK250325","","126.5","","1186793.73"
"2025-03-29","2025-03-25","SF FuneralFDC00000007F33250325","","126.5","","1186920.23"
"2025-03-29","2025-03-25","SF FuneralFDC00000007Q9T250325","","126.5","","1187046.73"
"2025-03-29","2025-03-25","SF FuneralFDC00000007TNM250325","","126.5","","1187173.23"
"2025-03-29","2025-03-25","SF FuneralF811637       250325","","126.5","","1187299.73"
"2025-03-29","2025-03-25","SF FuneralF813480       250325","","63.25","","1187362.98"
"2025-03-29","2025-03-25","SF FuneralF818917       250325","","126.5","","1187489.48"
"2025-03-29","2025-03-25","SF FuneralF823123       250325","","126.5","","1187615.98"
"2025-03-29","2025-03-25","SF FuneralFDC0000000CWJT250325","","63.25","","1187679.23"
"2025-03-29","2025-03-25","SF FuneralF841803       250325","","126.5","","1187805.73"
"2025-03-29","2025-03-25","SF FuneralF986987       250325","","126.5","","1187932.23"
"2025-03-29","2025-03-25","SF FuneralF1060916      250325","","126.5","","1188058.73"
"2025-03-29","2025-03-25","SF FuneralF1074593      250325","","126.5","","1188185.23"
"2025-03-29","2025-03-25","SF FuneralF1120337      250325","","126.5","","1188311.73"
"2025-03-29","2025-03-25","SF FuneralF1129906      250325","","126.5","","1188438.23"
"2025-03-29","2025-03-25","SF FuneralFDC0000000Q26X250325","","126.5","","1188564.73"
"2025-03-29","2025-03-25","SF FuneralF1131619      250325","","126.5","","1188691.23"
"2025-03-29","2025-03-25","SF FuneralF1131740      250325","","126.5","","1188817.73"
"2025-03-29","2025-03-25","SF FuneralFDC0000000Q6DN250325","","126.5","","1188944.23"
"2025-03-29","2025-03-25","SF FuneralF1131907      250325","","126.5","","1189070.73"
"2025-03-29","2025-03-25","SF FuneralF1133745      250325","","126.5","","1189197.23"
"2025-03-29","2025-03-25","SF FuneralF1134825      250325","","126.5","","1189323.73"
"2025-03-29","2025-03-25","SF FuneralFDC0000000QL8H250325","","126.5","","1189450.23"
"2025-03-29","2025-03-26","SF FuneralF986933       250326","","126.5","","1189576.73"
"2025-03-29","2025-03-26","SF FuneralFDC0000000JCX1250326","","126.5","","1189703.23"
"2025-03-29","2025-03-26","SF FuneralF993908       250326","","126.5","","1189829.73"
"2025-03-29","2025-03-26","SF FuneralF1122781      250326","","126.5","","1189956.23"
"2025-03-29","2025-03-27","SF FuneralFDC000000067VH250327","","126.5","","1190082.73"
"2025-03-29","2025-03-27","SF FuneralF806015       250327","","126.5","","1190209.23"
"2025-03-29","2025-03-27","SF FuneralF1121923      250327","","126.5","","1190335.73"
"2025-03-29","2025-03-28","SF FuneralFDC00000006GJB250328","","126.5","","1190462.23"
"2025-03-29","2025-03-28","SF FuneralFDC00000007HWV250328","","126.5","","1190588.73"
"2025-03-29","2025-03-28","SF FuneralF816288       250328","","126.5","","1190715.23"
"2025-03-29","2025-03-28","SF FuneralF823120       250328","","126.5","","1190841.73"
"2025-03-29","2025-03-28","SF FuneralF981545       250328","","126.5","","1190968.23"
"2025-03-29","2025-03-28","SF FuneralF1062690      250328","","126.5","","1191094.73"
"2025-03-29","2025-03-28","SF FuneralF1062712      250328","","126.5","","1191221.23"
"2025-03-29","2025-03-28","SF FuneralF1062716      250328","","126.5","","1191347.73"
"2025-03-29","2025-03-28","SF FuneralF1108600      250328","","126.5","","1191474.23"
"2025-03-29","2025-03-28","SF FuneralF1113148      250328","","126.5","","1191600.73"
"2025-03-29","2025-03-28","SF FuneralF1116760      250328","","126.5","","1191727.23"
"2025-03-29","2025-03-28","SF FuneralF1133562      250328","","126.5","","1191853.73"
"2025-03-29","2025-03-28","SF FuneralF1133750      250328","","126.5","","1191980.23"
"2025-03-29","2025-03-28","SF FuneralFDC0000000QG6P250328","","126.5","","1192106.73"
"2025-03-29","2025-03-20","SF FuneralF987948       250322","","126.5","","1192233.23"
"2025-03-29","2025-03-20","SF FuneralF988262       250322","","126.5","","1192359.73"
"2025-03-29","2025-03-20","SF FuneralF990262       250323","","126.5","","1192486.23"
"2025-03-29","2025-03-22","SF FuneralFDC00000006NG2250322","","126.5","","1192612.73"
"2025-03-29","2025-03-22","SF FuneralFDC00000008205250321","","126.5","","1192739.23"
"2025-03-29","2025-03-22","SF FuneralF812664       250322","","126.5","","1192865.73"
"2025-03-29","2025-03-22","SF FuneralFDC0000000M0ZD250322","","126.5","","1192992.23"
"2025-03-29","2025-03-22","SF FuneralF1116000      250323","","126.5","","1193118.73"
"2025-03-29","2025-03-22","SF FuneralF1120823      250322","","126.5","","1193245.23"
"2025-03-29","2025-03-22","SF FuneralF1129085      250323","","126.5","","1193371.73"
"2025-03-29","2025-03-24","SF FuneralFDC000000034JS250324","","110","","1193481.73"
"2025-03-29","2025-03-24","SF FuneralFDC00000003D9X250324","","220","","1193701.73"
"2025-03-29","2025-03-24","SF FuneralFDC00000008JC5250324","","126.5","","1193828.23"
"2025-03-29","2025-03-24","SF FuneralFDC000000099T5250323","","126.5","","1193954.73"
"2025-03-29","2025-03-24","SF FuneralF827769       250324","","126.5","","1194081.23"
"2025-03-29","2025-03-24","SF FuneralF987009       250324","","126.5","","1194207.73"
"2025-03-29","2025-03-24","SF FuneralFDC0000000LWJY250324","","126.5","","1194334.23"
"2025-03-29","2025-03-24","SF FuneralF1131530      250324","","126.5","","1194460.73"
"2025-03-29","2025-03-24","SF FuneralF1134082      250324","","126.5","","1194587.23"
"2025-03-29","2025-03-25","SF FuneralF816652       250325","","126.5","","1194713.73"
"2025-03-29","2025-03-25","SF FuneralF1072850      250325","","63.25","","1194776.98"
"2025-03-29","2025-03-25","SF FuneralF1080351      250325","","63.25","","1194840.23"
"2025-03-29","2025-03-25","SF FuneralFDC0000000Q3YX250325","","126.5","","1194966.73"
"2025-03-29","2025-03-25","SF FuneralFDC0000000Q3YY250325","","126.5","","1195093.23"
"2025-03-29","2025-03-26","SF FuneralFDC0000000NZM2250326","","126.5","","1195219.73"
"2025-03-29","2025-03-26","SF FuneralF1120917      250326","","126.5","","1195346.23"
"2025-03-29","2025-03-27","SF FuneralFDC00000006FKS250327","","126.5","","1195472.73"
"2025-03-29","2025-03-27","SF FuneralFDC00000007TMJ250327","","126.5","","1195599.23"
"2025-03-29","2025-03-27","SF FuneralFDC00000008RHL250327","","126.5","","1195725.73"
"2025-03-29","2025-03-27","SF FuneralFDC00000008RKZ250327","","126.5","","1195852.23"
"2025-03-29","2025-03-27","SF FuneralF820060       250327","","126.5","","1195978.73"
"2025-03-29","2025-03-27","SF FuneralF834878       250327","","126.5","","1196105.23"
"2025-03-29","2025-03-27","SF FuneralFDC0000000D2XC250327","","126.5","","1196231.73"
"2025-03-29","2025-03-27","SF FuneralF841074       250327","","126.5","","1196358.23"
"2025-03-29","2025-03-27","SF FuneralF841104       250327","","126.5","","1196484.73"
"2025-03-29","2025-03-27","SF FuneralFDC0000000KFH7250327","","126.5","","1196611.23"
"2025-03-29","2025-03-27","SF FuneralF1112480      250327","","126.5","","1196737.73"
"2025-03-29","2025-03-27","SF FuneralF1114046      250327","","126.5","","1196864.23"
"2025-03-29","2025-03-27","SF FuneralF1122732      250327","","126.5","","1196990.73"
"2025-03-29","2025-03-28","SF FuneralFDC0000000507R250328","","126.5","","1197117.23"
"2025-03-29","2025-03-28","SF FuneralFDC00000006J0T250328","","126.5","","1197243.73"
"2025-03-29","2025-03-28","SF FuneralFDC00000006YXS250328","","126.5","","1197370.23"
"2025-03-29","2025-03-28","SF FuneralF816407       250328","","126.5","","1197496.73"
"2025-03-29","2025-03-28","SF FuneralF817444       250328","","126.5","","1197623.23"
"2025-03-29","2025-03-28","SF FuneralFDC0000000JVBW250328","","126.5","","1197749.73"
"2025-03-29","2025-03-28","SF FuneralF1055273      250328","","126.5","","1197876.23"
"2025-03-29","2025-03-28","SF FuneralF1066296      250328","","126.5","","1198002.73"
"2025-03-29","2025-03-28","SF FuneralF1066602      250328","","256.5","","1198259.23"
"2025-03-29","2025-03-28","SF FuneralF1114930      250328","","126.5","","1198385.73"
"2025-03-29","2025-03-28","SF FuneralF1116792      250328","","126.5","","1198512.23"
"2025-03-29","2025-03-28","SF FuneralF1116924      250328","","126.5","","1198638.73"
"2025-03-29","2025-03-28","SF FuneralF1118274      250328","","126.5","","1198765.23"
"2025-03-29","2025-03-28","SF FuneralF1125714      250328","","126.5","","1198891.73"
"2025-03-29","2025-03-28","SF FuneralF1125938      250328","","126.5","","1199018.23"
"2025-03-29","2025-03-28","SF FuneralFDC0000000Q8WD250328","","126.5","","1199144.73"
"2025-03-29","2025-03-28","SF FuneralFDC0000000Q8WM250328","","126.5","","1199271.23"
"2025-03-29","2025-03-28","SF FuneralFDC0000000PPGM250328","","126.5","","1199397.73"
"2025-03-29","2025-03-26","SF FuneralFDC000000064GW250326","","31.63","","1199429.36"
"2025-03-29","2025-03-28","SF FuneralF831565       250328","","31.63","","1199460.99"
"2025-03-29","2025-03-22","SF FuneralF831565       250321","","31.63","","1199492.62"
"2025-03-29","2025-03-24","SF FuneralF810327       250324","","31.63","","1199524.25"
"2025-03-29","2025-03-25","SF FuneralF817682       250325","","31.63","","1199555.88"
"2025-03-29","2025-03-25","SF FuneralFDC0000000CWFK250325","","31.63","","1199587.51"
"2025-03-29","2025-03-25","SF FuneralFDC0000000JHBW250325","","31.63","","1199619.14"
"2025-03-29","2025-03-25","SF FuneralF1103795      250325","","31.63","","1199650.77"
"2025-03-29","2025-03-25","SF FuneralF1115225      250325","","31.63","","1199682.4"
"2025-03-29","2025-03-25","SF FuneralFDC0000000NRVB250325","","31.63","","1199714.03"
"2025-03-29","2025-03-25","SF FuneralF1130616      250325","","31.63","","1199745.66"
"2025-03-29","2025-03-25","SF FuneralF743038       250325","","31.63","","1199777.29"
"2025-03-29","2025-03-25","SF FuneralF1132382      250325","","31.63","","1199808.92"
"2025-03-29","2025-03-22","SF FuneralFDC0000000PXSJ250323","","126.5","","1199935.42"
"2025-03-29","2025-03-24","SF FuneralFDC000000079KK250324","","126.5","","1200061.92"
"2025-03-29","2025-03-24","SF FuneralF1075195      250324","","126.5","","1200188.42"
"2025-03-29","2025-03-27","SF FuneralFDC00000006GSP250327","","126.5","","1200314.92"
"2025-03-29","2025-03-27","SF FuneralF1079287      250327","","126.5","","1200441.42"
"2025-03-29","2025-03-27","SF FuneralF1120664      250327","","126.5","","1200567.92"
"2025-03-29","2025-03-28","SF FuneralFDC00000006CQ3250328","","126.5","","1200694.42"
"2025-03-29","2025-03-28","SF FuneralFDC0000000LZKG250328","","126.5","","1200820.92"
"2025-03-29","2025-03-19","SF FuneralF834869       250319","","126.5","","1200947.42"
"2025-03-29","2025-03-28","SF FuneralFDC00000005X9P250328","","126.5","","1201073.92"
"2025-03-29","2025-03-28","SF FuneralFDC000000064KQ250328","","126.5","","1201200.42"
"2025-03-29","2025-03-28","SF FuneralFDC000000064KR250328","","126.5","","1201326.92"
"2025-03-29","2025-03-28","SF FuneralFDC00000007548250328","","126.5","","1201453.42"
"2025-03-29","2025-03-28","SF FuneralFDC00000007FK7250328","","126.5","","1201579.92"
"2025-03-29","2025-03-28","SF FuneralFDC000000083CD250328","","126.5","","1201706.42"
"2025-03-29","2025-03-28","SF FuneralFDC00000008741250328","","126.5","","1201832.92"
"2025-03-29","2025-03-28","SF FuneralF799938       250328","","126.5","","1201959.42"
"2025-03-29","2025-03-28","SF FuneralF810363       250328","","126.5","","1202085.92"
"2025-03-29","2025-03-28","SF FuneralF815332       250328","","126.5","","1202212.42"
"2025-03-29","2025-03-28","SF FuneralF819861       250328","","126.5","","1202338.92"
"2025-03-29","2025-03-28","SF FuneralF834276       250328","","126.5","","1202465.42"
"2025-03-29","2025-03-28","SF FuneralF987462       250328","","126.5","","1202591.92"
"2025-03-29","2025-03-28","SF FuneralF990088       250330","","126.5","","1202718.42"
"2025-03-29","2025-03-28","SF FuneralF1021028      250328","","126.5","","1202844.92"
"2025-03-29","2025-03-28","SF FuneralFDC0000000JXHY250328","","126.5","","1202971.42"
"2025-03-29","2025-03-28","SF FuneralFDC0000000JZ0C250328","","126.5","","1203097.92"
"2025-03-29","2025-03-28","SF FuneralFDC0000000KY2H250328","","63.25","","1203161.17"
"2025-03-29","2025-03-28","SF FuneralF1079814      250328","","126.5","","1203287.67"
"2025-03-29","2025-03-28","SF FuneralF1109690      250328","","126.5","","1203414.17"
"2025-03-29","2025-03-28","SF FuneralF1113887      250328","","126.5","","1203540.67"
"2025-03-29","2025-03-28","SF FuneralF1118372      250328","","126.5","","1203667.17"
"2025-03-29","2025-03-28","SF FuneralF1125710      250328","","126.5","","1203793.67"
"2025-03-29","2025-03-28","SF FuneralF1125798      250328","","126.5","","1203920.17"
"2025-03-29","2025-03-28","SF FuneralF1127950      250328","","126.5","","1204046.67"
"2025-03-29","2025-03-28","SF FuneralF1128229      250328","","126.5","","1204173.17"
"2025-03-29","2025-03-28","SF FuneralF1134670      250328","","126.5","","1204299.67"
"2025-03-29","2025-03-28","SF FuneralF1134939      250328","","126.5","","1204426.17"
"2025-03-29","2025-03-28","SF FuneralF1135035      250328","","126.5","","1204552.67"
"2025-03-29","2025-03-28","SF FuneralF1135534      250328","","126.5","","1204679.17"
"2025-03-29","2025-03-28","SF FuneralFDC0000000QMR6250328","","126.5","","1204805.67"
"2025-03-29","2025-03-28","SF FuneralF1135763      250328","","126.5","","1204932.17"
"2025-03-29","2025-03-25","SF FuneralFDC000000057TZ250325","","126.5","","1205058.67"
"2025-03-29","2025-03-25","SF FuneralFDC00000006B1X250325","","126.5","","1205185.17"
"2025-03-29","2025-03-25","SF FuneralFDC00000006GN2250325","","126.5","","1205311.67"
"2025-03-29","2025-03-25","SF FuneralFDC00000006NCH250325","","63.25","","1205374.92"
"2025-03-29","2025-03-25","SF FuneralFDC0000000719J250325","","126.5","","1205501.42"
"2025-03-29","2025-03-25","SF FuneralFDC00000007388250325","","126.5","","1205627.92"
"2025-03-29","2025-03-25","SF FuneralFDC00000007N2L250325","","126.5","","1205754.42"
"2025-03-29","2025-03-25","SF FuneralFDC0000000822J250325","","126.5","","1205880.92"
"2025-03-29","2025-03-25","SF FuneralF802406       250325","","126.5","","1206007.42"
"2025-03-29","2025-03-25","SF FuneralFDC00000008MDL250325","","126.5","","1206133.92"
"2025-03-29","2025-03-25","SF FuneralFDC00000008MXM250325","","126.5","","1206260.42"
"2025-03-29","2025-03-25","SF FuneralF808541       250325","","191.5","","1206451.92"
"2025-03-29","2025-03-25","SF FuneralF811721       250325","","126.5","","1206578.42"
"2025-03-29","2025-03-25","SF FuneralF816365       250325","","126.5","","1206704.92"
"2025-03-29","2025-03-25","SF FuneralF821871       250325","","63.25","","1206768.17"
"2025-03-29","2025-03-25","SF FuneralF833760       250325","","126.5","","1206894.67"
"2025-03-29","2025-03-25","SF FuneralF840821       250325","","63.25","","1206957.92"
"2025-03-29","2025-03-25","SF FuneralF987238       250325","","126.5","","1207084.42"
"2025-03-29","2025-03-25","SF FuneralF992018       250325","","126.5","","1207210.92"
"2025-03-29","2025-03-25","SF FuneralF1016773      250325","","126.5","","1207337.42"
"2025-03-29","2025-03-25","SF FuneralF1020783      250325","","126.5","","1207463.92"
"2025-03-29","2025-03-25","SF FuneralF1055105      250325","","126.5","","1207590.42"
"2025-03-29","2025-03-25","SF FuneralF1058661      250325","","126.5","","1207716.92"
"2025-03-29","2025-03-25","SF FuneralF993377       250325","","63.25","","1207780.17"
"2025-03-29","2025-03-25","SF FuneralF1083636      250325","","63.25","","1207843.42"
"2025-03-29","2025-03-25","SF FuneralF1066019      250325","","126.5","","1207969.92"
"2025-03-29","2025-03-25","SF FuneralF1085191      250325","","63.25","","1208033.17"
"2025-03-29","2025-03-25","SF FuneralF1103541      250325","","126.5","","1208159.67"
"2025-03-29","2025-03-25","SF FuneralF1104010      250325","","126.5","","1208286.17"
"2025-03-29","2025-03-25","SF FuneralF1109644      250325","","126.5","","1208412.67"
"2025-03-29","2025-03-25","SF FuneralF1112446      250325","","126.5","","1208539.17"
"2025-03-29","2025-03-25","SF FuneralF1113788      250325","","126.5","","1208665.67"
"2025-03-29","2025-03-25","SF FuneralF1116940      250325","","126.5","","1208792.17"
"2025-03-29","2025-03-25","SF FuneralF1118010      250325","","63.25","","1208855.42"
"2025-03-29","2025-03-25","SF FuneralF1120526      250325","","126.5","","1208981.92"
"2025-03-29","2025-03-25","SF FuneralF1120657      250325","","126.5","","1209108.42"
"2025-03-29","2025-03-25","SF FuneralF1120678      250325","","126.5","","1209234.92"
"2025-03-29","2025-03-25","SF FuneralF1120784      250325","","126.5","","1209361.42"
"2025-03-29","2025-03-25","SF FuneralF1120840      250325","","126.5","","1209487.92"
"2025-03-29","2025-03-25","SF FuneralF1123420      250325","","126.5","","1209614.42"
"2025-03-29","2025-03-25","SF FuneralF1130982      250325","","126.5","","1209740.92"
"2025-03-29","2025-03-25","SF FuneralFDC0000000Q3YJ250325","","126.5","","1209867.42"
"2025-03-29","2025-03-25","SF FuneralFDC0000000Q3YQ250325","","126.5","","1209993.92"
"2025-03-29","2025-03-25","SF FuneralF1131267      250325","","126.5","","1210120.42"
"2025-03-29","2025-03-25","SF FuneralF1131282      250325","","126.5","","1210246.92"
"2025-03-29","2025-03-25","SF FuneralF1132098      250325","","126.5","","1210373.42"
"2025-03-29","2025-03-25","SF FuneralF1134471      250325","","63.25","","1210436.67"
"2025-03-29","2025-03-25","SF FuneralF1135179      250325","","63.25","","1210499.92"
"2025-03-29","2025-03-25","SF FuneralFDC0000000QLGY250325","","63.25","","1210563.17"
"2025-03-29","2025-03-26","SF FuneralF821404       250326","","126.5","","1210689.67"
"2025-03-29","2025-03-26","SF FuneralF827754       250326","","126.5","","1210816.17"
"2025-03-29","2025-03-26","SF FuneralF831599       250326","","126.5","","1210942.67"
"2025-03-29","2025-03-26","SF FuneralFDC0000000FVPK250326","","126.5","","1211069.17"
"2025-03-29","2025-03-26","SF FuneralF992108       250326","","126.5","","1211195.67"
"2025-03-29","2025-03-26","SF FuneralF1017051      250326","","126.5","","1211322.17"
"2025-03-29","2025-03-26","SF FuneralF1059444      250326","","126.5","","1211448.67"
"2025-03-29","2025-03-26","SF FuneralF1124775      250326","","126.5","","1211575.17"
"2025-03-29","2025-03-26","SF FuneralFDC0000000PFWQ250326","","126.5","","1211701.67"
"2025-03-29","2025-03-27","SF FuneralFDC000000064FV250327","","126.5","","1211828.17"
"2025-03-29","2025-03-27","SF FuneralFDC000000065GW250327","","126.5","","1211954.67"
"2025-03-29","2025-03-27","SF FuneralF802244       250327","","126.5","","1212081.17"
"2025-03-29","2025-03-27","SF FuneralF803722       250327","","126.5","","1212207.67"
"2025-03-29","2025-03-27","SF FuneralF805122       250327","","126.5","","1212334.17"
"2025-03-29","2025-03-27","SF FuneralFDC000000093F2250327","","126.5","","1212460.67"
"2025-03-29","2025-03-27","SF FuneralFDC00000009HB8250327","","126.5","","1212587.17"
"2025-03-29","2025-03-27","SF FuneralF827966       250327","","126.5","","1212713.67"
"2025-03-29","2025-03-27","SF FuneralF828754       250327","","126.5","","1212840.17"
"2025-03-29","2025-03-27","SF FuneralFDC0000000BQQ3250327","","126.5","","1212966.67"
"2025-03-29","2025-03-27","SF FuneralF828920       250327","","126.5","","1213093.17"
"2025-03-29","2025-03-27","SF FuneralF834081       250327","","126.5","","1213219.67"
"2025-03-29","2025-03-27","SF FuneralFDC0000000DZGG250327","","126.5","","1213346.17"
"2025-03-29","2025-03-27","SF FuneralF1055002      250327","","126.5","","1213472.67"
"2025-03-29","2025-03-27","SF FuneralF1060856      250327","","126.5","","1213599.17"
"2025-03-29","2025-03-27","SF FuneralF1078585      250327","","126.5","","1213725.67"
"2025-03-29","2025-03-27","SF FuneralF1112009      250327","","126.5","","1213852.17"
"2025-03-29","2025-03-27","SF FuneralF1112265      250327","","126.5","","1213978.67"
"2025-03-29","2025-03-27","SF FuneralFDC0000000N3WX250327","","126.5","","1214105.17"
"2025-03-29","2025-03-27","SF FuneralF1120157      250327","","126.5","","1214231.67"
"2025-03-29","2025-03-27","SF FuneralF1120892      250327","","126.5","","1214358.17"
"2025-03-29","2025-03-27","SF FuneralF1125263      250327","","126.5","","1214484.67"
"2025-03-29","2025-03-27","SF FuneralF1125843      250327","","126.5","","1214611.17"
"2025-03-29","2025-03-27","SF FuneralF1128075      250327","","126.5","","1214737.67"
"2025-03-29","2025-03-22","SF FuneralFDC00000003MN1250322","","220","","1214957.67"
"2025-03-29","2025-03-22","SF FuneralFDC00000003MNW250322","","220","","1215177.67"
"2025-03-29","2025-03-22","SF FuneralFDC00000006034250322","","126.5","","1215304.17"
"2025-03-29","2025-03-22","SF FuneralFDC0000000615K250322","","126.5","","1215430.67"
"2025-03-29","2025-03-22","SF FuneralFDC000000065VK250322","","126.5","","1215557.17"
"2025-03-29","2025-03-22","SF FuneralFDC0000000752S250322","","63.25","","1215620.42"
"2025-03-29","2025-03-22","SF FuneralFDC00000008KRN250322","","126.5","","1215746.92"
"2025-03-29","2025-03-22","SF FuneralF818242       250322","","126.5","","1215873.42"
"2025-03-29","2025-03-22","SF FuneralF819883       250322","","126.5","","1215999.92"
"2025-03-29","2025-03-22","SF FuneralF992433       250322","","126.5","","1216126.42"
"2025-03-29","2025-03-22","SF FuneralF1017741      250322","","126.5","","1216252.92"
"2025-03-29","2025-03-22","SF FuneralF1073820      250322","","126.5","","1216379.42"
"2025-03-29","2025-03-22","SF FuneralF1074834      250323","","126.5","","1216505.92"
"2025-03-29","2025-03-22","SF FuneralF1108414      250322","","126.5","","1216632.42"
"2025-03-29","2025-03-22","SF FuneralF1125102      250323","","126.5","","1216758.92"
"2025-03-29","2025-03-22","SF FuneralF1125104      250323","","126.5","","1216885.42"
"2025-03-29","2025-03-22","SF FuneralF1127664      250322","","126.5","","1217011.92"
"2025-03-29","2025-03-24","SF FuneralFDC00000007ZFY250324","","126.5","","1217138.42"
"2025-03-29","2025-03-24","SF FuneralFDC0000000G01D250322","","126.5","","1217264.92"
"2025-03-29","2025-03-24","SF FuneralF1055287      250324","","126.5","","1217391.42"
"2025-03-29","2025-03-24","SF FuneralF1067997      250324","","126.5","","1217517.92"
"2025-03-29","2025-03-24","SF FuneralF1115148      250324","","126.5","","1217644.42"
"2025-03-29","2025-03-24","SF FuneralFDC0000000P0LT250324","","126.5","","1217770.92"
"2025-03-29","2025-03-24","SF FuneralFDC0000000PBGT250324","","126.5","","1217897.42"
"2025-03-29","2025-03-24","SF FuneralF1116081      250324","","126.5","","1218023.92"
"2025-03-29","2025-03-24","SF FuneralF1120876      250324","","126.5","","1218150.42"
"2025-03-29","2025-03-25","SF FuneralFDC000000067XN250325","","126.5","","1218276.92"
"2025-03-29","2025-03-25","SF FuneralF1124555      250325","","126.5","","1218403.42"
"2025-03-29","2025-03-26","SF FuneralFDC00000006XYJ250326","","126.5","","1218529.92"
"2025-03-29","2025-03-27","SF FuneralFDC00000006DJR250327","","126.5","","1218656.42"
"2025-03-29","2025-03-27","SF FuneralF1067989      250327","","126.5","","1218782.92"
"2025-03-29","2025-03-27","SF FuneralFDC00000005LNN250327","","126.5","","1218909.42"
"2025-03-29","2025-03-27","SF FuneralFDC000000081CC250327","","126.5","","1219035.92"
"2025-03-29","2025-03-27","SF FuneralF804409       250327","","126.5","","1219162.42"
"2025-03-29","2025-03-27","SF FuneralF812079       250327","","126.5","","1219288.92"
"2025-03-29","2025-03-27","SF FuneralF812363       250327","","126.5","","1219415.42"
"2025-03-29","2025-03-27","SF FuneralF812575       250327","","126.5","","1219541.92"
"2025-03-29","2025-03-27","SF FuneralF833226       250327","","126.5","","1219668.42"
"2025-03-29","2025-03-27","SF FuneralF1050804      250327","","126.5","","1219794.92"
"2025-03-29","2025-03-27","SF FuneralFDC0000000K9DR250327","","126.5","","1219921.42"
"2025-03-29","2025-03-27","SF FuneralF1108947      250327","","126.5","","1220047.92"
"2025-03-29","2025-03-27","SF FuneralF1116775      250327","","126.5","","1220174.42"
"2025-03-29","2025-03-27","SF FuneralF1118964      250327","","126.5","","1220300.92"
"2025-03-29","2025-03-27","SF FuneralF1120118      250327","","126.5","","1220427.42"
"2025-03-29","2025-03-27","SF FuneralF1123270      250327","","126.5","","1220553.92"
"2025-03-29","2025-03-27","SF FuneralFDC0000000PLXF250327","","126.5","","1220680.42"
"2025-03-29","2025-03-27","SF FuneralF1133584      250327","","126.5","","1220806.92"
"2025-03-29","2025-03-24","SF FuneralFDC00000007DCR250324","","126.5","","1220933.42"
"2025-03-29","2025-03-24","SF FuneralF1109922      250324","","126.5","","1221059.92"
"2025-03-29","2025-03-24","SF FuneralF1123063      250324","","126.5","","1221186.42"
"2025-03-29","2025-03-25","SF FuneralFDC0000000595N250325","","31.62","","1221218.04"
"2025-03-29","2025-03-25","SF FuneralFDC000000068HC250325","","126.5","","1221344.54"
"2025-03-29","2025-03-25","SF FuneralFDC00000007CQV250325","","31.63","","1221376.17"
"2025-03-29","2025-03-25","SF FuneralFDC00000007PQ8250325","","126.5","","1221502.67"
"2025-03-29","2025-03-25","SF FuneralF819049       250325","","126.5","","1221629.17"
"2025-03-29","2025-03-25","SF FuneralF993703       250325","","63.25","","1221692.42"
"2025-03-29","2025-03-25","SF FuneralF1050752      250325","","126.5","","1221818.92"
"2025-03-29","2025-03-25","SF FuneralFDC0000000LBW9250325","","126.5","","1221945.42"
"2025-03-29","2025-03-25","SF FuneralF1118348      250325","","31.63","","1221977.05"
"2025-03-29","2025-03-25","SF FuneralF1121896      250325","","126.5","","1222103.55"
"2025-03-29","2025-03-25","SF FuneralF1130344      250325","","31.63","","1222135.18"
"2025-03-29","2025-03-25","SF FuneralF1130833      250325","","126.5","","1222261.68"
"2025-03-29","2025-03-25","SF FuneralF1130991      250325","","31.63","","1222293.31"
"2025-03-29","2025-03-25","SF FuneralFDC0000000Q40W250325","","126.5","","1222419.81"
"2025-03-29","2025-03-25","SF FuneralF1132474      250325","","126.5","","1222546.31"
"2025-03-29","2025-03-29","SF FuneralF1110082      250330","","63.25","","1222609.56"
"2025-03-29","2025-03-29","SF FuneralF1115087      250330","","126.5","","1222736.06"
"2025-03-29","2025-03-22","SF FuneralFDC00000005MLD250322","","126.5","","1222862.56"
"2025-03-29","2025-03-22","SF FuneralFDC00000005NJ8250322","","126.5","","1222989.06"
"2025-03-29","2025-03-22","SF FuneralF820988       250322","","126.5","","1223115.56"
"2025-03-29","2025-03-22","SF FuneralF1060392      250322","","126.5","","1223242.06"
"2025-03-29","2025-03-22","SF FuneralFDC0000000LQKZ250323","","126.5","","1223368.56"
"2025-03-29","2025-03-22","SF FuneralF1108306      250322","","126.5","","1223495.06"
"2025-03-29","2025-03-26","SF FuneralFDC000000078V2250326","","126.5","","1223621.56"
"2025-03-29","2025-03-26","SF FuneralF820082       250326","","126.5","","1223748.06"
"2025-03-29","2025-03-26","SF FuneralFDC0000000BV1Z250326","","126.5","","1223874.56"
"2025-03-29","2025-03-26","SF FuneralFDC0000000BW7W250326","","126.5","","1224001.06"
"2025-03-29","2025-03-28","SF FuneralFDC00000006CMJ250328","","126.5","","1224127.56"
"2025-03-29","2025-03-28","SF FuneralFDC00000006P8Q250328","","213.31","","1224340.87"
"2025-03-29","2025-03-28","SF FuneralF823086       250328","","126.5","","1224467.37"
"2025-03-29","2025-03-28","SF FuneralF990105       250328","","126.5","","1224593.87"
"2025-03-29","2025-03-28","SF FuneralFDC0000000JV0H250328","","126.5","","1224720.37"
"2025-03-29","2025-03-28","SF FuneralF1116064      250328","","126.5","","1224846.87"
"2025-03-29","2025-03-28","SF FuneralF1125083      250328","","126.5","","1224973.37"
"2025-03-29","2025-03-28","SF FuneralF1133234      250328","","126.5","","1225099.87"
"2025-03-29","2025-03-28","SF FuneralF1133557      250328","","126.5","","1225226.37"
"2025-03-29","2025-03-28","SF FuneralFDC0000000QGMN250328","","126.5","","1225352.87"
"2025-03-29","2025-03-28","SF FuneralFDC0000000QHPH250328","","126.5","","1225479.37"
"2025-03-29","2025-03-28","SF FuneralF1134441      250328","","126.5","","1225605.87"
"2025-03-29","2025-03-28","SF FuneralFDC0000000QLQM250328","","126.5","","1225732.37"
"2025-03-29","2025-03-25","SF FuneralF834882       250325","","31.63","","1225764"
"2025-03-29","2025-03-25","SF FuneralF1060316      250325","","31.63","","1225795.63"
"2025-03-29","2025-03-25","SF FuneralF1074917      250325","","31.63","","1225827.26"
"2025-03-29","2025-03-25","SF FuneralF1104234      250325","","31.63","","1225858.89"
"2025-03-29","2025-03-26","SF FuneralF844042       250326","","31.63","","1225890.52"
"2025-03-29","2025-03-26","SF FuneralFDC0000000L9LS250326","","31.63","","1225922.15"
"2025-03-29","2025-03-28","SF FuneralF818785       250328","","31.63","","1225953.78"
"2025-03-29","2025-03-28","SF FuneralF1079691      250328","","31.63","","1225985.41"
"2025-03-29","2025-03-28","SF FuneralFDC0000000NNGY250328","","31.63","","1226017.04"
"2025-03-29","2025-03-29","SF FuneralF832932       250329","","31.63","","1226048.67"
"2025-03-29","2025-03-29","SF FuneralFDC0000000KH3D250330","","31.63","","1226080.3"
"2025-03-29","2025-03-29","SF FuneralF1120593      250330","","31.63","","1226111.93"
"2025-03-29","2025-03-29","SF FuneralF1121775      250330","","47.88","","1226159.81"
"2025-03-29","2025-03-20","SF FuneralFDC00000006DGD250320","","126.5","","1226286.31"
"2025-03-29","2025-03-20","SF FuneralF987232       250322","","126.5","","1226412.81"
"2025-03-29","2025-03-22","SF FuneralFDC000000035YY250322","","220","","1226632.81"
"2025-03-29","2025-03-22","SF FuneralFDC000000053ZX250322","","126.5","","1226759.31"
"2025-03-29","2025-03-22","SF FuneralFDC00000005409250322","","126.5","","1226885.81"
"2025-03-29","2025-03-22","SF FuneralFDC00000005427250322","","126.5","","1227012.31"
"2025-03-29","2025-03-22","SF FuneralFDC00000005QRC250321","","63.25","","1227075.56"
"2025-03-29","2025-03-22","SF FuneralFDC00000005RK6250322","","126.5","","1227202.06"
"2025-03-29","2025-03-22","SF FuneralFDC000000069P1250322","","126.5","","1227328.56"
"2025-03-29","2025-03-22","SF FuneralFDC00000007H38250322","","126.5","","1227455.06"
"2025-03-29","2025-03-22","SF FuneralF815776       250322","","126.5","","1227581.56"
"2025-03-29","2025-03-22","SF FuneralFDC0000000BWGJ250322","","126.5","","1227708.06"
"2025-03-29","2025-03-22","SF FuneralF1055113      250322","","126.5","","1227834.56"
"2025-03-29","2025-03-22","SF FuneralFDC0000000KP8M250322","","126.5","","1227961.06"
"2025-03-29","2025-03-22","SF FuneralF1084381      250322","","126.5","","1228087.56"
"2025-03-29","2025-03-22","SF FuneralF1100145      250322","","126.5","","1228214.06"
"2025-03-29","2025-03-22","SF FuneralF1108857      250322","","126.5","","1228340.56"
"2025-03-29","2025-03-22","SF FuneralF1113926      250322","","126.5","","1228467.06"
"2025-03-29","2025-03-22","SF FuneralF1118144      250323","","126.5","","1228593.56"
"2025-03-29","2025-03-22","SF FuneralFDC0000000PSNP250322","","126.5","","1228720.06"
"2025-03-29","2025-03-24","SF FuneralFDC00000006LM0250324","","126.5","","1228846.56"
"2025-03-29","2025-03-24","SF FuneralFDC000000070Y8250324","","126.5","","1228973.06"
"2025-03-29","2025-03-24","SF FuneralFDC00000007VBC250324","","126.5","","1229099.56"
"2025-03-29","2025-03-24","SF FuneralF834533       250324","","126.5","","1229226.06"
"2025-03-29","2025-03-24","SF FuneralF843220       250321","","63.25","","1229289.31"
"2025-03-29","2025-03-24","SF FuneralF1108545      250324","","126.5","","1229415.81"
"2025-03-29","2025-03-24","SF FuneralFDC0000000N12V250324","","126.5","","1229542.31"
"2025-03-29","2025-03-24","SF FuneralF1113962      250324","","126.5","","1229668.81"
"2025-03-29","2025-03-24","SF FuneralF1132092      250324","","126.5","","1229795.31"
"2025-03-29","2025-03-27","SF FuneralFDC0000000696S250327","","126.5","","1229921.81"
"2025-03-29","2025-03-27","SF FuneralFDC00000006W74250327","","126.5","","1230048.31"
"2025-03-29","2025-03-27","SF FuneralF809224       250327","","126.5","","1230174.81"
"2025-03-29","2025-03-27","SF FuneralFDC00000009DZL250327","","126.5","","1230301.31"
"2025-03-29","2025-03-27","SF FuneralF820134       250327","","126.5","","1230427.81"
"2025-03-29","2025-03-27","SF FuneralF822385       250327","","126.5","","1230554.31"
"2025-03-29","2025-03-27","SF FuneralF828449       250327","","126.5","","1230680.81"
"2025-03-29","2025-03-27","SF FuneralF829532       250327","","126.5","","1230807.31"
"2025-03-29","2025-03-27","SF FuneralF830039       250327","","126.5","","1230933.81"
"2025-03-29","2025-03-27","SF FuneralF842477       250327","","126.5","","1231060.31"
"2025-03-29","2025-03-27","SF FuneralF1016881      250327","","126.5","","1231186.81"
"2025-03-29","2025-03-27","SF FuneralF1058672      250327","","126.5","","1231313.31"
"2025-03-29","2025-03-27","SF FuneralF1059710      250327","","126.5","","1231439.81"
"2025-03-29","2025-03-27","SF FuneralF1062684      250327","","126.5","","1231566.31"
"2025-03-29","2025-03-27","SF FuneralF1074699      250327","","126.5","","1231692.81"
"2025-03-29","2025-03-27","SF FuneralF1078479      250327","","126.5","","1231819.31"
"2025-03-29","2025-03-27","SF FuneralF1108677      250327","","126.5","","1231945.81"
"2025-03-29","2025-03-27","SF FuneralF1109603      250327","","126.5","","1232072.31"
"2025-03-29","2025-03-27","SF FuneralF1075060      250327","","126.5","","1232198.81"
"2025-03-29","2025-03-27","SF FuneralF1120867      250327","","126.5","","1232325.31"
"2025-03-29","2025-03-27","SF FuneralF1123208      250327","","126.5","","1232451.81"
"2025-03-29","2025-03-27","SF FuneralFDC0000000P4Y5250327","","126.5","","1232578.31"
"2025-03-29","2025-03-27","SF FuneralF1123552      250327","","126.5","","1232704.81"
"2025-03-29","2025-03-27","SF FuneralF1125409      250327","","126.5","","1232831.31"
"2025-03-29","2025-03-29","SF FuneralFDC00000005H9H250329","","220","","1233051.31"
"2025-03-29","2025-03-29","SF FuneralFDC00000005W9N250329","","220","","1233271.31"
"2025-03-29","2025-03-29","SF FuneralFDC000000069RW250329","","126.5","","1233397.81"
"2025-03-29","2025-03-29","SF FuneralFDC00000006Q0Q250329","","126.5","","1233524.31"
"2025-03-29","2025-03-29","SF FuneralFDC000000077M9250329","","126.5","","1233650.81"
"2025-03-29","2025-03-29","SF FuneralFDC00000007BGR250329","","126.5","","1233777.31"
"2025-03-29","2025-03-29","SF FuneralF816379       250329","","126.5","","1233903.81"
"2025-03-29","2025-03-29","SF FuneralF821514       250329","","126.5","","1234030.31"
"2025-03-29","2025-03-29","SF FuneralF828051       250329","","126.5","","1234156.81"
"2025-03-29","2025-03-29","SF FuneralF1033766      250330","","126.5","","1234283.31"
"2025-03-29","2025-03-29","SF FuneralF1084609      250330","","126.5","","1234409.81"
"2025-03-29","2025-03-29","SF FuneralF1103593      250329","","126.5","","1234536.31"
"2025-03-29","2025-03-29","SF FuneralFDC0000000NCRN250329","","63.25","","1234599.56"
"2025-03-29","2025-03-29","SF FuneralF1118760      250329","","126.5","","1234726.06"
"2025-03-29","2025-03-29","SF FuneralF1120762      250330","","126.5","","1234852.56"
"2025-03-29","2025-03-29","SF FuneralF1129052      250329","","126.5","","1234979.06"
"2025-03-29","2025-03-29","SF FuneralFDC0000000QM57250330","","126.5","","1235105.56"
"2025-03-29","2025-03-25","SF FuneralFDC00000006Y66250325","","126.5","","1235232.06"
"2025-03-29","2025-03-25","SF FuneralFDC00000007NL9250325","","126.5","","1235358.56"
"2025-03-29","2025-03-25","SF FuneralFDC00000007NXQ250325","","126.5","","1235485.06"
"2025-03-29","2025-03-25","SF FuneralFDC00000007XCF250325","","126.5","","1235611.56"
"2025-03-29","2025-03-25","SF FuneralFDC00000007XCG250325","","126.5","","1235738.06"
"2025-03-29","2025-03-25","SF FuneralFDC000000082Y2250325","","126.5","","1235864.56"
"2025-03-29","2025-03-25","SF FuneralF809008       250325","","126.5","","1235991.06"
"2025-03-29","2025-03-25","SF FuneralF1060918      250325","","126.5","","1236117.56"
"2025-03-29","2025-03-25","SF FuneralF1130400      250325","","126.5","","1236244.06"
"2025-03-29","2025-03-25","SF FuneralF1130910      250325","","126.5","","1236370.56"
"2025-03-29","2025-03-29","SF FuneralFDC000000051JT250329","","220","","1236590.56"
"2025-03-29","2025-03-29","SF FuneralFDC00000005PM7250329","","126.5","","1236717.06"
"2025-03-29","2025-03-29","SF FuneralFDC00000005VPK250329","","126.5","","1236843.56"
"2025-03-29","2025-03-29","SF FuneralFDC00000005W02250329","","126.5","","1236970.06"
"2025-03-29","2025-03-29","SF FuneralFDC00000006LTK250329","","63.25","","1237033.31"
"2025-03-29","2025-03-29","SF FuneralFDC00000006W2N250329","","126.5","","1237159.81"
"2025-03-29","2025-03-29","SF FuneralF823032       250329","","126.5","","1237286.31"
"2025-03-29","2025-03-29","SF FuneralF831115       250329","","126.5","","1237412.81"
"2025-03-29","2025-03-29","SF FuneralF1078703      250330","","126.5","","1237539.31"
"2025-03-29","2025-03-29","SF FuneralF1083667      250329","","126.5","","1237665.81"
"2025-03-29","2025-03-29","SF FuneralF1104118      250329","","126.5","","1237792.31"
"2025-03-29","2025-03-29","SF FuneralFDC0000000MGRV250329","","126.5","","1237918.81"
"2025-03-29","2025-03-29","SF FuneralF1122754      250330","","126.5","","1238045.31"
"2025-03-29","2025-03-29","SF FuneralF1124330      250329","","126.5","","1238171.81"
"2025-03-29","2025-03-26","SF FuneralF1074899      250326","","126.5","","1238298.31"
"2025-03-29","2025-03-26","SF FuneralFDC0000000PQNK250326","","63.25","","1238361.56"
"2025-03-29","2025-03-26","SF FuneralF1131883      250326","","63.25","","1238424.81"
"2025-03-29","2025-03-26","SF FuneralF1134330      250326","","63.25","","1238488.06"
"2025-03-29","2025-03-28","SF FuneralFDC00000006MMV250328","","126.5","","1238614.56"
"2025-03-29","2025-03-28","SF FuneralFDC000000089KV250328","","126.5","","1238741.06"
"2025-03-29","2025-03-28","SF FuneralF802266       250328","","126.5","","1238867.56"
"2025-03-29","2025-03-28","SF FuneralF808783       250328","","126.5","","1238994.06"
"2025-03-29","2025-03-28","SF FuneralF808952       250328","","126.5","","1239120.56"
"2025-03-29","2025-03-28","SF FuneralFDC0000000CS3N250328","","126.5","","1239247.06"
"2025-03-29","2025-03-28","SF FuneralF980260       250328","","126.5","","1239373.56"
"2025-03-29","2025-03-28","SF FuneralFDC0000000HYQ5250328","","126.5","","1239500.06"
"2025-03-29","2025-03-28","SF FuneralF785787       250328","","63.25","","1239563.31"
"2025-03-29","2025-03-28","SF FuneralF1066426      250328","","126.5","","1239689.81"
"2025-03-29","2025-03-28","SF FuneralF1080458      250328","","126.5","","1239816.31"
"2025-03-29","2025-03-28","SF FuneralF1108733      250328","","126.5","","1239942.81"
"2025-03-29","2025-03-28","SF FuneralF1117743      250328","","126.5","","1240069.31"
"2025-03-29","2025-03-28","SF FuneralF795240       250328","","126.5","","1240195.81"
"2025-03-29","2025-03-28","SF FuneralF1127746      250328","","126.5","","1240322.31"
"2025-03-29","2025-03-28","SF FuneralFDC0000000QG6F250328","","126.5","","1240448.81"
"2025-03-29","2025-03-28","SF FuneralF1133810      250328","","126.5","","1240575.31"
"2025-03-29","2025-03-28","SF FuneralF1134480      250328","","126.5","","1240701.81"
"2025-03-29","2025-03-28","SF FuneralF1134613      250328","","126.5","","1240828.31"
"2025-03-29","2025-03-28","SF FuneralFDC0000000QK0Y250328","","126.5","","1240954.81"
"2025-03-29","2025-03-28","SF FuneralFDC0000000QL6Z250328","","126.5","","1241081.31"
"2025-03-29","2025-03-24","SF FuneralFDC00000007K9Q250323","","126.5","","1241207.81"
"2025-03-29","2025-03-25","SF FuneralF815758       250325","","126.5","","1241334.31"
"2025-03-29","2025-03-27","SF FuneralF844280       250327","","126.5","","1241460.81"
"2025-03-29","2025-03-27","SF FuneralF1080259      250327","","126.5","","1241587.31"
"2025-03-29","2025-03-27","SF FuneralF1118592      250327","","126.5","","1241713.81"
"2025-03-29","2025-03-28","SF FuneralFDC00000007632250328","","126.5","","1241840.31"
"2025-03-29","2025-03-28","SF FuneralF797727       250328","","126.5","","1241966.81"
"2025-03-29","2025-03-28","SF FuneralF816521       250328","","126.5","","1242093.31"
"2025-03-29","2025-03-28","SF FuneralF816993       250328","","126.5","","1242219.81"
"2025-03-29","2025-03-28","SF FuneralF821009       250328","","126.5","","1242346.31"
"2025-03-29","2025-03-28","SF FuneralF1073279      250328","","126.5","","1242472.81"
"2025-03-29","2025-03-26","SF FuneralF991987       250326","","126.5","","1242599.31"
"2025-03-29","2025-03-29","SF FuneralFDC00000006MZH250329","","126.5","","1242725.81"
"2025-03-29","2025-03-29","SF FuneralF1125981      250329","","126.5","","1242852.31"
"2025-03-29","2025-03-29","SF FuneralFDC00000006FDH250329","","126.5","","1242978.81"
"2025-03-29","2025-03-29","SF FuneralF1130421      250329","","31.63","","1243010.44"
"2025-03-29","2025-03-27","SF FuneralFDC00000005GSZ250327","","126.5","","1243136.94"
"2025-03-29","2025-03-27","SF FuneralFDC00000005L3F250327","","126.5","","1243263.44"
"2025-03-29","2025-03-27","SF FuneralFDC00000006YL1250327","","126.5","","1243389.94"
"2025-03-29","2025-03-27","SF FuneralF802337       250327","","126.5","","1243516.44"
"2025-03-29","2025-03-27","SF FuneralF813527       250327","","126.5","","1243642.94"
"2025-03-29","2025-03-27","SF FuneralF821749       250327","","126.5","","1243769.44"
"2025-03-29","2025-03-27","SF FuneralF820950       250327","","126.5","","1243895.94"
"2025-03-29","2025-03-27","SF FuneralF841835       250327","","126.5","","1244022.44"
"2025-03-29","2025-03-27","SF FuneralF1060650      250327","","126.5","","1244148.94"
"2025-03-29","2025-03-27","SF FuneralF1109938      250327","","126.5","","1244275.44"
"2025-03-29","2025-03-27","SF FuneralF1112521      250327","","126.5","","1244401.94"
"2025-03-29","2025-03-27","SF FuneralF1114728      250327","","126.5","","1244528.44"
"2025-03-29","2025-03-27","SF FuneralF1122038      250327","","126.5","","1244654.94"
"2025-03-29","2025-03-27","SF FuneralF1132153      250327","","126.5","","1244781.44"
"2025-03-29","2025-03-28","SF FuneralFDC00000002VF9250328","","220","","1245001.44"
"2025-03-29","2025-03-28","SF FuneralFDC0000000681B250328","","191.5","","1245192.94"
"2025-03-29","2025-03-28","SF FuneralFDC000000090BY250328","","126.5","","1245319.44"
"2025-03-29","2025-03-28","SF FuneralF844567       250328","","126.5","","1245445.94"
"2025-03-29","2025-03-28","SF FuneralF1066698      250328","","126.5","","1245572.44"
"2025-03-29","2025-03-28","SF FuneralF1083877      250328","","126.5","","1245698.94"
"2025-03-29","2025-03-28","SF FuneralFDC0000000QLLK250328","","126.5","","1245825.44"
"2025-03-29","2025-03-22","SF FuneralFDC0000000616V250322","","126.5","","1245951.94"
"2025-03-29","2025-03-22","SF FuneralFDC00000007MGW250322","","126.5","","1246078.44"
"2025-03-29","2025-03-22","SF FuneralFDC000000083SM250322","","126.5","","1246204.94"
"2025-03-29","2025-03-22","SF FuneralFDC00000009515250322","","126.5","","1246331.44"
"2025-03-29","2025-03-22","SF FuneralFDC0000000BLDN250322","","126.5","","1246457.94"
"2025-03-29","2025-03-22","SF FuneralF992442       250322","","126.5","","1246584.44"
"2025-03-29","2025-03-22","SF FuneralF1080292      250322","","126.5","","1246710.94"
"2025-03-29","2025-03-22","SF FuneralF1085073      250322","","126.5","","1246837.44"
"2025-03-29","2025-03-22","SF FuneralF1112166      250322","","126.5","","1246963.94"
"2025-03-29","2025-03-22","SF FuneralF1117602      250322","","126.5","","1247090.44"
"2025-03-29","2025-03-24","SF FuneralFDC00000007GYF250324","","126.5","","1247216.94"
"2025-03-29","2025-03-24","SF FuneralF808607       250323","","126.5","","1247343.44"
"2025-03-29","2025-03-24","SF FuneralF833038       250324","","126.5","","1247469.94"
"2025-03-29","2025-03-24","SF FuneralF1083805      250324","","126.5","","1247596.44"
"2025-03-29","2025-03-25","SF FuneralFDC00000007GXN250325","","126.5","","1247722.94"
"2025-03-29","2025-03-25","SF FuneralFDC00000007LDQ250325","","126.5","","1247849.44"
"2025-03-29","2025-03-25","SF FuneralFDC00000007LL1250325","","126.5","","1247975.94"
"2025-03-29","2025-03-25","SF FuneralFDC00000007LQZ250325","","126.5","","1248102.44"
"2025-03-29","2025-03-25","SF FuneralFDC00000007MTQ250325","","126.5","","1248228.94"
"2025-03-29","2025-03-25","SF FuneralFDC00000007RGW250325","","126.5","","1248355.44"
"2025-03-29","2025-03-25","SF FuneralFDC00000007TPS250325","","126.5","","1248481.94"
"2025-03-29","2025-03-25","SF FuneralF808104       250325","","126.5","","1248608.44"
"2025-03-29","2025-03-25","SF FuneralF822239       250325","","31.63","","1248640.07"
"2025-03-29","2025-03-25","SF FuneralF1060329      250325","","126.5","","1248766.57"
"2025-03-29","2025-03-25","SF FuneralF1104066      250325","","126.5","","1248893.07"
"2025-03-29","2025-03-25","SF FuneralF1120751      250325","","126.5","","1249019.57"
"2025-03-29","2025-03-25","SF FuneralF1122750      250325","","31.63","","1249051.2"
"2025-03-29","2025-03-26","SF FuneralFDC000000074GL250326","","126.5","","1249177.7"
"2025-03-29","2025-03-26","SF FuneralF819801       250326","","126.5","","1249304.2"
"2025-03-29","2025-03-26","SF FuneralF828709       250326","","126.5","","1249430.7"
"2025-03-29","2025-03-26","SF FuneralF830959       250326","","126.5","","1249557.2"
"2025-03-29","2025-03-26","SF FuneralF989323       250326","","126.5","","1249683.7"
"2025-03-29","2025-03-26","SF FuneralF991687       250326","","126.5","","1249810.2"
"2025-03-29","2025-03-26","SF FuneralF1062663      250326","","126.5","","1249936.7"
"2025-03-29","2025-03-20","SF FuneralF981014       250322","","126.5","","1250063.2"
"2025-03-29","2025-03-22","SF FuneralFDC00000007JR7250322","","126.5","","1250189.7"
"2025-03-29","2025-03-22","SF FuneralFDC00000008HXR250322","","126.5","","1250316.2"
"2025-03-29","2025-03-22","SF FuneralF823307       250322","","126.5","","1250442.7"
"2025-03-29","2025-03-22","SF FuneralF831901       250322","","126.5","","1250569.2"
"2025-03-29","2025-03-22","SF FuneralF992319       250322","","126.5","","1250695.7"
"2025-03-29","2025-03-22","SF FuneralFDC0000000L7NZ250322","","126.5","","1250822.2"
"2025-03-29","2025-03-22","SF FuneralFDC0000000LCSQ250322","","126.5","","1250948.7"
"2025-03-29","2025-03-22","SF FuneralFDC0000000LCSR250322","","126.5","","1251075.2"
"2025-03-29","2025-03-22","SF FuneralFDC0000000PNQ8250323","","126.5","","1251201.7"
"2025-03-29","2025-03-22","SF FuneralFDC0000000PNQD250323","","126.5","","1251328.2"
"2025-03-29","2025-03-24","SF FuneralFDC000000066LB250323","","126.5","","1251454.7"
"2025-03-29","2025-03-24","SF FuneralF817065       250324","","126.5","","1251581.2"
"2025-03-29","2025-03-25","SF FuneralFDC0000000751R250325","","126.5","","1251707.7"
"2025-03-29","2025-03-25","SF FuneralFDC000000079QY250325","","31.63","","1251739.33"
"2025-03-29","2025-03-25","SF FuneralFDC00000007LMS250325","","126.5","","1251865.83"
"2025-03-29","2025-03-25","SF FuneralFDC00000007NXT250325","","126.5","","1251992.33"
"2025-03-29","2025-03-25","SF FuneralFDC00000007XMS250325","","126.5","","1252118.83"
"2025-03-29","2025-03-25","SF FuneralF802375       250325","","31.63","","1252150.46"
"2025-03-29","2025-03-25","SF FuneralF817132       250325","","126.5","","1252276.96"
"2025-03-29","2025-03-25","SF FuneralFDC0000000HL8F250325","","126.5","","1252403.46"
"2025-03-29","2025-03-25","SF FuneralF986863       250325","","126.5","","1252529.96"
"2025-03-29","2025-03-25","SF FuneralF1052690      250325","","126.5","","1252656.46"
"2025-03-29","2025-03-25","SF FuneralF1068221      250325","","31.63","","1252688.09"
"2025-03-29","2025-03-25","SF FuneralF1084879      250325","","126.5","","1252814.59"
"2025-03-29","2025-03-25","SF FuneralF1103565      250325","","63.25","","1252877.84"
"2025-03-29","2025-03-25","SF FuneralF1108251      250325","","31.63","","1252909.47"
"2025-03-29","2025-03-25","SF FuneralF1114169      250325","","126.5","","1253035.97"
"2025-03-29","2025-03-25","SF FuneralF981451       250325","","31.63","","1253067.6"
"2025-03-29","2025-03-25","SF FuneralF1130923      250325","","126.5","","1253194.1"
"2025-03-29","2025-03-25","SF FuneralF1131583      250325","","126.5","","1253320.6"
"2025-03-29","2025-03-25","SF FuneralFDC0000000Q5WJ250325","","126.5","","1253447.1"
"2025-03-29","2025-03-25","SF FuneralF1134566      250325","","63.25","","1253510.35"
"2025-03-29","2025-03-26","SF FuneralF799091       250326","","126.5","","1253636.85"
"2025-03-29","2025-03-26","SF FuneralF793455       250326","","126.5","","1253763.35"
"2025-03-29","2025-03-26","SF FuneralF840729       250326","","126.5","","1253889.85"
"2025-03-29","2025-03-26","SF FuneralF992781       250326","","126.5","","1254016.35"
"2025-03-29","2025-03-26","SF FuneralF1116727      250326","","126.5","","1254142.85"
"2025-03-29","2025-03-26","SF FuneralF1129063      250326","","126.5","","1254269.35"
"2025-03-29","2025-03-27","SF FuneralFDC00000005XT6250327","","126.5","","1254395.85"
"2025-03-29","2025-03-27","SF FuneralFDC000000069GZ250327","","126.5","","1254522.35"
"2025-03-29","2025-03-27","SF FuneralFDC000000073S1250327","","126.5","","1254648.85"
"2025-03-29","2025-03-27","SF FuneralFDC0000000757N250327","","126.5","","1254775.35"
"2025-03-29","2025-03-27","SF FuneralFDC000000075NW250327","","126.5","","1254901.85"
"2025-03-29","2025-03-27","SF FuneralFDC0000000814J250327","","126.5","","1255028.35"
"2025-03-29","2025-03-27","SF FuneralF827599       250327","","126.5","","1255154.85"
"2025-03-29","2025-03-27","SF FuneralF843084       250327","","126.5","","1255281.35"
"2025-03-29","2025-03-27","SF FuneralF1021783      250327","","126.5","","1255407.85"
"2025-03-29","2025-03-27","SF FuneralFDC0000000N7RF250327","","126.5","","1255534.35"
"2025-03-29","2025-03-27","SF FuneralF783349       250327","","126.5","","1255660.85"
"2025-03-29","2025-03-27","SF FuneralF1120758      250327","","126.5","","1255787.35"
"2025-03-29","2025-03-27","SF FuneralFDC0000000QHMW250327","","126.5","","1255913.85"
"2025-03-29","2025-03-28","SF FuneralFDC000000069BF250328","","126.5","","1256040.35"
"2025-03-29","2025-03-28","SF FuneralFDC000000071MZ250328","","126.5","","1256166.85"
"2025-03-29","2025-03-28","SF FuneralFDC0000000BGQB250328","","191.5","","1256358.35"
"2025-03-29","2025-03-28","SF FuneralF987464       250328","","126.5","","1256484.85"
"2025-03-29","2025-03-28","SF FuneralF1021364      250328","","126.5","","1256611.35"
"2025-03-29","2025-03-28","SF FuneralF1021471      250328","","126.5","","1256737.85"
"2025-03-29","2025-03-28","SF FuneralF1066592      250328","","126.5","","1256864.35"
"2025-03-29","2025-03-28","SF FuneralF1110355      250328","","126.5","","1256990.85"
"2025-03-29","2025-03-28","SF FuneralF1111550      250328","","126.5","","1257117.35"
"2025-03-29","2025-03-28","SF FuneralF1115120      250328","","126.5","","1257243.85"
"2025-03-29","2025-03-28","SF FuneralFDC0000000NNBR250328","","126.5","","1257370.35"
"2025-03-29","2025-03-28","SF FuneralF1127488      250328","","126.5","","1257496.85"
"2025-03-29","2025-03-28","SF FuneralF1129091      250328","","126.5","","1257623.35"
"2025-03-29","2025-03-28","SF FuneralF1129342      250328","","126.5","","1257749.85"
"2025-03-29","2025-03-29","SF FuneralFDC00000002VBK250329","","220","","1257969.85"
"2025-03-29","2025-03-29","SF FuneralFDC00000007GP4250329","","126.5","","1258096.35"
"2025-03-29","2025-03-29","SF FuneralF834860       250329","","126.5","","1258222.85"
"2025-03-29","2025-03-29","SF FuneralF1084911      250329","","126.5","","1258349.35"
"2025-03-29","2025-03-29","SF FuneralF1085236      250329","","126.5","","1258475.85"
"2025-03-29","2025-03-29","SF FuneralFDC00000006HWT250329","","126.5","","1258602.35"
"2025-03-29","2025-03-29","SF FuneralF1119679      250329","","126.5","","1258728.85"
"2025-03-29","2025-03-29","SF FuneralF1128055      250330","","31.63","","1258760.48"
"2025-03-29","2025-03-22","SF FuneralFDC0000000MRRW250322","","126.5","","1258886.98"
"2025-03-29","2025-03-25","SF FuneralFDC0000000Q8H7250325","","31.63","","1258918.61"
"2025-03-29","2025-03-24","SF FuneralF1132851      250324","","126.5","","1259045.11"
"2025-03-29","2025-03-27","SF FuneralF1113198      250327","","126.5","","1259171.61"
"2025-03-29","2025-03-25","Rev SF FuneralFDC00000007TNM250325","","-126.5","","1259045.11"
"2025-03-29","2025-03-25","Rev SF FuneralFDC00000007NXQ250325","","-126.5","","1258918.61"
"2025-03-29","2025-03-25","Rev SF FuneralFDC0000000Q7SH250325","","-126.5","","1258792.11"
"2025-03-29","2025-03-26","Rev SF FuneralFDC00000006WCL250326","","-126.5","","1258665.61"
"2025-03-29","2025-03-26","Rev SF FuneralFDC00000006WCW250326","","-126.5","","1258539.11"
"2025-03-29","2025-03-26","Rev SF FuneralFDC00000006WCZ250326","","-126.5","","1258412.61"
"2025-03-29","2025-03-26","Rev SF FuneralFDC00000006X9Y250326","","-126.5","","1258286.11"
"2025-03-29","2025-03-27","Rev SF FuneralFDC000000069J2250327","","-126.5","","1258159.61"
"2025-03-29","2025-03-27","Rev SF FuneralFDC00000005GBC250327","","-126.5","","1258033.11"
"2025-03-29","2025-03-27","Rev SF FuneralFDC00000009HB8250327","","-126.5","","1257906.61"
"2025-03-29","2025-03-27","Rev SF FuneralFDC0000000KFJS250327","","-321.5","","1257585.11"
"2025-03-29","2025-03-28","Rev SF FuneralFDC000000069N7250328","","-126.5","","1257458.61"
"2025-03-29","2025-03-28","Rev SF FuneralFDC00000007548250328","","-126.5","","1257332.11"
"2025-03-29","2025-03-28","Rev SF FuneralFDC00000006YXS250328","","-126.5","","1257205.61"
"2025-03-29","2025-03-28","Rev SF FuneralFDC0000000JXHY250328","","-126.5","","1257079.11"
"2025-03-29","2025-03-28","Rev SF FuneralFDC0000000HQMZ250328","","-126.5","","1256952.61"
"2025-03-29","2025-03-29","Rev SF FuneralFDC0000000NCRN250329","","-63.25","","1256889.36"
"2025-03-29","2025-03-25","Rev SF FuneralF1111658      250325","","-63.25","","1256826.11"
"2025-03-29","2025-03-22","Rev SF FuneralFDC0000000678S250322","","-126.5","","1256699.61"
"2025-03-29","2025-03-22","Rev SF FuneralFDC0000000678T250322","","-126.5","","1256573.11"
"2025-03-29","2025-03-22","Rev SF FuneralFDC00000003MN1250322","","-220","","1256353.11"
"2025-03-29","2025-03-22","Rev SF FuneralFDC00000003MNW250322","","-220","","1256133.11"
"2025-03-29","2025-03-22","Rev SF FuneralFDC00000003D66250322","","-220","","1255913.11"
"2025-03-29","2025-03-22","Rev SF FuneralFDC00000005X1Q250322","","-220","","1255693.11"
"2025-03-29","2025-03-24","Rev SF FuneralFDC00000008JY9250324","","-63.25","","1255629.86"
"2025-03-29","2025-03-24","Rev SF FuneralFDC00000006LM0250324","","-126.5","","1255503.36"
"2025-03-29","2025-03-25","Rev SF FuneralFDC00000006ST9250325","","-31.63","","1255471.73"
"2025-03-29","2025-03-25","Rev SF FuneralFDC0000000JHBW250325","","-31.63","","1255440.1"
"2025-03-29","2025-03-24","Rev SF FuneralFDC00000005XG9250324","","-31.63","","1255408.47"
"2025-03-29","2025-03-28","Rev SF FuneralFDC0000000NNGY250328","","-31.63","","1255376.84"
"2025-03-29","2025-03-25","SF FuneralF833072       250325","","31.63","","1255408.47"
"2025-03-29","2025-03-25","SF FuneralFDC0000000NZV5250325","","31.63","","1255440.1"
"2025-03-29","2025-03-25","SF FuneralF1121873      250325","","31.63","","1255471.73"
"2025-03-29","2025-03-26","SF FuneralF842872       250326","","31.63","","1255503.36"
"2025-03-29","2025-03-26","SF FuneralF844044       250326","","31.63","","1255534.99"
"2025-03-29","2025-03-20","SF FuneralFDC00000006HTW250320","","126.5","","1255661.49"
"2025-03-29","2025-03-22","SF FuneralFDC000000061QK250322","","126.5","","1255787.99"
"2025-03-29","2025-03-22","SF FuneralFDC00000007813250322","","126.5","","1255914.49"
"2025-03-29","2025-03-22","SF FuneralFDC000000085RF250322","","126.5","","1256040.99"
"2025-03-29","2025-03-22","SF FuneralF823551       250322","","126.5","","1256167.49"
"2025-03-29","2025-03-22","SF FuneralFDC0000000C4G1250322","","126.5","","1256293.99"
"2025-03-29","2025-03-22","SF FuneralF840449       250322","","126.5","","1256420.49"
"2025-03-29","2025-03-22","SF FuneralF993957       250322","","126.5","","1256546.99"
"2025-03-29","2025-03-22","SF FuneralF1112180      250323","","126.5","","1256673.49"
"2025-03-29","2025-03-24","SF FuneralFDC0000000NBRX250324","","126.5","","1256799.99"
"2025-03-29","2025-03-25","SF FuneralFDC00000007Q8D250325","","126.5","","1256926.49"
"2025-03-29","2025-03-25","SF FuneralFDC00000008MGS250325","","126.5","","1257052.99"
"2025-03-29","2025-03-25","SF FuneralF1059381      250325","","126.5","","1257179.49"
"2025-03-29","2025-03-25","SF FuneralF1066743      250325","","126.5","","1257305.99"
"2025-03-29","2025-03-25","SF FuneralF1078282      250325","","126.5","","1257432.49"
"2025-03-29","2025-03-25","SF FuneralF1124752      250325","","126.5","","1257558.99"
"2025-03-29","2025-03-26","SF FuneralFDC000000082VD250326","","126.5","","1257685.49"
"2025-03-29","2025-03-26","SF FuneralF828047       250326","","126.5","","1257811.99"
"2025-03-29","2025-03-26","SF FuneralF828762       250326","","126.5","","1257938.49"
"2025-03-29","2025-03-26","SF FuneralF992515       250326","","126.5","","1258064.99"
"2025-03-29","2025-03-26","SF FuneralF993807       250326","","126.5","","1258191.49"
"2025-03-29","2025-03-26","SF FuneralF1125087      250326","","126.5","","1258317.99"
"2025-03-29","2025-03-26","SF FuneralF1125182      250326","","126.5","","1258444.49"
"2025-03-29","2025-03-27","SF FuneralFDC000000085BX250327","","126.5","","1258570.99"
"2025-03-29","2025-03-27","SF FuneralF812976       250327","","126.5","","1258697.49"
"2025-03-29","2025-03-27","SF FuneralF986787       250327","","126.5","","1258823.99"
"2025-03-29","2025-03-27","SF FuneralF1021104      250327","","126.5","","1258950.49"
"2025-03-29","2025-03-27","SF FuneralF1083829      250327","","126.5","","1259076.99"
"2025-03-29","2025-03-27","SF FuneralF1112241      250327","","126.5","","1259203.49"
"2025-03-29","2025-03-27","SF FuneralF1112356      250327","","126.5","","1259329.99"
"2025-03-29","2025-03-27","SF FuneralF1113109      250327","","126.5","","1259456.49"
"2025-03-29","2025-03-27","SF FuneralF1120779      250327","","126.5","","1259582.99"
"2025-03-29","2025-03-28","SF FuneralFDC00000003VHJ250328","","220","","1259802.99"
"2025-03-29","2025-03-28","SF FuneralFDC0000000684V250328","","126.5","","1259929.49"
"2025-03-29","2025-03-28","SF FuneralFDC00000006HKH250328","","126.5","","1260055.99"
"2025-03-29","2025-03-28","SF FuneralF822539       250328","","126.5","","1260182.49"
"2025-03-29","2025-03-28","SF FuneralFDC0000000LTR0250328","","126.5","","1260308.99"
"2025-03-29","2025-03-28","SF FuneralF1109576      250328","","126.5","","1260435.49"
"2025-03-29","2025-03-28","SF FuneralFDC0000000PL03250328","","126.5","","1260561.99"
"2025-03-29","2025-03-28","SF FuneralF1134434      250328","","126.5","","1260688.49"
"2025-03-29","2025-03-29","SF FuneralF828840       250329","","126.5","","1260814.99"
"2025-03-29","2025-03-29","SF FuneralF1052326      250329","","126.5","","1260941.49"
"2025-03-29","2025-03-22","SF FuneralF809363       250322","","126.5","","1261067.99"
"2025-03-29","2025-03-24","SF FuneralF831656       250323","","126.5","","1261194.49"
"2025-03-29","2025-03-24","SF FuneralFDC0000000MLB3250324","","126.5","","1261320.99"
"2025-03-29","2025-03-25","SF FuneralF1128831      250325","","126.5","","1261447.49"
"2025-03-29","2025-03-26","SF FuneralF1128076      250326","","63.25","","1261510.74"
"2025-03-29","2025-03-27","SF FuneralFDC00000005WNX250327","","126.5","","1261637.24"
"2025-03-29","2025-03-27","SF FuneralFDC000000086H5250327","","126.5","","1261763.74"
"2025-03-29","2025-03-27","SF FuneralF802305       250327","","126.5","","1261890.24"
"2025-03-29","2025-03-27","SF FuneralFDC00000008RYW250327","","126.5","","1262016.74"
"2025-03-29","2025-03-27","SF FuneralFDC00000008RZ0250327","","126.5","","1262143.24"
"2025-03-29","2025-03-27","SF FuneralF812609       250327","","126.5","","1262269.74"
"2025-03-29","2025-03-28","SF FuneralFDC00000006KZR250328","","126.5","","1262396.24"
"2025-03-29","2025-03-28","SF FuneralFDC00000006Y27250328","","126.5","","1262522.74"
"2025-03-29","2025-03-28","SF FuneralFDC0000000GTPK250328","","126.5","","1262649.24"
"2025-03-29","2025-03-28","SF FuneralFDC0000000KY6L250328","","126.5","","1262775.74"
"2025-03-29","2025-03-28","SF FuneralF1078508      250328","","126.5","","1262902.24"
"2025-03-29","2025-03-28","SF FuneralF1133103      250328","","126.5","","1263028.74"
"2025-03-29","2025-03-29","SF FuneralF821915       250329","","126.5","","1263155.24"
"2025-03-29","2025-03-25","SF FuneralF1129262      250325","","126.5","","1263281.74"
"2025-03-29","2025-03-27","SF FuneralFDC0000000LBKN250327","","126.5","","1263408.24"
"2025-03-29","2025-03-27","SF FuneralF1121904      250327","","126.5","","1263534.74"
"2025-03-29","2025-03-28","Rev SF FuneralFDC00000006W33250328","","-126.5","","1263408.24"
"2025-03-29","2025-03-25","Rev SF FuneralFDC0000000NRQK250325","","-31.63","","1263376.61"
"2025-03-29","2025-03-25","Rev SF FuneralFDC00000007V1W250325","","-126.5","","1263250.11"
"2025-03-29","2025-03-22","Rev SF FuneralFDC000000035YY250322","","-220","","1263030.11"
"2025-03-29","2025-03-29","Rev SF FuneralFDC00000005W9N250329","","-220","","1262810.11"
"2025-03-29","2025-03-27","Rev SF FuneralFDC0000000F5C8250327","","-126.5","","1262683.61"
"2025-03-29","2025-03-27","Rev SF FuneralFDC0000000D2XC250327","","-126.5","","1262557.11"
"2025-03-29","2025-01-24","Rev SF FuneralFDC00000006D77250128","","-126.5","","1262430.61"
"2025-03-29","2025-03-08","Rev SF FuneralFDC0000000752S250308","","-63.25","","1262367.36"
"2025-03-29","2025-03-20","Rev SF FuneralFDC00000006DGD250320","","-126.5","","1262240.86"
"2025-03-29","2025-03-25","Rev SF FuneralFDC00000005P7W250325","","-126.5","","1262114.36"
"2025-03-29","2025-03-28","Rev SF FuneralFDC0000000HYQ5250328","","-126.5","","1261987.86"
"2025-03-29","2025-02-28","Rev SF FuneralFDC00000006D77250228","","-126.5","","1261861.36"
"2025-03-29","2025-03-24","Rev SF FuneralFDC00000006LCM250324","","-126.5","","1261734.86"
"2025-03-29","2024-10-28","Rev SF FuneralFDC00000006D77241028","","-126.5","","1261608.36"
"2025-03-29","2024-12-11","Rev SF FuneralFDC00000006D77241228","","-126.5","","1261481.86"
"2025-03-29","2025-03-28","Rev SF FuneralFDC00000006HKH250328","","-126.5","","1261355.36"
"2025-03-29","2025-03-28","Rev SF FuneralFDC0000000GTPK250328","","-126.5","","1261228.86"
"2025-03-29","2025-03-28","Rev SF FuneralFDC00000006D77250328","","-126.5","","1261102.36"
"2025-03-29","2025-03-22","Rev SF FuneralFDC0000000752S250322","","-63.25","","1261039.11"
"2025-03-29","2025-03-22","Rev SF FuneralFDC00000007813250322","","-126.5","","1260912.61"
"2025-03-29","2025-03-22","Rev SF FuneralFDC00000008TX4250321","","-126.5","","1260786.11"
"2025-03-29","2025-03-20","Rev SF FuneralFDC00000005MXN250320","","-126.5","","1260659.61"
"2025-03-29","2024-11-28","Rev SF FuneralFDC00000006D77241128","","-126.5","","1260533.11"
"2025-03-29","2025-02-22","Rev SF FuneralFDC0000000752S250222","","-63.25","","1260469.86"
"2025-03-29","2025-03-22","SF FuneralFDC00000005HF0250322","","126.5","","1260596.36"
"2025-03-29","2025-03-22","SF FuneralF829613       250322","","126.5","","1260722.86"
"2025-03-29","2025-03-25","SF FuneralFDC00000006V4D250325","","126.5","","1260849.36"
"2025-03-29","2025-03-25","SF FuneralFDC00000007GSG250325","","126.5","","1260975.86"
"2025-03-29","2025-03-25","SF FuneralF993633       250325","","31.63","","1261007.49"
"2025-03-29","2025-03-25","SF FuneralF1132516      250325","","126.5","","1261133.99"
"2025-03-29","2025-03-27","SF FuneralF1073283      250327","","126.5","","1261260.49"
"2025-03-29","2025-03-28","SF FuneralFDC00000009HWN250328","","126.5","","1261386.99"
"2025-03-29","2025-03-28","SF FuneralF815922       250328","","126.5","","1261513.49"
"2025-03-29","2025-03-28","SF FuneralF1127582      250328","","126.5","","1261639.99"
"2025-03-29","2025-03-24","SF FuneralF1128062      250324","","31.63","","1261671.62"
"2025-03-29","2025-03-26","SF FuneralF830655       250326","","126.5","","1261798.12"
"2025-03-29","2025-03-27","SF FuneralFDC00000003KDQ250327","","220","","1262018.12"
"2025-03-29","2025-03-27","SF FuneralF812307       250327","","126.5","","1262144.62"
"2025-03-29","2025-03-27","SF FuneralF1068173      250327","","126.5","","1262271.12"
"2025-03-29","2025-03-28","SF FuneralF1108967      250328","","126.5","","1262397.62"
"2025-03-29","2025-03-27","SF FuneralFDC0000000782L250327","","126.5","","1262524.12"
"2025-03-29","2025-03-27","SF FuneralF812325       250327","","126.5","","1262650.62"
"2025-03-29","2025-03-27","SF FuneralF827814       250327","","126.5","","1262777.12"
"2025-03-29","2025-03-27","SF FuneralF1084928      250327","","126.5","","1262903.62"
"2025-03-29","2025-03-27","SF FuneralF1127897      250327","","126.5","","1263030.12"
"2025-03-29","2025-03-27","SF FuneralF1128706      250327","","126.5","","1263156.62"
"2025-03-29","2025-03-29","SF FuneralF1020807      250329","","126.5","","1263283.12"
"2025-03-29","2025-03-25","SF FuneralFDC0000000788B250325","","31.63","","1263314.75"
"2025-03-29","2025-03-25","SF FuneralF808612       250325","","126.5","","1263441.25"
"2025-03-29","2025-03-25","SF FuneralF1120305      250325","","126.5","","1263567.75"
"2025-03-29","2025-03-22","SF FuneralFDC00000006NNW250321","","126.5","","1263694.25"
"2025-03-29","2025-03-28","SF FuneralFDC00000006NJC250328","","126.5","","1263820.75"
"2025-03-29","2025-03-28","SF FuneralF1108971      250328","","126.5","","1263947.25"
"2025-03-29","2025-03-29","SF FuneralFDC000000069HL250329","","126.5","","1264073.75"
"2025-03-29","2025-03-27","Rev SF FuneralFDC0000000NJPF250327","","-126.5","","1263947.25"
"2025-03-29","2025-03-22","SF FuneralF804204       250322","","126.5","","1264073.75"
"2025-03-29","2025-03-27","SF FuneralFDC00000007HG0250327","","126.5","","1264200.25"
"2025-03-29","2025-03-27","SF FuneralF843392       250327","","126.5","","1264326.75"
"2025-03-29","2025-03-28","SF FuneralFDC000000068VL250328","","126.5","","1264453.25"
"2025-03-29","2025-03-28","SF FuneralFDC000000068VV250328","","126.5","","1264579.75"
"2025-03-29","2025-03-28","SF FuneralFDC000000068VZ250328","","126.5","","1264706.25"
"2025-03-30","2025-03-22","SF FuneralFDC000000080J1250322","","126.5","","1264832.75"
"2025-03-30","2025-03-22","SF FuneralF833114       250322","","126.5","","1264959.25"
"2025-03-30","2025-03-24","SF FuneralFDC00000007C6Q250323","","126.5","","1265085.75"
"2025-03-30","2025-03-24","SF FuneralF809158       250323","","126.5","","1265212.25"
"2025-03-30","2025-03-24","SF FuneralF815223       250323","","126.5","","1265338.75"
"2025-03-30","2025-03-24","SF FuneralF827755       250323","","126.5","","1265465.25"
"2025-03-30","2025-03-25","SF FuneralF987322       250325","","126.5","","1265591.75"
"2025-03-30","2025-03-25","SF FuneralF992165       250325","","126.5","","1265718.25"
"2025-03-30","2025-03-25","SF FuneralFDC0000000JNC2250325","","126.5","","1265844.75"
"2025-03-30","2025-03-25","SF FuneralF1131630      250325","","126.5","","1265971.25"
"2025-03-30","2025-03-27","SF FuneralFDC00000006NC2250327","","220","","1266191.25"
"2025-03-30","2025-03-27","SF FuneralF817862       250327","","126.5","","1266317.75"
"2025-03-30","2025-03-27","SF FuneralF820887       250327","","126.5","","1266444.25"
"2025-03-30","2025-03-27","SF FuneralFDC0000000BQKQ250327","","126.5","","1266570.75"
"2025-03-30","2025-03-27","SF FuneralF1055314      250327","","126.5","","1266697.25"
"2025-03-30","2025-03-27","SF FuneralF1110817      250327","","63.25","","1266760.5"
"2025-03-30","2025-03-27","SF FuneralFDC0000000P2ZT250327","","126.5","","1266887"
"2025-03-30","2025-03-27","SF FuneralF1134185      250327","","126.5","","1267013.5"
"2025-03-30","2025-03-28","SF FuneralFDC00000006MDK250328","","126.5","","1267140"
"2025-03-30","2025-03-28","SF FuneralFDC00000008BLR250328","","126.5","","1267266.5"
"2025-03-30","2025-03-28","SF FuneralF805791       250328","","126.5","","1267393"
"2025-03-30","2025-03-28","SF FuneralF812479       250328","","126.5","","1267519.5"
"2025-03-30","2025-03-28","SF FuneralFDC0000000JR9H250328","","126.5","","1267646"
"2025-03-30","2025-03-28","SF FuneralF1072718      250328","","126.5","","1267772.5"
"2025-03-30","2025-03-28","SF FuneralF1116125      250328","","126.5","","1267899"
"2025-03-30","2025-03-28","SF FuneralF1126203      250328","","126.5","","1268025.5"
"2025-03-30","2025-03-29","SF FuneralFDC0000000PXGC250330","","126.5","","1268152"
"2025-03-30","2025-03-29","SF FuneralF1129098      250330","","126.5","","1268278.5"
"2025-03-30","2025-03-22","SF FuneralF1108242      250322","","126.5","","1268405"
"2025-03-30","2025-03-28","SF FuneralF847452       250328","","31.63","","1268436.63"
"2025-03-30","2025-03-28","SF FuneralF1125000      250328","","126.5","","1268563.13"
"2025-03-30","2025-03-29","SF FuneralF818080       250329","","126.5","","1268689.63"
"2025-03-30","2025-03-28","SF FuneralFDC0000000694T250328","","126.5","","1268816.13"
"2025-03-30","2025-03-28","SF FuneralF1125132      250328","","126.5","","1268942.63"
"2025-03-30","2025-03-28","SF FuneralF1133728      250328","","126.5","","1269069.13"
"2025-03-30","2025-03-29","SF FuneralF993362       250329","","126.5","","1269195.63"
"2025-03-30","2025-03-29","SF FuneralFDC0000000795L250329","","31.63","","1269227.26"
"2025-03-30","2025-03-25","SF FuneralFDC00000009CP1250325","","95.75","","1269323.01"
"2025-03-30","2025-03-26","SF FuneralFDC000000034MB250326","","220","","1269543.01"
"2025-03-30","2025-03-26","SF FuneralFDC000000077ZJ250326","","126.5","","1269669.51"
"2025-03-30","2025-03-26","SF FuneralF993452       250326","","126.5","","1269796.01"
"2025-03-30","2025-03-27","SF FuneralFDC00000009JVK250327","","126.5","","1269922.51"
"2025-03-30","2025-03-27","SF FuneralF841142       250327","","126.5","","1270049.01"
"2025-03-30","2025-03-27","SF FuneralF987653       250327","","126.5","","1270175.51"
"2025-03-30","2025-03-27","SF FuneralF1068192      250327","","126.5","","1270302.01"
"2025-03-30","2025-03-27","SF FuneralFDC0000000QMMZ250327","","126.5","","1270428.51"
"2025-03-30","2025-03-28","SF FuneralFDC000000068DR250328","","126.5","","1270555.01"
"2025-03-30","2025-03-28","SF FuneralFDC00000006B3J250328","","126.5","","1270681.51"
"2025-03-30","2025-03-28","SF FuneralFDC00000008BQG250328","","126.5","","1270808.01"
"2025-03-30","2025-03-28","SF FuneralFDC00000008BT8250328","","126.5","","1270934.51"
"2025-03-30","2025-03-28","SF FuneralF810075       250328","","126.5","","1271061.01"
"2025-03-30","2025-03-28","SF FuneralF988533       250328","","126.5","","1271187.51"
"2025-03-30","2025-03-28","SF FuneralF1022066      250328","","126.5","","1271314.01"
"2025-03-30","2025-03-28","SF FuneralF1117026      250328","","126.5","","1271440.51"
"2025-03-30","2025-03-28","SF FuneralFDC0000000NPGV250328","","126.5","","1271567.01"
"2025-03-30","2025-03-28","SF FuneralFDC0000000Q7XZ250328","","126.5","","1271693.51"
"2025-03-30","2025-03-28","SF FuneralFDC0000000Q7Y2250328","","126.5","","1271820.01"
"2025-03-30","2025-03-28","SF FuneralF1132830      250328","","126.5","","1271946.51"
"2025-03-30","2025-03-28","SF FuneralF1133757      250328","","126.5","","1272073.01"
"2025-03-30","2025-03-22","SF FuneralFDC00000007CF5250322","","126.5","","1272199.51"
"2025-03-30","2025-03-29","SF FuneralFDC0000000NJHM250329","","63.25","","1272262.76"
"2025-03-30","2025-03-20","SF FuneralF988990       250320","","126.5","","1272389.26"
"2025-03-30","2025-03-22","SF FuneralF1074877      250322","","126.5","","1272515.76"
"2025-03-30","2025-03-22","SF FuneralF1108168      250322","","126.5","","1272642.26"
"2025-03-30","2025-03-25","SF FuneralFDC00000007YPY250325","","126.5","","1272768.76"
"2025-03-30","2025-03-25","SF FuneralF1125399      250325","","126.5","","1272895.26"
"2025-03-30","2025-03-26","SF FuneralF992042       250326","","126.5","","1273021.76"
"2025-03-30","2025-03-27","SF FuneralFDC00000006G52250327","","126.5","","1273148.26"
"2025-03-30","2025-03-27","SF FuneralF981601       250327","","126.5","","1273274.76"
"2025-03-30","2025-03-27","SF FuneralFDC0000000NZ9M250327","","126.5","","1273401.26"
"2025-03-30","2025-03-25","SF FuneralF816154       250325","","126.5","","1273527.76"
"2025-03-30","2025-03-25","SF FuneralF1113205      250325","","126.5","","1273654.26"
"2025-03-30","2025-03-26","SF FuneralF1124148      250326","","126.5","","1273780.76"
"2025-03-30","2025-03-27","SF FuneralF993361       250327","","126.5","","1273907.26"
"2025-03-30","2025-03-27","SF FuneralFDC0000000LDRG250327","","126.5","","1274033.76"
"2025-03-30","2025-03-20","SF FuneralF833290       250320","","126.5","","1274160.26"
"2025-03-30","2025-03-24","SF FuneralF1066573      250324","","126.5","","1274286.76"
"2025-03-30","2025-03-24","SF FuneralF1126891      250324","","126.5","","1274413.26"
"2025-03-30","2025-03-25","SF FuneralF1112093      250325","","63.25","","1274476.51"
"2025-03-30","2025-03-25","SF FuneralF1133926      250325","","126.5","","1274603.01"
"2025-03-30","2025-03-26","SF FuneralF1120553      250326","","126.5","","1274729.51"
"2025-03-30","2025-03-27","SF FuneralFDC00000003NT6250327","","220","","1274949.51"
"2025-03-30","2025-03-27","SF FuneralF833006       250327","","126.5","","1275076.01"
"2025-03-30","2025-03-28","SF FuneralFDC00000005WRL250328","","220","","1275296.01"
"2025-03-30","2025-03-26","SF FuneralF1123107      250326","","126.5","","1275422.51"
"2025-03-30","2025-03-27","SF FuneralFDC00000006JT3250327","","126.5","","1275549.01"
"2025-03-30","2025-03-27","SF FuneralF812020       250327","","126.5","","1275675.51"
"2025-03-30","2025-03-27","SF FuneralFDC0000000K1GY250327","","126.5","","1275802.01"
"2025-03-30","2025-03-27","SF FuneralF1118056      250327","","126.5","","1275928.51"
"2025-03-30","2025-03-22","SF FuneralF1129182      250323","","126.5","","1276055.01"
"2025-03-30","2025-03-25","SF FuneralF833843       250325","","126.5","","1276181.51"
"2025-03-30","2025-03-25","SF FuneralF841858       250325","","126.5","","1276308.01"
"2025-03-30","2025-03-25","SF FuneralF1131152      250325","","126.5","","1276434.51"
"2025-03-30","2025-03-26","SF FuneralF1079659      250326","","126.5","","1276561.01"
"2025-03-30","2025-03-27","SF FuneralFDC000000096SP250327","","126.5","","1276687.51"
"2025-03-30","2025-03-27","SF FuneralF830649       250327","","31.63","","1276719.14"
"2025-03-30","2025-03-27","SF FuneralF1108113      250327","","31.63","","1276750.77"
"2025-03-30","2025-03-27","SF FuneralF1121872      250327","","126.5","","1276877.27"
"2025-03-30","2025-03-28","SF FuneralFDC00000006TSZ250328","","126.5","","1277003.77"
"2025-03-30","2025-03-28","SF FuneralF821298       250328","","126.5","","1277130.27"
"2025-03-30","2025-03-28","SF FuneralFDC0000000N77G250328","","126.5","","1277256.77"
"2025-03-30","2025-03-28","SF FuneralF1118332      250328","","63.25","","1277320.02"
"2025-03-30","2025-03-29","SF FuneralF821850       250329","","126.5","","1277446.52"
"2025-03-30","2025-03-22","SF FuneralF823590       250322","","126.5","","1277573.02"
"2025-03-30","2025-03-27","SF FuneralF829084       250327","","126.5","","1277699.52"
"2025-03-30","2025-03-27","SF FuneralF1085139      250327","","126.5","","1277826.02"
"2025-03-30","2025-03-30","SF FuneralF829764       250330","","63.25","","1277889.27"
"2025-03-30","2025-03-30","SF FuneralF833253       250330","","31.63","","1277920.9"
"2025-03-30","2025-03-24","SF FuneralFDC0000000N4NK250324","","126.5","","1278047.4"
"2025-03-30","2025-03-26","SF FuneralF802401       250326","","63.25","","1278110.65"
"2025-03-30","2025-03-28","SF FuneralFDC000000078SQ250328","","126.5","","1278237.15"
"2025-03-30","2025-03-28","SF FuneralF821794       250328","","126.5","","1278363.65"
"2025-03-30","2025-03-28","SF FuneralF989308       250328","","126.5","","1278490.15"
"2025-03-30","2025-03-28","SF FuneralF1127841      250328","","126.5","","1278616.65"
"2025-03-30","2025-03-22","SF FuneralFDC00000008SSP250322","","126.5","","1278743.15"
"2025-03-30","2025-03-22","SF FuneralF1054887      250322","","126.5","","1278869.65"
"2025-03-30","2025-03-25","SF FuneralFDC00000007N5X250325","","126.5","","1278996.15"
"2025-03-30","2025-03-25","SF FuneralF1125711      250325","","126.5","","1279122.65"
"2025-03-30","2025-03-28","SF FuneralFDC000000070FN250328","","126.5","","1279249.15"
"2025-03-30","2025-03-28","SF FuneralF1068021      250328","","126.5","","1279375.65"
"2025-03-30","2025-03-30","SF FuneralF804166       250330","","126.5","","1279502.15"
"2025-03-30","2025-03-30","SF FuneralF814334       250330","","126.5","","1279628.65"
"2025-03-30","2025-03-28","SF FuneralF1021699      250328","","126.5","","1279755.15"
"2025-03-30","2025-03-22","SF FuneralF1050863      250322","","126.5","","1279881.65"
"2025-03-30","2025-03-22","SF FuneralF1125126      250322","","126.5","","1280008.15"
"2025-03-30","2025-03-24","SF FuneralFDC00000007554250323","","126.5","","1280134.65"
"2025-03-30","2025-03-25","SF FuneralF810617       250325","","126.5","","1280261.15"
"2025-03-30","2025-03-25","SF FuneralF1108340      250325","","126.5","","1280387.65"
"2025-03-30","2025-03-27","SF FuneralF813372       250327","","126.5","","1280514.15"
"2025-03-30","2025-03-27","SF FuneralF1122617      250327","","126.5","","1280640.65"
"2025-03-30","2025-03-28","SF FuneralFDC00000006GKS250328","","126.5","","1280767.15"
"2025-03-30","2025-03-28","SF FuneralF808895       250328","","126.5","","1280893.65"
"2025-03-30","2025-03-28","SF FuneralF981670       250328","","31.63","","1280925.28"
"2025-03-30","2025-03-29","SF FuneralFDC0000000LVNH250330","","126.5","","1281051.78"
"2025-03-31","2025-03-28","SF FuneralFDC00000006GFP250328","","126.5","","1281178.28"
"2025-03-31","2025-03-28","SF FuneralF1110090      250328","","126.5","","1281304.78"
"2025-03-31","2025-03-28","SF FuneralF1117871      250328","","126.5","","1281431.28"
"2025-03-31","2025-03-24","SF FuneralFDC000000090G7250323","","126.5","","1281557.78"
"2025-03-31","2025-03-28","SF FuneralF834544       250328","","31.63","","1281589.41"
"2025-03-31","2025-03-28","SF FuneralF1061782      250328","","31.63","","1281621.04"
"2025-03-31","2025-03-28","SF FuneralFDC0000000NPT2250328","","126.5","","1281747.54"
"2025-03-31","2025-03-31","SF FuneralF843230       250329","","126.5","","1281874.04"
"2025-03-31","2025-03-22","SF FuneralFDC00000006388250322","","126.5","","1282000.54"
"2025-03-31","2025-03-22","SF FuneralF802711       250322","","126.5","","1282127.04"
"2025-03-31","2025-03-27","SF FuneralFDC0000000L0CH250327","","126.5","","1282253.54"
"2025-03-31","2025-03-28","SF FuneralFDC000000075CB250328","","126.5","","1282380.04"
"2025-03-31","2025-03-28","SF FuneralFDC00000007CLH250328","","126.5","","1282506.54"
"2025-03-31","2025-03-28","SF FuneralF1108647      250328","","126.5","","1282633.04"
"2025-03-31","2025-03-28","SF FuneralF1117729      250328","","126.5","","1282759.54"
"2025-03-31","2025-03-27","SF FuneralF1135462      250327","","63.25","","1282822.79"
"2025-03-31","2025-03-25","SF FuneralFDC00000007MTG250325","","126.5","","1282949.29"
"2025-03-31","2025-03-25","SF FuneralFDC00000007NXW250325","","191.5","","1283140.79"
"2025-03-31","2025-03-25","SF FuneralF793754       250325","","126.5","","1283267.29"
"2025-03-31","2025-03-25","SF FuneralF795238       250325","","126.5","","1283393.79"
"2025-03-31","2025-03-25","SF FuneralFDC00000007YCD250325","","126.5","","1283520.29"
"2025-03-31","2025-03-25","SF FuneralF802431       250325","","126.5","","1283646.79"
"2025-03-31","2025-03-25","SF FuneralF992344       250325","","126.5","","1283773.29"
"2025-03-31","2025-03-25","SF FuneralF787713       250325","","191.5","","1283964.79"
"2025-03-31","2025-03-25","SF FuneralF1131306      250325","","126.5","","1284091.29"
"2025-03-31","2025-03-25","SF FuneralFDC0000000Q5R3250325","","126.5","","1284217.79"
"2025-03-31","2025-03-25","SF FuneralF1131893      250325","","126.5","","1284344.29"
"2025-03-31","2025-03-25","SF FuneralF1131993      250325","","126.5","","1284470.79"
"2025-03-31","2025-03-25","SF FuneralF1132336      250325","","126.5","","1284597.29"
"2025-03-31","2025-03-26","SF FuneralF798875       250326","","126.5","","1284723.79"
"2025-03-31","2025-03-26","SF FuneralF986952       250326","","126.5","","1284850.29"
"2025-03-31","2025-03-26","SF FuneralF987016       250326","","31.63","","1284881.92"
"2025-03-31","2025-03-26","SF FuneralF990706       250326","","63.25","","1284945.17"
"2025-03-31","2025-03-26","SF FuneralF992105       250326","","126.5","","1285071.67"
"2025-03-31","2025-03-26","SF FuneralF993281       250326","","126.5","","1285198.17"
"2025-03-31","2025-03-26","SF FuneralF1059437      250326","","126.5","","1285324.67"
"2025-03-31","2025-03-26","SF FuneralFDC0000000M2N1250326","","63.25","","1285387.92"
"2025-03-31","2025-03-27","SF FuneralFDC0000000363M250327","","220","","1285607.92"
"2025-03-31","2025-03-27","SF FuneralFDC00000005DKB250327","","126.5","","1285734.42"
"2025-03-31","2025-03-27","SF FuneralFDC00000005DX7250327","","126.5","","1285860.92"
"2025-03-31","2025-03-27","SF FuneralFDC00000005JMT250327","","126.5","","1285987.42"
"2025-03-31","2025-03-27","SF FuneralFDC00000005RGF250327","","126.5","","1286113.92"
"2025-03-31","2025-03-27","SF FuneralFDC000000066HH250327","","126.5","","1286240.42"
"2025-03-31","2025-03-27","SF FuneralFDC000000066J1250327","","126.5","","1286366.92"
"2025-03-31","2025-03-27","SF FuneralFDC000000066J7250327","","126.5","","1286493.42"
"2025-03-31","2025-03-27","SF FuneralFDC0000000689S250327","","126.5","","1286619.92"
"2025-03-31","2025-03-27","SF FuneralFDC00000006DJ6250327","","126.5","","1286746.42"
"2025-03-31","2025-03-27","SF FuneralFDC00000006LCH250327","","126.5","","1286872.92"
"2025-03-31","2025-03-27","SF FuneralFDC00000006LYJ250327","","126.5","","1286999.42"
"2025-03-31","2025-03-27","SF FuneralFDC00000006LYK250327","","126.5","","1287125.92"
"2025-03-31","2025-03-27","SF FuneralFDC00000006N8P250327","","126.5","","1287252.42"
"2025-03-31","2025-03-27","SF FuneralFDC00000006NGN250327","","126.5","","1287378.92"
"2025-03-31","2025-03-27","SF FuneralFDC000000073BQ250327","","126.5","","1287505.42"
"2025-03-31","2025-03-27","SF FuneralFDC00000007RBZ250327","","126.5","","1287631.92"
"2025-03-31","2025-03-27","SF FuneralFDC00000008HFF250327","","126.5","","1287758.42"
"2025-03-31","2025-03-27","SF FuneralF802378       250327","","126.5","","1287884.92"
"2025-03-31","2025-03-27","SF FuneralF803382       250327","","126.5","","1288011.42"
"2025-03-31","2025-03-27","SF FuneralF809294       250327","","126.5","","1288137.92"
"2025-03-31","2025-03-27","SF FuneralF784822       250327","","126.5","","1288264.42"
"2025-03-31","2025-03-27","SF FuneralF812220       250327","","126.5","","1288390.92"
"2025-03-31","2025-03-27","SF FuneralF813320       250327","","126.5","","1288517.42"
"2025-03-31","2025-03-27","SF FuneralF813697       250327","","126.5","","1288643.92"
"2025-03-31","2025-03-27","SF FuneralF816604       250327","","126.5","","1288770.42"
"2025-03-31","2025-03-27","SF FuneralF819162       250327","","126.5","","1288896.92"
"2025-03-31","2025-03-27","SF FuneralF828039       250327","","126.5","","1289023.42"
"2025-03-31","2025-03-27","SF FuneralF829828       250327","","126.5","","1289149.92"
"2025-03-31","2025-03-27","SF FuneralF841083       250327","","126.5","","1289276.42"
"2025-03-31","2025-03-27","SF FuneralF900865       250327","","126.5","","1289402.92"
"2025-03-31","2025-03-27","SF FuneralFDC0000000HGKV250327","","126.5","","1289529.42"
"2025-03-31","2025-03-27","SF FuneralF1011946      250327","","126.5","","1289655.92"
"2025-03-31","2025-03-27","SF FuneralFDC0000000LDQ5250327","","126.5","","1289782.42"
"2025-03-31","2025-03-27","SF FuneralF1108989      250327","","126.5","","1289908.92"
"2025-03-31","2025-03-27","SF FuneralF1109572      250327","","126.5","","1290035.42"
"2025-03-31","2025-03-27","SF FuneralF1112493      250327","","126.5","","1290161.92"
"2025-03-31","2025-03-27","SF FuneralF1113227      250327","","126.5","","1290288.42"
"2025-03-31","2025-03-27","SF FuneralF1114352      250327","","126.5","","1290414.92"
"2025-03-31","2025-03-27","SF FuneralF1114602      250327","","126.5","","1290541.42"
"2025-03-31","2025-03-27","SF FuneralF1122369      250327","","126.5","","1290667.92"
"2025-03-31","2025-03-27","SF FuneralF1124187      250327","","126.5","","1290794.42"
"2025-03-31","2025-03-27","SF FuneralF1125741      250327","","126.5","","1290920.92"
"2025-03-31","2025-03-27","SF FuneralF1126291      250327","","126.5","","1291047.42"
"2025-03-31","2025-03-22","SF FuneralFDC00000005GV6250322","","126.5","","1291173.92"
"2025-03-31","2025-03-22","SF FuneralFDC000000099NZ250322","","126.5","","1291300.42"
"2025-03-31","2025-03-22","SF FuneralF823625       250322","","126.5","","1291426.92"
"2025-03-31","2025-03-24","SF FuneralF812464       250323","","126.5","","1291553.42"
"2025-03-31","2025-03-24","SF FuneralF1116117      250324","","126.5","","1291679.92"
"2025-03-31","2025-03-29","SF FuneralFDC00000006GQV250329","","126.5","","1291806.42"
"2025-03-31","2025-03-29","SF FuneralFDC00000008327250329","","126.5","","1291932.92"
"2025-03-31","2025-03-29","SF FuneralF799698       250329","","126.5","","1292059.42"
"2025-03-31","2025-03-29","SF FuneralF820124       250329","","126.5","","1292185.92"
"2025-03-31","2025-03-29","SF FuneralF842768       250329","","126.5","","1292312.42"
"2025-03-31","2025-03-29","SF FuneralF1112535      250330","","126.5","","1292438.92"
"2025-03-31","2025-03-28","SF FuneralFDC00000002WKX250328","","220","","1292658.92"
"2025-03-31","2025-03-28","SF FuneralFDC000000062FM250328","","126.5","","1292785.42"
"2025-03-31","2025-03-28","SF FuneralFDC000000066P4250328","","126.5","","1292911.92"
"2025-03-31","2025-03-28","SF FuneralFDC0000000672K250328","","126.5","","1293038.42"
"2025-03-31","2025-03-28","SF FuneralFDC000000067KH250328","","126.5","","1293164.92"
"2025-03-31","2025-03-28","SF FuneralFDC000000067RP250328","","126.5","","1293291.42"
"2025-03-31","2025-03-28","SF FuneralFDC00000006883250328","","126.5","","1293417.92"
"2025-03-31","2025-03-28","SF FuneralFDC000000069HQ250328","","126.5","","1293544.42"
"2025-03-31","2025-03-28","SF FuneralFDC000000069LW250328","","126.5","","1293670.92"
"2025-03-31","2025-03-28","SF FuneralFDC00000006BRV250328","","126.5","","1293797.42"
"2025-03-31","2025-03-28","SF FuneralFDC00000006H74250328","","126.5","","1293923.92"
"2025-03-31","2025-03-28","SF FuneralFDC00000006L3K250328","","126.5","","1294050.42"
"2025-03-31","2025-03-28","SF FuneralFDC00000006LP0250328","","278.31","","1294328.73"
"2025-03-31","2025-03-28","SF FuneralFDC00000006M31250328","","126.5","","1294455.23"
"2025-03-31","2025-03-28","SF FuneralFDC00000006ND6250328","","126.5","","1294581.73"
"2025-03-31","2025-03-28","SF FuneralFDC00000006P80250328","","126.5","","1294708.23"
"2025-03-31","2025-03-28","SF FuneralFDC00000006P8D250328","","126.5","","1294834.73"
"2025-03-31","2025-03-28","SF FuneralFDC00000006P9B250328","","126.5","","1294961.23"
"2025-03-31","2025-03-28","SF FuneralFDC00000006PSF250328","","31.63","","1294992.86"
"2025-03-31","2025-03-28","SF FuneralFDC00000006QDN250328","","126.5","","1295119.36"
"2025-03-31","2025-03-28","SF FuneralFDC00000006Y4Y250328","","126.5","","1295245.86"
"2025-03-31","2025-03-28","SF FuneralFDC00000007154250328","","126.5","","1295372.36"
"2025-03-31","2025-03-28","SF FuneralFDC000000074B2250328","","126.5","","1295498.86"
"2025-03-31","2025-03-28","SF FuneralFDC000000077RT250328","","126.5","","1295625.36"
"2025-03-31","2025-03-28","SF FuneralFDC000000078CV250328","","126.5","","1295751.86"
"2025-03-31","2025-03-28","SF FuneralFDC00000007G37250328","","126.5","","1295878.36"
"2025-03-31","2025-03-28","SF FuneralFDC00000007H00250328","","126.5","","1296004.86"
"2025-03-31","2025-03-28","SF FuneralFDC00000007MSD250328","","126.5","","1296131.36"
"2025-03-31","2025-03-28","SF FuneralF794329       250328","","126.5","","1296257.86"
"2025-03-31","2025-03-28","SF FuneralF798718       250328","","126.5","","1296384.36"
"2025-03-31","2025-03-28","SF FuneralF800095       250328","","126.5","","1296510.86"
"2025-03-31","2025-03-28","SF FuneralF800998       250328","","126.5","","1296637.36"
"2025-03-31","2025-03-28","SF FuneralF802467       250328","","126.5","","1296763.86"
"2025-03-31","2025-03-28","SF FuneralF808207       250328","","126.5","","1296890.36"
"2025-03-31","2025-03-28","SF FuneralF808585       250328","","126.5","","1297016.86"
"2025-03-31","2025-03-28","SF FuneralFDC0000000903V250328","","191.5","","1297208.36"
"2025-03-31","2025-03-28","SF FuneralFDC000000095QV250328","","126.5","","1297334.86"
"2025-03-31","2025-03-28","SF FuneralF814917       250328","","126.5","","1297461.36"
"2025-03-31","2025-03-28","SF FuneralF816501       250328","","126.5","","1297587.86"
"2025-03-31","2025-03-28","SF FuneralF817358       250328","","126.5","","1297714.36"
"2025-03-31","2025-03-28","SF FuneralF818394       250328","","126.5","","1297840.86"
"2025-03-31","2025-03-28","SF FuneralF818580       250328","","126.5","","1297967.36"
"2025-03-31","2025-03-28","SF FuneralF820078       250328","","126.5","","1298093.86"
"2025-03-31","2025-03-28","SF FuneralF822264       250328","","126.5","","1298220.36"
"2025-03-31","2025-03-28","SF FuneralF822267       250328","","31.63","","1298251.99"
"2025-03-31","2025-03-28","SF FuneralF824000       250328","","126.5","","1298378.49"
"2025-03-31","2025-03-28","SF FuneralF832898       250328","","126.5","","1298504.99"
"2025-03-31","2025-03-28","SF FuneralF847439       250328","","126.5","","1298631.49"
"2025-03-31","2025-03-28","SF FuneralF981746       250328","","126.5","","1298757.99"
"2025-03-31","2025-03-28","SF FuneralF988333       250328","","126.5","","1298884.49"
"2025-03-31","2025-03-28","SF FuneralF1021249      250328","","126.5","","1299010.99"
"2025-03-31","2025-03-28","SF FuneralF1022127      250328","","126.5","","1299137.49"
"2025-03-31","2025-03-28","SF FuneralF1065823      250328","","126.5","","1299263.99"
"2025-03-31","2025-03-28","SF FuneralFDC0000000L8B0250328","","31.63","","1299295.62"
"2025-03-31","2025-03-28","SF FuneralFDC0000000LH9B250328","","126.5","","1299422.12"
"2025-03-31","2025-03-28","SF FuneralF1083725      250328","","126.5","","1299548.62"
"2025-03-31","2025-03-28","SF FuneralF1083838      250328","","126.5","","1299675.12"
"2025-03-31","2025-03-28","SF FuneralF1084391      250328","","126.5","","1299801.62"
"2025-03-31","2025-03-28","SF FuneralF1096647      250328","","126.5","","1299928.12"
"2025-03-31","2025-03-28","SF FuneralF789357       250328","","256.5","","1300184.62"
"2025-03-31","2025-03-28","SF FuneralF1117169      250328","","126.5","","1300311.12"
"2025-03-31","2025-03-28","SF FuneralF1117197      250328","","126.5","","1300437.62"
"2025-03-31","2025-03-28","SF FuneralF1122327      250328","","126.5","","1300564.12"
"2025-03-31","2025-03-28","SF FuneralF1126874      250328","","31.63","","1300595.75"
"2025-03-31","2025-03-28","SF FuneralF1127634      250328","","126.5","","1300722.25"
"2025-03-31","2025-03-28","SF FuneralFDC0000000PV43250328","","126.5","","1300848.75"
"2025-03-31","2025-03-28","SF FuneralFDC0000000PV47250328","","126.5","","1300975.25"
"2025-03-31","2025-03-28","SF FuneralF1131985      250328","","126.5","","1301101.75"
"2025-03-31","2025-03-28","SF FuneralF1132523      250328","","126.5","","1301228.25"
"2025-03-31","2025-03-28","SF FuneralFDC0000000QD79250328","","126.5","","1301354.75"
"2025-03-31","2025-03-31","SF FuneralFDC00000007JXM250331","","126.5","","1301481.25"
"2025-03-31","2025-03-31","SF FuneralF814635       250330","","126.5","","1301607.75"
"2025-03-31","2025-03-22","SF FuneralF1021390      250322","","126.5","","1301734.25"
"2025-03-31","2025-03-27","SF FuneralFDC000000065NQ250327","","126.5","","1301860.75"
"2025-03-31","2025-03-27","SF FuneralF814212       250327","","126.5","","1301987.25"
"2025-03-31","2025-03-27","SF FuneralFDC0000000LBZ7250327","","126.5","","1302113.75"
"2025-03-31","2025-03-28","SF FuneralFDC00000006913250328","","126.5","","1302240.25"
"2025-03-31","2025-03-28","SF FuneralFDC00000007J3K250328","","126.5","","1302366.75"
"2025-03-31","2025-03-28","SF FuneralFDC00000007N2N250328","","126.5","","1302493.25"
"2025-03-31","2025-03-28","SF FuneralF800698       250328","","126.5","","1302619.75"
"2025-03-31","2025-03-28","SF FuneralFDC0000000CTBB250328","","126.5","","1302746.25"
"2025-03-31","2025-03-28","SF FuneralF833512       250328","","126.5","","1302872.75"
"2025-03-31","2025-03-28","SF FuneralF1079133      250328","","126.5","","1302999.25"
"2025-03-31","2025-03-26","SF FuneralF1021586      250326","","126.5","","1303125.75"
"2025-03-31","2025-03-28","SF FuneralFDC00000005RX5250328","","220","","1303345.75"
"2025-03-31","2025-03-28","SF FuneralFDC00000005S80250328","","126.5","","1303472.25"
"2025-03-31","2025-03-28","SF FuneralFDC00000005VPZ250328","","31.63","","1303503.88"
"2025-03-31","2025-03-28","SF FuneralFDC000000064DV250328","","126.5","","1303630.38"
"2025-03-31","2025-03-28","SF FuneralFDC000000065DL250328","","126.5","","1303756.88"
"2025-03-31","2025-03-28","SF FuneralFDC000000065JW250328","","126.5","","1303883.38"
"2025-03-31","2025-03-28","SF FuneralFDC000000065QV250328","","126.5","","1304009.88"
"2025-03-31","2025-03-28","SF FuneralFDC000000065TG250328","","126.5","","1304136.38"
"2025-03-31","2025-03-28","SF FuneralFDC0000000661H250328","","220","","1304356.38"
"2025-03-31","2025-03-28","SF FuneralFDC0000000662X250328","","126.5","","1304482.88"
"2025-03-31","2025-03-28","SF FuneralFDC00000006645250328","","220","","1304702.88"
"2025-03-31","2025-03-28","SF FuneralFDC000000066CJ250328","","126.5","","1304829.38"
"2025-03-31","2025-03-28","SF FuneralFDC0000000674F250328","","126.5","","1304955.88"
"2025-03-31","2025-03-28","SF FuneralFDC000000067QP250328","","126.5","","1305082.38"
"2025-03-31","2025-03-28","SF FuneralFDC00000006992250328","","126.5","","1305208.88"
"2025-03-31","2025-03-28","SF FuneralFDC0000000699F250328","","126.5","","1305335.38"
"2025-03-31","2025-03-28","SF FuneralFDC00000006B68250328","","126.5","","1305461.88"
"2025-03-31","2025-03-28","SF FuneralFDC00000006C6V250328","","126.5","","1305588.38"
"2025-03-31","2025-03-28","SF FuneralFDC00000006CC3250328","","126.5","","1305714.88"
"2025-03-31","2025-03-28","SF FuneralFDC00000006K8P250328","","126.5","","1305841.38"
"2025-03-31","2025-03-28","SF FuneralFDC00000006PY2250328","","126.5","","1305967.88"
"2025-03-31","2025-03-28","SF FuneralFDC00000006XWL250328","","126.5","","1306094.38"
"2025-03-31","2025-03-28","SF FuneralFDC00000006Z6M250328","","126.5","","1306220.88"
"2025-03-31","2025-03-28","SF FuneralFDC0000000744Y250328","","126.5","","1306347.38"
"2025-03-31","2025-03-28","SF FuneralFDC000000077B5250328","","126.5","","1306473.88"
"2025-03-31","2025-03-28","SF FuneralFDC00000007B73250328","","126.5","","1306600.38"
"2025-03-31","2025-03-28","SF FuneralFDC00000007FRV250328","","126.5","","1306726.88"
"2025-03-31","2025-03-28","SF FuneralF799413       250328","","126.5","","1306853.38"
"2025-03-31","2025-03-28","SF FuneralF809564       250328","","126.5","","1306979.88"
"2025-03-31","2025-03-28","SF FuneralF810323       250328","","126.5","","1307106.38"
"2025-03-31","2025-03-28","SF FuneralF818916       250328","","126.5","","1307232.88"
"2025-03-31","2025-03-28","SF FuneralF820063       250328","","126.5","","1307359.38"
"2025-03-31","2025-03-28","SF FuneralFDC0000000B86P250328","","126.5","","1307485.88"
"2025-03-31","2025-03-28","SF FuneralF821927       250328","","31.63","","1307517.51"
"2025-03-31","2025-03-28","SF FuneralFDC0000000CHK6250328","","126.5","","1307644.01"
"2025-03-31","2025-03-28","SF FuneralF832653       250328","","126.5","","1307770.51"
"2025-03-31","2025-03-28","SF FuneralF833108       250328","","126.5","","1307897.01"
"2025-03-31","2025-03-28","SF FuneralF877822       250328","","126.5","","1308023.51"
"2025-03-31","2025-03-28","SF FuneralF981095       250328","","126.5","","1308150.01"
"2025-03-31","2025-03-28","SF FuneralF1017586      250328","","126.5","","1308276.51"
"2025-03-31","2025-03-28","SF FuneralFDC0000000JM3K250328","","126.5","","1308403.01"
"2025-03-31","2025-03-28","SF FuneralF1085402      250328","","126.5","","1308529.51"
"2025-03-31","2025-03-28","SF FuneralFDC0000000MRWF250328","","126.5","","1308656.01"
"2025-03-31","2025-03-28","SF FuneralFDC0000000MRWM250328","","126.5","","1308782.51"
"2025-03-31","2025-03-28","SF FuneralFDC0000000MTK6250328","","126.5","","1308909.01"
"2025-03-31","2025-03-28","SF FuneralF1123167      250328","","31.63","","1308940.64"
"2025-03-31","2025-03-28","SF FuneralF784609       250328","","126.5","","1309067.14"
"2025-03-31","2025-03-28","SF FuneralFDC0000000PK37250328","","126.5","","1309193.64"
"2025-03-31","2025-03-28","SF FuneralF1126836      250328","","126.5","","1309320.14"
"2025-03-31","2025-03-28","SF FuneralFDC0000000PVCT250328","","126.5","","1309446.64"
"2025-03-31","2025-03-28","SF FuneralF1115022      250328","","126.5","","1309573.14"
"2025-03-31","2025-03-28","SF FuneralF1134009      250328","","126.5","","1309699.64"
"2025-03-31","2025-03-28","SF FuneralF1134491      250328","","31.63","","1309731.27"
"2025-03-31","2025-03-28","SF FuneralF1134931      250328","","126.5","","1309857.77"
"2025-03-31","2025-03-27","SF FuneralFDC000000032HT250327","","220","","1310077.77"
"2025-03-31","2025-03-27","SF FuneralFDC00000003L05250327","","220","","1310297.77"
"2025-03-31","2025-03-27","SF FuneralFDC00000005FB2250327","","126.5","","1310424.27"
"2025-03-31","2025-03-27","SF FuneralFDC00000005H8T250327","","126.5","","1310550.77"
"2025-03-31","2025-03-27","SF FuneralFDC00000005MQK250327","","126.5","","1310677.27"
"2025-03-31","2025-03-27","SF FuneralFDC000000065M0250327","","126.5","","1310803.77"
"2025-03-31","2025-03-27","SF FuneralF802156       250327","","126.5","","1310930.27"
"2025-03-31","2025-03-27","SF FuneralFDC00000008LW0250327","","126.5","","1311056.77"
"2025-03-31","2025-03-27","SF FuneralF808124       250327","","126.5","","1311183.27"
"2025-03-31","2025-03-27","SF FuneralF823197       250327","","126.5","","1311309.77"
"2025-03-31","2025-03-27","SF FuneralF824003       250327","","126.5","","1311436.27"
"2025-03-31","2025-03-27","SF FuneralFDC0000000BVXT250327","","126.5","","1311562.77"
"2025-03-31","2025-03-27","SF FuneralF832507       250327","","126.5","","1311689.27"
"2025-03-31","2025-03-27","SF FuneralF833514       250327","","126.5","","1311815.77"
"2025-03-31","2025-03-27","SF FuneralF834832       250327","","126.5","","1311942.27"
"2025-03-31","2025-03-27","SF FuneralF841173       250327","","126.5","","1312068.77"
"2025-03-31","2025-03-27","SF FuneralF843372       250327","","126.5","","1312195.27"
"2025-03-31","2025-03-27","SF FuneralF988360       250327","","126.5","","1312321.77"
"2025-03-31","2025-03-27","SF FuneralF1060356      250327","","126.5","","1312448.27"
"2025-03-31","2025-03-27","SF FuneralF1074892      250327","","126.5","","1312574.77"
"2025-03-31","2025-03-27","SF FuneralF1084991      250327","","126.5","","1312701.27"
"2025-03-31","2025-03-27","SF FuneralFDC0000000MVRW250327","","126.5","","1312827.77"
"2025-03-31","2025-03-27","SF FuneralF1112373      250327","","126.5","","1312954.27"
"2025-03-31","2025-03-31","SF FuneralFDC00000008JNH250330","","126.5","","1313080.77"
"2025-03-31","2025-03-31","SF FuneralFDC00000008KX0250331","","31.63","","1313112.4"
"2025-03-31","2025-03-31","SF FuneralF987157       250331","","63.25","","1313175.65"
"2025-03-31","2025-03-31","SF FuneralFDC000000070CJ250331","","31.63","","1313207.28"
"2025-03-31","2025-03-31","SF FuneralFDC000000073MF250331","","126.5","","1313333.78"
"2025-03-31","2025-03-31","SF FuneralFDC000000076F0250331","","126.5","","1313460.28"
"2025-03-31","2025-03-31","SF FuneralFDC00000007GXS250331","","31.63","","1313491.91"
"2025-03-31","2025-03-25","SF FuneralF794462       250325","","126.5","","1313618.41"
"2025-03-31","2025-03-25","SF FuneralF1130852      250325","","126.5","","1313744.91"
"2025-03-31","2025-03-24","SF FuneralFDC00000006892250324","","126.5","","1313871.41"
"2025-03-31","2025-03-29","SF FuneralFDC00000002YZ9250329","","220","","1314091.41"
"2025-03-31","2025-03-29","SF FuneralFDC0000000NJNG250329","","126.5","","1314217.91"
"2025-03-31","2025-03-29","SF FuneralFDC0000000NJNK250329","","126.5","","1314344.41"
"2025-03-31","2025-03-29","SF FuneralFDC0000000PK90250329","","126.5","","1314470.91"
"2025-03-31","2025-03-31","SF FuneralFDC0000000MR2H250331","","31.63","","1314502.54"
"2025-03-31","2025-03-31","SF FuneralFDC0000000496P250331","","220","","1314722.54"
"2025-03-31","2025-03-31","SF FuneralFDC000000089G2250330","","31.63","","1314754.17"
"2025-03-31","2025-03-31","SF FuneralF900674       250329","","126.5","","1314880.67"
"2025-03-31","2025-03-31","SF FuneralFDC00000002XYZ250330","","55","","1314935.67"
"2025-03-31","2025-03-31","SF FuneralFDC0000000HS6H250331","","31.63","","1314967.3"
"2025-03-31","2025-03-31","SF FuneralF1127801      250331","","31.63","","1314998.93"
"2025-03-31","2025-03-31","SF FuneralF1133144      250331","","63.25","","1315062.18"
"2025-03-31","2025-03-22","SF FuneralFDC000000032DV250322","","220","","1315282.18"
"2025-03-31","2025-03-22","SF FuneralFDC00000003378250322","","110","","1315392.18"
"2025-03-31","2025-03-22","SF FuneralFDC00000005ZR9250322","","126.5","","1315518.68"
"2025-03-31","2025-03-22","SF FuneralFDC000000060Z5250322","","126.5","","1315645.18"
"2025-03-31","2025-03-22","SF FuneralFDC000000062H2250322","","126.5","","1315771.68"
"2025-03-31","2025-03-22","SF FuneralF798526       250322","","126.5","","1315898.18"
"2025-03-31","2025-03-22","SF FuneralF827801       250322","","126.5","","1316024.68"
"2025-03-31","2025-03-22","SF FuneralF831560       250322","","126.5","","1316151.18"
"2025-03-31","2025-03-22","SF FuneralF1127847      250323","","63.25","","1316214.43"
"2025-03-31","2025-03-26","SF FuneralFDC00000005J71250326","","126.5","","1316340.93"
"2025-03-31","2025-03-26","SF FuneralF823256       250326","","126.5","","1316467.43"
"2025-03-31","2025-03-26","SF FuneralF828827       250326","","126.5","","1316593.93"
"2025-03-31","2025-03-26","SF FuneralF842812       250326","","126.5","","1316720.43"
"2025-03-31","2025-03-26","SF FuneralFDC0000000H1YY250326","","126.5","","1316846.93"
"2025-03-31","2025-03-26","SF FuneralF988623       250326","","126.5","","1316973.43"
"2025-03-31","2025-03-26","SF FuneralF991031       250326","","126.5","","1317099.93"
"2025-03-31","2025-03-26","SF FuneralF992012       250326","","126.5","","1317226.43"
"2025-03-31","2025-03-26","SF FuneralF992484       250326","","126.5","","1317352.93"
"2025-03-31","2025-03-26","SF FuneralFDC0000000J997250326","","126.5","","1317479.43"
"2025-03-31","2025-03-26","SF FuneralF1132803      250326","","126.5","","1317605.93"
"2025-03-31","2025-03-25","SF FuneralF1131788      250325","","126.5","","1317732.43"
"2025-03-31","2025-03-27","SF FuneralFDC00000002XV8250327","","220","","1317952.43"
"2025-03-31","2025-03-27","SF FuneralFDC00000003219250327","","220","","1318172.43"
"2025-03-31","2025-03-27","SF FuneralFDC000000032C0250327","","220","","1318392.43"
"2025-03-31","2025-03-27","SF FuneralFDC000000032G9250327","","220","","1318612.43"
"2025-03-31","2025-03-27","SF FuneralFDC000000032PX250327","","220","","1318832.43"
"2025-03-31","2025-03-27","SF FuneralFDC0000000351X250327","","220","","1319052.43"
"2025-03-31","2025-03-27","SF FuneralFDC00000003CY8250327","","220","","1319272.43"
"2025-03-31","2025-03-27","SF FuneralFDC00000003K0N250327","","220","","1319492.43"
"2025-03-31","2025-03-27","SF FuneralFDC00000003ML6250327","","220","","1319712.43"
"2025-03-31","2025-03-27","SF FuneralFDC00000004BXQ250327","","220","","1319932.43"
"2025-03-31","2025-03-27","SF FuneralFDC000000058VQ250327","","126","","1320058.43"
"2025-03-31","2025-03-27","SF FuneralF797873       250327","","126.5","","1320184.93"
"2025-03-31","2025-03-27","SF FuneralFDC000000085XL250327","","126.5","","1320311.43"
"2025-03-31","2025-03-27","SF FuneralF803758       250327","","126.5","","1320437.93"
"2025-03-31","2025-03-27","SF FuneralF1108571      250327","","126.5","","1320564.43"
"2025-03-31","2025-03-27","SF FuneralF1111585      250327","","126.5","","1320690.93"
"2025-03-31","2025-03-27","SF FuneralF1120755      250327","","126.5","","1320817.43"
"2025-03-31","2025-03-27","SF FuneralF1126118      250327","","126.5","","1320943.93"
"2025-03-31","2025-03-29","SF FuneralFDC00000005MRB250329","","126.5","","1321070.43"
"2025-03-31","2025-03-29","SF FuneralFDC000000068BH250329","","126.5","","1321196.93"
"2025-03-31","2025-03-29","SF FuneralFDC00000006JT4250329","","126.5","","1321323.43"
"2025-03-31","2025-03-29","SF FuneralFDC00000006YY0250329","","126.5","","1321449.93"
"2025-03-31","2025-03-29","SF FuneralF1074580      250329","","63.25","","1321513.18"
"2025-03-31","2025-03-29","SF FuneralF1084548      250329","","126.5","","1321639.68"
"2025-03-31","2025-03-29","SF FuneralFDC0000000MC56250329","","126.5","","1321766.18"
"2025-03-31","2025-03-29","SF FuneralF1128069      250329","","126.5","","1321892.68"
"2025-03-31","2025-03-29","SF FuneralFDC0000000QJVG250330","","126.5","","1322019.18"
"2025-03-31","2025-03-28","SF FuneralFDC00000002RBG250328","","220","","1322239.18"
"2025-03-31","2025-03-28","SF FuneralFDC00000002TX8250328","","220","","1322459.18"
"2025-03-31","2025-03-28","SF FuneralFDC00000002TYK250328","","220","","1322679.18"
"2025-03-31","2025-03-28","SF FuneralFDC00000002WRT250328","","220","","1322899.18"
"2025-03-31","2025-03-28","SF FuneralFDC0000000347L250328","","220","","1323119.18"
"2025-03-31","2025-03-28","SF FuneralFDC00000004015250328","","220","","1323339.18"
"2025-03-31","2025-03-28","SF FuneralFDC00000004ZSB250328","","220","","1323559.18"
"2025-03-31","2025-03-28","SF FuneralFDC00000005N21250328","","126.5","","1323685.68"
"2025-03-31","2025-03-28","SF FuneralFDC00000005Q4G250328","","126.5","","1323812.18"
"2025-03-31","2025-03-28","SF FuneralFDC00000005QKT250328","","126.5","","1323938.68"
"2025-03-31","2025-03-28","SF FuneralFDC00000005SMG250328","","126.5","","1324065.18"
"2025-03-31","2025-03-28","SF FuneralFDC00000005T5H250328","","220","","1324285.18"
"2025-03-31","2025-03-28","SF FuneralFDC00000005XCF250328","","220","","1324505.18"
"2025-03-31","2025-03-28","SF FuneralFDC00000005XRK250328","","126.5","","1324631.68"
"2025-03-31","2025-03-28","SF FuneralFDC000000065HV250328","","126.5","","1324758.18"
"2025-03-31","2025-03-28","SF FuneralFDC000000065P3250328","","126.5","","1324884.68"
"2025-03-31","2025-03-28","SF FuneralFDC000000066DQ250328","","126.5","","1325011.18"
"2025-03-31","2025-03-28","SF FuneralFDC000000066NX250328","","126.5","","1325137.68"
"2025-03-31","2025-03-28","SF FuneralFDC000000066T3250328","","126.5","","1325264.18"
"2025-03-31","2025-03-28","SF FuneralFDC000000067FB250328","","126.5","","1325390.68"
"2025-03-31","2025-03-28","SF FuneralFDC000000067L0250328","","126.5","","1325517.18"
"2025-03-31","2025-03-28","SF FuneralFDC000000067PJ250328","","126.5","","1325643.68"
"2025-03-31","2025-03-28","SF FuneralFDC000000067SK250328","","126.5","","1325770.18"
"2025-03-31","2025-03-28","SF FuneralFDC0000000687B250328","","126.5","","1325896.68"
"2025-03-31","2025-03-28","SF FuneralFDC000000068NP250328","","126.5","","1326023.18"
"2025-03-31","2025-03-28","SF FuneralFDC000000069M7250328","","126.5","","1326149.68"
"2025-03-31","2025-03-28","SF FuneralFDC00000006BTS250328","","126.5","","1326276.18"
"2025-03-31","2025-03-28","SF FuneralFDC00000006CFC250328","","126.5","","1326402.68"
"2025-03-31","2025-03-28","SF FuneralFDC00000006GY3250328","","126.5","","1326529.18"
"2025-03-31","2025-03-28","SF FuneralFDC00000006JY2250328","","126.5","","1326655.68"
"2025-03-31","2025-03-28","SF FuneralFDC00000006KHS250328","","126.5","","1326782.18"
"2025-03-31","2025-03-28","SF FuneralFDC00000006KQ7250328","","126.5","","1326908.68"
"2025-03-31","2025-03-28","SF FuneralFDC00000006KVT250328","","126.5","","1327035.18"
"2025-03-31","2025-03-28","SF FuneralFDC00000006LM8250328","","126.5","","1327161.68"
"2025-03-31","2025-03-28","SF FuneralFDC00000006MDP250328","","126.5","","1327288.18"
"2025-03-31","2025-03-28","SF FuneralFDC00000006NS2250328","","126.5","","1327414.68"
"2025-03-31","2025-03-28","SF FuneralFDC00000006QZT250328","","126.5","","1327541.18"
"2025-03-31","2025-03-28","SF FuneralFDC00000006X2F250328","","126.5","","1327667.68"
"2025-03-31","2025-03-28","SF FuneralFDC00000006Y7V250328","","220","","1327887.68"
"2025-03-31","2025-03-28","SF FuneralFDC00000006YD5250328","","126.5","","1328014.18"
"2025-03-31","2025-03-28","SF FuneralFDC000000073RL250328","","126.5","","1328140.68"
"2025-03-31","2025-03-28","SF FuneralFDC000000073VJ250328","","126.5","","1328267.18"
"2025-03-31","2025-03-28","SF FuneralFDC000000075FY250328","","126.5","","1328393.68"
"2025-03-31","2025-03-28","SF FuneralFDC00000007684250328","","126.5","","1328520.18"
"2025-03-31","2025-03-28","SF FuneralFDC0000000768V250328","","126.5","","1328646.68"
"2025-03-31","2025-03-28","SF FuneralFDC00000007769250328","","126.5","","1328773.18"
"2025-03-31","2025-03-28","SF FuneralFDC000000077MM250328","","126.5","","1328899.68"
"2025-03-31","2025-03-28","SF FuneralFDC000000078DX250328","","126.5","","1329026.18"
"2025-03-31","2025-03-28","SF FuneralFDC00000007974250328","","126.5","","1329152.68"
"2025-03-31","2025-03-28","SF FuneralFDC000000079ZB250328","","126.5","","1329279.18"
"2025-03-31","2025-03-28","SF FuneralFDC00000007G9J250328","","191.5","","1329470.68"
"2025-03-31","2025-03-28","SF FuneralFDC00000007NYN250328","","126.5","","1329597.18"
"2025-03-31","2025-03-28","SF FuneralF793709       250328","","126.5","","1329723.68"
"2025-03-31","2025-03-28","SF FuneralFDC00000007R4C250328","","126.5","","1329850.18"
"2025-03-31","2025-03-28","SF FuneralFDC00000007R7B250328","","126.5","","1329976.68"
"2025-03-31","2025-03-28","SF FuneralFDC00000007ZQV250328","","126.5","","1330103.18"
"2025-03-31","2025-03-28","SF FuneralFDC0000000823T250328","","126.5","","1330229.68"
"2025-03-31","2025-03-28","SF FuneralFDC000000083GM250328","","126.5","","1330356.18"
"2025-03-31","2025-03-28","SF FuneralFDC000000083M9250328","","126.5","","1330482.68"
"2025-03-31","2025-03-28","SF FuneralF798755       250328","","126.5","","1330609.18"
"2025-03-31","2025-03-28","SF FuneralF798835       250328","","126.5","","1330735.68"
"2025-03-31","2025-03-28","SF FuneralF801420       250328","","126.5","","1330862.18"
"2025-03-31","2025-03-28","SF FuneralF804570       250328","","126.5","","1330988.68"
"2025-03-31","2025-03-28","SF FuneralFDC00000008TZM250328","","126.5","","1331115.18"
"2025-03-31","2025-03-28","SF FuneralF808133       250328","","126.5","","1331241.68"
"2025-03-31","2025-03-28","SF FuneralF808337       250328","","126.5","","1331368.18"
"2025-03-31","2025-03-28","SF FuneralF809024       250328","","126.5","","1331494.68"
"2025-03-31","2025-03-28","SF FuneralF787800       250328","","126.5","","1331621.18"
"2025-03-31","2025-03-28","SF FuneralF809167       250328","","126.5","","1331747.68"
"2025-03-31","2025-03-28","SF FuneralF809852       250328","","126.5","","1331874.18"
"2025-03-31","2025-03-28","SF FuneralF809981       250328","","126.5","","1332000.68"
"2025-03-31","2025-03-28","SF FuneralF810187       250328","","126.5","","1332127.18"
"2025-03-31","2025-03-28","SF FuneralF810517       250328","","126.5","","1332253.68"
"2025-03-31","2025-03-28","SF FuneralFDC000000096RC250328","","126.5","","1332380.18"
"2025-03-31","2025-03-28","SF FuneralFDC00000009C5X250328","","126.5","","1332506.68"
"2025-03-31","2025-03-28","SF FuneralFDC00000009H0N250328","","126.5","","1332633.18"
"2025-03-31","2025-03-28","SF FuneralFDC00000009P9Q250328","","126.5","","1332759.68"
"2025-03-31","2025-03-28","SF FuneralF815954       250328","","126.5","","1332886.18"
"2025-03-31","2025-03-28","SF FuneralF816350       250328","","126.5","","1333012.68"
"2025-03-31","2025-03-28","SF FuneralF816546       250328","","126.5","","1333139.18"
"2025-03-31","2025-03-28","SF FuneralF816559       250328","","126.5","","1333265.68"
"2025-03-31","2025-03-28","SF FuneralF817829       250328","","126.5","","1333392.18"
"2025-03-31","2025-03-28","SF FuneralF818008       250328","","126.5","","1333518.68"
"2025-03-31","2025-03-28","SF FuneralF819984       250328","","126.5","","1333645.18"
"2025-03-31","2025-03-28","SF FuneralF820139       250328","","126.5","","1333771.68"
"2025-03-31","2025-03-28","SF FuneralFDC0000000B89Y250328","","126.5","","1333898.18"
"2025-03-31","2025-03-28","SF FuneralFDC0000000B8LB250328","","126.5","","1334024.68"
"2025-03-31","2025-03-28","SF FuneralFDC0000000B8MC250328","","126.5","","1334151.18"
"2025-03-31","2025-03-28","SF FuneralF822558       250328","","126.5","","1334277.68"
"2025-03-31","2025-03-28","SF FuneralF830449       250328","","126.5","","1334404.18"
"2025-03-31","2025-03-28","SF FuneralF832095       250328","","126.5","","1334530.68"
"2025-03-31","2025-03-28","SF FuneralF833074       250328","","126.5","","1334657.18"
"2025-03-31","2025-03-28","SF FuneralFDC0000000CRTH250328","","126.5","","1334783.68"
"2025-03-31","2025-03-28","SF FuneralFDC0000000CRTK250328","","126.5","","1334910.18"
"2025-03-31","2025-03-28","SF FuneralF833681       250328","","126.5","","1335036.68"
"2025-03-31","2025-03-28","SF FuneralF834365       250328","","126.5","","1335163.18"
"2025-03-31","2025-03-28","SF FuneralF834676       250328","","126.5","","1335289.68"
"2025-03-31","2025-03-28","SF FuneralF834926       250328","","126.5","","1335416.18"
"2025-03-31","2025-03-28","SF FuneralF842166       250328","","126.5","","1335542.68"
"2025-03-31","2025-03-28","SF FuneralF843435       250328","","126.5","","1335669.18"
"2025-03-31","2025-03-28","SF FuneralF900959       250328","","126.5","","1335795.68"
"2025-03-31","2025-03-28","SF FuneralF987101       250328","","126.5","","1335922.18"
"2025-03-31","2025-03-28","SF FuneralF988159       250328","","126.5","","1336048.68"
"2025-03-31","2025-03-28","SF FuneralF988770       250328","","126.5","","1336175.18"
"2025-03-31","2025-03-28","SF FuneralF989166       250328","","126.5","","1336301.68"
"2025-03-31","2025-03-28","SF FuneralF990158       250328","","126.5","","1336428.18"
"2025-03-31","2025-03-28","SF FuneralF990444       250328","","126.5","","1336554.68"
"2025-03-31","2025-03-28","SF FuneralFDC0000000JL2V250328","","191.5","","1336746.18"
"2025-03-31","2025-03-28","SF FuneralF1020822      250328","","126.5","","1336872.68"
"2025-03-31","2025-03-28","SF FuneralF1020824      250328","","126.5","","1336999.18"
"2025-03-31","2025-03-28","SF FuneralF1020871      250328","","126.5","","1337125.68"
"2025-03-31","2025-03-28","SF FuneralF1021287      250328","","126.5","","1337252.18"
"2025-03-31","2025-03-28","SF FuneralF1021329      250328","","126.5","","1337378.68"
"2025-03-31","2025-03-28","SF FuneralFDC0000000JW31250328","","126.5","","1337505.18"
"2025-03-31","2025-03-28","SF FuneralF802366       250328","","126.5","","1337631.68"
"2025-03-31","2025-03-28","SF FuneralF1062730      250328","","126.5","","1337758.18"
"2025-03-31","2025-03-28","SF FuneralF1066047      250328","","256.5","","1338014.68"
"2025-03-31","2025-03-28","SF FuneralFDC0000000KTDL250328","","126.5","","1338141.18"
"2025-03-31","2025-03-28","SF FuneralF1066373      250328","","126.5","","1338267.68"
"2025-03-31","2025-03-28","SF FuneralF1067945      250328","","126.5","","1338394.18"
"2025-03-31","2025-03-28","SF FuneralF1072713      250328","","126.5","","1338520.68"
"2025-03-31","2025-03-28","SF FuneralFDC0000000L06D250328","","126.5","","1338647.18"
"2025-03-31","2025-03-28","SF FuneralF1073165      250328","","126.5","","1338773.68"
"2025-03-31","2025-03-28","SF FuneralF1073290      250328","","126.5","","1338900.18"
"2025-03-31","2025-03-28","SF FuneralF1084004      250328","","126.5","","1339026.68"
"2025-03-31","2025-03-28","SF FuneralF1084161      250328","","126.5","","1339153.18"
"2025-03-31","2025-03-28","SF FuneralF1102885      250328","","126.5","","1339279.68"
"2025-03-31","2025-03-28","SF FuneralFDC0000000M91K250328","","126.5","","1339406.18"
"2025-03-31","2025-03-28","SF FuneralF841180       250328","","126.5","","1339532.68"
"2025-03-31","2025-03-28","SF FuneralF1108580      250328","","126.5","","1339659.18"
"2025-03-31","2025-03-28","SF FuneralF1108671      250328","","126.5","","1339785.68"
"2025-03-31","2025-03-28","SF FuneralF1108772      250328","","126.5","","1339912.18"
"2025-03-31","2025-03-28","SF FuneralF1108809      250328","","126.5","","1340038.68"
"2025-03-31","2025-03-28","SF FuneralF1109691      250328","","126.5","","1340165.18"
"2025-03-31","2025-03-28","SF FuneralFDC0000000MLFC250328","","126.5","","1340291.68"
"2025-03-31","2025-03-28","SF FuneralF1114080      250328","","126.5","","1340418.18"
"2025-03-31","2025-03-28","SF FuneralF1113159      250328","","191.5","","1340609.68"
"2025-03-31","2025-03-28","SF FuneralF1117361      250328","","126.5","","1340736.18"
"2025-03-31","2025-03-28","SF FuneralF1117424      250328","","126.5","","1340862.68"
"2025-03-31","2025-03-28","SF FuneralF1118486      250328","","126.5","","1340989.18"
"2025-03-31","2025-03-28","SF FuneralFDC0000000NPHB250328","","126.5","","1341115.68"
"2025-03-31","2025-03-28","SF FuneralF1118861      250328","","126.5","","1341242.18"
"2025-03-31","2025-03-28","SF FuneralF1119869      250328","","126.5","","1341368.68"
"2025-03-31","2025-03-28","SF FuneralF1120883      250328","","126.5","","1341495.18"
"2025-03-31","2025-03-28","SF FuneralFDC0000000P529250328","","126.5","","1341621.68"
"2025-03-31","2025-03-28","SF FuneralFDC0000000P52F250328","","126.5","","1341748.18"
"2025-03-31","2025-03-28","SF FuneralF1124617      250328","","126.5","","1341874.68"
"2025-03-31","2025-03-28","SF FuneralF1125016      250328","","126.5","","1342001.18"
"2025-03-31","2025-03-28","SF FuneralF1125300      250328","","126.5","","1342127.68"
"2025-03-31","2025-03-28","SF FuneralF1126073      250328","","126.5","","1342254.18"
"2025-03-31","2025-03-28","SF FuneralFDC0000000PL33250328","","126.5","","1342380.68"
"2025-03-31","2025-03-28","SF FuneralF1126831      250328","","126.5","","1342507.18"
"2025-03-31","2025-03-28","SF FuneralF796263       250328","","213.31","","1342720.49"
"2025-03-31","2025-03-28","SF FuneralFDC0000000PPFH250328","","126.5","","1342846.99"
"2025-03-31","2025-03-28","SF FuneralFDC0000000PRNZ250328","","126.5","","1342973.49"
"2025-03-31","2025-03-28","SF FuneralF1127742      250328","","126.5","","1343099.99"
"2025-03-31","2025-03-28","SF FuneralFDC0000000PRVZ250328","","126.5","","1343226.49"
"2025-03-31","2025-03-28","SF FuneralFDC0000000PSD4250328","","126.5","","1343352.99"
"2025-03-31","2025-03-28","SF FuneralF1127816      250328","","126.5","","1343479.49"
"2025-03-31","2025-03-28","SF FuneralF1127840      250328","","126.5","","1343605.99"
"2025-03-31","2025-03-28","SF FuneralF1127849      250328","","126.5","","1343732.49"
"2025-03-31","2025-03-28","SF FuneralF1127853      250328","","126.5","","1343858.99"
"2025-03-31","2025-03-28","SF FuneralF1127930      250328","","126.5","","1343985.49"
"2025-03-31","2025-03-28","SF FuneralF1128155      250328","","126.5","","1344111.99"
"2025-03-31","2025-03-28","SF FuneralF1128909      250328","","126.5","","1344238.49"
"2025-03-31","2025-03-28","SF FuneralF1129363      250328","","126.5","","1344364.99"
"2025-03-31","2025-03-28","SF FuneralF1131916      250328","","126.5","","1344491.49"
"2025-03-31","2025-03-28","SF FuneralF1133521      250328","","126.5","","1344617.99"
"2025-03-31","2025-03-28","SF FuneralF1133569      250328","","126.5","","1344744.49"
"2025-03-31","2025-03-28","SF FuneralF1133807      250328","","126.5","","1344870.99"
"2025-03-31","2025-03-28","SF FuneralF1133857      250328","","126.5","","1344997.49"
"2025-03-31","2025-03-28","SF FuneralFDC0000000QH0S250328","","126.5","","1345123.99"
"2025-03-31","2025-03-28","SF FuneralF1134754      250328","","126.5","","1345250.49"
"2025-03-31","2025-03-28","SF FuneralF1134855      250328","","126.5","","1345376.99"
"2025-03-31","2025-03-28","SF FuneralFDC0000000QLT8250328","","63.25","","1345440.24"
"2025-03-31","2025-03-28","SF FuneralFDC0000000QLT9250328","","63.25","","1345503.49"
"2025-03-31","2025-03-28","SF FuneralF1135569      250328","","126.5","","1345629.99"
"2025-03-31","2025-03-28","SF FuneralFDC00000005GY1250328","","31.63","","1345661.62"
"2025-03-31","2025-03-28","SF FuneralFDC00000005PXF250328","","31.63","","1345693.25"
"2025-03-31","2025-03-28","SF FuneralFDC00000005V4S250328","","31.63","","1345724.88"
"2025-03-31","2025-03-28","SF FuneralFDC000000069RZ250328","","31.63","","1345756.51"
"2025-03-31","2025-03-28","SF FuneralFDC00000006R81250328","","31.63","","1345788.14"
"2025-03-31","2025-03-28","SF FuneralFDC00000007MW5250328","","31.63","","1345819.77"
"2025-03-31","2025-03-28","SF FuneralFDC00000007WBL250328","","31.63","","1345851.4"
"2025-03-31","2025-03-28","SF FuneralFDC00000007WJL250328","","31.63","","1345883.03"
"2025-03-31","2025-03-28","SF FuneralF795812       250328","","31.63","","1345914.66"
"2025-03-31","2025-03-28","SF FuneralFDC000000086Y9250328","","31.63","","1345946.29"
"2025-03-31","2025-03-28","SF FuneralF790399       250328","","47.88","","1345994.17"
"2025-03-31","2025-03-28","SF FuneralF811119       250328","","31.63","","1346025.8"
"2025-03-31","2025-03-28","SF FuneralF813030       250328","","31.63","","1346057.43"
"2025-03-31","2025-03-28","SF FuneralF814303       250328","","31.63","","1346089.06"
"2025-03-31","2025-03-28","SF FuneralF815340       250328","","31.63","","1346120.69"
"2025-03-31","2025-03-28","SF FuneralF817463       250328","","31.63","","1346152.32"
"2025-03-31","2025-03-28","SF FuneralF817655       250328","","31.63","","1346183.95"
"2025-03-31","2025-03-28","SF FuneralF819497       250328","","31.63","","1346215.58"
"2025-03-31","2025-03-28","SF FuneralF823750       250328","","31.63","","1346247.21"
"2025-03-31","2025-03-28","SF FuneralF829118       250328","","31.63","","1346278.84"
"2025-03-31","2025-03-28","SF FuneralF830931       250328","","31.63","","1346310.47"
"2025-03-31","2025-03-28","SF FuneralF832185       250328","","31.63","","1346342.1"
"2025-03-31","2025-03-28","SF FuneralF832777       250328","","31.63","","1346373.73"
"2025-03-31","2025-03-28","SF FuneralF819053       250328","","31.63","","1346405.36"
"2025-03-31","2025-03-28","SF FuneralF843596       250328","","31.63","","1346436.99"
"2025-03-31","2025-03-28","SF FuneralFDC0000000FQWF250328","","31.63","","1346468.62"
"2025-03-31","2025-03-28","SF FuneralF844636       250328","","31.63","","1346500.25"
"2025-03-31","2025-03-28","SF FuneralF774474       250328","","156.28","","1346656.53"
"2025-03-31","2025-03-28","SF FuneralF986934       250328","","31.63","","1346688.16"
"2025-03-31","2025-03-28","SF FuneralF992752       250328","","31.63","","1346719.79"
"2025-03-31","2025-03-28","SF FuneralF993205       250328","","31.63","","1346751.42"
"2025-03-31","2025-03-28","SF FuneralF993478       250328","","31.63","","1346783.05"
"2025-03-31","2025-03-28","SF FuneralFDC0000000JFC4250328","","31.63","","1346814.68"
"2025-03-31","2025-03-28","SF FuneralF1052348      250328","","31.63","","1346846.31"
"2025-03-31","2025-03-28","SF FuneralFDC0000000K7CQ250328","","31.63","","1346877.94"
"2025-03-31","2025-03-28","SF FuneralFDC0000000KLCD250328","","31.63","","1346909.57"
"2025-03-31","2025-03-28","SF FuneralF1061613      250328","","31.63","","1346941.2"
"2025-03-31","2025-03-28","SF FuneralF1068145      250328","","31.63","","1346972.83"
"2025-03-31","2025-03-28","SF FuneralF1072884      250328","","31.63","","1347004.46"
"2025-03-31","2025-03-28","SF FuneralF1073030      250328","","31.63","","1347036.09"
"2025-03-31","2025-03-28","SF FuneralFDC0000000L3MT250328","","31.63","","1347067.72"
"2025-03-31","2025-03-28","SF FuneralF1085355      250328","","31.63","","1347099.35"
"2025-03-31","2025-03-28","SF FuneralF1104196      250328","","31.63","","1347130.98"
"2025-03-31","2025-03-28","SF FuneralF1104243      250328","","31.63","","1347162.61"
"2025-03-31","2025-03-28","SF FuneralF1115119      250328","","31.63","","1347194.24"
"2025-03-31","2025-03-28","SF FuneralF1122752      250328","","31.63","","1347225.87"
"2025-03-31","2025-03-28","SF FuneralF1123008      250328","","31.63","","1347257.5"
"2025-03-31","2025-03-28","SF FuneralF1123947      250328","","31.63","","1347289.13"
"2025-03-31","2025-03-28","SF FuneralF1127351      250328","","31.63","","1347320.76"
"2025-03-31","2025-03-28","SF FuneralF1130338      250328","","31.63","","1347352.39"
"2025-03-31","2025-03-28","SF FuneralF1130369      250328","","31.63","","1347384.02"
"2025-03-31","2025-03-28","SF FuneralF1130684      250328","","31.63","","1347415.65"
"2025-03-31","2025-03-28","SF FuneralF1134821      250328","","31.63","","1347447.28"
"2025-03-31","2025-03-28","SF FuneralF1135092      250328","","31.63","","1347478.91"
"2025-03-31","2025-03-28","SF FuneralF1135156      250328","","31.63","","1347510.54"
"2025-03-31","2025-03-28","SF FuneralF1135327      250328","","31.63","","1347542.17"
"2025-03-31","2025-03-28","SF FuneralF1135609      250328","","31.63","","1347573.8"
"2025-03-31","2025-03-28","SF FuneralF1135661      250328","","31.63","","1347605.43"
"2025-03-31","2025-03-29","SF FuneralFDC00000006HHY250329","","31.63","","1347637.06"
"2025-03-31","2025-03-29","SF FuneralF1060024      250329","","31.63","","1347668.69"
"2025-03-31","2025-03-29","SF FuneralFDC0000000P0VX250330","","31.63","","1347700.32"
"2025-03-31","2025-03-29","SF FuneralFDC0000000P0VY250330","","31.63","","1347731.95"
"2025-03-31","2025-03-29","SF FuneralFDC0000000P0W3250330","","31.63","","1347763.58"
"2025-03-31","2025-03-29","SF FuneralF1122269      250330","","31.63","","1347795.21"
"2025-03-31","2025-03-24","SF FuneralFDC000000073MN250324","","126.5","","1347921.71"
"2025-03-31","2025-03-24","SF FuneralFDC00000007P1P250324","","126.5","","1348048.21"
"2025-03-31","2025-03-24","SF FuneralF808514       250323","","126.5","","1348174.71"
"2025-03-31","2025-03-24","SF FuneralF816227       250324","","126.5","","1348301.21"
"2025-03-31","2025-03-24","SF FuneralF818769       250323","","126.5","","1348427.71"
"2025-03-31","2025-03-25","SF FuneralFDC00000007MZ7250325","","126.5","","1348554.21"
"2025-03-31","2025-03-25","SF FuneralFDC00000007N71250325","","126.5","","1348680.71"
"2025-03-31","2025-03-25","SF FuneralFDC00000007NDR250325","","126.5","","1348807.21"
"2025-03-31","2025-03-25","SF FuneralFDC00000007NFM250325","","126.5","","1348933.71"
"2025-03-31","2025-03-25","SF FuneralFDC00000007NTQ250325","","126.5","","1349060.21"
"2025-03-31","2025-03-25","SF FuneralFDC00000007PQR250325","","126.5","","1349186.71"
"2025-03-31","2025-03-25","SF FuneralFDC00000007QX3250325","","256.5","","1349443.21"
"2025-03-31","2025-03-25","SF FuneralF794530       250325","","126.5","","1349569.71"
"2025-03-31","2025-03-25","SF FuneralFDC00000007V50250325","","126.5","","1349696.21"
"2025-03-31","2025-03-25","SF FuneralF795301       250325","","126.5","","1349822.71"
"2025-03-31","2025-03-25","SF FuneralFDC00000008P1W250325","","126.5","","1349949.21"
"2025-03-31","2025-03-25","SF FuneralF1021253      250325","","126.5","","1350075.71"
"2025-03-31","2025-03-25","SF FuneralF1080210      250325","","126.5","","1350202.21"
"2025-03-31","2025-03-25","SF FuneralF1127112      250325","","126.5","","1350328.71"
"2025-03-31","2025-03-25","SF FuneralF1129025      250325","","126.5","","1350455.21"
"2025-03-31","2025-03-25","SF FuneralF1129924      250325","","126.5","","1350581.71"
"2025-03-31","2025-03-25","SF FuneralF1130911      250325","","126.5","","1350708.21"
"2025-03-31","2025-03-25","SF FuneralF1130938      250325","","126.5","","1350834.71"
"2025-03-31","2025-03-25","SF FuneralF1131174      250325","","126.5","","1350961.21"
"2025-03-31","2025-03-25","SF FuneralF1131307      250325","","126.5","","1351087.71"
"2025-03-31","2025-03-25","SF FuneralF1131573      250325","","126.5","","1351214.21"
"2025-03-31","2025-03-31","SF FuneralFDC0000000376D250331","","55","","1351269.21"
"2025-03-31","2025-03-31","SF FuneralFDC00000005NT1250331","","31.63","","1351300.84"
"2025-03-31","2025-03-31","SF FuneralFDC00000005RZQ250331","","31.63","","1351332.47"
"2025-03-31","2025-03-31","SF FuneralFDC00000005WTC250331","","55","","1351387.47"
"2025-03-31","2025-03-31","SF FuneralFDC000000069C5250331","","31.63","","1351419.1"
"2025-03-31","2025-03-31","SF FuneralFDC00000006RQ8250330","","31.63","","1351450.73"
"2025-03-31","2025-03-31","SF FuneralFDC00000007DSV250331","","31.63","","1351482.36"
"2025-03-31","2025-03-31","SF FuneralFDC00000007GS9250331","","31.63","","1351513.99"
"2025-03-31","2025-03-31","SF FuneralF803226       250331","","31.63","","1351545.62"
"2025-03-31","2025-03-31","SF FuneralF811593       250331","","31.63","","1351577.25"
"2025-03-31","2025-03-31","SF FuneralFDC00000009G6R250331","","31.63","","1351608.88"
"2025-03-31","2025-03-31","SF FuneralF810327       250331","","31.63","","1351640.51"
"2025-03-31","2025-03-31","SF FuneralF816565       250331","","31.63","","1351672.14"
"2025-03-31","2025-03-31","SF FuneralF828566       250331","","31.63","","1351703.77"
"2025-03-31","2025-03-31","SF FuneralF831617       250331","","31.63","","1351735.4"
"2025-03-31","2025-03-31","SF FuneralF841850       250331","","31.63","","1351767.03"
"2025-03-31","2025-03-31","SF FuneralF901184       250331","","31.63","","1351798.66"
"2025-03-31","2025-03-31","SF FuneralF1017111      250331","","31.63","","1351830.29"
"2025-03-31","2025-03-31","SF FuneralF1066299      250331","","31.63","","1351861.92"
"2025-03-31","2025-03-31","SF FuneralF1072930      250331","","31.63","","1351893.55"
"2025-03-31","2025-03-31","SF FuneralF1073374      250331","","31.63","","1351925.18"
"2025-03-31","2025-03-31","SF FuneralF1108567      250331","","31.63","","1351956.81"
"2025-03-31","2025-03-31","SF FuneralFDC0000000N7Y7250331","","31.63","","1351988.44"
"2025-03-31","2025-03-31","SF FuneralF1117767      250331","","31.63","","1352020.07"
"2025-03-31","2025-03-31","SF FuneralF1118005      250331","","31.63","","1352051.7"
"2025-03-31","2025-03-31","SF FuneralF1129904      250331","","31.63","","1352083.33"
"2025-03-31","2025-03-31","SF FuneralF1130649      250331","","31.63","","1352114.96"
"2025-03-31","2025-03-31","SF FuneralF1132115      250331","","31.63","","1352146.59"
"2025-03-31","2025-03-31","SF FuneralFDC00000005NYD250331","","63.25","","1352209.84"
"2025-03-31","2025-03-31","SF FuneralFDC00000005SZ4250331","","63.25","","1352273.09"
"2025-03-31","2025-03-31","SF FuneralFDC00000005V4Q250330","","126.5","","1352399.59"
"2025-03-31","2025-03-31","SF FuneralFDC00000006VYW250330","","126.5","","1352526.09"
"2025-03-31","2025-03-31","SF FuneralFDC000000072B6250331","","63.25","","1352589.34"
"2025-03-31","2025-03-31","SF FuneralFDC00000008PPZ250330","","126.5","","1352715.84"
"2025-03-31","2025-03-31","SF FuneralFDC00000008PQ0250330","","126.5","","1352842.34"
"2025-03-31","2025-03-31","SF FuneralFDC00000008PQ1250330","","126.5","","1352968.84"
"2025-03-31","2025-03-31","SF FuneralFDC0000000B7Y7250331","","126.5","","1353095.34"
"2025-03-31","2025-03-31","SF FuneralF822919       250331","","63.25","","1353158.59"
"2025-03-31","2025-03-31","SF FuneralFDC0000000GFB9250329","","126.5","","1353285.09"
"2025-03-31","2025-03-31","SF FuneralF900407       250330","","126.5","","1353411.59"
"2025-03-31","2025-03-31","SF FuneralF1066517      250331","","63.25","","1353474.84"
"2025-03-31","2025-03-31","SF FuneralF1126950      250331","","126.5","","1353601.34"
"2025-03-31","2025-03-25","SF FuneralF1104197      250325","","31.63","","1353632.97"
"2025-03-31","2025-03-25","SF FuneralF1126100      250325","","31.63","","1353664.6"
"2025-03-31","2025-03-27","SF FuneralFDC00000003307250327","","220","","1353884.6"
"2025-03-31","2025-03-27","SF FuneralFDC000000033GX250327","","220","","1354104.6"
"2025-03-31","2025-03-27","SF FuneralFDC000000057NX250327","","220","","1354324.6"
"2025-03-31","2025-03-27","SF FuneralFDC000000057XC250327","","126.5","","1354451.1"
"2025-03-31","2025-03-27","SF FuneralFDC00000005DV8250327","","126.5","","1354577.6"
"2025-03-31","2025-03-27","SF FuneralFDC00000005LWD250327","","126.5","","1354704.1"
"2025-03-31","2025-03-27","SF FuneralFDC00000005M0W250327","","126.5","","1354830.6"
"2025-03-31","2025-03-27","SF FuneralFDC00000005M1B250327","","126.5","","1354957.1"
"2025-03-31","2025-03-27","SF FuneralFDC00000005MRT250327","","126.5","","1355083.6"
"2025-03-31","2025-03-27","SF FuneralFDC00000005MXC250327","","126.5","","1355210.1"
"2025-03-31","2025-03-27","SF FuneralFDC00000005WZQ250327","","126.5","","1355336.6"
"2025-03-31","2025-03-27","SF FuneralFDC00000005ZTP250327","","126.5","","1355463.1"
"2025-03-31","2025-03-27","SF FuneralFDC000000065JT250327","","126.5","","1355589.6"
"2025-03-31","2025-03-27","SF FuneralFDC000000065L1250327","","126.5","","1355716.1"
"2025-03-31","2025-03-27","SF FuneralFDC000000065P9250327","","126.5","","1355842.6"
"2025-03-31","2025-03-27","SF FuneralFDC000000065RQ250327","","126.5","","1355969.1"
"2025-03-31","2025-03-27","SF FuneralFDC000000065RY250327","","126.5","","1356095.6"
"2025-03-31","2025-03-27","SF FuneralFDC00000006615250327","","126.5","","1356222.1"
"2025-03-31","2025-03-27","SF FuneralFDC000000066HR250327","","126.5","","1356348.6"
"2025-03-31","2025-03-27","SF FuneralFDC000000066SJ250327","","126.5","","1356475.1"
"2025-03-31","2025-03-27","SF FuneralFDC0000000670D250327","","126.5","","1356601.6"
"2025-03-31","2025-03-27","SF FuneralFDC000000067QN250327","","126.5","","1356728.1"
"2025-03-31","2025-03-27","SF FuneralFDC00000006JJ4250327","","126.5","","1356854.6"
"2025-03-31","2025-03-27","SF FuneralFDC00000006KJN250327","","126.5","","1356981.1"
"2025-03-31","2025-03-27","SF FuneralFDC00000006KKC250327","","126.5","","1357107.6"
"2025-03-31","2025-03-27","SF FuneralFDC00000006SD3250327","","126.5","","1357234.1"
"2025-03-31","2025-03-27","SF FuneralFDC00000006W6Q250327","","126.5","","1357360.6"
"2025-03-31","2025-03-27","SF FuneralFDC000000073RH250327","","126.5","","1357487.1"
"2025-03-31","2025-03-27","SF FuneralFDC00000007QY7250327","","126.5","","1357613.6"
"2025-03-31","2025-03-27","SF FuneralFDC000000089FT250327","","126.5","","1357740.1"
"2025-03-31","2025-03-27","SF FuneralF802237       250327","","126.5","","1357866.6"
"2025-03-31","2025-03-27","SF FuneralF802458       250327","","126.5","","1357993.1"
"2025-03-31","2025-03-27","SF FuneralF802603       250327","","126.5","","1358119.6"
"2025-03-31","2025-03-27","SF FuneralF803986       250327","","126.5","","1358246.1"
"2025-03-31","2025-03-27","SF FuneralF804112       250327","","126.5","","1358372.6"
"2025-03-31","2025-03-27","SF FuneralFDC00000008QWP250327","","126.5","","1358499.1"
"2025-03-31","2025-03-27","SF FuneralF805825       250327","","126.5","","1358625.6"
"2025-03-31","2025-03-27","SF FuneralF805967       250327","","126.5","","1358752.1"
"2025-03-31","2025-03-27","SF FuneralF808632       250327","","126.5","","1358878.6"
"2025-03-31","2025-03-27","SF FuneralF809200       250327","","126.5","","1359005.1"
"2025-03-31","2025-03-27","SF FuneralF796462       250327","","126.5","","1359131.6"
"2025-03-31","2025-03-27","SF FuneralF812072       250327","","126.5","","1359258.1"
"2025-03-31","2025-03-27","SF FuneralF813185       250327","","126.5","","1359384.6"
"2025-03-31","2025-03-27","SF FuneralF813261       250327","","126.5","","1359511.1"
"2025-03-31","2025-03-27","SF FuneralF813534       250327","","126.5","","1359637.6"
"2025-03-31","2025-03-27","SF FuneralF813673       250327","","126.5","","1359764.1"
"2025-03-31","2025-03-27","SF FuneralF813806       250327","","126.5","","1359890.6"
"2025-03-31","2025-03-27","SF FuneralF814104       250327","","126.5","","1360017.1"
"2025-03-31","2025-03-27","SF FuneralF814446       250327","","126.5","","1360143.6"
"2025-03-31","2025-03-27","SF FuneralF816045       250327","","126.5","","1360270.1"
"2025-03-31","2025-03-27","SF FuneralF817038       250327","","126.5","","1360396.6"
"2025-03-31","2025-03-27","SF FuneralF817505       250327","","126.5","","1360523.1"
"2025-03-31","2025-03-27","SF FuneralF817688       250327","","126.5","","1360649.6"
"2025-03-31","2025-03-27","SF FuneralFDC0000000BFNQ250327","","126.5","","1360776.1"
"2025-03-31","2025-03-27","SF FuneralF823986       250327","","126.5","","1360902.6"
"2025-03-31","2025-03-27","SF FuneralF824553       250327","","263.2","","1361165.8"
"2025-03-31","2025-03-27","SF FuneralF825178       250327","","126.5","","1361292.3"
"2025-03-31","2025-03-27","SF FuneralF827646       250327","","126.5","","1361418.8"
"2025-03-31","2025-03-27","SF FuneralF827782       250327","","126.5","","1361545.3"
"2025-03-31","2025-03-27","SF FuneralFDC0000000BNK6250327","","126.5","","1361671.8"
"2025-03-31","2025-03-27","SF FuneralF828807       250327","","126.5","","1361798.3"
"2025-03-31","2025-03-27","SF FuneralF829767       250327","","126.5","","1361924.8"
"2025-03-31","2025-03-27","SF FuneralF838814       250327","","126.5","","1362051.3"
"2025-03-31","2025-03-27","SF FuneralF841521       250327","","126.5","","1362177.8"
"2025-03-31","2025-03-27","SF FuneralF842672       250327","","126.5","","1362304.3"
"2025-03-31","2025-03-27","SF FuneralF843098       250327","","126.5","","1362430.8"
"2025-03-31","2025-03-27","SF FuneralF843738       250327","","126.5","","1362557.3"
"2025-03-31","2025-03-27","SF FuneralF900708       250327","","126.5","","1362683.8"
"2025-03-31","2025-03-27","SF FuneralF901222       250327","","126.5","","1362810.3"
"2025-03-31","2025-03-27","SF FuneralF981052       250327","","126.5","","1362936.8"
"2025-03-31","2025-03-27","SF FuneralF981836       250327","","126.5","","1363063.3"
"2025-03-31","2025-03-27","SF FuneralF987799       250327","","126.5","","1363189.8"
"2025-03-31","2025-03-27","SF FuneralF989879       250327","","126.5","","1363316.3"
"2025-03-31","2025-03-27","SF FuneralF990402       250327","","126.5","","1363442.8"
"2025-03-31","2025-03-27","SF FuneralFDC0000000JG82250327","","126.5","","1363569.3"
"2025-03-31","2025-03-27","SF FuneralF1017539      250327","","191.5","","1363760.8"
"2025-03-31","2025-03-27","SF FuneralF1021170      250327","","126.5","","1363887.3"
"2025-03-31","2025-03-27","SF FuneralF1052054      250327","","126.5","","1364013.8"
"2025-03-31","2025-03-27","SF FuneralF1052777      250327","","126.5","","1364140.3"
"2025-03-31","2025-03-27","SF FuneralF1055055      250327","","126.5","","1364266.8"
"2025-03-31","2025-03-27","SF FuneralF1055099      250327","","126.5","","1364393.3"
"2025-03-31","2025-03-27","SF FuneralF1055129      250327","","126.5","","1364519.8"
"2025-03-31","2025-03-27","SF FuneralF1055189      250327","","126.5","","1364646.3"
"2025-03-31","2025-03-27","SF FuneralF1055213      250327","","126.5","","1364772.8"
"2025-03-31","2025-03-27","SF FuneralF1058620      250327","","126.5","","1364899.3"
"2025-03-31","2025-03-27","SF FuneralF1059330      250327","","126.5","","1365025.8"
"2025-03-31","2025-03-27","SF FuneralF1059833      250327","","126.5","","1365152.3"
"2025-03-31","2025-03-27","SF FuneralFDC0000000KJWG250327","","126.5","","1365278.8"
"2025-03-31","2025-03-27","SF FuneralFDC0000000KW00250327","","126.5","","1365405.3"
"2025-03-31","2025-03-27","SF FuneralF1066546      250327","","126.5","","1365531.8"
"2025-03-31","2025-03-27","SF FuneralF1068184      250327","","126.5","","1365658.3"
"2025-03-31","2025-03-27","SF FuneralF1073697      250327","","126.5","","1365784.8"
"2025-03-31","2025-03-27","SF FuneralF1074676      250327","","126.5","","1365911.3"
"2025-03-31","2025-03-27","SF FuneralF1074712      250327","","126.5","","1366037.8"
"2025-03-31","2025-03-27","SF FuneralF1074928      250327","","126.5","","1366164.3"
"2025-03-31","2025-03-27","SF FuneralF1079001      250327","","126.5","","1366290.8"
"2025-03-31","2025-03-27","SF FuneralF1080219      250327","","126.5","","1366417.3"
"2025-03-31","2025-03-27","SF FuneralFDC0000000LNK4250327","","126.5","","1366543.8"
"2025-03-31","2025-03-27","SF FuneralFDC0000000LS81250327","","126.5","","1366670.3"
"2025-03-31","2025-03-27","SF FuneralF1108966      250327","","126.5","","1366796.8"
"2025-03-31","2025-03-27","SF FuneralF1110517      250327","","126.5","","1366923.3"
"2025-03-31","2025-03-27","SF FuneralF1112352      250327","","126.5","","1367049.8"
"2025-03-31","2025-03-27","SF FuneralFDC0000000N3BK250327","","126.5","","1367176.3"
"2025-03-31","2025-03-27","SF FuneralF1113121      250327","","126.5","","1367302.8"
"2025-03-31","2025-03-27","SF FuneralF1113138      250327","","126.5","","1367429.3"
"2025-03-31","2025-03-27","SF FuneralFDC0000000N4F1250327","","126.5","","1367555.8"
"2025-03-31","2025-03-27","SF FuneralF1113279      250327","","126.5","","1367682.3"
"2025-03-31","2025-03-27","SF FuneralF1113552      250327","","126.5","","1367808.8"
"2025-03-31","2025-03-27","SF FuneralF1114148      250327","","126.5","","1367935.3"
"2025-03-31","2025-03-27","SF FuneralFDC0000000N89V250327","","126.5","","1368061.8"
"2025-03-31","2025-03-27","SF FuneralF1114848      250327","","126.5","","1368188.3"
"2025-03-31","2025-03-27","SF FuneralF1116657      250327","","126.5","","1368314.8"
"2025-03-31","2025-03-27","SF FuneralFDC0000000NJ7F250327","","126.5","","1368441.3"
"2025-03-31","2025-03-27","SF FuneralFDC0000000NK7F250327","","126.5","","1368567.8"
"2025-03-31","2025-03-27","SF FuneralFDC0000000NKHH250327","","126.5","","1368694.3"
"2025-03-31","2025-03-27","SF FuneralF1118059      250327","","126.5","","1368820.8"
"2025-03-31","2025-03-27","SF FuneralF1120528      250327","","126.5","","1368947.3"
"2025-03-31","2025-03-27","SF FuneralF1120666      250327","","126.5","","1369073.8"
"2025-03-31","2025-03-27","SF FuneralF1120865      250327","","126.5","","1369200.3"
"2025-03-31","2025-03-27","SF FuneralF1120884      250327","","126.5","","1369326.8"
"2025-03-31","2025-03-27","SF FuneralF1120909      250327","","126.5","","1369453.3"
"2025-03-31","2025-03-27","SF FuneralFDC0000000NZTN250327","","126.5","","1369579.8"
"2025-03-31","2025-03-27","SF FuneralF1122070      250327","","126.5","","1369706.3"
"2025-03-31","2025-03-27","SF FuneralF1122315      250327","","126.5","","1369832.8"
"2025-03-31","2025-03-27","SF FuneralF1122612      250327","","126.5","","1369959.3"
"2025-03-31","2025-03-27","SF FuneralF1122700      250327","","126.5","","1370085.8"
"2025-03-31","2025-03-27","SF FuneralF1122933      250327","","126.5","","1370212.3"
"2025-03-31","2025-03-27","SF FuneralF1122969      250327","","126.5","","1370338.8"
"2025-03-31","2025-03-27","SF FuneralF1123263      250327","","126.5","","1370465.3"
"2025-03-31","2025-03-27","SF FuneralF1123412      250327","","126.5","","1370591.8"
"2025-03-31","2025-03-27","SF FuneralF1123612      250327","","126.5","","1370718.3"
"2025-03-31","2025-03-27","SF FuneralF1123955      250327","","126.5","","1370844.8"
"2025-03-31","2025-03-27","SF FuneralF1124176      250327","","126.5","","1370971.3"
"2025-03-31","2025-03-27","SF FuneralF1125428      250327","","126.5","","1371097.8"
"2025-03-31","2025-03-27","SF FuneralFDC0000000PH8C250327","","126.5","","1371224.3"
"2025-03-31","2025-03-27","SF FuneralFDC0000000PH8H250327","","126.5","","1371350.8"
"2025-03-31","2025-03-27","SF FuneralF1131232      250327","","63.25","","1371414.05"
"2025-03-31","2025-03-27","SF FuneralF1133483      250327","","126.5","","1371540.55"
"2025-03-31","2025-03-27","SF FuneralFDC0000000QF05250327","","126.5","","1371667.05"
"2025-03-31","2025-03-27","SF FuneralF1133754      250327","","126.5","","1371793.55"
"2025-03-31","2025-03-27","SF FuneralF1134091      250327","","126.5","","1371920.05"
"2025-03-31","2025-03-22","SF FuneralFDC00000005DGP250322","","126.5","","1372046.55"
"2025-03-31","2025-03-22","SF FuneralFDC00000005Y6M250321","","126.5","","1372173.05"
"2025-03-31","2025-03-22","SF FuneralFDC00000007FZ3250322","","126.5","","1372299.55"
"2025-03-31","2025-03-24","SF FuneralF1113747      250324","","126.5","","1372426.05"
"2025-03-31","2025-03-25","SF FuneralFDC00000006CPG250325","","126.5","","1372552.55"
"2025-03-31","2025-03-25","SF FuneralFDC00000007TP4250325","","126.5","","1372679.05"
"2025-03-31","2025-03-25","SF FuneralF802404       250325","","126.5","","1372805.55"
"2025-03-31","2025-03-25","SF FuneralF811655       250325","","31.63","","1372837.18"
"2025-03-31","2025-03-25","SF FuneralF991948       250325","","126.5","","1372963.68"
"2025-03-31","2025-03-25","SF FuneralF1075012      250325","","126.5","","1373090.18"
"2025-03-31","2025-03-25","SF FuneralF1131894      250325","","126.5","","1373216.68"
"2025-03-31","2025-03-22","SF FuneralFDC00000006XPY250322","","126.5","","1373343.18"
"2025-03-31","2025-03-25","SF FuneralFDC000000077V3250325","","126.5","","1373469.68"
"2025-03-31","2025-03-25","SF FuneralFDC00000007GFW250325","","126.5","","1373596.18"
"2025-03-31","2025-03-25","SF FuneralFDC00000007MMS250325","","126.5","","1373722.68"
"2025-03-31","2025-03-25","SF FuneralFDC00000007NBZ250325","","126.5","","1373849.18"
"2025-03-31","2025-03-25","SF FuneralFDC00000007NLH250325","","126.5","","1373975.68"
"2025-03-31","2025-03-25","SF FuneralF1075100      250325","","126.5","","1374102.18"
"2025-03-31","2025-03-25","SF FuneralF1130879      250325","","126.5","","1374228.68"
"2025-03-31","2025-03-25","SF FuneralFDC0000000Q5BY250325","","126.5","","1374355.18"
"2025-03-31","2025-03-25","SF FuneralF1132026      250325","","126.5","","1374481.68"
"2025-03-31","2025-03-27","SF FuneralFDC0000000339T250327","","220","","1374701.68"
"2025-03-31","2025-03-27","SF FuneralFDC000000034XG250327","","220","","1374921.68"
"2025-03-31","2025-03-27","SF FuneralFDC00000003FFM250327","","220","","1375141.68"
"2025-03-31","2025-03-27","SF FuneralFDC00000005DYC250327","","126.5","","1375268.18"
"2025-03-31","2025-03-27","SF FuneralFDC000000065G6250327","","126.5","","1375394.68"
"2025-03-31","2025-03-27","SF FuneralFDC000000067RS250327","","126.5","","1375521.18"
"2025-03-31","2025-03-27","SF FuneralFDC00000006GZM250327","","126.5","","1375647.68"
"2025-03-31","2025-03-27","SF FuneralFDC00000006S4T250327","","126.5","","1375774.18"
"2025-03-31","2025-03-27","SF FuneralF812329       250327","","126.5","","1375900.68"
"2025-03-31","2025-03-27","SF FuneralFDC0000000BJTG250327","","126.5","","1376027.18"
"2025-03-31","2025-03-27","SF FuneralF828098       250327","","126.5","","1376153.68"
"2025-03-31","2025-03-27","SF FuneralF828476       250327","","126.5","","1376280.18"
"2025-03-31","2025-03-27","SF FuneralFDC0000000BVKG250327","","126.5","","1376406.68"
"2025-03-31","2025-03-27","SF FuneralFDC0000000FGV1250327","","126.5","","1376533.18"
"2025-03-31","2025-03-27","SF FuneralF981693       250327","","126.5","","1376659.68"
"2025-03-31","2025-03-27","SF FuneralF981439       250327","","126.5","","1376786.18"
"2025-03-31","2025-03-27","SF FuneralFDC0000000N0H3250327","","126.5","","1376912.68"
"2025-03-31","2025-03-27","SF FuneralF1112491      250327","","126.5","","1377039.18"
"2025-03-31","2025-03-27","SF FuneralF1114461      250327","","126.5","","1377165.68"
"2025-03-31","2025-03-27","SF FuneralFDC0000000NWVP250327","","126.5","","1377292.18"
"2025-03-31","2025-03-27","SF FuneralF1123980      250327","","126.5","","1377418.68"
"2025-03-31","2025-03-28","SF FuneralFDC00000003C1N250328","","220","","1377638.68"
"2025-03-31","2025-03-28","SF FuneralFDC000000043CD250328","","220","","1377858.68"
"2025-03-31","2025-03-28","SF FuneralFDC00000005S28250328","","126.5","","1377985.18"
"2025-03-31","2025-03-28","SF FuneralFDC000000065JM250328","","126.5","","1378111.68"
"2025-03-31","2025-03-28","SF FuneralFDC000000065JX250328","","126.5","","1378238.18"
"2025-03-31","2025-03-28","SF FuneralFDC000000065PG250328","","126.5","","1378364.68"
"2025-03-31","2025-03-28","SF FuneralFDC000000069WZ250328","","126.5","","1378491.18"
"2025-03-31","2025-03-28","SF FuneralFDC00000006LQJ250328","","126.5","","1378617.68"
"2025-03-31","2025-03-28","SF FuneralFDC000000070CD250328","","31.63","","1378649.31"
"2025-03-31","2025-03-28","SF FuneralFDC000000074MB250328","","126.5","","1378775.81"
"2025-03-31","2025-03-28","SF FuneralFDC0000000757Z250328","","126.5","","1378902.31"
"2025-03-31","2025-03-28","SF FuneralFDC00000007B90250328","","126.5","","1379028.81"
"2025-03-31","2025-03-28","SF FuneralFDC00000007CPT250328","","126.5","","1379155.31"
"2025-03-31","2025-03-28","SF FuneralFDC000000082J1250328","","126.5","","1379281.81"
"2025-03-31","2025-03-28","SF FuneralF798088       250328","","126.5","","1379408.31"
"2025-03-31","2025-03-28","SF FuneralF799033       250328","","126.5","","1379534.81"
"2025-03-31","2025-03-28","SF FuneralF814074       250328","","31.63","","1379566.44"
"2025-03-31","2025-03-28","SF FuneralF819723       250328","","126.5","","1379692.94"
"2025-03-31","2025-03-28","SF FuneralF832766       250328","","126.5","","1379819.44"
"2025-03-31","2025-03-28","SF FuneralF833322       250328","","126.5","","1379945.94"
"2025-03-31","2025-03-28","SF FuneralF987816       250328","","126.5","","1380072.44"
"2025-03-31","2025-03-28","SF FuneralF1072946      250328","","126.5","","1380198.94"
"2025-03-31","2025-03-28","SF FuneralFDC0000000NC6Y250328","","126.5","","1380325.44"
"2025-03-31","2025-03-28","SF FuneralFDC0000000PKN8250328","","126.5","","1380451.94"
"2025-03-31","2025-03-31","SF FuneralFDC00000005NX7250331","","31.63","","1380483.57"
"2025-03-31","2025-03-31","SF FuneralFDC00000006XFK250331","","31.63","","1380515.2"
"2025-03-31","2025-03-31","SF FuneralFDC0000000BV0W250331","","63.25","","1380578.45"
"2025-03-31","2025-03-31","SF FuneralF1073862      250331","","31.63","","1380610.08"
"2025-03-31","2025-03-31","SF FuneralFDC0000000MSC7250331","","47.88","","1380657.96"
"2025-03-31","2025-03-27","SF FuneralFDC0000000362M250327","","220","","1380877.96"
"2025-03-31","2025-03-27","SF FuneralFDC00000005CS0250327","","126.5","","1381004.46"
"2025-03-31","2025-03-27","SF FuneralFDC00000005DZD250327","","126.5","","1381130.96"
"2025-03-31","2025-03-27","SF FuneralFDC00000005LP7250327","","126.5","","1381257.46"
"2025-03-31","2025-03-27","SF FuneralFDC00000005N00250327","","126.5","","1381383.96"
"2025-03-31","2025-03-27","SF FuneralFDC000000065JG250327","","126.5","","1381510.46"
"2025-03-31","2025-03-27","SF FuneralFDC000000065T8250327","","126.5","","1381636.96"
"2025-03-31","2025-03-27","SF FuneralFDC0000000661K250327","","126.5","","1381763.46"
"2025-03-31","2025-03-27","SF FuneralFDC00000006BSP250327","","126.5","","1381889.96"
"2025-03-31","2025-03-27","SF FuneralFDC00000006JPV250327","","126.5","","1382016.46"
"2025-03-31","2025-03-27","SF FuneralFDC00000008JLZ250327","","126.5","","1382142.96"
"2025-03-31","2025-03-27","SF FuneralFDC00000008SH9250327","","126.5","","1382269.46"
"2025-03-31","2025-03-27","SF FuneralF805856       250327","","126.5","","1382395.96"
"2025-03-31","2025-03-27","SF FuneralF808910       250327","","126.5","","1382522.46"
"2025-03-31","2025-03-27","SF FuneralFDC00000009BZG250327","","126.5","","1382648.96"
"2025-03-31","2025-03-27","SF FuneralF817023       250327","","126.5","","1382775.46"
"2025-03-31","2025-03-27","SF FuneralF818962       250327","","126.5","","1382901.96"
"2025-03-31","2025-03-27","SF FuneralF822553       250327","","126.5","","1383028.46"
"2025-03-31","2025-03-27","SF FuneralF805939       250327","","126.5","","1383154.96"
"2025-03-31","2025-03-27","SF FuneralF827590       250327","","126.5","","1383281.46"
"2025-03-31","2025-03-27","SF FuneralF828050       250327","","126.5","","1383407.96"
"2025-03-31","2025-03-27","SF FuneralF828131       250327","","126.5","","1383534.46"
"2025-03-31","2025-03-27","SF FuneralF829736       250327","","126.5","","1383660.96"
"2025-03-31","2025-03-27","SF FuneralF841052       250327","","126.5","","1383787.46"
"2025-03-31","2025-03-27","SF FuneralF842040       250327","","126.5","","1383913.96"
"2025-03-31","2025-03-27","SF FuneralF842465       250327","","126.5","","1384040.46"
"2025-03-31","2025-03-27","SF FuneralF774280       250327","","126.5","","1384166.96"
"2025-03-31","2025-03-27","SF FuneralF981374       250327","","126.5","","1384293.46"
"2025-03-31","2025-03-27","SF FuneralFDC0000000HJTV250327","","126.5","","1384419.96"
"2025-03-31","2025-03-27","SF FuneralF1033574      250327","","126.5","","1384546.46"
"2025-03-31","2025-03-27","SF FuneralF1058733      250327","","126.5","","1384672.96"
"2025-03-31","2025-03-27","SF FuneralF1062659      250327","","126.5","","1384799.46"
"2025-03-31","2025-03-27","SF FuneralFDC0000000L42F250327","","126.5","","1384925.96"
"2025-03-31","2025-03-27","SF FuneralF1078993      250327","","126.5","","1385052.46"
"2025-03-31","2025-03-27","SF FuneralFDC0000000MKG3250327","","126.5","","1385178.96"
"2025-03-31","2025-03-27","SF FuneralF1111354      250327","","126.5","","1385305.46"
"2025-03-31","2025-03-27","SF FuneralFDC0000000N9QR250327","","126.5","","1385431.96"
"2025-03-31","2025-03-27","SF FuneralF1115081      250327","","126.5","","1385558.46"
"2025-03-31","2025-03-27","SF FuneralF1115773      250327","","126.5","","1385684.96"
"2025-03-31","2025-03-27","SF FuneralF1117863      250327","","126.5","","1385811.46"
"2025-03-31","2025-03-27","SF FuneralFDC0000000NPN8250327","","126.5","","1385937.96"
"2025-03-31","2025-03-27","SF FuneralFDC0000000NPRY250327","","126.5","","1386064.46"
"2025-03-31","2025-03-27","SF FuneralFDC0000000P0BD250327","","126.5","","1386190.96"
"2025-03-31","2025-03-27","SF FuneralF1122785      250327","","126.5","","1386317.46"
"2025-03-31","2025-03-27","SF FuneralF1127856      250327","","126.5","","1386443.96"
"2025-03-31","2025-03-27","SF FuneralF1133739      250327","","126.5","","1386570.46"
"2025-03-31","2025-03-29","SF FuneralFDC0000000741Q250329","","126.5","","1386696.96"
"2025-03-31","2025-03-29","SF FuneralF798132       250329","","126.5","","1386823.46"
"2025-03-31","2025-03-28","SF FuneralFDC00000002V62250328","","220","","1387043.46"
"2025-03-31","2025-03-28","SF FuneralFDC000000032CP250328","","220","","1387263.46"
"2025-03-31","2025-03-28","SF FuneralFDC000000044R7250328","","220","","1387483.46"
"2025-03-31","2025-03-28","SF FuneralFDC00000005N37250328","","126.5","","1387609.96"
"2025-03-31","2025-03-28","SF FuneralFDC00000005TX1250328","","31.63","","1387641.59"
"2025-03-31","2025-03-28","SF FuneralFDC00000005Z98250328","","126.5","","1387768.09"
"2025-03-31","2025-03-28","SF FuneralFDC000000062NG250328","","126.5","","1387894.59"
"2025-03-31","2025-03-28","SF FuneralFDC000000065BG250328","","126.5","","1388021.09"
"2025-03-31","2025-03-28","SF FuneralFDC000000065HF250328","","126.5","","1388147.59"
"2025-03-31","2025-03-28","SF FuneralFDC000000065J4250328","","126.5","","1388274.09"
"2025-03-31","2025-03-28","SF FuneralFDC000000066BV250328","","126.5","","1388400.59"
"2025-03-31","2025-03-28","SF FuneralFDC00000006758250328","","126.5","","1388527.09"
"2025-03-31","2025-03-28","SF FuneralFDC00000006898250328","","126.5","","1388653.59"
"2025-03-31","2025-03-28","SF FuneralFDC000000068DQ250328","","126.5","","1388780.09"
"2025-03-31","2025-03-28","SF FuneralFDC00000006BNZ250328","","126.5","","1388906.59"
"2025-03-31","2025-03-28","SF FuneralFDC00000006C2W250328","","126.5","","1389033.09"
"2025-03-31","2025-03-28","SF FuneralFDC00000006HHM250328","","126.5","","1389159.59"
"2025-03-31","2025-03-28","SF FuneralFDC00000006L53250328","","126.5","","1389286.09"
"2025-03-31","2025-03-28","SF FuneralFDC00000006NFW250328","","31.63","","1389317.72"
"2025-03-31","2025-03-28","SF FuneralFDC00000006QWQ250328","","126.5","","1389444.22"
"2025-03-31","2025-03-28","SF FuneralFDC00000006SG0250328","","126.5","","1389570.72"
"2025-03-31","2025-03-28","SF FuneralFDC00000006X9J250328","","126.5","","1389697.22"
"2025-03-31","2025-03-28","SF FuneralFDC000000072S2250328","","126.5","","1389823.72"
"2025-03-31","2025-03-28","SF FuneralF779346       250328","","31.63","","1389855.35"
"2025-03-31","2025-03-28","SF FuneralF799191       250328","","126.5","","1389981.85"
"2025-03-31","2025-03-28","SF FuneralF808152       250328","","126.5","","1390108.35"
"2025-03-31","2025-03-28","SF FuneralF808550       250328","","126.5","","1390234.85"
"2025-03-31","2025-03-28","SF FuneralF808587       250328","","126.5","","1390361.35"
"2025-03-31","2025-03-28","SF FuneralF816232       250328","","126.5","","1390487.85"
"2025-03-31","2025-03-28","SF FuneralF817318       250328","","126.5","","1390614.35"
"2025-03-31","2025-03-28","SF FuneralF819405       250328","","126.5","","1390740.85"
"2025-03-31","2025-03-28","SF FuneralF819939       250328","","126.5","","1390867.35"
"2025-03-31","2025-03-28","SF FuneralFDC0000000B7F4250328","","126.5","","1390993.85"
"2025-03-31","2025-03-28","SF FuneralF822592       250328","","126.5","","1391120.35"
"2025-03-31","2025-03-28","SF FuneralF833775       250328","","126.5","","1391246.85"
"2025-03-31","2025-03-28","SF FuneralF842095       250328","","126.5","","1391373.35"
"2025-03-31","2025-03-28","SF FuneralF847432       250328","","126.5","","1391499.85"
"2025-03-31","2025-03-28","SF FuneralF901201       250328","","126.5","","1391626.35"
"2025-03-31","2025-03-28","SF FuneralF981854       250328","","126.5","","1391752.85"
"2025-03-31","2025-03-28","SF FuneralF989351       250328","","126.5","","1391879.35"
"2025-03-31","2025-03-28","SF FuneralF1021052      250328","","126.5","","1392005.85"
"2025-03-31","2025-03-28","SF FuneralF1022178      250328","","126.5","","1392132.35"
"2025-03-31","2025-03-28","SF FuneralF1033691      250328","","126.5","","1392258.85"
"2025-03-31","2025-03-28","SF FuneralFDC0000000L8NN250328","","31.63","","1392290.48"
"2025-03-31","2025-03-28","SF FuneralF1075225      250328","","126.5","","1392416.98"
"2025-03-31","2025-03-28","SF FuneralF1083801      250328","","126.5","","1392543.48"
"2025-03-31","2025-03-28","SF FuneralF1109647      250328","","126.5","","1392669.98"
"2025-03-31","2025-03-28","SF FuneralF1109879      250328","","126.5","","1392796.48"
"2025-03-31","2025-03-28","SF FuneralFDC0000000ML47250328","","126.5","","1392922.98"
"2025-03-31","2025-03-28","SF FuneralF1111600      250328","","126.5","","1393049.48"
"2025-03-31","2025-03-28","SF FuneralF1116815      250328","","126.5","","1393175.98"
"2025-03-31","2025-03-28","SF FuneralF1116945      250328","","126.5","","1393302.48"
"2025-03-31","2025-03-28","SF FuneralF1118870      250328","","126.5","","1393428.98"
"2025-03-31","2025-03-28","SF FuneralF1130038      250328","","126.5","","1393555.48"
"2025-03-31","2025-03-31","SF FuneralF1127880      250331","","126.5","","1393681.98"
"2025-03-31","2025-03-26","SF FuneralF827698       250326","","126.5","","1393808.48"
"2025-03-31","2025-03-26","SF FuneralF829643       250326","","126.5","","1393934.98"
"2025-03-31","2025-03-26","SF FuneralF992476       250326","","126.5","","1394061.48"
"2025-03-31","2025-03-26","SF FuneralF993237       250326","","126.5","","1394187.98"
"2025-03-31","2025-03-26","SF FuneralF993559       250326","","126.5","","1394314.48"
"2025-03-31","2025-03-26","SF FuneralFDC0000000JTYL250326","","126.5","","1394440.98"
"2025-03-31","2025-03-26","SF FuneralF1075025      250326","","126.5","","1394567.48"
"2025-03-31","2025-03-25","SF FuneralFDC00000007MN0250325","","126.5","","1394693.98"
"2025-03-31","2025-03-25","SF FuneralF793314       250325","","126.5","","1394820.48"
"2025-03-31","2025-03-25","SF FuneralF794430       250325","","126.5","","1394946.98"
"2025-03-31","2025-03-25","SF FuneralF794850       250325","","126.5","","1395073.48"
"2025-03-31","2025-03-25","SF FuneralFDC0000000Q5BW250325","","126.5","","1395199.98"
"2025-03-31","2025-03-25","SF FuneralFDC0000000Q7HY250325","","126.5","","1395326.48"
"2025-03-31","2025-03-26","SF FuneralF994115       250326","","126.5","","1395452.98"
"2025-03-31","2025-03-27","SF FuneralFDC00000002VWG250327","","220","","1395672.98"
"2025-03-31","2025-03-27","SF FuneralFDC000000031XT250327","","220","","1395892.98"
"2025-03-31","2025-03-27","SF FuneralFDC00000003235250327","","220","","1396112.98"
"2025-03-31","2025-03-27","SF FuneralFDC00000003NRY250327","","220","","1396332.98"
"2025-03-31","2025-03-27","SF FuneralFDC000000059D3250327","","126.5","","1396459.48"
"2025-03-31","2025-03-27","SF FuneralFDC00000005DXV250327","","126.5","","1396585.98"
"2025-03-31","2025-03-27","SF FuneralFDC00000005KQJ250327","","126.5","","1396712.48"
"2025-03-31","2025-03-27","SF FuneralFDC00000005N7G250327","","126.5","","1396838.98"
"2025-03-31","2025-03-27","SF FuneralFDC000000066PW250327","","126.5","","1396965.48"
"2025-03-31","2025-03-27","SF FuneralFDC000000066PY250327","","126.5","","1397091.98"
"2025-03-31","2025-03-27","SF FuneralFDC00000006BHP250327","","126.5","","1397218.48"
"2025-03-31","2025-03-27","SF FuneralFDC00000006DTV250327","","126.5","","1397344.98"
"2025-03-31","2025-03-27","SF FuneralFDC00000006W4J250327","","126.5","","1397471.48"
"2025-03-31","2025-03-27","SF FuneralFDC00000008KD5250327","","126.5","","1397597.98"
"2025-03-31","2025-03-27","SF FuneralFDC00000008KK2250327","","126.5","","1397724.48"
"2025-03-31","2025-03-27","SF FuneralF804519       250327","","126.5","","1397850.98"
"2025-03-31","2025-03-27","SF FuneralF778125       250327","","220","","1398070.98"
"2025-03-31","2025-03-27","SF FuneralF812657       250327","","126.5","","1398197.48"
"2025-03-31","2025-03-27","SF FuneralF815064       250327","","126.5","","1398323.98"
"2025-03-31","2025-03-27","SF FuneralF822952       250327","","126.5","","1398450.48"
"2025-03-31","2025-03-27","SF FuneralF823983       250327","","126.5","","1398576.98"
"2025-03-31","2025-03-27","SF FuneralF830408       250327","","126.5","","1398703.48"
"2025-03-31","2025-03-27","SF FuneralF841625       250327","","126.5","","1398829.98"
"2025-03-31","2025-03-27","SF FuneralFDC0000000K5PJ250327","","321.5","","1399151.48"
"2025-03-31","2025-03-27","SF FuneralF1054903      250327","","126.5","","1399277.98"
"2025-03-31","2025-03-27","SF FuneralF1074835      250327","","126.5","","1399404.48"
"2025-03-31","2025-03-27","SF FuneralF831783       250327","","126.5","","1399530.98"
"2025-03-31","2025-03-27","SF FuneralF1108993      250327","","126.5","","1399657.48"
"2025-03-31","2025-03-27","SF FuneralFDC0000000N5CR250327","","126.5","","1399783.98"
"2025-03-31","2025-03-27","SF FuneralF1118782      250327","","126.5","","1399910.48"
"2025-03-31","2025-03-27","SF FuneralFDC0000000NYK8250327","","126.5","","1400036.98"
"2025-03-31","2025-03-28","SF FuneralFDC000000065PP250328","","126.5","","1400163.48"
"2025-03-31","2025-03-28","SF FuneralFDC000000065QB250328","","126.5","","1400289.98"
"2025-03-31","2025-03-28","SF FuneralFDC000000065TR250328","","126.5","","1400416.48"
"2025-03-31","2025-03-28","SF FuneralFDC00000006660250328","","126.5","","1400542.98"
"2025-03-31","2025-03-28","SF FuneralFDC000000067CN250328","","126.5","","1400669.48"
"2025-03-31","2025-03-28","SF FuneralFDC000000067R3250328","","220","","1400889.48"
"2025-03-31","2025-03-28","SF FuneralFDC0000000692V250328","","126.5","","1401015.98"
"2025-03-31","2025-03-28","SF FuneralFDC000000069HM250328","","126.5","","1401142.48"
"2025-03-31","2025-03-28","SF FuneralFDC00000006BND250328","","126.5","","1401268.98"
"2025-03-31","2025-03-28","SF FuneralFDC00000006CH3250328","","126.5","","1401395.48"
"2025-03-31","2025-03-28","SF FuneralFDC00000006K2J250328","","126.5","","1401521.98"
"2025-03-31","2025-03-28","SF FuneralFDC00000006LGS250328","","126.5","","1401648.48"
"2025-03-31","2025-03-28","SF FuneralFDC00000006R0M250328","","126.5","","1401774.98"
"2025-03-31","2025-03-28","SF FuneralFDC00000006XVJ250328","","126.5","","1401901.48"
"2025-03-31","2025-03-28","SF FuneralFDC00000007441250328","","126.5","","1402027.98"
"2025-03-31","2025-03-28","SF FuneralFDC000000074LY250328","","126.5","","1402154.48"
"2025-03-31","2025-03-28","SF FuneralFDC00000007HC9250328","","126.5","","1402280.98"
"2025-03-31","2025-03-28","SF FuneralF817335       250328","","126.5","","1402407.48"
"2025-03-31","2025-03-28","SF FuneralF817341       250328","","126.5","","1402533.98"
"2025-03-31","2025-03-28","SF FuneralF817524       250328","","126.5","","1402660.48"
"2025-03-31","2025-03-28","SF FuneralF812012       250328","","126.5","","1402786.98"
"2025-03-31","2025-03-28","SF FuneralF832563       250328","","126.5","","1402913.48"
"2025-03-31","2025-03-28","SF FuneralFDC0000000CR7X250328","","126.5","","1403039.98"
"2025-03-31","2025-03-28","SF FuneralF842737       250328","","31.63","","1403071.61"
"2025-03-31","2025-03-28","SF FuneralF843410       250328","","31.63","","1403103.24"
"2025-03-31","2025-03-28","SF FuneralF993809       250328","","31.63","","1403134.87"
"2025-03-31","2025-03-28","SF FuneralF1017724      250328","","126.5","","1403261.37"
"2025-03-31","2025-03-28","SF FuneralF1084023      250328","","126.5","","1403387.87"
"2025-03-31","2025-03-28","SF FuneralF1103530      250328","","126.5","","1403514.37"
"2025-03-31","2025-03-28","SF FuneralF1128214      250328","","126.5","","1403640.87"
"2025-03-31","2025-03-28","SF FuneralF1129021      250328","","126.5","","1403767.37"
"2025-03-31","2025-03-28","SF FuneralF1130931      250328","","126.5","","1403893.87"
"2025-03-31","2025-03-29","SF FuneralFDC00000005MPF250329","","126.5","","1404020.37"
"2025-03-31","2025-03-31","SF FuneralFDC00000005MKM250330","","126.5","","1404146.87"
"2025-03-31","2025-03-31","SF FuneralFDC00000006GNR250331","","31.63","","1404178.5"
"2025-03-31","2025-03-31","SF FuneralF832849       250331","","126.5","","1404305"
"2025-03-31","2025-03-31","SF FuneralF1080529      250331","","31.63","","1404336.63"
"2025-03-31","2025-03-31","SF FuneralF1112136      250331","","31.63","","1404368.26"
"2025-03-31","2025-03-31","Fee-Teller Transactions","","-11.91","","1404356.35"
"2025-03-31","2025-03-31","Dep-Cash-SFTAP2023804554","","126.5","11.91","1404482.85"
"2025-03-31","2025-03-27","SF FuneralFDC000000066HG250327","","126.5","","1404609.35"
"2025-03-31","2025-03-31","SF FuneralFDC00000005H8J250330","","31.63","","1404640.98"
"2025-03-31","2025-03-28","Rev SF FuneralFDC0000000KLCD250328","","-31.63","","1404609.35"
"2025-03-31","2025-03-28","Rev SF FuneralFDC000000069RZ250328","","-31.63","","1404577.72"
"2025-03-31","2025-03-28","Rev SF FuneralFDC0000000JR9H250328","","-126.5","","1404451.22"
"2025-03-31","2025-03-28","Rev SF FuneralFDC00000006MDK250328","","-126.5","","1404324.72"
"2025-03-31","2025-03-11","Rev SF FuneralFDC0000000FQV0250311","","-63.25","","1404261.47"
"2025-03-31","2025-03-22","Rev SF FuneralFDC0000000713G250322","","-126.5","","1404134.97"
"2025-03-31","2025-03-28","Rev SF FuneralFDC00000008BQG250328","","-126.5","","1404008.47"
"2025-03-31","2025-03-28","Rev SF FuneralFDC00000008BT8250328","","-126.5","","1403881.97"
"2025-03-31","2025-03-28","Rev SF FuneralFDC00000005WRL250328","","-220","","1403661.97"
"2025-03-31","2025-03-28","Rev SF FuneralFDC000000068DR250328","","-126.5","","1403535.47"
"2025-03-31","2025-03-27","Rev SF FuneralFDC00000003NT6250327","","-220","","1403315.47"
"2025-03-31","2025-03-24","Rev SF FuneralFDC00000007NPQ250324","","-126.5","","1403188.97"
"2025-03-31","2025-03-25","Rev SF FuneralFDC00000006RZQ250325","","-126.5","","1403062.47"
"2025-03-31","2025-03-25","Rev SF FuneralFDC00000007VD0250325","","-126.5","","1402935.97"
"2025-03-31","2025-03-25","Rev SF FuneralFDC00000007VFN250325","","-126.5","","1402809.47"
"2025-03-31","2025-03-25","Rev SF FuneralFDC00000007GSG250325","","-126.5","","1402682.97"
"2025-03-31","2025-03-24","Rev SF FuneralFDC0000000N12V250324","","-126.5","","1402556.47"
"2025-03-31","2025-03-27","Rev SF FuneralFDC0000000K1GY250327","","-126.5","","1402429.97"
"2025-03-31","2025-03-27","Rev SF FuneralFDC0000000FT33250327","","-126.5","","1402303.47"
"2025-03-31","2025-03-25","Rev SF FuneralFDC00000007F33250325","","-126.5","","1402176.97"
"2025-03-31","2025-03-25","Rev SF FuneralFDC00000007Q8D250325","","-126.5","","1402050.47"
"2025-03-31","2025-03-28","Rev SF FuneralFDC0000000QK0Y250328","","-126.5","","1401923.97"
"2025-03-31","2025-03-25","Rev SF FuneralFDC0000000FQV0250325","","-63.25","","1401860.72"
"2025-03-31","2025-03-28","Rev SF FuneralFDC00000009HWN250328","","-126.5","","1401734.22"
"2025-03-31","2025-03-25","Rev SF FuneralFDC0000000Q8DY250325","","-126.5","","1401607.72"
"2025-03-31","2025-03-29","Rev SF FuneralFDC0000000KH3D250330","","-31.63","","1401576.09"
"2025-03-31","2025-03-22","Rev SF FuneralFDC000000087Y5250321","","-126.5","","1401449.59"
"2025-03-31","2025-02-22","Rev SF FuneralFDC00000007W03250222","","-126.5","","1401323.09"
"2025-03-31","2025-03-25","Rev SF FuneralFDC00000009CP1250325","","-95.75","","1401227.34"
"2025-03-31","2025-03-22","Rev SF FuneralFDC00000005409250322","","-126.5","","1401100.84"
"2025-03-31","2025-03-22","Rev SF FuneralFDC00000007W03250322","","-126.5","","1400974.34"
"2025-03-31","2025-03-22","Rev SF FuneralFDC000000053ZX250322","","-126.5","","1400847.84"
"2025-03-31","2025-03-29","Rev SF FuneralFDC00000005H9H250329","","-220","","1400627.84"
"2025-03-31","2025-03-29","Rev SF FuneralFDC0000000PXGC250330","","-126.5","","1400501.34"
"2025-03-31","2025-03-22","Rev SF FuneralFDC000000063V7250322","","-126.5","","1400374.84"
"2025-03-31","2025-03-22","Rev SF FuneralFDC0000000P47W250323","","-126.5","","1400248.34"
"2025-03-31","2025-03-24","Rev SF FuneralFDC000000090G7250323","","-126.5","","1400121.84"
"2025-03-31","2025-02-27","Rev SF FuneralFDC0000000P4Y5250227","","-126.5","","1399995.34"
"2025-03-31","2025-03-24","Rev SF FuneralFDC0000000JNDN250324","","-126.5","","1399868.84"
"2025-03-31","2025-03-22","Rev SF FuneralFDC00000007YVT250322","","-126.5","","1399742.34"
"2025-03-31","2025-03-22","Rev SF FuneralFDC0000000K4RL250322","","-126.5","","1399615.84"
"2025-03-31","2025-03-25","Rev SF FuneralFDC000000087TS250325","","-126.5","","1399489.34"
"2025-03-31","2025-03-26","Rev SF FuneralFDC0000000H1YY250326","","-126.5","","1399362.84"
"2025-03-31","2025-03-27","Rev SF FuneralFDC0000000372T250327","","-220","","1399142.84"
"2025-03-31","2025-03-27","Rev SF FuneralFDC0000000L0CH250327","","-126.5","","1399016.34"
"2025-03-31","2025-03-27","Rev SF FuneralFDC0000000JG82250327","","-126.5","","1398889.84"
"2025-03-31","2025-03-27","Rev SF FuneralFDC0000000P4Y5250327","","-126.5","","1398763.34"
"2025-03-31","2025-03-27","Rev SF FuneralFDC0000000NZTN250327","","-126.5","","1398636.84"
"2025-03-31","2025-03-28","Rev SF FuneralFDC00000007CLH250328","","-126.5","","1398510.34"
"2025-03-31","2025-03-27","Rev SF FuneralFDC0000000N4F1250327","","-126.5","","1398383.84"
"2025-03-31","2025-03-28","Rev SF FuneralFDC000000078DX250328","","-126.5","","1398257.34"
"2025-03-31","2025-03-27","Rev SF FuneralFDC00000005WZH250327","","-220","","1398037.34"
"2025-03-31","2025-03-28","Rev SF FuneralFDC0000000MLFC250328","","-126.5","","1397910.84"
"2025-03-31","2025-03-27","Rev SF FuneralFDC000000096SP250327","","-126.5","","1397784.34"
"2025-03-31","2025-03-28","Rev SF FuneralFDC000000089KV250328","","-126.5","","1397657.84"
"2025-03-31","2025-03-28","Rev SF FuneralFDC0000000NPGV250328","","-126.5","","1397531.34"
"2025-03-31","2025-03-28","Rev SF FuneralFDC00000007684250328","","-126.5","","1397404.84"
"2025-03-31","2025-03-28","Rev SF FuneralFDC0000000B89Y250328","","-126.5","","1397278.34"
"2025-03-31","2025-03-28","Rev SF FuneralFDC00000008CY5250328","","-126.5","","1397151.84"
"2025-03-31","2025-03-28","Rev SF FuneralFDC0000000PSD4250328","","-126.5","","1397025.34"
"2025-03-31","2025-03-29","Rev SF FuneralFDC0000000LVNH250330","","-126.5","","1396898.84"
"2025-03-31","2025-03-24","SF FuneralFDC00000006L11250324","","126.5","","1397025.34"
"2025-03-31","2025-03-28","SF FuneralF1127882      250328","","126.5","","1397151.84"
"2025-03-31","2025-03-25","SF FuneralF816436       250325","","31.63","","1397183.47"
"2025-03-31","2025-03-25","SF FuneralF816835       250325","","31.63","","1397215.1"
"2025-03-31","2025-03-25","SF FuneralFDC0000000PJX8250325","","31.63","","1397246.73"
"2025-03-31","2025-03-28","SF FuneralF1130754      250328","","31.63","","1397278.36"
"2025-03-31","2025-03-22","SF FuneralF1120381      250322","","126.5","","1397404.86"
"2025-03-31","2025-03-24","SF FuneralFDC00000006L6F250323","","126.5","","1397531.36"
"2025-03-31","2025-03-24","SF FuneralF841769       250323","","126.5","","1397657.86"
"2025-03-31","2025-03-25","SF FuneralFDC000000079JH250325","","126.5","","1397784.36"
"2025-03-31","2025-03-25","SF FuneralF1111516      250325","","63.25","","1397847.61"
"2025-03-31","2025-03-25","SF FuneralF1131345      250325","","126.5","","1397974.11"
"2025-03-31","2025-03-26","SF FuneralFDC0000000BBS5250326","","126.5","","1398100.61"
"2025-03-31","2025-03-26","SF FuneralF828069       250326","","126.5","","1398227.11"
"2025-03-31","2025-03-26","SF FuneralF900809       250326","","126.5","","1398353.61"
"2025-03-31","2025-03-26","SF FuneralF1060693      250326","","126.5","","1398480.11"
"2025-03-31","2025-03-26","SF FuneralF1061004      250326","","63.25","","1398543.36"
"2025-03-31","2025-03-27","SF FuneralF803709       250327","","126.5","","1398669.86"
"2025-03-31","2025-03-27","SF FuneralF812261       250327","","126.5","","1398796.36"
"2025-03-31","2025-03-27","SF FuneralFDC00000009FDG250327","","126.5","","1398922.86"
"2025-03-31","2025-03-27","SF FuneralFDC0000000LLZK250327","","191.5","","1399114.36"
"2025-03-31","2025-03-27","SF FuneralF1114544      250327","","126.5","","1399240.86"
"2025-03-31","2025-03-27","SF FuneralF1121984      250327","","126.5","","1399367.36"
"2025-03-31","2025-03-27","SF FuneralF1122194      250327","","126.5","","1399493.86"
"2025-03-31","2025-03-27","SF FuneralFDC0000000PG88250327","","126.5","","1399620.36"
"2025-03-31","2025-03-28","SF FuneralF797176       250328","","126.5","","1399746.86"
"2025-03-31","2025-03-28","SF FuneralF900720       250328","","126.5","","1399873.36"
"2025-03-31","2025-03-28","SF FuneralFDC0000000HT8C250328","","126.5","","1399999.86"
"2025-03-31","2025-03-28","SF FuneralF1104253      250328","","126.5","","1400126.36"
"2025-03-31","2025-03-28","SF FuneralFDC0000000Q3DK250328","","126.5","","1400252.86"
"2025-03-31","2025-03-28","SF FuneralFDC0000000Q3DP250328","","126.5","","1400379.36"
"2025-03-31","2025-03-28","SF FuneralF1131039      250328","","63.25","","1400442.61"
"2025-03-31","2025-03-28","SF FuneralFDC0000000QGFM250328","","126.5","","1400569.11"
"2025-03-31","2025-03-28","SF FuneralFDC0000000QGFP250328","","126.5","","1400695.61"
"2025-03-31","2025-03-31","SF FuneralF1080434      250331","","126.5","","1400822.11"
"2025-03-31","2025-03-22","SF FuneralFDC000000070QW250322","","126.5","","1400948.61"
"2025-03-31","2025-03-22","SF FuneralF1083847      250322","","126.5","","1401075.11"
"2025-03-31","2025-03-22","SF FuneralF1129246      250322","","126.5","","1401201.61"
"2025-03-31","2025-03-25","SF FuneralFDC0000000CQMV250325","","63.25","","1401264.86"
"2025-03-31","2025-03-25","SF FuneralF1021121      250325","","126.5","","1401391.36"
"2025-03-31","2025-03-25","SF FuneralF1123498      250325","","126.5","","1401517.86"
"2025-03-31","2025-03-25","SF FuneralF1124199      250325","","126.5","","1401644.36"
"2025-03-31","2025-03-27","SF FuneralFDC00000005MVD250327","","126.5","","1401770.86"
"2025-03-31","2025-03-27","SF FuneralF1108365      250327","","126.5","","1401897.36"
"2025-03-31","2025-03-27","SF FuneralF1108921      250327","","126.5","","1402023.86"
"2025-03-31","2025-03-27","SF FuneralF1109833      250327","","126.5","","1402150.36"
"2025-03-31","2025-03-27","SF FuneralFDC0000000MYV6250327","","126.5","","1402276.86"
"2025-03-31","2025-03-27","SF FuneralF1118019      250327","","126.5","","1402403.36"
"2025-03-31","2025-03-27","SF FuneralF1120925      250327","","126.5","","1402529.86"
"2025-03-31","2025-03-28","SF FuneralFDC00000005WF5250328","","126.5","","1402656.36"
"2025-03-31","2025-03-28","SF FuneralFDC00000006BC6250328","","126.5","","1402782.86"
"2025-03-31","2025-03-28","SF FuneralFDC00000006C6F250328","","126.5","","1402909.36"
"2025-03-31","2025-03-28","SF FuneralFDC0000000706X250328","","126.5","","1403035.86"
"2025-03-31","2025-03-28","SF FuneralFDC0000000739K250328","","126.5","","1403162.36"
"2025-03-31","2025-03-28","SF FuneralFDC000000087YC250328","","126.5","","1403288.86"
"2025-03-31","2025-03-28","SF FuneralFDC00000008YFT250328","","126.5","","1403415.36"
"2025-03-31","2025-03-28","SF FuneralFDC0000000HT8H250328","","126.5","","1403541.86"
"2025-03-31","2025-03-28","SF FuneralF1021067      250328","","126.5","","1403668.36"
"2025-03-31","2025-03-28","SF FuneralF1083912      250328","","126.5","","1403794.86"
"2025-03-31","2025-03-28","SF FuneralF1110695      250328","","126.5","","1403921.36"
"2025-03-31","2025-03-28","SF FuneralFDC0000000QGFK250328","","126.5","","1404047.86"
"2025-03-31","2025-03-28","SF FuneralFDC0000000QHR5250328","","126.5","","1404174.36"
"2025-03-31","2025-03-28","SF FuneralFDC0000000QHR6250328","","126.5","","1404300.86"
"2025-03-31","2025-03-28","SF FuneralF1134481      250328","","126.5","","1404427.36"
"2025-03-31","2025-03-28","SF FuneralF1134489      250328","","126.5","","1404553.86"
"2025-03-31","2025-03-29","SF FuneralF796673       250329","","126.5","","1404680.36"
"2025-03-31","2025-03-29","SF FuneralF1084401      250329","","126.5","","1404806.86"
"2025-03-31","2025-03-22","SF FuneralFDC00000005ZGP250322","","126.5","","1404933.36"
"2025-03-31","2025-03-22","SF FuneralFDC00000007K94250322","","126.5","","1405059.86"
"2025-03-31","2025-03-22","SF FuneralFDC00000008LMD250322","","126.5","","1405186.36"
"2025-03-31","2025-03-22","SF FuneralF986664       250322","","126.5","","1405312.86"
"2025-03-31","2025-03-22","SF FuneralF1020821      250322","","126.5","","1405439.36"
"2025-03-31","2025-03-22","SF FuneralF1055069      250322","","126.5","","1405565.86"
"2025-03-31","2025-03-22","SF FuneralF1128782      250322","","126.5","","1405692.36"
"2025-03-31","2025-03-24","SF FuneralFDC00000009PLP250323","","191.5","","1405883.86"
"2025-03-31","2025-03-24","SF FuneralF843437       250324","","126.5","","1406010.36"
"2025-03-31","2025-03-24","SF FuneralF847441       250322","","126.5","","1406136.86"
"2025-03-31","2025-03-24","SF FuneralF1108282      250324","","126.5","","1406263.36"
"2025-03-31","2025-03-25","SF FuneralFDC000000031BJ250325","","220","","1406483.36"
"2025-03-31","2025-03-25","SF FuneralFDC0000000738X250325","","63.25","","1406546.61"
"2025-03-31","2025-03-25","SF FuneralFDC0000000LMWH250325","","126.5","","1406673.11"
"2025-03-31","2025-03-25","SF FuneralF1083711      250325","","63.25","","1406736.36"
"2025-03-31","2025-03-27","SF FuneralFDC0000000DNYN250327","","126.5","","1406862.86"
"2025-03-31","2025-03-27","SF FuneralFDC0000000GP26250327","","126.5","","1406989.36"
"2025-03-31","2025-03-27","SF FuneralF1111713      250327","","126.5","","1407115.86"
"2025-03-31","2025-03-28","SF FuneralF804061       250328","","126.5","","1407242.36"
"2025-03-31","2025-03-28","SF FuneralF805111       250328","","126.5","","1407368.86"
"2025-03-31","2025-03-28","SF FuneralFDC00000009Q9G250328","","126.5","","1407495.36"
"2025-03-31","2025-03-28","SF FuneralF834023       250328","","126.5","","1407621.86"
"2025-03-31","2025-03-28","SF FuneralF1084296      250328","","126.5","","1407748.36"
"2025-03-31","2025-03-28","SF FuneralF1118775      250328","","126.5","","1407874.86"
"2025-03-31","2025-03-28","SF FuneralF1133828      250328","","126.5","","1408001.36"
"2025-03-31","2025-03-29","SF FuneralF1113873      250330","","126.5","","1408127.86"
"2025-03-31","2025-03-29","SF FuneralFDC0000000P1LP250330","","126.5","","1408254.36"
"2025-03-31","2025-03-31","SF FuneralFDC000000039Y2250331","","220","","1408474.36"
"2025-03-31","2025-03-27","SF FuneralF1060376      250327","","126.5","","1408600.86"
"2025-03-31","2025-03-27","SF FuneralF1078423      250327","","126.5","","1408727.36"
"2025-03-31","2025-03-28","SF FuneralFDC0000000673F250328","","126.5","","1408853.86"
"2025-03-31","2025-03-22","SF FuneralF1020955      250322","","126.5","","1408980.36"
"2025-03-31","2025-03-26","SF FuneralF1120546      250326","","126.5","","1409106.86"
"2025-03-31","2025-03-27","SF FuneralFDC00000005BQK250327","","126.5","","1409233.36"
"2025-03-31","2025-03-27","SF FuneralFDC000000086C7250327","","126.5","","1409359.86"
"2025-03-31","2025-03-27","SF FuneralF813409       250327","","126.5","","1409486.36"
"2025-03-31","2025-03-27","SF FuneralF1060530      250327","","126.5","","1409612.86"
"2025-03-31","2025-03-27","SF FuneralF1114915      250327","","126.5","","1409739.36"
"2025-03-31","2025-03-27","SF FuneralF1115003      250327","","126.5","","1409865.86"
"2025-03-31","2025-03-28","SF FuneralFDC000000065DD250328","","126.5","","1409992.36"
"2025-03-31","2025-03-28","SF FuneralFDC000000075P4250328","","126.5","","1410118.86"
"2025-03-31","2025-03-28","SF FuneralFDC0000000LN1H250328","","126.5","","1410245.36"
"2025-03-31","2025-03-25","SF FuneralFDC00000007NZ9250325","","126.5","","1410371.86"
"2025-03-31","2025-03-25","SF FuneralF989129       250325","","126.5","","1410498.36"
"2025-03-31","2025-03-25","SF FuneralF1020554      250325","","126.5","","1410624.86"
"2025-03-31","2025-03-27","SF FuneralF811858       250327","","126.5","","1410751.36"
"2025-03-31","2025-03-28","SF FuneralFDC0000000HT9R250328","","126.5","","1410877.86"
"2025-03-31","2025-03-28","SF FuneralF989235       250329","","126.5","","1411004.36"
"2025-03-31","2025-03-28","SF FuneralF782399       250328","","126.5","","1411130.86"
"2025-03-31","2025-03-29","SF FuneralF1130776      250329","","31.63","","1411162.49"
"2025-03-31","2025-03-31","SF FuneralF813490       250330","","126.5","","1411288.99"
"2025-03-31","2025-03-25","SF FuneralF1021948      250325","","126.5","","1411415.49"
"2025-03-31","2025-03-26","SF FuneralF992446       250326","","126.5","","1411541.99"
"2025-03-31","2025-03-28","SF FuneralFDC0000000H05Q250328","","126.5","","1411668.49"
"2025-03-31","2025-03-28","SF FuneralF900784       250328","","126.5","","1411794.99"
"2025-03-31","2025-03-28","SF FuneralF987134       250328","","126.5","","1411921.49"
"2025-03-31","2025-03-31","SF FuneralFDC000000086M1250331","","126.5","","1412047.99"
"2025-03-31","2025-03-22","SF FuneralF1125746      250322","","126.5","","1412174.49"
"2025-03-31","2025-03-27","SF FuneralF821012       250327","","126.5","","1412300.99"
"2025-03-31","2025-03-27","SF FuneralF1134508      250327","","126.5","","1412427.49"
"2025-03-31","2025-03-28","SF FuneralFDC00000003C8S250328","","220","","1412647.49"
"2025-03-31","2025-03-28","SF FuneralFDC0000000731L250328","","126.5","","1412773.99"
"2025-03-31","2025-03-28","SF FuneralF1050815      250328","","126.5","","1412900.49"
"2025-03-31","2025-03-22","SF FuneralFDC00000006BZP250322","","126.5","","1413026.99"
"2025-03-31","2025-03-25","SF FuneralFDC00000006Q68250325","","31.63","","1413058.62"
"2025-03-31","2025-03-28","SF FuneralF843757       250328","","31.63","","1413090.25"
"2025-03-31","2025-03-28","SF FuneralF1127614      250328","","31.63","","1413121.88"
"2025-03-31","2025-03-29","SF FuneralF1122295      250330","","31.63","","1413153.51"
"2025-03-31","2025-03-29","SF FuneralF1130825      250329","","31.63","","1413185.14"
"2025-03-31","2025-03-31","SF FuneralF1124411      250331","","31.63","","1413216.77"
"2025-03-31","2025-03-22","SF FuneralFDC00000007DJF250322","","126.5","","1413343.27"
"2025-03-31","2025-03-22","SF FuneralFDC00000007S3V250322","","126.5","","1413469.77"
"2025-03-31","2025-03-22","SF FuneralFDC0000000CY83250322","","126.5","","1413596.27"
"2025-03-31","2025-03-22","SF FuneralFDC0000000CY84250322","","126.5","","1413722.77"
"2025-03-31","2025-03-24","SF FuneralF1085057      250324","","126.5","","1413849.27"
"2025-03-31","2025-03-25","SF FuneralFDC00000007XMT250325","","126.5","","1413975.77"
"2025-03-31","2025-03-25","SF FuneralF804121       250325","","126.5","","1414102.27"
"2025-03-31","2025-03-25","SF FuneralF821168       250325","","126.5","","1414228.77"
"2025-03-31","2025-03-25","SF FuneralF1132328      250325","","126.5","","1414355.27"
"2025-03-31","2025-03-26","SF FuneralF992065       250326","","126.5","","1414481.77"
"2025-03-31","2025-03-26","SF FuneralFDC0000000JCRJ250326","","126.5","","1414608.27"
"2025-03-31","2025-03-27","SF FuneralFDC000000032FF250327","","220","","1414828.27"
"2025-03-31","2025-03-27","SF FuneralFDC00000005L0M250327","","126.5","","1414954.77"
"2025-03-31","2025-03-27","SF FuneralF842458       250327","","126.5","","1415081.27"
"2025-03-31","2025-03-27","SF FuneralF1065797      250327","","126.5","","1415207.77"
"2025-03-31","2025-03-27","SF FuneralFDC0000000L0CK250327","","126.5","","1415334.27"
"2025-03-31","2025-03-27","SF FuneralF1074938      250327","","126.5","","1415460.77"
"2025-03-31","2025-03-27","SF FuneralF1079294      250327","","126.5","","1415587.27"
"2025-03-31","2025-03-27","SF FuneralF1112528      250327","","126.5","","1415713.77"
"2025-03-31","2025-03-27","SF FuneralF1134355      250327","","126.5","","1415840.27"
"2025-03-31","2025-03-28","SF FuneralFDC00000006BKR250328","","126.5","","1415966.77"
"2025-03-31","2025-03-28","SF FuneralFDC00000006K1D250328","","126.5","","1416093.27"
"2025-03-31","2025-03-28","SF FuneralFDC00000006R8B250328","","126.5","","1416219.77"
"2025-03-31","2025-03-28","SF FuneralFDC00000006R8Z250328","","126.5","","1416346.27"
"2025-03-31","2025-03-28","SF FuneralFDC00000007DTN250328","","126.5","","1416472.77"
"2025-03-31","2025-03-28","SF FuneralFDC00000007DTV250328","","126.5","","1416599.27"
"2025-03-31","2025-03-28","SF FuneralF812157       250328","","126.5","","1416725.77"
"2025-03-31","2025-03-28","SF FuneralF822207       250328","","126.5","","1416852.27"
"2025-03-31","2025-03-28","SF FuneralF822797       250328","","126.5","","1416978.77"
"2025-03-31","2025-03-28","SF FuneralF901237       250328","","126.5","","1417105.27"
"2025-03-31","2025-03-28","SF FuneralF986874       250328","","126.5","","1417231.77"
"2025-03-31","2025-03-28","SF FuneralF988956       250328","","126.5","","1417358.27"
"2025-03-31","2025-03-28","SF FuneralF781093       250328","","126.5","","1417484.77"
"2025-03-31","2025-03-28","SF FuneralFDC0000000LT4Y250328","","126.5","","1417611.27"
"2025-03-31","2025-03-28","SF FuneralF1117595      250328","","126.5","","1417737.77"
"2025-03-31","2025-03-28","SF FuneralF1129001      250328","","126.5","","1417864.27"
"2025-03-31","2025-03-28","SF FuneralF1130493      250328","","126.5","","1417990.77"
"2025-03-31","2025-03-28","SF FuneralFDC0000000QKS9250328","","126.5","","1418117.27"
"2025-03-31","2025-03-28","SF FuneralFDC0000000QKSB250328","","126.5","","1418243.77"
"2025-03-31","2025-03-29","SF FuneralFDC000000034CD250329","","220","","1418463.77"
"2025-03-31","2025-03-29","SF FuneralF803094       250329","","126.5","","1418590.27"
"2025-03-31","2025-03-24","SF FuneralFDC000000065ZR250324","","126.5","","1418716.77"
"2025-03-31","2025-03-28","SF FuneralFDC0000000NJS8250328","","126.5","","1418843.27"
"2025-03-31","2025-03-28","SF FuneralFDC00000006CQR250328","","126.5","","1418969.77"
"2025-03-31","2025-03-28","SF FuneralF834048       250328","","126.5","","1419096.27"
"2025-03-31","2025-03-28","SF FuneralF1085258      250328","","126.5","","1419222.77"
"2025-03-31","2025-03-22","SF FuneralF1083889      250322","","126.5","","1419349.27"
"2025-03-31","2025-03-27","SF FuneralFDC000000073ZQ250327","","126.5","","1419475.77"
"2025-03-31","2025-03-27","SF FuneralF844737       250327","","126.5","","1419602.27"
"2025-03-31","2025-03-28","SF FuneralFDC000000070ZN250328","","126.5","","1419728.77"
"2025-03-31","2025-03-29","SF FuneralF1020601      250329","","31.63","","1419760.4"
"2025-03-31","2025-03-27","SF FuneralF827679       250327","","126.5","","1419886.9"
"2025-03-31","2025-03-28","SF FuneralFDC000000063LC250328","","126.5","","1420013.4"
"2025-03-31","2025-03-28","SF FuneralF1125801      250328","","126.5","","1420139.9"
"2025-03-31","2025-03-22","SF FuneralF1113209      250322","","126.5","","1420266.4"
"2025-03-31","2025-03-25","SF FuneralFDC00000009PWR250325","","126.5","","1420392.9"
"2025-03-31","2025-03-25","SF FuneralF1132201      250325","","126.5","","1420519.4"
"2025-03-31","2025-03-25","SF FuneralFDC0000000Q4L6250325","","126.5","","1420645.9"
"2025-03-31","2025-03-27","SF FuneralF1133719      250327","","126.5","","1420772.4"
"2025-03-31","2025-03-28","SF FuneralFDC0000000685F250328","","126.5","","1420898.9"
"2025-03-31","2025-03-28","SF FuneralF793528       250328","","126.5","","1421025.4"
"2025-03-31","2025-03-28","SF FuneralFDC0000000B662250328","","126.5","","1421151.9"
"2025-03-31","2025-03-28","SF FuneralF1133554      250328","","126.5","","1421278.4"
"2025-03-31","2025-03-25","SF FuneralF843037       250325","","31.63","","1421310.03"
"2025-03-31","2025-03-28","SF FuneralF834570       250328","","31.63","","1421341.66"
"2025-03-31","2025-03-31","SF FuneralF1060055      250331","","31.63","","1421373.29"
"2025-03-31","2025-03-22","SF FuneralFDC000000071F2250322","","126.5","","1421499.79"
"2025-03-31","2025-03-22","SF FuneralF821132       250322","","126.5","","1421626.29"
"2025-03-31","2025-03-25","SF FuneralF793946       250325","","126.5","","1421752.79"
"2025-03-31","2025-03-25","SF FuneralF810352       250325","","126.5","","1421879.29"
"2025-03-31","2025-03-25","SF FuneralF817194       250325","","126.5","","1422005.79"
"2025-03-31","2025-03-25","SF FuneralF843990       250325","","126.5","","1422132.29"
"2025-03-31","2025-03-26","SF FuneralF990283       250326","","126.5","","1422258.79"
"2025-03-31","2025-03-27","SF FuneralFDC00000005MQV250327","","126.5","","1422385.29"
"2025-03-31","2025-03-27","SF FuneralFDC000000066P9250327","","126.5","","1422511.79"
"2025-03-31","2025-03-27","SF FuneralFDC00000006X1M250327","","126.5","","1422638.29"
"2025-03-31","2025-03-27","SF FuneralFDC0000000K22Y250327","","126.5","","1422764.79"
"2025-03-31","2025-03-28","SF FuneralFDC00000005MZR250328","","126.5","","1422891.29"
"2025-03-31","2025-03-28","SF FuneralFDC00000005XG3250328","","126.5","","1423017.79"
"2025-03-31","2025-03-28","SF FuneralFDC0000000684P250328","","126.5","","1423144.29"
"2025-03-31","2025-03-28","SF FuneralFDC00000006Z0J250328","","126.5","","1423270.79"
"2025-03-31","2025-03-28","SF FuneralF809383       250328","","126.5","","1423397.29"
"2025-03-31","2025-03-28","SF FuneralFDC0000000N5N9250328","","126.5","","1423523.79"
"2025-03-31","2025-03-28","SF FuneralF1134974      250328","","126.5","","1423650.29"
"2025-03-31","2025-03-29","SF FuneralF830255       250329","","126.5","","1423776.79"
"2025-03-31","2025-03-29","SF FuneralF900551       250330","","126.5","","1423903.29"
"2025-03-31","2025-03-31","SF FuneralFDC00000008JKX250330","","126.5","","1424029.79"
"2025-03-31","2025-03-31","SF FuneralF812110       250331","","63.25","","1424093.04"
"2025-03-31","2025-03-31","SF FuneralF818788       250330","","126.5","","1424219.54"
"2025-03-31","2025-03-31","Rev SF FuneralFDC00000008PPZ250330","","-126.5","","1424093.04"
"2025-03-31","2025-03-31","Rev SF FuneralFDC00000008PQ0250330","","-126.5","","1423966.54"
"2025-03-31","2024-12-02","Rev SF FuneralFDC00000007QZ5241201","","-126.5","","1423840.04"
"2025-03-31","2025-03-22","Rev SF FuneralFDC000000070QW250322","","-126.5","","1423713.54"
"2025-03-31","2024-10-01","Rev SF FuneralFDC00000007QZ5241001","","-126.5","","1423587.04"
"2025-03-31","2025-03-28","Rev SF FuneralFDC0000000QHR6250328","","-126.5","","1423460.54"
"2025-03-31","2025-03-28","Rev SF FuneralFDC0000000QHR5250328","","-126.5","","1423334.04"
"2025-03-31","2025-03-24","Rev SF FuneralFDC000000065ZR250324","","-126.5","","1423207.54"
"2025-03-31","2025-03-25","Rev SF FuneralFDC0000000Q3YX250325","","-126.5","","1423081.04"
"2025-03-31","2025-03-28","Rev SF FuneralFDC00000004015250328","","-220","","1422861.04"
"2025-03-31","2025-03-28","Rev SF FuneralFDC0000000NJS8250328","","-126.5","","1422734.54"
"2025-03-31","2025-03-25","Rev SF FuneralFDC0000000Q3YY250325","","-126.5","","1422608.04"
"2025-03-31","2025-03-24","Rev SF FuneralFDC00000009PLP250323","","-191.5","","1422416.54"
"2025-03-31","2025-03-27","Rev SF FuneralFDC0000000L0CK250327","","-126.5","","1422290.04"
"2025-03-31","2025-03-27","Rev SF FuneralFDC00000006NC2250327","","-220","","1422070.04"
"2025-03-31","2025-03-22","Rev SF FuneralFDC0000000N7HW250322","","-126.5","","1421943.54"
"2025-03-31","2025-03-27","Rev SF FuneralFDC0000000N3WX250327","","-126.5","","1421817.04"
"2025-03-31","2025-03-26","Rev SF FuneralFDC00000005J71250326","","-126.5","","1421690.54"
"2025-03-31","2025-03-28","Rev SF FuneralFDC00000006GKS250328","","-126.5","","1421564.04"
"2025-03-31","2025-03-28","Rev SF FuneralFDC0000000KTDL250328","","-126.5","","1421437.54"
"2025-03-31","2024-11-01","Rev SF FuneralFDC00000007QZ5241101","","-126.5","","1421311.04"
"2025-03-31","2025-03-28","Rev SF FuneralFDC00000006KVT250328","","-126.5","","1421184.54"
"2025-03-31","2025-03-28","Rev SF FuneralFDC0000000QLT8250328","","-63.25","","1421121.29"
"2025-03-31","2025-03-27","Rev SF FuneralFDC00000008QWP250327","","-126.5","","1420994.79"
"2025-03-31","2025-03-28","Rev SF FuneralFDC00000006BTS250328","","-126.5","","1420868.29"
"2025-03-31","2025-03-27","Rev SF FuneralFDC00000006ZHS250327","","-126.5","","1420741.79"
"2025-03-31","2025-03-28","Rev SF FuneralFDC0000000LTTB250328","","-126.5","","1420615.29"
"2025-03-31","2025-03-27","Rev SF FuneralFDC000000066P9250327","","-126.5","","1420488.79"
"2025-03-31","2025-03-01","Rev SF FuneralFDC00000007QZ5250301","","-126.5","","1420362.29"
"2025-03-31","2025-03-27","Rev SF FuneralFDC000000032G9250327","","-220","","1420142.29"
"2025-03-31","2025-02-01","Rev SF FuneralFDC00000007QZ5250201","","-126.5","","1420015.79"
"2025-03-31","2025-01-02","Rev SF FuneralFDC00000007QZ5250101","","-126.5","","1419889.29"
"2025-03-31","2025-03-22","Rev SF FuneralFDC00000005ZGP250322","","-126.5","","1419762.79"
"2025-03-31","2025-03-31","Rev SF FuneralFDC0000000GFB9250329","","-126.5","","1419636.29"
"2025-03-31","2025-03-28","Rev SF FuneralFDC0000000HT9R250328","","-126.5","","1419509.79"
"2025-03-31","2025-03-28","Rev SF FuneralFDC0000000KY4F250328","","-126.5","","1419383.29"
"2025-03-31","2025-03-28","Rev SF FuneralFDC0000000QGFM250328","","-126.5","","1419256.79"
"2025-03-31","2025-03-28","Rev SF FuneralFDC00000005SMG250328","","-126.5","","1419130.29"
"2025-03-31","2025-02-28","Rev SF FuneralFDC0000000LTTB250228","","-126.5","","1419003.79"
"2025-03-31","2025-03-22","Rev SF FuneralFDC00000005HJM250321","","-31.63","","1418972.16"
"2025-03-31","2025-03-31","Rev SF FuneralFDC00000005WTC250331","","-55","","1418917.16"
"2025-03-31","2025-03-28","Rev SF FuneralFDC00000007WBL250328","","-31.63","","1418885.53"
"2025-03-31","2025-03-28","Rev SF FuneralFDC00000007MW5250328","","-31.63","","1418853.9"
"2025-03-31","2025-03-31","Rev SF FuneralFDC000000069C5250331","","-31.63","","1418822.27"
"2025-03-31","2025-03-31","Rev SF FuneralFDC00000005NT1250331","","-31.63","","1418790.64"
"2025-03-31","2025-03-27","Rev SF FuneralFDC0000000P2ZT250327","","-126.5","","1418664.14"
"2025-03-31","2025-03-27","Rev SF FuneralFDC00000009FDG250327","","-126.5","","1418537.64"
"2025-03-31","2025-03-27","Rev SF FuneralFDC0000000BNK6250327","","-126.5","","1418411.14"
"2025-03-31","2025-03-27","Rev SF FuneralFDC0000000BP51250327","","-126.5","","1418284.64"
"2025-03-31","2025-03-31","Rev SF FuneralFDC00000008PQ1250330","","-126.5","","1418158.14"
"2025-03-31","2025-03-28","Rev SF FuneralFDC000000075P4250328","","-126.5","","1418031.64"
"2025-03-31","2025-03-28","Rev SF FuneralFDC000000077MM250328","","-126.5","","1417905.14"
"2025-03-31","2025-03-28","Rev SF FuneralFDC00000007DTN250328","","-126.5","","1417778.64"
"2025-03-31","2025-03-28","Rev SF FuneralFDC00000007DTV250328","","-126.5","","1417652.14"
"2025-03-31","2025-03-28","Rev SF FuneralFDC0000000L06D250328","","-126.5","","1417525.64"
"2025-03-31","2025-03-28","Rev SF FuneralFDC000000075FY250328","","-126.5","","1417399.14"
"2025-03-31","2025-03-24","Rev SF FuneralFDC0000000MK0D250324","","-126.5","","1417272.64"
"2025-03-31","2025-03-28","SF FuneralFDC000000086G5250328","","126.5","","1417399.14"
"2025-03-31","2025-03-28","SF FuneralF1079321      250328","","63.25","","1417462.39"
"2025-03-31","2025-03-25","SF FuneralFDC00000007TW1250325","","126.5","","1417588.89"
"2025-03-31","2025-03-31","SF FuneralFDC000000069CL250331","","31.63","","1417620.52"
"2025-03-31","2025-03-27","SF FuneralF1108693      250327","","126.5","","1417747.02"
"2025-03-31","2025-03-26","SF FuneralF981315       250326","","126.5","","1417873.52"
"2025-03-31","2025-03-28","SF FuneralFDC00000005GV2250328","","126.5","","1418000.02"
"2025-03-31","2025-03-28","SF FuneralFDC00000007326250328","","126.5","","1418126.52"
"2025-03-31","2025-03-28","SF FuneralF814615       250328","","126.5","","1418253.02"
"2025-03-31","2025-03-28","SF FuneralF1116990      250328","","126.5","","1418379.52"
"2025-03-31","2025-03-28","SF FuneralF1128207      250328","","126.5","","1418506.02"
"2025-03-31","2025-03-28","SF FuneralFDC0000000QGFV250328","","126.5","","1418632.52"
"2025-03-31","2025-03-22","SF FuneralFDC000000030SK250322","","220","","1418852.52"
"2025-03-31","2025-03-22","SF FuneralFDC000000060R4250321","","126.5","","1418979.02"
"2025-03-31","2025-03-22","SF FuneralF1118051      250322","","126.5","","1419105.52"
"2025-03-31","2025-03-24","SF FuneralFDC00000005CYT250324","","126.5","","1419232.02"
"2025-03-31","2025-03-25","SF FuneralF843616       250325","","63.25","","1419295.27"
"2025-03-31","2025-03-25","SF FuneralF1074970      250325","","126.5","","1419421.77"
"2025-03-31","2025-03-25","SF FuneralF1126864      250325","","126.5","","1419548.27"
"2025-03-31","2025-03-26","SF FuneralF1021156      250326","","126.5","","1419674.77"
"2025-03-31","2025-03-27","SF FuneralFDC00000005NF7250327","","126.5","","1419801.27"
"2025-03-31","2025-03-27","SF FuneralFDC000000084B2250327","","126.5","","1419927.77"
"2025-03-31","2025-03-27","SF FuneralF1113598      250327","","126.5","","1420054.27"
"2025-03-31","2025-03-28","SF FuneralFDC000000082KC250328","","126.5","","1420180.77"
"2025-03-31","2025-03-28","SF FuneralFDC0000000888B250328","","126.5","","1420307.27"
"2025-03-31","2025-03-28","SF FuneralF1127958      250328","","126.5","","1420433.77"
"2025-03-31","2025-03-28","SF FuneralF1128071      250328","","126.5","","1420560.27"
"2025-03-31","2025-03-28","SF FuneralF1132809      250328","","126.5","","1420686.77"
"2025-03-31","2025-03-29","SF FuneralF1125978      250329","","126.5","","1420813.27"
"2025-03-31","2025-03-27","SF FuneralFDC0000000NK9S250327","","126.5","","1420939.77"
"2025-03-31","2025-03-29","SF FuneralFDC000000030FC250329","","220","","1421159.77"
"2025-03-31","2025-03-29","SF FuneralF794461       250329","","126.5","","1421286.27"
"2025-03-31","2025-03-29","SF FuneralF1021491      250330","","31.63","","1421317.9"
"2025-03-31","2025-03-29","SF FuneralF1102869      250329","","126.5","","1421444.4"
"2025-03-31","2025-03-29","SF FuneralF1102939      250329","","126.5","","1421570.9"
"2025-03-31","2025-03-27","SF FuneralFDC000000059D7250327","","126.5","","1421697.4"
"2025-03-31","2025-03-27","SF FuneralFDC00000005CNV250327","","365.12","","1422062.52"
"2025-03-31","2025-03-27","SF FuneralFDC00000005GZP250327","","126.5","","1422189.02"
"2025-03-31","2025-03-27","SF FuneralF811811       250327","","126.5","","1422315.52"
"2025-03-31","2025-03-27","SF FuneralF811986       250327","","126.5","","1422442.02"
"2025-03-31","2025-03-27","SF FuneralF814286       250327","","126.5","","1422568.52"
"2025-03-31","2025-03-27","SF FuneralF819920       250327","","126.5","","1422695.02"
"2025-03-31","2025-03-27","SF FuneralFDC0000000BX71250327","","126.5","","1422821.52"
"2025-03-31","2025-03-27","SF FuneralF831772       250327","","126.5","","1422948.02"
"2025-03-31","2025-03-27","SF FuneralFDC0000000HJT5250327","","126.5","","1423074.52"
"2025-03-31","2025-03-27","SF FuneralF1050697      250327","","126.5","","1423201.02"
"2025-03-31","2025-03-27","SF FuneralF1112441      250327","","126.5","","1423327.52"
"2025-03-31","2025-03-27","SF FuneralF1123074      250327","","126.5","","1423454.02"
"2025-03-31","2025-03-12","Rev SF FuneralFDC0000000QD4Y250312","","-126.5","","1423327.52"
"2025-03-31","2025-03-31","EFT-ABSA BANK 5006010045088","","126","","1423453.52"
"2025-03-31","2025-03-31","Fee-Administration","","-100","","1423353.52"
