"Txn date","Effective","Description","Truncated card number","Amount","Charges","Balance"
"2025-03-09","2025-02-27","SF FuneralF843298       250227","","126.5","","187747.76"
"2025-03-09","2025-03-07","SF FuneralFDC00000008NYM250307","","31.63","","187779.39"
"2025-03-09","2025-03-08","SF FuneralF1060024      250308","","31.63","","187811.02"
"2025-03-09","2025-03-03","SF FuneralF1072934      250303","","31.63","","187842.65"
"2025-03-09","2025-03-06","SF FuneralF1123949      250306","","31.63","","187874.28"
"2025-03-09","2025-03-07","SF FuneralF1073818      250307","","31.63","","187905.91"
"2025-03-09","2025-03-06","SF FuneralF832011       250306","","63.25","","187969.16"
"2025-03-09","2025-03-09","SF FuneralF833253       250309","","31.63","","188000.79"
"2025-03-09","2025-03-04","SF FuneralFDC00000005LTH250304","","64.5","","188065.29"
"2025-03-09","2025-03-07","SF FuneralFDC0000000L3MT250307","","31.63","","188096.92"
"2025-03-09","2025-03-04","SF FuneralFDC00000007CF7250304","","63.25","","188160.17"
"2025-03-09","2025-03-05","SF FuneralF1132911      250305","","31.63","","188191.8"
"2025-03-09","2025-03-01","SF FuneralFDC00000007PMH250301","","126.5","","188318.3"
"2025-03-09","2025-03-04","SF FuneralFDC0000000HXY2250304","","31.63","","188349.93"
"2025-03-10","2025-03-07","SF FuneralFDC00000007RD4250307","","31.63","","188381.56"
"2025-03-10","2025-03-07","SF FuneralF981670       250307","","31.63","","188413.19"
"2025-03-10","2025-03-07","SF FuneralF1104243      250307","","31.63","","188444.82"
"2025-03-10","2025-03-07","SF FuneralFDC00000005CSP250307","","63.25","","188508.07"
"2025-03-10","2025-03-07","SF FuneralFDC00000005HS9250307","","126.5","","188634.57"
"2025-03-10","2025-03-07","SF FuneralF844458       250307","","126.5","","188761.07"
"2025-03-10","2025-03-10","SF FuneralFDC00000006876250310","","126.5","","188887.57"
"2025-03-10","2025-03-10","SF FuneralFDC00000007R5Z250310","","63.25","","188950.82"
"2025-03-10","2025-03-10","SF FuneralF809717       250310","","63.25","","189014.07"
"2025-03-10","2025-03-10","SF FuneralF819950       250310","","63.25","","189077.32"
"2025-03-10","2025-03-10","SF FuneralF831977       250309","","126.5","","189203.82"
"2025-03-10","2025-03-10","SF FuneralF844597       250310","","63.25","","189267.07"
"2025-03-10","2025-03-10","SF FuneralF1020942      250310","","63.25","","189330.32"
"2025-03-10","2025-03-10","SF FuneralF1060914      250310","","63.25","","189393.57"
"2025-03-10","2025-03-10","SF FuneralF1104033      250310","","63.25","","189456.82"
"2025-03-10","2025-03-10","SF FuneralFDC0000000M9K6250310","","63.25","","189520.07"
"2025-03-10","2025-03-10","SF FuneralFDC0000000Q1FK250310","","126.5","","189646.57"
"2025-03-10","2025-03-10","SF FuneralF1130435      250310","","126.5","","189773.07"
"2025-03-10","2025-03-06","SF FuneralF1085168      250306","","31.63","","189804.7"
"2025-03-10","2025-03-07","SF FuneralF790399       250307","","47.88","","189852.58"
"2025-03-10","2025-03-07","SF FuneralF813030       250307","","31.63","","189884.21"
"2025-03-10","2025-03-07","SF FuneralF815340       250307","","31.63","","189915.84"
"2025-03-10","2025-03-07","SF FuneralF817463       250307","","31.63","","189947.47"
"2025-03-10","2025-03-07","SF FuneralF830931       250307","","31.63","","189979.1"
"2025-03-10","2025-03-07","SF FuneralF832185       250307","","31.63","","190010.73"
"2025-03-10","2025-03-07","SF FuneralF832777       250307","","31.63","","190042.36"
"2025-03-10","2025-03-07","SF FuneralF819053       250307","","31.63","","190073.99"
"2025-03-10","2025-03-07","SF FuneralF843596       250307","","31.63","","190105.62"
"2025-03-10","2025-03-07","SF FuneralFDC0000000FQWF250307","","31.63","","190137.25"
"2025-03-10","2025-03-07","SF FuneralF844636       250307","","31.63","","190168.88"
"2025-03-10","2025-03-07","SF FuneralFDC0000000HXHK250307","","47.88","","190216.76"
"2025-03-10","2025-03-07","SF FuneralF992752       250307","","31.63","","190248.39"
"2025-03-10","2025-03-07","SF FuneralF993205       250307","","31.63","","190280.02"
"2025-03-10","2025-03-07","SF FuneralF1033620      250307","","31.63","","190311.65"
"2025-03-10","2025-03-07","SF FuneralF1052348      250307","","31.63","","190343.28"
"2025-03-10","2025-03-07","SF FuneralFDC0000000KLCD250307","","31.63","","190374.91"
"2025-03-10","2025-03-07","SF FuneralF1068145      250307","","31.63","","190406.54"
"2025-03-10","2025-03-07","SF FuneralF1072884      250307","","31.63","","190438.17"
"2025-03-10","2025-03-07","SF FuneralF1073030      250307","","31.63","","190469.8"
"2025-03-10","2025-03-07","SF FuneralF1104196      250307","","31.63","","190501.43"
"2025-03-10","2025-03-07","SF FuneralF1111672      250307","","31.63","","190533.06"
"2025-03-10","2025-03-10","SF FuneralFDC00000007DSV250310","","31.63","","190564.69"
"2025-03-10","2025-03-10","SF FuneralF831617       250310","","31.63","","190596.32"
"2025-03-10","2025-03-10","SF FuneralF1017111      250310","","31.63","","190627.95"
"2025-03-10","2025-03-10","SF FuneralF1052812      250310","","31.63","","190659.58"
"2025-03-10","2025-03-10","SF FuneralF1060055      250310","","31.63","","190691.21"
"2025-03-10","2025-03-10","SF FuneralF1129452      250310","","31.63","","190722.84"
"2025-03-10","2025-03-04","SF FuneralF1104197      250304","","31.63","","190754.47"
"2025-03-10","2025-03-06","SF FuneralF1108113      250306","","31.63","","190786.1"
"2025-03-10","2025-03-07","SF FuneralFDC00000005GY1250307","","31.63","","190817.73"
"2025-03-10","2025-03-07","SF FuneralFDC00000005PXF250307","","31.63","","190849.36"
"2025-03-10","2025-03-07","SF FuneralFDC00000005QCT250307","","31.63","","190880.99"
"2025-03-10","2025-03-07","SF FuneralFDC00000005V4S250307","","31.63","","190912.62"
"2025-03-10","2025-03-07","SF FuneralFDC000000069RZ250307","","31.63","","190944.25"
"2025-03-10","2025-03-07","SF FuneralFDC00000006R81250307","","31.63","","190975.88"
"2025-03-10","2025-03-07","SF FuneralFDC00000007WBL250307","","31.63","","191007.51"
"2025-03-10","2025-03-07","SF FuneralFDC00000007WJL250307","","31.63","","191039.14"
"2025-03-10","2025-03-07","SF FuneralF795812       250307","","31.63","","191070.77"
"2025-03-10","2025-03-07","SF FuneralFDC000000086Y9250307","","31.63","","191102.4"
"2025-03-10","2025-03-07","SF FuneralF811119       250307","","31.63","","191134.03"
"2025-03-10","2025-03-07","SF FuneralF823750       250307","","31.63","","191165.66"
"2025-03-10","2025-03-07","SF FuneralF829118       250307","","31.63","","191197.29"
"2025-03-10","2025-03-07","SF FuneralFDC0000000HBD0250307","","31.63","","191228.92"
"2025-03-10","2025-03-07","SF FuneralFDC0000000J2XM250309","","31.63","","191260.55"
"2025-03-10","2025-03-07","SF FuneralFDC0000000JFC4250307","","31.63","","191292.18"
"2025-03-10","2025-03-07","SF FuneralF1065649      250307","","31.63","","191323.81"
"2025-03-10","2025-03-07","SF FuneralF1078056      250307","","31.63","","191355.44"
"2025-03-10","2025-03-07","SF FuneralF1084400      250307","","31.63","","191387.07"
"2025-03-10","2025-03-07","SF FuneralF1085355      250307","","31.63","","191418.7"
"2025-03-10","2025-03-07","SF FuneralF1115119      250307","","31.63","","191450.33"
"2025-03-10","2025-03-07","SF FuneralFDC0000000NNGY250307","","31.63","","191481.96"
"2025-03-10","2025-03-07","SF FuneralF1123008      250307","","31.63","","191513.59"
"2025-03-10","2025-03-07","SF FuneralF1123947      250307","","31.63","","191545.22"
"2025-03-10","2025-03-07","SF FuneralF1130369      250307","","31.63","","191576.85"
"2025-03-10","2025-03-07","SF FuneralF1130684      250307","","31.63","","191608.48"
"2025-03-10","2025-03-07","SF FuneralF1131198      250307","","31.63","","191640.11"
"2025-03-10","2025-03-07","SF FuneralF1131924      250307","","31.63","","191671.74"
"2025-03-10","2025-03-07","SF FuneralFDC0000000Q7FQ250307","","31.63","","191703.37"
"2025-03-10","2025-03-07","SF FuneralF1132194      250307","","31.63","","191735"
"2025-03-10","2025-03-07","SF FuneralFDC0000000Q9Z0250307","","31.63","","191766.63"
"2025-03-10","2025-03-07","SF FuneralF1132933      250307","","31.63","","191798.26"
"2025-03-10","2025-03-08","SF FuneralFDC00000006HHY250308","","31.63","","191829.89"
"2025-03-10","2025-03-08","SF FuneralFDC00000007G0S250308","","31.63","","191861.52"
"2025-03-10","2025-03-10","SF FuneralFDC00000005LS9250310","","31.63","","191893.15"
"2025-03-10","2025-03-10","SF FuneralFDC00000005NR4250310","","31.63","","191924.78"
"2025-03-10","2025-03-10","SF FuneralFDC00000005NT1250310","","31.63","","191956.41"
"2025-03-10","2025-03-10","SF FuneralFDC00000005RZQ250310","","31.63","","191988.04"
"2025-03-10","2025-03-10","SF FuneralFDC00000005XG9250310","","31.63","","192019.67"
"2025-03-10","2025-03-10","SF FuneralFDC000000071S5250310","","31.63","","192051.3"
"2025-03-10","2025-03-10","SF FuneralFDC00000007GS9250310","","31.63","","192082.93"
"2025-03-10","2025-03-10","SF FuneralF830431       250310","","31.63","","192114.56"
"2025-03-10","2025-03-10","SF FuneralF1052717      250310","","31.63","","192146.19"
"2025-03-10","2025-03-10","SF FuneralF1072928      250310","","31.63","","192177.82"
"2025-03-10","2025-03-10","SF FuneralF1072934      250310","","31.63","","192209.45"
"2025-03-10","2025-03-10","SF FuneralF1115136      250310","","31.63","","192241.08"
"2025-03-10","2025-03-10","SF FuneralF1117767      250310","","31.63","","192272.71"
"2025-03-10","2025-03-10","SF FuneralF1124411      250310","","31.63","","192304.34"
"2025-03-10","2025-03-07","SF FuneralF813620       250307","","126.5","","192430.84"
"2025-03-10","2025-03-10","SF FuneralFDC00000005LX1250309","","63.25","","192494.09"
"2025-03-10","2025-03-10","SF FuneralFDC00000005ZZL250309","","126.5","","192620.59"
"2025-03-10","2025-03-10","SF FuneralF1126313      250310","","63.25","","192683.84"
"2025-03-10","2025-03-10","SF FuneralFDC00000002XYZ250309","","55","","192738.84"
"2025-03-10","2025-03-10","SF FuneralFDC000000089G2250309","","31.63","","192770.47"
"2025-03-10","2025-03-10","SF FuneralFDC0000000MR2H250310","","31.63","","192802.1"
"2025-03-10","2025-03-10","SF FuneralF1113735      250310","","31.63","","192833.73"
"2025-03-10","2025-03-10","SF FuneralF1127801      250310","","31.63","","192865.36"
"2025-03-10","2025-03-07","SF FuneralFDC00000007G54250307","","31.63","","192896.99"
"2025-03-10","2025-03-07","SF FuneralF805319       250307","","31.63","","192928.62"
"2025-03-10","2025-03-07","SF FuneralF821927       250307","","31.63","","192960.25"
"2025-03-10","2025-03-07","SF FuneralF822337       250307","","126.5","","193086.75"
"2025-03-10","2025-03-07","SF FuneralF981626       250307","","126.5","","193213.25"
"2025-03-10","2025-03-07","SF FuneralF1123167      250307","","31.63","","193244.88"
"2025-03-10","2025-03-07","SF FuneralF1126869      250307","","31.63","","193276.51"
"2025-03-10","2025-03-10","SF FuneralFDC00000005LWP250309","","31.63","","193308.14"
"2025-03-10","2025-03-10","SF FuneralFDC00000005Z12250310","","31.63","","193339.77"
"2025-03-10","2025-03-10","SF FuneralFDC000000069CL250310","","31.63","","193371.4"
"2025-03-10","2025-03-10","SF FuneralF820956       250309","","31.63","","193403.03"
"2025-03-10","2025-03-07","SF FuneralFDC00000002WNP250307","","220","","193623.03"
"2025-03-10","2025-03-07","SF FuneralFDC00000005TX1250307","","31.63","","193654.66"
"2025-03-10","2025-03-07","SF FuneralFDC00000006NFW250307","","31.63","","193686.29"
"2025-03-10","2025-03-07","SF FuneralFDC00000007GX8250307","","126.5","","193812.79"
"2025-03-10","2025-03-07","SF FuneralF779346       250307","","31.63","","193844.42"
"2025-03-10","2025-03-07","SF FuneralFDC0000000L8NN250307","","31.63","","193876.05"
"2025-03-10","2025-03-07","SF FuneralFDC00000005J39250307","","126.5","","194002.55"
"2025-03-10","2025-03-07","SF FuneralFDC000000070CD250307","","31.63","","194034.18"
"2025-03-10","2025-03-07","SF FuneralFDC000000087TX250307","","126.5","","194160.68"
"2025-03-10","2025-03-07","SF FuneralF814074       250307","","31.63","","194192.31"
"2025-03-10","2025-03-07","SF FuneralF1104255      250307","","31.63","","194223.94"
"2025-03-10","2025-03-07","SF FuneralF1128672      250307","","31.63","","194255.57"
"2025-03-10","2025-03-10","SF FuneralFDC00000005NX7250310","","31.63","","194287.2"
"2025-03-10","2025-03-10","SF FuneralFDC00000006GNR250310","","31.63","","194318.83"
"2025-03-10","2025-03-10","SF FuneralFDC00000006XFM250310","","31.63","","194350.46"
"2025-03-10","2025-03-10","SF FuneralFDC0000000MSC7250310","","47.88","","194398.34"
"2025-03-10","2025-03-10","SF FuneralF1112136      250310","","31.63","","194429.97"
"2025-03-10","2025-02-27","SF FuneralF1109860      250227","","126.5","","194556.47"
"2025-03-10","2025-03-07","SF FuneralFDC000000088H0250307","","126.5","","194682.97"
"2025-03-10","2025-03-07","SF FuneralF822267       250307","","31.63","","194714.6"
"2025-03-10","2025-03-07","SF FuneralFDC0000000L8B0250307","","31.63","","194746.23"
"2025-03-10","2025-03-07","SF FuneralF1118177      250307","","126.5","","194872.73"
"2025-03-10","2025-03-07","SF FuneralF1122989      250307","","126.5","","194999.23"
"2025-03-10","2025-03-07","SF FuneralF1132255      250307","","31.63","","195030.86"
"2025-03-10","2025-03-08","SF FuneralF1060968      250309","","31.63","","195062.49"
"2025-03-10","2025-03-10","SF FuneralFDC00000005H8J250309","","31.63","","195094.12"
"2025-03-10","2025-03-04","SF FuneralF1016647      250304","","126.5","","195220.62"
"2025-03-10","2025-03-05","SF FuneralF987016       250305","","31.63","","195252.25"
"2025-03-10","2025-02-25","Rev SF FuneralFDC00000007NZG250225","","-126.5","","195125.75"
"2025-03-10","2025-02-28","Rev SF FuneralFDC00000007H55250228","","-126.5","","194999.25"
"2025-03-10","2025-03-04","Rev SF FuneralFDC00000008TJ6250304","","-126.5","","194872.75"
"2025-03-10","2025-03-04","Rev SF FuneralFDC0000000BG38250304","","-126.5","","194746.25"
"2025-03-10","2025-03-03","Rev SF FuneralFDC00000006GTL250302","","-126.5","","194619.75"
"2025-03-10","2025-02-21","Rev SF FuneralFDC0000000L3MT250221","","-31.63","","194588.12"
"2025-03-10","2025-03-07","Rev SF FuneralFDC0000000KLCD250307","","-31.63","","194556.49"
"2025-03-10","2025-03-07","Rev SF FuneralFDC0000000L3MT250307","","-31.63","","194524.86"
"2025-03-10","2025-03-07","Rev SF FuneralFDC0000000B37Y250307","","-31.63","","194493.23"
"2025-03-10","2025-03-07","Rev SF FuneralFDC00000007MW5250307","","-31.63","","194461.6"
"2025-03-10","2025-03-07","Rev SF FuneralFDC00000008NYM250307","","-31.63","","194429.97"
"2025-03-10","2025-03-04","Rev SF FuneralFDC00000008C95250304","","-31.63","","194398.34"
"2025-03-10","2025-02-28","Rev SF FuneralFDC00000006C6F250228","","-126.5","","194271.84"
"2025-03-10","2025-02-27","Rev SF FuneralFDC0000000BP51250227","","-126.5","","194145.34"
"2025-03-10","2025-02-28","Rev SF FuneralFDC00000006KVT250228","","-126.5","","194018.84"
"2025-03-10","2025-02-28","Rev SF FuneralFDC00000006KYZ250228","","-126.5","","193892.34"
"2025-03-10","2025-03-04","SF FuneralF1103795      250304","","31.63","","193923.97"
"2025-03-10","2025-03-07","SF FuneralFDC00000006NRD250307","","126.5","","194050.47"
"2025-03-10","2025-03-10","SF FuneralF834933       250310","","31.63","","194082.1"
"2025-03-10","2025-03-10","SF FuneralFDC0000000LJ60250310","","31.63","","194113.73"
"2025-03-10","2025-03-10","SF FuneralF1132115      250310","","31.63","","194145.36"
"2025-03-10","2024-12-23","Rev SF FuneralFDC00000006CQR241228","","-126.5","","194018.86"
"2025-03-10","2025-01-24","Rev SF FuneralFDC00000006CQR250128","","-126.5","","193892.36"
"2025-03-10","2025-03-04","SF FuneralF1073036      250304","","63.25","","193955.61"
"2025-03-10","2025-03-04","SF FuneralF1118312      250304","","63.25","","194018.86"
"2025-03-10","2025-03-07","SF FuneralFDC00000005HJM250307","","31.63","","194050.49"
"2025-03-10","2025-03-07","SF FuneralFDC00000006Q6W250307","","126.5","","194176.99"
"2025-03-10","2025-03-07","SF FuneralF815510       250307","","31.63","","194208.62"
"2025-03-10","2025-03-08","SF FuneralF814211       250308","","31.63","","194240.25"
"2025-03-10","2025-03-04","SF FuneralF1122605      250304","","31.63","","194271.88"
"2025-03-10","2025-03-07","SF FuneralFDC00000007Q3J250307","","126.5","","194398.38"
"2025-03-10","2025-03-07","SF FuneralFDC000000085Z5250307","","31.63","","194430.01"
"2025-03-10","2025-03-07","SF FuneralF1127614      250307","","31.63","","194461.64"
"2025-03-10","2025-03-07","SF FuneralF1132536      250307","","63.25","","194524.89"
"2025-03-10","2025-03-08","SF FuneralF1130825      250308","","31.63","","194556.52"
"2025-03-10","2025-03-10","SF FuneralFDC000000070Z5250309","","31.63","","194588.15"
"2025-03-10","2025-03-10","SF FuneralF799566       250309","","126.5","","194714.65"
"2025-03-10","2025-03-10","SF FuneralF841615       250310","","31.63","","194746.28"
"2025-03-10","2025-03-03","SF FuneralF901048       250303","","126.5","","194872.78"
"2025-03-10","2025-03-07","SF FuneralFDC00000005QYG250307","","63.25","","194936.03"
"2025-03-10","2025-03-07","SF FuneralF981788       250307","","31.63","","194967.66"
"2025-03-10","2025-03-07","SF FuneralF1130754      250307","","31.63","","194999.29"
"2025-03-10","2025-03-07","Rev SF FuneralFDC00000007RD4250307","","-31.63","","194967.66"
"2025-03-10","2025-02-28","Rev SF FuneralFDC00000005HJM250228","","-31.63","","194936.03"
"2025-03-10","2025-02-21","Rev SF FuneralFDC00000005HJM250221","","-31.63","","194904.4"
"2025-03-10","2025-02-25","Rev SF FuneralFDC000000079S6250225","","-31.63","","194872.77"
"2025-03-10","2025-03-07","Rev SF FuneralFDC00000005HJM250307","","-31.63","","194841.14"
"2025-03-10","2025-03-07","Rev SF FuneralFDC000000069RZ250307","","-31.63","","194809.51"
"2025-03-10","2025-03-10","Rev SF FuneralFDC00000005NT1250310","","-31.63","","194777.88"
"2025-03-10","2025-03-10","Rev SF FuneralFDC00000005XG9250310","","-31.63","","194746.25"
"2025-03-10","2025-03-07","Rev SF FuneralFDC0000000JFC4250307","","-31.63","","194714.62"
"2025-03-10","2025-02-22","Rev SF FuneralFDC000000094FC250222","","-126.5","","194588.12"
"2025-03-10","2025-03-07","Rev SF FuneralFDC00000006Q6W250307","","-126.5","","194461.62"
"2025-03-10","2025-03-10","Rev SF FuneralFDC00000007R5Z250310","","-63.25","","194398.37"
"2025-03-10","2025-03-10","Fee-Teller Transactions","","-15.82","","194382.55"
"2025-03-10","2025-03-10","Dep-Cash-7509300723080","","253","15.82","194635.55"
"2025-03-10","2025-03-07","SF FuneralF1079112      250307","","126.5","","194762.05"
"2025-03-10","2025-03-01","SF FuneralFDC00000007RQ9250301","","126.5","","194888.55"
"2025-03-11","2025-03-07","SF FuneralF1060095      250307","","63.25","","194951.8"
"2025-03-11","2025-03-08","SF FuneralFDC00000007445250308","","63.25","","195015.05"
"2025-03-11","2025-03-01","SF FuneralF1113781      250301","","126.5","","195141.55"
"2025-03-11","2025-03-07","SF FuneralF847452       250307","","31.63","","195173.18"
"2025-03-11","2025-03-07","SF FuneralFDC0000000JXHW250307","","126.5","","195299.68"
"2025-03-11","2025-03-07","SF FuneralF1022172      250307","","126.5","","195426.18"
"2025-03-11","2025-03-07","SF FuneralF1033704      250307","","31.63","","195457.81"
"2025-03-11","2025-03-07","SF FuneralF1061782      250307","","31.63","","195489.44"
"2025-03-11","2025-03-07","SF FuneralF1054780      250307","","31.63","","195521.07"
"2025-03-11","2025-03-07","SF FuneralF1121971      250307","","31.63","","195552.7"
"2025-03-11","2025-03-08","SF FuneralFDC00000006W3S250308","","126.5","","195679.2"
"2025-03-11","2025-03-08","SF FuneralF1054925      250309","","31.63","","195710.83"
"2025-03-11","2025-03-08","SF FuneralF1074576      250309","","31.63","","195742.46"
"2025-03-11","2025-03-10","SF FuneralFDC00000005F1K250310","","31.63","","195774.09"
"2025-03-11","2025-03-10","SF FuneralFDC00000006XRW250309","","63.25","","195837.34"
"2025-03-11","2025-03-10","SF FuneralF1131037      250310","","31.63","","195868.97"
"2025-03-11","2025-03-04","SF FuneralFDC00000007F8K250304","","63.25","","195932.22"
"2025-03-11","2025-03-07","SF FuneralFDC00000005VPZ250307","","31.63","","195963.85"
"2025-03-11","2025-03-07","SF FuneralFDC0000000HX7W250307","","31.63","","195995.48"
"2025-03-11","2025-03-07","SF FuneralF1129945      250307","","31.63","","196027.11"
"2025-03-11","2025-03-10","SF FuneralFDC00000005Z06250310","","31.63","","196058.74"
"2025-03-11","2025-03-10","SF FuneralFDC00000005Z25250310","","31.63","","196090.37"
"2025-03-11","2025-03-10","SF FuneralF1085023      250310","","63.25","","196153.62"
"2025-03-11","2025-03-07","SF FuneralF840580       250307","","31.63","","196185.25"
"2025-03-11","2025-03-03","SF FuneralF1083929      250303","","63.25","","196248.5"
"2025-03-11","2025-03-08","SF FuneralFDC00000005KXR250308","","31.63","","196280.13"
"2025-03-11","2025-03-11","SF FuneralFDC0000000455X250311","","55","","196335.13"
"2025-03-11","2025-03-11","SF FuneralFDC00000005P3Q250311","","31.63","","196366.76"
"2025-03-11","2025-03-11","SF FuneralFDC00000005YYS250311","","31.63","","196398.39"
"2025-03-11","2025-03-11","SF FuneralFDC00000007X30250311","","31.63","","196430.02"
"2025-03-11","2025-03-11","SF FuneralFDC00000007X31250311","","31.63","","196461.65"
"2025-03-11","2025-03-11","SF FuneralFDC00000007YZB250311","","31.63","","196493.28"
"2025-03-11","2025-03-11","SF FuneralFDC00000007ZD3250311","","31.63","","196524.91"
"2025-03-11","2025-03-11","SF FuneralFDC00000008H47250311","","31.63","","196556.54"
"2025-03-11","2025-03-11","SF FuneralFDC00000008YCZ250311","","31.63","","196588.17"
"2025-03-11","2025-03-11","SF FuneralF811401       250311","","31.63","","196619.8"
"2025-03-11","2025-03-11","SF FuneralF814338       250311","","31.63","","196651.43"
"2025-03-11","2025-03-11","SF FuneralF816835       250311","","31.63","","196683.06"
"2025-03-11","2025-03-11","SF FuneralF817293       250311","","31.63","","196714.69"
"2025-03-11","2025-03-11","SF FuneralFDC0000000BT1S250311","","31.63","","196746.32"
"2025-03-11","2025-03-11","SF FuneralFDC0000000CWFK250311","","31.63","","196777.95"
"2025-03-11","2025-03-11","SF FuneralF834203       250311","","31.63","","196809.58"
"2025-03-11","2025-03-11","SF FuneralFDC0000000HK7D250311","","31.63","","196841.21"
"2025-03-11","2025-03-11","SF FuneralFDC0000000HN9N250311","","31.63","","196872.84"
"2025-03-11","2025-03-11","SF FuneralF990591       250311","","31.63","","196904.47"
"2025-03-11","2025-03-11","SF FuneralF991480       250311","","31.63","","196936.1"
"2025-03-11","2025-03-11","SF FuneralF1060838      250311","","31.63","","196967.73"
"2025-03-11","2025-03-11","SF FuneralF1068212      250311","","31.63","","196999.36"
"2025-03-11","2025-03-11","SF FuneralFDC0000000L0TL250311","","31.63","","197030.99"
"2025-03-11","2025-03-11","SF FuneralFDC0000000L0TM250311","","31.63","","197062.62"
"2025-03-11","2025-03-11","SF FuneralF1073801      250311","","31.63","","197094.25"
"2025-03-11","2025-03-11","SF FuneralF1079259      250311","","31.63","","197125.88"
"2025-03-11","2025-03-11","SF FuneralF1080246      250311","","31.63","","197157.51"
"2025-03-11","2025-03-11","SF FuneralF1113741      250311","","31.63","","197189.14"
"2025-03-11","2025-03-11","SF FuneralF1118338      250311","","31.63","","197220.77"
"2025-03-11","2025-03-11","SF FuneralF1122605      250311","","31.63","","197252.4"
"2025-03-11","2025-03-11","SF FuneralF1126072      250311","","31.63","","197284.03"
"2025-03-11","2025-03-11","SF FuneralF1128762      250311","","31.63","","197315.66"
"2025-03-11","2025-03-11","SF FuneralF1130733      250311","","31.63","","197347.29"
"2025-03-11","2025-03-11","SF FuneralF743038       250311","","31.63","","197378.92"
"2025-03-11","2025-03-11","SF FuneralF1131798      250311","","31.63","","197410.55"
"2025-03-11","2025-03-11","SF FuneralF1133759      250311","","31.63","","197442.18"
"2025-03-11","2025-03-04","SF FuneralF1084538      250304","","126.5","","197568.68"
"2025-03-11","2025-03-11","SF FuneralFDC000000069HF250311","","126.5","","197695.18"
"2025-03-11","2025-03-11","SF FuneralFDC00000006FKH250311","","63.25","","197758.43"
"2025-03-11","2025-03-11","SF FuneralFDC00000006NCH250311","","63.25","","197821.68"
"2025-03-11","2025-03-11","SF FuneralFDC000000072YQ250311","","63.25","","197884.93"
"2025-03-11","2025-03-11","SF FuneralFDC0000000G5YG250311","","126.5","","198011.43"
"2025-03-11","2025-03-11","SF FuneralF990246       250311","","63.25","","198074.68"
"2025-03-11","2025-03-11","SF FuneralF1020991      250311","","63.25","","198137.93"
"2025-03-11","2025-03-11","SF FuneralF1052117      250311","","63.25","","198201.18"
"2025-03-11","2025-03-11","SF FuneralF1111528      250311","","63.25","","198264.43"
"2025-03-11","2025-03-11","SF FuneralF1119864      250311","","63.25","","198327.68"
"2025-03-11","2025-03-11","SF FuneralF1129403      250311","","63.25","","198390.93"
"2025-03-11","2025-03-11","SF FuneralF808312       250311","","63.25","","198454.18"
"2025-03-11","2025-03-11","SF FuneralF1021427      250311","","63.25","","198517.43"
"2025-03-11","2025-03-11","SF FuneralF1067947      250311","","63.25","","198580.68"
"2025-03-11","2025-03-11","SF FuneralF1134431      250311","","63.25","","198643.93"
"2025-03-11","2025-03-11","SF FuneralF1134471      250311","","63.25","","198707.18"
"2025-03-11","2025-03-11","SF FuneralF818153       250311","","31.63","","198738.81"
"2025-03-11","2025-03-11","SF FuneralF1110349      250311","","31.63","","198770.44"
"2025-03-11","2025-03-11","SF FuneralF1115080      250311","","63.25","","198833.69"
"2025-03-11","2025-03-11","SF FuneralF1125777      250311","","31.63","","198865.32"
"2025-03-11","2025-03-11","SF FuneralFDC0000000QHS5250311","","31.63","","198896.95"
"2025-03-11","2025-03-11","SF FuneralFDC0000000QHS1250311","","31.63","","198928.58"
"2025-03-11","2025-03-07","SF FuneralF833636       250307","","126.5","","199055.08"
"2025-03-11","2025-03-11","SF FuneralFDC0000000892D250311","","31.63","","199086.71"
"2025-03-11","2025-03-11","SF FuneralFDC00000008C4Y250311","","63.25","","199149.96"
"2025-03-11","2025-03-11","SF FuneralFDC0000000BP65250311","","63.25","","199213.21"
"2025-03-11","2025-03-11","SF FuneralF829557       250311","","31.63","","199244.84"
"2025-03-11","2025-03-11","SF FuneralF986694       250311","","31.63","","199276.47"
"2025-03-11","2025-03-11","SF FuneralF1061075      250311","","31.63","","199308.1"
"2025-03-11","2025-03-11","SF FuneralFDC0000000ML7D250311","","31.63","","199339.73"
"2025-03-11","2025-03-11","SF FuneralF1110796      250311","","31.63","","199371.36"
"2025-03-11","2025-03-11","SF FuneralFDC0000000N8HR250311","","63.25","","199434.61"
"2025-03-11","2025-03-11","SF FuneralF1123172      250311","","31.63","","199466.24"
"2025-03-11","2025-03-11","SF FuneralF1130345      250311","","31.63","","199497.87"
"2025-03-11","2025-03-07","SF FuneralF986938       250307","","126.5","","199624.37"
"2025-03-11","2025-03-10","SF FuneralF790662       250310","","126.5","","199750.87"
"2025-03-11","2025-03-11","SF FuneralF804091       250311","","31.63","","199782.5"
"2025-03-11","2025-03-11","SF FuneralF1084859      250311","","31.63","","199814.13"
"2025-03-11","2025-03-11","SF FuneralF1111603      250311","","31.63","","199845.76"
"2025-03-11","2025-03-11","SF FuneralFDC00000002Y4M250311","","55","","199900.76"
"2025-03-11","2025-03-11","SF FuneralFDC000000061YD250311","","31.63","","199932.39"
"2025-03-11","2025-03-11","SF FuneralFDC000000080WH250311","","31.63","","199964.02"
"2025-03-11","2025-03-11","SF FuneralF815108       250311","","63.25","","200027.27"
"2025-03-11","2025-03-11","SF FuneralF990232       250311","","31.63","","200058.9"
"2025-03-11","2025-03-11","SF FuneralF1020916      250311","","31.63","","200090.53"
"2025-03-11","2025-03-11","SF FuneralF1080286      250311","","31.63","","200122.16"
"2025-03-11","2025-03-11","SF FuneralF1108251      250311","","31.63","","200153.79"
"2025-03-11","2025-03-11","SF FuneralF1115105      250311","","31.63","","200185.42"
"2025-03-11","2025-03-11","SF FuneralF1083898      250311","","63.25","","200248.67"
"2025-03-11","2025-03-11","SF FuneralF1115126      250311","","63.25","","200311.92"
"2025-03-11","2025-03-11","SF FuneralF1115749      250311","","31.63","","200343.55"
"2025-03-11","2025-03-11","SF FuneralF1127485      250311","","31.63","","200375.18"
"2025-03-11","2025-03-11","SF FuneralF1128977      250311","","126.5","","200501.68"
"2025-03-11","2025-03-11","SF FuneralF1129103      250311","","31.63","","200533.31"
"2025-03-11","2025-03-11","SF FuneralF1132314      250311","","31.63","","200564.94"
"2025-03-11","2025-03-11","Supreme Refunds","","-15242.52","","185322.42"
"2025-03-11","2025-03-11","Fee-Txn Notify E-Mail","","-1","","185321.42"
"2025-03-11","2025-03-07","Rev SF FuneralFDC0000000NNGY250307","","-31.63","","185289.79"
"2025-03-11","2025-03-10","Rev SF FuneralFDC0000000LJ60250310","","-31.63","","185258.16"
"2025-03-11","2025-02-20","Rev SF FuneralFDC00000008VQQ250220","","-126.5","","185131.66"
"2025-03-11","2024-12-11","Rev SF FuneralF1060639      241222","","-126.5","","185005.16"
"2025-03-11","2025-03-08","SF FuneralF1125662      250308","","31.63","","185036.79"
"2025-03-11","2025-03-10","SF FuneralF803226       250310","","31.63","","185068.42"
"2025-03-11","2025-03-10","SF FuneralF1125923      250310","","31.63","","185100.05"
"2025-03-11","2025-03-11","SF FuneralFDC00000006H1Y250311","","31.63","","185131.68"
"2025-03-11","2025-03-11","SF FuneralF834400       250311","","126.5","","185258.18"
"2025-03-11","2025-03-11","SF FuneralFDC0000000HXY2250311","","31.63","","185289.81"
"2025-03-11","2025-03-11","SF FuneralF1121908      250311","","31.63","","185321.44"
"2025-03-11","2025-03-11","SF FuneralF802295       250311","","31.63","","185353.07"
"2025-03-11","2025-03-11","SF FuneralFDC0000000G8NQ250311","","126.5","","185479.57"
"2025-03-11","2025-03-11","SF FuneralFDC0000000NT58250311","","31.63","","185511.2"
"2025-03-11","2025-03-07","SF FuneralFDC000000072CV250307","","126.5","","185637.7"
"2025-03-11","2025-03-11","SF FuneralF987244       250311","","31.63","","185669.33"
"2025-03-11","2025-03-08","SF FuneralFDC0000000NLY9250308","","31.63","","185700.96"
"2025-03-11","2025-03-08","SF FuneralF1117993      250308","","31.63","","185732.59"
"2025-03-11","2025-03-11","SF FuneralF1060950      250311","","31.63","","185764.22"
"2025-03-11","2025-03-08","SF FuneralF832932       250308","","31.63","","185795.85"
"2025-03-11","2025-03-11","SF FuneralFDC000000064P9250311","","31.63","","185827.48"
"2025-03-11","2025-03-11","SF FuneralF1050833      250311","","31.63","","185859.11"
"2025-03-11","2025-03-11","SF FuneralF1131019      250311","","63.25","","185922.36"
"2025-03-11","2025-03-11","Rev SF FuneralFDC0000000HN9N250311","","-31.63","","185890.73"
"2025-03-11","2025-03-07","Rev SF FuneralFDC000000072CV250307","","-126.5","","185764.23"
"2025-03-11","2025-03-01","Rev SF FuneralFDC0000000PVPN250301","","-126.5","","185637.73"
"2025-03-11","2025-02-26","Rev SF FuneralFDC00000005J71250226","","-126.5","","185511.23"
"2025-03-11","2024-12-11","Rev SF FuneralFDC0000000NJ9V241228","","-126.5","","185384.73"
"2025-03-11","2025-03-01","Rev SF FuneralFDC00000008LKW250301","","-191.5","","185193.23"
"2025-03-11","2025-01-27","Rev SF FuneralFDC00000005J71250126","","-126.5","","185066.73"
"2025-03-11","2025-03-11","Rev SF FuneralFDC0000000G5YG250311","","-126.5","","184940.23"
"2025-03-11","2025-03-11","Rev SF FuneralFDC0000000G8NQ250311","","-126.5","","184813.73"
"2025-03-11","2025-03-10","SF FuneralF987492       250310","","31.63","","184845.36"
"2025-03-11","2025-03-11","SF FuneralF1131796      250311","","31.63","","184876.99"
"2025-03-12","2025-03-10","SF FuneralFDC00000006X3B250309","","126.5","","185003.49"
"2025-03-12","2025-03-10","SF FuneralF819085       250310","","63.25","","185066.74"
"2025-03-12","2025-03-08","SF FuneralF1130776      250308","","31.63","","185098.37"
"2025-03-12","2025-03-08","SF FuneralFDC00000005MWG250308","","31.63","","185130"
"2025-03-12","2025-03-10","SF FuneralF1123098      250310","","31.63","","185161.63"
"2025-03-12","2025-03-11","SF FuneralF844564       250311","","63.25","","185224.88"
"2025-03-12","2025-03-08","SF FuneralF1127843      250308","","31.63","","185256.51"
"2025-03-12","2025-03-10","SF FuneralFDC0000000376D250310","","55","","185311.51"
"2025-03-12","2025-03-10","SF FuneralFDC000000086PX250309","","31.63","","185343.14"
"2025-03-12","2025-03-10","SF FuneralF816565       250310","","31.63","","185374.77"
"2025-03-12","2025-03-10","SF FuneralF988318       250310","","31.63","","185406.4"
"2025-03-12","2025-03-10","SF FuneralF1123166      250310","","31.63","","185438.03"
"2025-03-12","2025-03-11","SF FuneralF1080249      250311","","31.63","","185469.66"
"2025-03-12","2025-03-11","SF FuneralF1129356      250311","","31.63","","185501.29"
"2025-03-12","2025-03-11","SF FuneralFDC0000000Q9MX250311","","126.5","","185627.79"
"2025-03-12","2025-03-10","SF FuneralF834627       250309","","31.63","","185659.42"
"2025-03-12","2025-03-10","SF FuneralF1068281      250310","","63.25","","185722.67"
"2025-03-12","2025-03-11","SF FuneralF1129391      250311","","126.5","","185849.17"
"2025-03-12","2025-03-11","SF FuneralF1132021      250311","","126.5","","185975.67"
"2025-03-12","2025-03-12","SF FuneralFDC00000005HS0250312","","126.5","","186102.17"
"2025-03-12","2025-03-12","SF FuneralFDC00000005LH2250312","","126.5","","186228.67"
"2025-03-12","2025-03-12","SF FuneralFDC00000005LN8250312","","191.5","","186420.17"
"2025-03-12","2025-03-12","SF FuneralFDC00000005SN0250312","","126.5","","186546.67"
"2025-03-12","2025-03-12","SF FuneralFDC0000000635J250312","","126.5","","186673.17"
"2025-03-12","2025-03-12","SF FuneralFDC0000000635T250312","","126.5","","186799.67"
"2025-03-12","2025-03-12","SF FuneralFDC00000006S1V250312","","126.5","","186926.17"
"2025-03-12","2025-03-12","SF FuneralFDC00000006XBS250312","","126.5","","187052.67"
"2025-03-12","2025-03-12","SF FuneralFDC000000083R0250312","","126.5","","187179.17"
"2025-03-12","2025-03-12","SF FuneralFDC000000089MZ250312","","126.5","","187305.67"
"2025-03-12","2025-03-12","SF FuneralF811783       250312","","126.5","","187432.17"
"2025-03-12","2025-03-12","SF FuneralF818343       250312","","126.5","","187558.67"
"2025-03-12","2025-03-12","SF FuneralF819057       250312","","126.5","","187685.17"
"2025-03-12","2025-03-12","SF FuneralF820222       250312","","126.5","","187811.67"
"2025-03-12","2025-03-12","SF FuneralF829893       250312","","126.5","","187938.17"
"2025-03-12","2025-03-12","SF FuneralF830056       250312","","126.5","","188064.67"
"2025-03-12","2025-03-12","SF FuneralF830097       250312","","126.5","","188191.17"
"2025-03-12","2025-03-12","SF FuneralF844079       250312","","126.5","","188317.67"
"2025-03-12","2025-03-12","SF FuneralF989251       250312","","126.5","","188444.17"
"2025-03-12","2025-03-12","SF FuneralF1054697      250312","","126.5","","188570.67"
"2025-03-12","2025-03-12","SF FuneralF1111478      250312","","126.5","","188697.17"
"2025-03-12","2025-03-12","SF FuneralF1120683      250312","","126.5","","188823.67"
"2025-03-12","2025-03-12","SF FuneralFDC0000000P3M1250312","","126.5","","188950.17"
"2025-03-12","2025-03-12","SF FuneralF1123405      250312","","126.5","","189076.67"
"2025-03-12","2025-03-12","SF FuneralF1124154      250312","","126.5","","189203.17"
"2025-03-12","2025-03-12","SF FuneralF1129277      250312","","126.5","","189329.67"
"2025-03-12","2025-03-12","SF FuneralFDC0000000QG63250312","","126.5","","189456.17"
"2025-03-12","2025-03-12","SF FuneralF1114763      250312","","126.5","","189582.67"
"2025-03-12","2025-03-12","SF FuneralFDC00000005N1S250312","","126.5","","189709.17"
"2025-03-12","2025-03-12","SF FuneralFDC00000005NJY250312","","126.5","","189835.67"
"2025-03-12","2025-03-12","SF FuneralFDC00000006D8W250312","","126.5","","189962.17"
"2025-03-12","2025-03-12","SF FuneralFDC00000006K30250312","","126.5","","190088.67"
"2025-03-12","2025-03-12","SF FuneralFDC00000006LX0250312","","126.5","","190215.17"
"2025-03-12","2025-03-12","SF FuneralFDC00000006PPH250312","","126.5","","190341.67"
"2025-03-12","2025-03-12","SF FuneralFDC00000006S9F250312","","126.5","","190468.17"
"2025-03-12","2025-03-12","SF FuneralFDC0000000811C250312","","126.5","","190594.67"
"2025-03-12","2025-03-12","SF FuneralF803533       250312","","126.5","","190721.17"
"2025-03-12","2025-03-12","SF FuneralFDC00000008Q6Q250312","","126.5","","190847.67"
"2025-03-12","2025-03-12","SF FuneralF989024       250312","","126.5","","190974.17"
"2025-03-12","2025-03-12","SF FuneralF1020450      250312","","126.5","","191100.67"
"2025-03-12","2025-03-12","SF FuneralFDC00000005LYY250312","","126.5","","191227.17"
"2025-03-12","2025-03-12","SF FuneralFDC0000000645D250312","","126.5","","191353.67"
"2025-03-12","2025-03-12","SF FuneralFDC000000072NS250312","","126.5","","191480.17"
"2025-03-12","2025-03-12","SF FuneralFDC00000007DLP250312","","126.5","","191606.67"
"2025-03-12","2025-03-12","SF FuneralFDC00000007PTW250312","","63.25","","191669.92"
"2025-03-12","2025-03-12","SF FuneralF800659       250312","","126.5","","191796.42"
"2025-03-12","2025-03-12","SF FuneralF808125       250312","","126.5","","191922.92"
"2025-03-12","2025-03-12","SF FuneralF808156       250312","","126.5","","192049.42"
"2025-03-12","2025-03-12","SF FuneralF809457       250312","","126.5","","192175.92"
"2025-03-12","2025-03-12","SF FuneralF834870       250312","","126.5","","192302.42"
"2025-03-12","2025-03-12","SF FuneralF990679       250312","","126.5","","192428.92"
"2025-03-12","2025-03-12","SF FuneralFDC0000000JZPH250312","","126.5","","192555.42"
"2025-03-12","2025-03-12","SF FuneralFDC0000000L73H250312","","126.5","","192681.92"
"2025-03-12","2025-03-12","SF FuneralF1080153      250312","","126.5","","192808.42"
"2025-03-12","2025-03-12","SF FuneralF1104188      250312","","126.5","","192934.92"
"2025-03-12","2025-03-12","SF FuneralF1111918      250312","","126.5","","193061.42"
"2025-03-12","2025-03-12","SF FuneralF844482       250312","","126.5","","193187.92"
"2025-03-12","2025-03-10","SF FuneralF1111402      250310","","63.25","","193251.17"
"2025-03-12","2025-03-08","SF FuneralF1074785      250308","","31.63","","193282.8"
"2025-03-12","2025-03-12","SF FuneralFDC000000037DQ250312","","220","","193502.8"
"2025-03-12","2025-03-12","SF FuneralFDC00000005J2J250312","","126.5","","193629.3"
"2025-03-12","2025-03-12","SF FuneralFDC00000005M50250312","","126.5","","193755.8"
"2025-03-12","2025-03-12","SF FuneralFDC00000005Z5K250312","","126.5","","193882.3"
"2025-03-12","2025-03-12","SF FuneralFDC0000000652G250312","","126.5","","194008.8"
"2025-03-12","2025-03-12","SF FuneralFDC00000006HXF250312","","126.5","","194135.3"
"2025-03-12","2025-03-12","SF FuneralFDC00000006ND7250312","","126.5","","194261.8"
"2025-03-12","2025-03-12","SF FuneralFDC00000006XVB250312","","126.5","","194388.3"
"2025-03-12","2025-03-12","SF FuneralFDC00000007D6T250312","","126.5","","194514.8"
"2025-03-12","2025-03-12","SF FuneralFDC00000007XCB250312","","126.5","","194641.3"
"2025-03-12","2025-03-12","SF FuneralF819285       250312","","126.5","","194767.8"
"2025-03-12","2025-03-12","SF FuneralFDC0000000BG87250312","","126.5","","194894.3"
"2025-03-12","2025-03-12","SF FuneralF989967       250312","","126.5","","195020.8"
"2025-03-12","2025-03-12","SF FuneralF990178       250312","","126.5","","195147.3"
"2025-03-12","2025-03-12","SF FuneralF1060909      250312","","126.5","","195273.8"
"2025-03-12","2025-03-12","SF FuneralF1083739      250312","","126.5","","195400.3"
"2025-03-12","2025-03-12","SF FuneralF1110717      250312","","126.5","","195526.8"
"2025-03-12","2025-03-11","SF FuneralF993703       250311","","63.25","","195590.05"
"2025-03-12","2025-03-12","SF FuneralFDC00000005N61250312","","126.5","","195716.55"
"2025-03-12","2025-03-12","SF FuneralFDC0000000618X250312","","126.5","","195843.05"
"2025-03-12","2025-03-12","SF FuneralFDC0000000619C250312","","126.5","","195969.55"
"2025-03-12","2025-03-12","SF FuneralF804247       250312","","126.5","","196096.05"
"2025-03-12","2025-03-12","SF FuneralF834337       250312","","126.5","","196222.55"
"2025-03-12","2025-03-12","SF FuneralFDC0000000GFXY250312","","126.5","","196349.05"
"2025-03-12","2025-03-12","SF FuneralFDC0000000GP6C250312","","126.5","","196475.55"
"2025-03-12","2025-03-12","SF FuneralFDC0000000PVCY250312","","126.5","","196602.05"
"2025-03-12","2025-03-10","SF FuneralFDC000000042HH250309","","55","","196657.05"
"2025-03-12","2025-03-12","SF FuneralFDC00000002XF4250312","","220","","196877.05"
"2025-03-12","2025-03-12","SF FuneralFDC00000005Q8W250312","","126.5","","197003.55"
"2025-03-12","2025-03-12","SF FuneralFDC0000000681T250312","","126.5","","197130.05"
"2025-03-12","2025-03-12","SF FuneralFDC00000007GSK250312","","126.5","","197256.55"
"2025-03-12","2025-03-12","SF FuneralFDC00000007GSM250312","","126.5","","197383.05"
"2025-03-12","2025-03-12","SF FuneralFDC00000007YXC250312","","126.5","","197509.55"
"2025-03-12","2025-03-12","SF FuneralF797631       250312","","126.5","","197636.05"
"2025-03-12","2025-03-12","SF FuneralFDC00000008BBJ250312","","126.5","","197762.55"
"2025-03-12","2025-03-12","SF FuneralF844427       250312","","126.5","","197889.05"
"2025-03-12","2025-03-12","SF FuneralF1074876      250312","","126.5","","198015.55"
"2025-03-12","2025-03-12","SF FuneralF1120307      250312","","126.5","","198142.05"
"2025-03-12","2025-03-12","SF FuneralF1124778      250312","","126.5","","198268.55"
"2025-03-12","2025-03-12","SF FuneralFDC0000000Q1BK250312","","126.5","","198395.05"
"2025-03-12","2025-03-07","SF FuneralF843410       250307","","31.63","","198426.68"
"2025-03-12","2025-03-12","SF FuneralFDC00000005HWH250312","","126.5","","198553.18"
"2025-03-12","2025-03-12","SF FuneralFDC00000005J86250312","","126.5","","198679.68"
"2025-03-12","2025-03-12","SF FuneralFDC00000005J87250312","","126.5","","198806.18"
"2025-03-12","2025-03-12","SF FuneralFDC00000005JKG250312","","126.5","","198932.68"
"2025-03-12","2025-03-12","SF FuneralFDC00000005V14250312","","126.5","","199059.18"
"2025-03-12","2025-03-12","SF FuneralFDC00000006JL4250312","","126.5","","199185.68"
"2025-03-12","2025-03-12","SF FuneralF812983       250312","","126.5","","199312.18"
"2025-03-12","2025-03-12","SF FuneralF819111       250312","","31.63","","199343.81"
"2025-03-12","2025-03-12","SF FuneralFDC0000000BMHJ250312","","126.5","","199470.31"
"2025-03-12","2025-03-12","SF FuneralF1060977      250312","","126.5","","199596.81"
"2025-03-12","2025-03-12","SF FuneralF1103739      250312","","126.5","","199723.31"
"2025-03-12","2025-03-05","Rev SF FuneralFDC0000000LG2D250305","","-31.63","","199691.68"
"2025-03-12","2025-01-24","Rev SF FuneralFDC00000006JY2250128","","-126.5","","199565.18"
"2025-03-12","2025-02-28","Rev SF FuneralFDC00000006JY2250228","","-126.5","","199438.68"
"2025-03-12","2025-03-11","Rev SF FuneralFDC0000000Q9MX250311","","-126.5","","199312.18"
"2025-03-12","2025-03-10","Rev SF FuneralFDC0000000Q1FK250310","","-126.5","","199185.68"
"2025-03-12","2025-03-07","Rev SF FuneralFDC0000000JXHW250307","","-126.5","","199059.18"
"2025-03-12","2025-03-11","SF FuneralFDC00000008M07250311","","31.63","","199090.81"
"2025-03-12","2025-03-11","SF FuneralFDC00000008M09250311","","31.63","","199122.44"
"2025-03-12","2025-03-12","SF FuneralFDC00000005L04250312","","126.5","","199248.94"
"2025-03-12","2025-03-12","SF FuneralFDC00000005RWQ250312","","126.5","","199375.44"
"2025-03-12","2025-03-12","SF FuneralFDC00000006ZBD250312","","126.5","","199501.94"
"2025-03-12","2025-03-12","SF FuneralFDC00000007C54250312","","126.5","","199628.44"
"2025-03-12","2025-03-12","SF FuneralF818175       250312","","126.5","","199754.94"
"2025-03-12","2025-03-12","SF FuneralF821224       250312","","126.5","","199881.44"
"2025-03-12","2025-03-12","SF FuneralF829959       250312","","126.5","","200007.94"
"2025-03-12","2025-03-12","SF FuneralF1073395      250312","","126.5","","200134.44"
"2025-03-12","2025-03-12","SF FuneralF1112131      250312","","126.5","","200260.94"
"2025-03-12","2025-03-12","SF FuneralFDC00000008HDY250312","","126.5","","200387.44"
"2025-03-12","2025-03-12","SF FuneralFDC0000000N9YT250312","","126.5","","200513.94"
"2025-03-12","2025-03-07","SF FuneralFDC0000000N8V4250307","","126.5","","200640.44"
"2025-03-12","2025-03-08","SF FuneralF784736       250308","","31.63","","200672.07"
"2025-03-12","2025-03-10","SF FuneralFDC00000009G6B250309","","31.63","","200703.7"
"2025-03-12","2025-03-10","SF FuneralFDC00000009G6R250310","","31.63","","200735.33"
"2025-03-12","2025-03-11","SF FuneralFDC0000000690Q250311","","31.63","","200766.96"
"2025-03-12","2025-03-12","SF FuneralFDC00000005N53250312","","126.5","","200893.46"
"2025-03-12","2025-03-12","SF FuneralFDC00000007DMT250312","","31.63","","200925.09"
"2025-03-12","2025-03-12","SF FuneralF1016865      250312","","126.5","","201051.59"
"2025-03-12","2025-03-11","SF FuneralF1068221      250311","","31.63","","201083.22"
"2025-03-12","2025-03-10","SF FuneralFDC00000005NKJ250310","","31.63","","201114.85"
"2025-03-12","2025-03-04","SF FuneralF808898       250304","","63.25","","201178.1"
"2025-03-12","2025-03-10","SF FuneralFDC00000007BGG250309","","31.63","","201209.73"
"2025-03-12","2025-03-10","SF FuneralF804824       250309","","126.5","","201336.23"
"2025-03-12","2025-03-10","SF FuneralF832990       250309","","31.63","","201367.86"
"2025-03-12","2025-03-10","SF FuneralF1119088      250310","","31.63","","201399.49"
"2025-03-12","2025-03-10","SF FuneralF1124140      250310","","31.63","","201431.12"
"2025-03-12","2025-03-11","SF FuneralF821871       250311","","63.25","","201494.37"
"2025-03-12","2025-03-12","SF FuneralFDC00000005X31250312","","126.5","","201620.87"
"2025-03-12","2025-03-12","SF FuneralFDC00000005YWK250312","","126.5","","201747.37"
"2025-03-12","2025-03-12","SF FuneralFDC00000007M3B250312","","126.5","","201873.87"
"2025-03-12","2025-03-12","SF FuneralFDC0000000LM22250312","","126.5","","202000.37"
"2025-03-12","2025-03-12","SF FuneralFDC0000000Q96W250312","","126.5","","202126.87"
"2025-03-12","2025-03-12","SF FuneralFDC000000031P9250312","","220","","202346.87"
"2025-03-12","2025-03-04","SF FuneralF1118294      250304","","126.5","","202473.37"
"2025-03-12","2025-03-12","SF FuneralF838848       250312","","126.5","","202599.87"
"2025-03-12","2025-03-08","SF FuneralFDC00000007VKH250308","","31.63","","202631.5"
"2025-03-12","2025-03-08","SF FuneralF1079004      250309","","31.63","","202663.13"
"2025-03-12","2025-03-08","SF FuneralF1108038      250308","","126.5","","202789.63"
"2025-03-12","2025-03-08","SF FuneralF1114548      250309","","126.5","","202916.13"
"2025-03-12","2025-03-10","SF FuneralFDC00000006RQ8250309","","31.63","","202947.76"
"2025-03-12","2025-03-10","SF FuneralFDC00000006SV7250309","","31.63","","202979.39"
"2025-03-12","2025-03-10","SF FuneralFDC000000080YP250309","","63.25","","203042.64"
"2025-03-12","2025-03-10","SF FuneralF804126       250310","","31.63","","203074.27"
"2025-03-12","2025-03-10","SF FuneralFDC00000009XWR250309","","31.63","","203105.9"
"2025-03-12","2025-03-10","SF FuneralFDC0000000F7T2250310","","31.63","","203137.53"
"2025-03-12","2025-03-11","SF FuneralF1130870      250311","","31.63","","203169.16"
"2025-03-12","2025-03-12","SF FuneralF800591       250312","","126.5","","203295.66"
"2025-03-12","2025-03-12","SF FuneralFDC0000000CNBM250312","","126.5","","203422.16"
"2025-03-12","2025-03-12","SF FuneralF1016830      250312","","126.5","","203548.66"
"2025-03-12","2025-03-12","SF FuneralF1065827      250312","","63.25","","203611.91"
"2025-03-12","2025-02-18","Rev SF FuneralFDC0000000PFVZ250218","","-126.5","","203485.41"
"2025-03-12","2025-03-12","Rev SF FuneralFDC00000005SN0250312","","-126.5","","203358.91"
"2025-03-12","2025-03-12","Rev SF FuneralFDC0000000Q96W250312","","-126.5","","203232.41"
"2025-03-12","2025-03-12","Rev SF FuneralFDC0000000LM22250312","","-126.5","","203105.91"
"2025-03-12","2025-03-12","Rev SF FuneralFDC00000005N1S250312","","-126.5","","202979.41"
"2025-03-12","2025-03-12","Rev SF FuneralFDC00000005RWQ250312","","-126.5","","202852.91"
"2025-03-12","2025-03-12","Rev SF FuneralFDC00000007C54250312","","-126.5","","202726.41"
"2025-03-12","2025-03-07","Rev SF FuneralFDC0000000N8V4250307","","-126.5","","202599.91"
"2025-03-12","2025-02-22","Rev SF FuneralFDC0000000KLT7250222","","-126.5","","202473.41"
"2025-03-12","2025-03-12","Rev SF FuneralFDC00000007DMT250312","","-31.63","","202441.78"
"2025-03-12","2025-02-28","Rev SF FuneralFDC00000006B8Q250228","","-31.63","","202410.15"
"2025-03-12","2025-02-28","Rev SF FuneralFDC00000006B9H250228","","-31.63","","202378.52"
"2025-03-12","2025-03-11","SF FuneralF801331       250311","","31.63","","202410.15"
"2025-03-12","2025-03-12","SF FuneralFDC0000000KKBT250312","","95.75","","202505.9"
"2025-03-12","2025-03-12","SF FuneralFDC00000005PJ7250312","","126.5","","202632.4"
"2025-03-12","2025-03-12","SF FuneralFDC000000073DD250312","","126.5","","202758.9"
"2025-03-12","2025-03-12","SF FuneralF833958       250312","","126.5","","202885.4"
"2025-03-12","2025-03-12","SF FuneralF1131516      250312","","126.5","","203011.9"
"2025-03-12","2025-03-12","SF FuneralFDC00000005HNS250312","","126.5","","203138.4"
"2025-03-12","2025-03-03","SF FuneralFDC00000006MWP250302","","63.25","","203201.65"
"2025-03-12","2025-03-01","Rev SF FuneralFDC0000000795H250301","","-126.5","","203075.15"
"2025-03-12","2025-01-02","Rev SF FuneralFDC0000000795H250101","","-126.5","","202948.65"
"2025-03-13","2025-03-10","SF FuneralFDC00000004CSK250310","","55","","203003.65"
"2025-03-13","2025-03-10","SF FuneralFDC00000004CSL250310","","55","","203058.65"
"2025-03-13","2025-03-10","SF FuneralF812202       250310","","31.63","","203090.28"
"2025-03-13","2025-03-10","SF FuneralFDC0000000CWBD250309","","31.63","","203121.91"
"2025-03-13","2025-03-08","SF FuneralFDC0000000JG27250309","","126.5","","203248.41"
"2025-03-13","2025-03-11","SF FuneralFDC00000007LG1250311","","31.63","","203280.04"
"2025-03-13","2025-03-11","SF FuneralFDC000000095C0250311","","126.5","","203406.54"
"2025-03-13","2025-03-10","SF FuneralFDC00000006V67250310","","126.5","","203533.04"
"2025-03-13","2025-03-11","SF FuneralFDC00000005K44250311","","126.5","","203659.54"
"2025-03-13","2025-03-12","SF FuneralFDC00000007CFW250312","","126.5","","203786.04"
"2025-03-13","2025-03-12","SF FuneralF823905       250312","","126.5","","203912.54"
"2025-03-13","2025-03-12","SF FuneralF843863       250312","","126.5","","204039.04"
"2025-03-13","2025-03-12","SF FuneralF1127610      250312","","126.5","","204165.54"
"2025-03-13","2025-03-08","SF FuneralFDC0000000JW2F250309","","126.5","","204292.04"
"2025-03-13","2025-03-08","SF FuneralF1021571      250309","","126.5","","204418.54"
"2025-03-13","2025-03-08","SF FuneralF1054722      250309","","63.25","","204481.79"
"2025-03-13","2025-03-08","SF FuneralF1080232      250309","","63.25","","204545.04"
"2025-03-13","2025-03-08","SF FuneralF1122295      250309","","31.63","","204576.67"
"2025-03-13","2025-03-10","SF FuneralFDC00000005RW6250309","","220","","204796.67"
"2025-03-13","2025-03-10","SF FuneralFDC00000005YNL250310","","55","","204851.67"
"2025-03-13","2025-03-10","SF FuneralFDC00000005YW3250310","","31.63","","204883.3"
"2025-03-13","2025-03-10","SF FuneralF805304       250309","","126.5","","205009.8"
"2025-03-13","2025-03-10","SF FuneralF744001       250309","","220","","205229.8"
"2025-03-13","2025-03-10","SF FuneralF819012       250310","","31.63","","205261.43"
"2025-03-13","2025-03-10","SF FuneralFDC0000000ML65250310","","31.63","","205293.06"
"2025-03-13","2025-03-10","SF FuneralF1130901      250310","","31.63","","205324.69"
"2025-03-13","2025-03-11","SF FuneralF832888       250311","","31.63","","205356.32"
"2025-03-13","2025-03-12","SF FuneralF814535       250312","","126.5","","205482.82"
"2025-03-13","2025-03-12","SF FuneralF1073408      250312","","126.5","","205609.32"
"2025-03-13","2025-03-12","SF FuneralF1116979      250312","","126.5","","205735.82"
"2025-03-13","2025-03-12","SF FuneralF1123156      250312","","126.5","","205862.32"
"2025-03-13","2025-03-12","SF FuneralFDC0000000P9J0250312","","126.5","","205988.82"
"2025-03-13","2025-03-12","SF FuneralFDC0000000P9J5250312","","126.5","","206115.32"
"2025-03-13","2025-03-12","SF FuneralF1129461      250312","","126.5","","206241.82"
"2025-03-13","2025-03-12","SF FuneralF1130874      250312","","126.5","","206368.32"
"2025-03-13","2025-03-07","SF FuneralF843757       250307","","31.63","","206399.95"
"2025-03-13","2025-03-08","SF FuneralFDC0000000JVCB250309","","31.63","","206431.58"
"2025-03-13","2025-03-08","SF FuneralF1054743      250309","","31.63","","206463.21"
"2025-03-13","2025-03-08","SF FuneralFDC0000000KH3D250309","","31.63","","206494.84"
"2025-03-13","2025-03-08","SF FuneralFDC0000000LNR4250309","","31.63","","206526.47"
"2025-03-13","2025-03-08","SF FuneralF1120593      250309","","31.63","","206558.1"
"2025-03-13","2025-03-08","SF FuneralFDC0000000PZBG250309","","31.63","","206589.73"
"2025-03-13","2025-03-10","SF FuneralF820012       250310","","31.63","","206621.36"
"2025-03-13","2025-03-10","SF FuneralF827602       250310","","31.63","","206652.99"
"2025-03-13","2025-03-10","SF FuneralF834650       250309","","31.63","","206684.62"
"2025-03-13","2025-03-10","SF FuneralFDC0000000K09V250310","","31.63","","206716.25"
"2025-03-13","2025-03-10","SF FuneralF1079351      250310","","31.63","","206747.88"
"2025-03-13","2025-03-10","SF FuneralF1122727      250310","","31.63","","206779.51"
"2025-03-13","2025-03-11","SF FuneralF831704       250311","","31.63","","206811.14"
"2025-03-13","2025-03-11","SF FuneralF1084842      250311","","31.63","","206842.77"
"2025-03-13","2025-03-08","SF FuneralF1129104      250308","","126.5","","206969.27"
"2025-03-13","2025-03-10","SF FuneralFDC00000005H2M250310","","126.5","","207095.77"
"2025-03-13","2025-03-10","SF FuneralF805875       250309","","63.25","","207159.02"
"2025-03-13","2025-03-10","SF FuneralF834835       250309","","126.5","","207285.52"
"2025-03-13","2025-03-10","SF FuneralFDC0000000K9LB250310","","126.5","","207412.02"
"2025-03-13","2025-03-12","SF FuneralFDC00000005J51250312","","126.5","","207538.52"
"2025-03-13","2025-03-12","SF FuneralFDC00000005X9N250312","","126.5","","207665.02"
"2025-03-13","2025-03-12","SF FuneralFDC000000064KN250312","","126.5","","207791.52"
"2025-03-13","2025-03-12","SF FuneralFDC00000006MF5250312","","126.5","","207918.02"
"2025-03-13","2025-03-12","SF FuneralFDC0000000BLKQ250312","","126.5","","208044.52"
"2025-03-13","2025-03-12","SF FuneralF834612       250312","","126.5","","208171.02"
"2025-03-13","2025-03-12","SF FuneralF1111368      250312","","126.5","","208297.52"
"2025-03-13","2025-03-12","SF FuneralF1130810      250312","","126.5","","208424.02"
"2025-03-13","2025-03-12","SF FuneralF1132841      250312","","126.5","","208550.52"
"2025-03-13","2025-03-11","SF FuneralF1129464      250311","","31.63","","208582.15"
"2025-03-13","2025-03-11","SF FuneralF823596       250311","","31.63","","208613.78"
"2025-03-13","2025-03-13","SF FuneralFDC00000006ZNM250313","","31.63","","208645.41"
"2025-03-13","2025-03-12","SF FuneralFDC000000068N0250312","","126.5","","208771.91"
"2025-03-13","2025-03-13","SF FuneralFDC00000006D10250313","","126.5","","208898.41"
"2025-03-13","2025-03-13","SF FuneralF1110797      250313","","126.5","","209024.91"
"2025-03-13","2025-03-07","SF FuneralF988945       250309","","31.63","","209056.54"
"2025-03-13","2025-03-10","SF FuneralFDC0000000502G250310","","31.63","","209088.17"
"2025-03-13","2025-03-10","SF FuneralFDC000000067C7250310","","31.63","","209119.8"
"2025-03-13","2025-03-10","SF FuneralFDC00000008MY8250309","","31.63","","209151.43"
"2025-03-13","2025-03-10","SF FuneralFDC00000009958250310","","31.63","","209183.06"
"2025-03-13","2025-03-10","SF FuneralF818028       250310","","31.63","","209214.69"
"2025-03-13","2025-03-10","SF FuneralF1108567      250310","","31.63","","209246.32"
"2025-03-13","2025-03-11","SF FuneralF809823       250311","","31.63","","209277.95"
"2025-03-13","2025-03-11","SF FuneralF799620       250311","","64.13","","209342.08"
"2025-03-13","2025-03-13","SF FuneralFDC00000005N6M250313","","31.63","","209373.71"
"2025-03-13","2025-03-10","SF FuneralFDC00000005N4P250310","","31.63","","209405.34"
"2025-03-13","2025-03-10","SF FuneralF811324       250310","","112.88","","209518.22"
"2025-03-13","2025-03-10","SF FuneralF1068000      250310","","31.63","","209549.85"
"2025-03-13","2025-03-11","SF FuneralFDC0000000NRQK250311","","31.63","","209581.48"
"2025-03-13","2025-03-12","SF FuneralFDC00000005HXT250312","","126.5","","209707.98"
"2025-03-13","2025-03-12","SF FuneralFDC00000005Z74250312","","126.5","","209834.48"
"2025-03-13","2025-03-12","SF FuneralF823847       250312","","126.5","","209960.98"
"2025-03-13","2025-03-13","SF FuneralFDC00000005MHW250313","","126.5","","210087.48"
"2025-03-13","2025-03-10","SF FuneralFDC000000072K8250310","","63.25","","210150.73"
"2025-03-13","2025-03-10","SF FuneralFDC000000076ND250309","","126.5","","210277.23"
"2025-03-13","2025-03-12","SF FuneralFDC0000000JHR3250312","","126.5","","210403.73"
"2025-03-13","2025-03-12","SF FuneralFDC0000000KJYJ250312","","126.5","","210530.23"
"2025-03-13","2025-03-12","SF FuneralF834066       250312","","126.5","","210656.73"
"2025-03-13","2025-03-12","SF FuneralFDC0000000HJLD250312","","126.5","","210783.23"
"2025-03-13","2025-03-12","SF FuneralF1072844      250312","","126.5","","210909.73"
"2025-03-13","2025-03-13","SF FuneralFDC00000006DDG250313","","126.5","","211036.23"
"2025-03-13","2025-03-08","SF FuneralF1132917      250309","","31.63","","211067.86"
"2025-03-13","2025-03-10","SF FuneralFDC00000003591250310","","55","","211122.86"
"2025-03-13","2025-03-10","SF FuneralF1066274      250310","","31.63","","211154.49"
"2025-03-13","2025-03-11","SF FuneralF1115031      250311","","31.63","","211186.12"
"2025-03-13","2025-03-12","SF FuneralFDC00000005X1L250312","","126.5","","211312.62"
"2025-03-13","2025-03-12","SF FuneralFDC0000000780W250312","","126.5","","211439.12"
"2025-03-13","2025-03-12","SF FuneralFDC000000096B5250312","","126.5","","211565.62"
"2025-03-13","2025-03-12","SF FuneralF987846       250312","","126.5","","211692.12"
"2025-03-13","2025-03-13","SF FuneralFDC00000007D5Y250313","","126.5","","211818.62"
"2025-03-13","2025-03-12","SF FuneralFDC000000075R4250312","","126.5","","211945.12"
"2025-03-13","2025-03-12","SF FuneralF805210       250312","","126.5","","212071.62"
"2025-03-13","2025-03-12","SF FuneralFDC0000000LLW8250312","","126.5","","212198.12"
"2025-03-13","2025-03-12","SF FuneralF1113569      250312","","126.5","","212324.62"
"2025-03-13","2025-03-08","SF FuneralF1021491      250309","","31.63","","212356.25"
"2025-03-13","2025-03-10","SF FuneralFDC00000005YV6250310","","63.25","","212419.5"
"2025-03-13","2025-03-10","SF FuneralFDC00000008JTC250310","","321.5","","212741"
"2025-03-13","2025-03-10","SF FuneralF819802       250310","","31.63","","212772.63"
"2025-03-13","2025-03-10","SF FuneralFDC0000000HS6H250310","","31.63","","212804.26"
"2025-03-13","2025-03-10","SF FuneralF1130847      250310","","31.63","","212835.89"
"2025-03-13","2025-03-10","SF FuneralF1134072      250310","","31.63","","212867.52"
"2025-03-13","2025-03-11","SF FuneralF810426       250311","","31.63","","212899.15"
"2025-03-13","2025-03-10","SF FuneralFDC00000009DX3250309","","31.63","","212930.78"
"2025-03-13","2025-03-10","SF FuneralFDC00000003S1L250310","","55","","212985.78"
"2025-03-13","2025-03-10","SF FuneralFDC00000005Z3L250310","","31.63","","213017.41"
"2025-03-13","2025-03-10","SF FuneralFDC0000000PYQW250310","","126.5","","213143.91"
"2025-03-13","2025-03-12","SF FuneralFDC00000005J17250312","","126.5","","213270.41"
"2025-03-13","2025-03-12","Rev SF FuneralFDC0000000P9J0250312","","-126.5","","213143.91"
"2025-03-13","2025-03-12","Rev SF FuneralFDC0000000P3M1250312","","-126.5","","213017.41"
"2025-03-13","2025-03-12","Rev SF FuneralFDC0000000P9J5250312","","-126.5","","212890.91"
"2025-03-13","2025-03-10","Rev SF FuneralFDC00000005YW3250310","","-31.63","","212859.28"
"2025-03-13","2025-03-10","Rev SF FuneralFDC00000005YNL250310","","-55","","212804.28"
"2025-03-13","2025-02-22","Rev SF FuneralFDC000000067N5250222","","-126.5","","212677.78"
"2025-03-13","2025-02-28","Rev SF FuneralFDC00000009Q9G250228","","-126.5","","212551.28"
"2025-03-13","2025-03-10","Rev SF FuneralFDC00000005RW6250309","","-220","","212331.28"
"2025-03-13","2025-03-12","Rev SF FuneralFDC0000000CNBM250312","","-126.5","","212204.78"
"2025-03-13","2025-03-10","SF FuneralF1117412      250310","","31.63","","212236.41"
"2025-03-13","2025-03-11","SF FuneralF828353       250311","","126.5","","212362.91"
"2025-03-13","2025-03-11","SF FuneralF992519       250311","","31.63","","212394.54"
"2025-03-13","2025-03-11","SF FuneralF993719       250311","","31.63","","212426.17"
"2025-03-13","2025-03-11","SF FuneralF1114433      250311","","31.63","","212457.8"
"2025-03-13","2025-03-12","SF FuneralFDC00000005PV0250312","","126.5","","212584.3"
"2025-03-13","2025-03-12","SF FuneralFDC00000005XGV250312","","126.5","","212710.8"
"2025-03-13","2025-03-12","SF FuneralFDC000000070JJ250312","","126.5","","212837.3"
"2025-03-13","2025-03-12","SF FuneralFDC00000009H1J250312","","126.5","","212963.8"
"2025-03-13","2025-03-12","SF FuneralF830843       250312","","126.5","","213090.3"
"2025-03-13","2025-03-12","SF FuneralF843496       250312","","126.5","","213216.8"
"2025-03-13","2025-03-12","SF FuneralFDC0000000G985250312","","126.5","","213343.3"
"2025-03-13","2025-03-12","SF FuneralF981257       250312","","126.5","","213469.8"
"2025-03-13","2025-03-12","SF FuneralF989562       250312","","126.5","","213596.3"
"2025-03-13","2025-03-12","SF FuneralF1132321      250312","","126.5","","213722.8"
"2025-03-13","2025-03-11","SF FuneralF1016936      250311","","63.25","","213786.05"
"2025-03-13","2025-03-12","SF FuneralF1118937      250312","","126.5","","213912.55"
"2025-03-13","2025-03-07","SF FuneralF830001       250307","","63.25","","213975.8"
"2025-03-13","2025-03-10","SF FuneralF987310       250310","","31.63","","214007.43"
"2025-03-13","2025-03-10","SF FuneralF1110362      250310","","31.63","","214039.06"
"2025-03-13","2025-03-11","SF FuneralF805648       250311","","31.63","","214070.69"
"2025-03-13","2025-03-11","SF FuneralFDC0000000N526250311","","31.63","","214102.32"
"2025-03-13","2025-03-12","SF FuneralF1103755      250312","","126.5","","214228.82"
"2025-03-13","2025-03-10","SF FuneralFDC00000006XFK250310","","31.63","","214260.45"
"2025-03-13","2025-03-10","SF FuneralF1021004      250310","","31.63","","214292.08"
"2025-03-13","2025-03-11","SF FuneralF988913       250311","","31.63","","214323.71"
"2025-03-13","2025-03-10","SF FuneralF1131520      250310","","31.63","","214355.34"
"2025-03-13","2025-03-11","SF FuneralFDC00000006MXW250311","","63.25","","214418.59"
"2025-03-13","2025-03-11","SF FuneralFDC00000008JVD250311","","31.63","","214450.22"
"2025-03-13","2025-03-11","SF FuneralF1111675      250311","","31.63","","214481.85"
"2025-03-13","2025-03-11","SF FuneralFDC0000000NTBQ250311","","31.63","","214513.48"
"2025-03-13","2025-03-11","SF FuneralF1120133      250311","","31.63","","214545.11"
"2025-03-13","2025-03-12","SF FuneralF1016869      250312","","126.5","","214671.61"
"2025-03-13","2025-03-12","SF FuneralFDC0000000LG2D250312","","31.63","","214703.24"
"2025-03-13","2025-03-12","SF FuneralF1078566      250312","","31.63","","214734.87"
"2025-03-13","2025-03-12","SF FuneralF1123121      250312","","126.5","","214861.37"
"2025-03-13","2025-03-11","SF FuneralF809796       250311","","63.25","","214924.62"
"2025-03-13","2025-03-07","SF FuneralF815237       250307","","63.25","","214987.87"
"2025-03-13","2025-03-11","SF FuneralF1119033      250311","","63.25","","215051.12"
"2025-03-13","2025-03-12","SF FuneralF833902       250312","","126.5","","215177.62"
"2025-03-13","2025-03-12","SF FuneralF1016930      250312","","126.5","","215304.12"
"2025-03-13","2025-03-10","SF FuneralF1111332      250310","","31.63","","215335.75"
"2025-03-13","2025-03-10","SF FuneralF1127505      250310","","31.63","","215367.38"
"2025-03-13","2025-03-04","SF FuneralF1017847      250304","","63.25","","215430.63"
"2025-03-13","2025-03-10","SF FuneralFDC000000070PX250310","","31.63","","215462.26"
"2025-03-13","2025-03-10","SF FuneralFDC00000007H6K250310","","31.63","","215493.89"
"2025-03-13","2025-03-10","SF FuneralFDC00000007PP8250310","","31.63","","215525.52"
"2025-03-13","2025-03-10","SF FuneralF800626       250310","","31.63","","215557.15"
"2025-03-13","2025-03-10","SF FuneralFDC0000000918Q250310","","47.88","","215605.03"
"2025-03-13","2025-03-10","SF FuneralF843034       250310","","31.63","","215636.66"
"2025-03-13","2025-03-10","SF FuneralF989371       250310","","63.25","","215699.91"
"2025-03-13","2025-03-10","SF FuneralF990991       250310","","63.25","","215763.16"
"2025-03-13","2025-03-10","SF FuneralF1017630      250310","","31.63","","215794.79"
"2025-03-13","2025-03-10","SF FuneralF1072930      250310","","31.63","","215826.42"
"2025-03-13","2025-03-10","SF FuneralF1115020      250310","","63.25","","215889.67"
"2025-03-13","2025-03-10","SF FuneralF1117477      250310","","31.63","","215921.3"
"2025-03-13","2025-03-10","SF FuneralF1125116      250310","","31.63","","215952.93"
"2025-03-13","2025-03-10","SF FuneralF1129904      250310","","31.63","","215984.56"
"2025-03-13","2025-03-10","SF FuneralF1130649      250310","","31.63","","216016.19"
"2025-03-13","2025-03-11","SF FuneralFDC00000005H2H250311","","31.63","","216047.82"
"2025-03-13","2025-03-11","SF FuneralFDC00000006QXL250311","","126.5","","216174.32"
"2025-03-13","2025-03-11","SF FuneralF815955       250311","","31.63","","216205.95"
"2025-03-13","2025-03-11","SF FuneralF1016929      250311","","63.25","","216269.2"
"2025-03-13","2025-03-11","SF FuneralFDC0000000K09P250311","","65","","216334.2"
"2025-03-13","2025-03-11","SF FuneralF1123129      250311","","31.63","","216365.83"
"2025-03-13","2025-03-11","SF FuneralF1126100      250311","","31.63","","216397.46"
"2025-03-13","2025-03-12","SF FuneralFDC00000005X2Z250312","","126.5","","216523.96"
"2025-03-13","2025-03-12","SF FuneralF818243       250312","","126.5","","216650.46"
"2025-03-13","2025-03-12","SF FuneralF1118896      250312","","126.5","","216776.96"
"2025-03-13","2025-03-12","SF FuneralF1127865      250312","","126.5","","216903.46"
"2025-03-13","2025-02-22","Rev SF FuneralFDC0000000P937250222","","-126.5","","216776.96"
"2025-03-13","2025-02-10","Rev SF FuneralFDC0000000PYQW250210","","-126.5","","216650.46"
"2025-03-13","2025-02-22","Rev SF FuneralFDC0000000P93F250222","","-126.5","","216523.96"
"2025-03-13","2025-03-10","Rev SF FuneralFDC0000000PYQW250310","","-126.5","","216397.46"
"2025-03-13","2025-02-01","Rev SF FuneralFDC0000000867Q250201","","-126.5","","216270.96"
"2025-03-13","2025-03-10","Rev SF FuneralFDC00000007H6K250310","","-31.63","","216239.33"
"2025-03-13","2025-03-08","Rev SF FuneralFDC0000000LNR4250309","","-31.63","","216207.7"
"2025-03-13","2025-03-10","Rev SF FuneralFDC000000076ND250309","","-126.5","","216081.2"
"2025-03-13","2025-03-12","Rev SF FuneralFDC00000005PV0250312","","-126.5","","215954.7"
"2025-03-13","2025-03-12","Rev SF FuneralFDC00000009H1J250312","","-126.5","","215828.2"
"2025-03-13","2025-02-20","Rev SF FuneralFDC00000005M0Y250220","","-126.5","","215701.7"
"2025-03-13","2025-03-12","Rev SF FuneralFDC00000005XGV250312","","-126.5","","215575.2"
"2025-03-13","2025-03-12","Rev SF FuneralFDC00000005Z74250312","","-126.5","","215448.7"
"2025-03-13","2025-03-12","Rev SF FuneralFDC000000070JJ250312","","-126.5","","215322.2"
"2025-03-13","2025-03-11","SF FuneralF815443       250311","","63.25","","215385.45"
"2025-03-13","2025-03-11","SF FuneralF820981       250311","","63.25","","215448.7"
"2025-03-13","2025-03-11","SF FuneralF843011       250311","","63.25","","215511.95"
"2025-03-13","2025-03-11","SF FuneralF1085053      250311","","63.25","","215575.2"
"2025-03-13","2025-03-12","SF FuneralFDC00000006RPD250312","","126.5","","215701.7"
"2025-03-13","2025-03-10","SF FuneralFDC0000000KZ2C250310","","31.63","","215733.33"
"2025-03-13","2025-03-10","SF FuneralFDC0000000NNDF250310","","31.63","","215764.96"
"2025-03-13","2025-03-10","SF FuneralF1125487      250310","","31.63","","215796.59"
"2025-03-13","2025-03-11","SF FuneralFDC0000000HQB5250311","","31.63","","215828.22"
"2025-03-13","2025-03-11","SF FuneralF1118809      250311","","31.63","","215859.85"
"2025-03-13","2025-03-11","SF FuneralF1118848      250311","","31.63","","215891.48"
"2025-03-13","2025-03-13","SF FuneralF1078865      250313","","47.88","","215939.36"
"2025-03-13","2025-03-10","SF FuneralF829978       250310","","63.25","","216002.61"
"2025-03-13","2025-03-10","SF FuneralF834614       250310","","31.63","","216034.24"
"2025-03-13","2025-03-10","SF FuneralF844339       250310","","31.63","","216065.87"
"2025-03-13","2025-03-10","SF FuneralF791581       250310","","47.88","","216113.75"
"2025-03-13","2025-03-10","SF FuneralF1100809      250310","","31.63","","216145.38"
"2025-03-13","2025-03-10","SF FuneralF1102815      250310","","31.63","","216177.01"
"2025-03-13","2025-03-10","SF FuneralFDC0000000P5BP250310","","126.5","","216303.51"
"2025-03-13","2025-03-11","SF FuneralF1068029      250311","","31.63","","216335.14"
"2025-03-13","2025-03-12","SF FuneralFDC00000007Y3H250312","","126.5","","216461.64"
"2025-03-13","2025-03-12","SF FuneralFDC00000008X5B250312","","31.63","","216493.27"
"2025-03-13","2025-03-12","SF FuneralF1118427      250312","","126.5","","216619.77"
"2025-03-13","2025-03-08","SF FuneralF1114730      250309","","31.63","","216651.4"
"2025-03-13","2025-03-10","SF FuneralF843842       250310","","63.25","","216714.65"
"2025-03-13","2025-03-10","SF FuneralF1068032      250310","","63.25","","216777.9"
"2025-03-13","2025-03-11","SF FuneralF1127432      250311","","31.63","","216809.53"
"2025-03-13","2025-03-13","SF FuneralF1122718      250313","","31.63","","216841.16"
"2025-03-13","2025-02-18","Rev SF FuneralFDC000000074HC250218","","-126.5","","216714.66"
"2025-03-14","2025-03-12","SF FuneralFDC00000003DJF250312","","220","","216934.66"
"2025-03-14","2025-03-12","SF FuneralFDC00000005CQB250312","","126.5","","217061.16"
"2025-03-14","2025-03-12","SF FuneralFDC00000005FBM250312","","126.5","","217187.66"
"2025-03-14","2025-03-12","SF FuneralFDC00000005HW1250312","","126.5","","217314.16"
"2025-03-14","2025-03-12","SF FuneralFDC00000005J0Y250312","","126.5","","217440.66"
"2025-03-14","2025-03-12","SF FuneralFDC00000005K8S250312","","220","","217660.66"
"2025-03-14","2025-03-12","SF FuneralFDC00000005K8Y250312","","220","","217880.66"
"2025-03-14","2025-03-12","SF FuneralFDC00000005K93250312","","220","","218100.66"
"2025-03-14","2025-03-12","SF FuneralFDC00000005KBC250312","","220","","218320.66"
"2025-03-14","2025-03-12","SF FuneralFDC00000005NP1250312","","126.5","","218447.16"
"2025-03-14","2025-03-12","SF FuneralFDC00000005QRT250312","","126.5","","218573.66"
"2025-03-14","2025-03-12","SF FuneralFDC00000005SND250312","","126.5","","218700.16"
"2025-03-14","2025-03-12","SF FuneralFDC00000005V4Z250312","","31.63","","218731.79"
"2025-03-14","2025-03-12","SF FuneralFDC000000065TC250312","","126.5","","218858.29"
"2025-03-14","2025-03-12","SF FuneralFDC00000006RXM250312","","126.5","","218984.79"
"2025-03-14","2025-03-12","SF FuneralFDC000000071DT250312","","126.5","","219111.29"
"2025-03-14","2025-03-12","SF FuneralFDC00000007DS2250312","","126.5","","219237.79"
"2025-03-14","2025-03-12","SF FuneralFDC000000082HL250312","","126.5","","219364.29"
"2025-03-14","2025-03-12","SF FuneralFDC000000089VR250312","","126.5","","219490.79"
"2025-03-14","2025-03-12","SF FuneralF810177       250312","","126.5","","219617.29"
"2025-03-14","2025-03-12","SF FuneralF840471       250312","","126.5","","219743.79"
"2025-03-14","2025-03-12","SF FuneralF987264       250312","","126.5","","219870.29"
"2025-03-14","2025-03-12","SF FuneralF993793       250312","","126.5","","219996.79"
"2025-03-14","2025-03-12","SF FuneralFDC0000000JJ24250312","","126.5","","220123.29"
"2025-03-14","2025-03-12","SF FuneralFDC0000000JKSD250312","","126.5","","220249.79"
"2025-03-14","2025-03-12","SF FuneralFDC0000000K87M250312","","126.5","","220376.29"
"2025-03-14","2025-03-12","SF FuneralF1055205      250312","","126.5","","220502.79"
"2025-03-14","2025-03-12","SF FuneralF1078398      250312","","126.5","","220629.29"
"2025-03-14","2025-03-12","SF FuneralF1108338      250312","","126.5","","220755.79"
"2025-03-14","2025-03-12","SF FuneralF1110735      250312","","126.5","","220882.29"
"2025-03-14","2025-03-12","SF FuneralF1111308      250312","","126.5","","221008.79"
"2025-03-14","2025-03-12","SF FuneralF1118528      250312","","126.5","","221135.29"
"2025-03-14","2025-03-12","SF FuneralF1118778      250312","","126.5","","221261.79"
"2025-03-14","2025-03-12","SF FuneralF785760       250312","","126.5","","221388.29"
"2025-03-14","2025-03-12","SF FuneralFDC0000000P675250312","","126.5","","221514.79"
"2025-03-14","2025-03-12","SF FuneralF1125161      250312","","126.5","","221641.29"
"2025-03-14","2025-03-12","SF FuneralFDC0000000PN4S250312","","126.5","","221767.79"
"2025-03-14","2025-03-12","SF FuneralF1130465      250312","","126.5","","221894.29"
"2025-03-14","2025-03-12","SF FuneralF1132507      250312","","126.5","","222020.79"
"2025-03-14","2025-03-12","SF FuneralF1132872      250312","","126.5","","222147.29"
"2025-03-14","2025-03-13","SF FuneralF1110763      250313","","31.63","","222178.92"
"2025-03-14","2025-03-11","SF FuneralFDC000000072SM250311","","31.63","","222210.55"
"2025-03-14","2025-03-11","SF FuneralFDC00000008BS8250311","","126.5","","222337.05"
"2025-03-14","2025-03-11","SF FuneralFDC00000008BSC250311","","126.5","","222463.55"
"2025-03-14","2025-03-11","SF FuneralFDC00000008BSF250311","","126.5","","222590.05"
"2025-03-14","2025-03-11","SF FuneralF814465       250311","","31.63","","222621.68"
"2025-03-14","2025-03-11","SF FuneralF830046       250311","","63.25","","222684.93"
"2025-03-14","2025-03-11","SF FuneralF830094       250311","","63.25","","222748.18"
"2025-03-14","2025-03-11","SF FuneralFDC0000000KFFJ250311","","31.63","","222779.81"
"2025-03-14","2025-03-11","SF FuneralF1112152      250311","","31.63","","222811.44"
"2025-03-14","2025-03-11","SF FuneralF1114513      250311","","31.63","","222843.07"
"2025-03-14","2025-03-11","SF FuneralF1130277      250311","","31.63","","222874.7"
"2025-03-14","2025-03-10","SF FuneralFDC00000006BK1250310","","31.63","","222906.33"
"2025-03-14","2025-03-10","SF FuneralFDC00000006Y3J250310","","126.5","","223032.83"
"2025-03-14","2025-03-10","SF FuneralFDC00000006Y3M250310","","126.5","","223159.33"
"2025-03-14","2025-03-10","SF FuneralFDC000000070CJ250310","","31.63","","223190.96"
"2025-03-14","2025-03-10","SF FuneralFDC00000007GXS250310","","31.63","","223222.59"
"2025-03-14","2025-03-10","SF FuneralFDC00000008KX0250310","","31.63","","223254.22"
"2025-03-14","2025-03-10","SF FuneralF809870       250310","","63.25","","223317.47"
"2025-03-14","2025-03-10","SF FuneralFDC0000000DGVD250310","","126.5","","223443.97"
"2025-03-14","2025-03-10","SF FuneralF844112       250309","","126.5","","223570.47"
"2025-03-14","2025-03-08","SF FuneralF1079578      250309","","126.5","","223696.97"
"2025-03-14","2025-03-10","SF FuneralFDC00000005PH9250310","","63.25","","223760.22"
"2025-03-14","2025-03-10","SF FuneralFDC00000005RR7250310","","31.63","","223791.85"
"2025-03-14","2025-03-10","SF FuneralFDC00000005RR8250310","","31.63","","223823.48"
"2025-03-14","2025-03-10","SF FuneralF796603       250310","","126.5","","223949.98"
"2025-03-14","2025-03-10","SF FuneralF801722       250310","","31.63","","223981.61"
"2025-03-14","2025-03-10","SF FuneralF802251       250310","","31.63","","224013.24"
"2025-03-14","2025-03-10","SF FuneralF804198       250310","","63.25","","224076.49"
"2025-03-14","2025-03-10","SF FuneralF810250       250310","","31.63","","224108.12"
"2025-03-14","2025-03-10","SF FuneralF814448       250309","","31.63","","224139.75"
"2025-03-14","2025-03-10","SF FuneralF815135       250310","","31.63","","224171.38"
"2025-03-14","2025-03-10","SF FuneralF820769       250310","","31.63","","224203.01"
"2025-03-14","2025-03-10","SF FuneralF834680       250309","","126.5","","224329.51"
"2025-03-14","2025-03-10","SF FuneralF901184       250310","","31.63","","224361.14"
"2025-03-14","2025-03-10","SF FuneralF986655       250310","","31.63","","224392.77"
"2025-03-14","2025-03-10","SF FuneralF990276       250310","","31.63","","224424.4"
"2025-03-14","2025-03-10","SF FuneralF993678       250310","","31.63","","224456.03"
"2025-03-14","2025-03-10","SF FuneralF1016810      250310","","31.63","","224487.66"
"2025-03-14","2025-03-10","SF FuneralF1020751      250310","","126.5","","224614.16"
"2025-03-14","2025-03-10","SF FuneralF1073147      250310","","31.63","","224645.79"
"2025-03-14","2025-03-10","SF FuneralF1073218      250310","","31.63","","224677.42"
"2025-03-14","2025-03-10","SF FuneralF1084032      250310","","31.63","","224709.05"
"2025-03-14","2025-03-10","SF FuneralF1102887      250310","","31.63","","224740.68"
"2025-03-14","2025-03-10","SF FuneralF1103857      250310","","31.63","","224772.31"
"2025-03-14","2025-03-10","SF FuneralF1112394      250310","","31.63","","224803.94"
"2025-03-14","2025-03-10","SF FuneralF1113769      250310","","63.25","","224867.19"
"2025-03-14","2025-03-10","SF FuneralFDC0000000N7Y7250310","","31.63","","224898.82"
"2025-03-14","2025-03-10","SF FuneralF1130713      250310","","31.63","","224930.45"
"2025-03-14","2025-03-10","SF FuneralF1132387      250310","","63.25","","224993.7"
"2025-03-14","2025-03-10","SF FuneralF1132453      250310","","31.63","","225025.33"
"2025-03-14","2025-03-11","SF FuneralFDC00000003D2J250311","","110","","225135.33"
"2025-03-14","2025-03-11","SF FuneralFDC00000007DFS250311","","31.63","","225166.96"
"2025-03-14","2025-03-11","SF FuneralFDC00000007KLD250311","","31.63","","225198.59"
"2025-03-14","2025-03-11","SF FuneralFDC00000007ZH7250311","","31.63","","225230.22"
"2025-03-14","2025-03-11","SF FuneralFDC000000094YF250311","","126.5","","225356.72"
"2025-03-14","2025-03-11","SF FuneralF816581       250311","","31.63","","225388.35"
"2025-03-14","2025-03-11","SF FuneralFDC0000000KFZP250311","","63.25","","225451.6"
"2025-03-14","2025-03-11","SF FuneralF1060528      250311","","63.25","","225514.85"
"2025-03-14","2025-03-11","SF FuneralF1111742      250311","","31.63","","225546.48"
"2025-03-14","2025-03-11","SF FuneralF1131536      250311","","31.63","","225578.11"
"2025-03-14","2025-03-12","SF FuneralFDC00000005SG7250312","","126.5","","225704.61"
"2025-03-14","2025-03-12","SF FuneralFDC00000007PTD250312","","220","","225924.61"
"2025-03-14","2025-03-12","SF FuneralF818782       250312","","126.5","","226051.11"
"2025-03-14","2025-03-12","SF FuneralF830765       250312","","126.5","","226177.61"
"2025-03-14","2025-03-12","SF FuneralF1103840      250312","","126.5","","226304.11"
"2025-03-14","2025-03-12","SF FuneralF1132313      250312","","126.5","","226430.61"
"2025-03-14","2025-03-12","SF FuneralF1132456      250312","","126.5","","226557.11"
"2025-03-14","2025-03-13","SF FuneralFDC000000066ZC250313","","126.5","","226683.61"
"2025-03-14","2025-03-13","SF FuneralF1111341      250313","","126.5","","226810.11"
"2025-03-14","2025-03-11","SF FuneralF1103986      250311","","31.63","","226841.74"
"2025-03-14","2025-03-08","SF FuneralF1111595      250309","","31.63","","226873.37"
"2025-03-14","2025-03-10","SF FuneralF834044       250310","","31.63","","226905"
"2025-03-14","2025-03-10","SF FuneralF1118957      250310","","31.63","","226936.63"
"2025-03-14","2025-03-10","SF FuneralF1131541      250310","","31.63","","226968.26"
"2025-03-14","2025-03-10","SF FuneralF1132295      250310","","31.63","","226999.89"
"2025-03-14","2025-03-11","SF FuneralFDC00000003BTC250311","","55","","227054.89"
"2025-03-14","2025-03-11","SF FuneralF821837       250311","","47.88","","227102.77"
"2025-03-14","2025-03-11","SF FuneralF987241       250311","","31.63","","227134.4"
"2025-03-14","2025-03-11","SF FuneralFDC0000000J00M250311","","31.63","","227166.03"
"2025-03-14","2025-03-11","SF FuneralF1110634      250311","","31.63","","227197.66"
"2025-03-14","2025-03-11","SF FuneralF1123316      250311","","31.63","","227229.29"
"2025-03-14","2025-03-12","SF FuneralF800771       250312","","31.63","","227260.92"
"2025-03-14","2025-03-12","SF FuneralF823094       250312","","31.63","","227292.55"
"2025-03-14","2025-03-12","SF FuneralF1060919      250312","","31.63","","227324.18"
"2025-03-14","2025-03-04","SF FuneralF1103647      250304","","63.25","","227387.43"
"2025-03-14","2025-03-10","SF FuneralF821865       250310","","63.25","","227450.68"
"2025-03-14","2025-03-10","SF FuneralF834043       250310","","63.25","","227513.93"
"2025-03-14","2025-03-10","SF FuneralF1060760      250310","","63.25","","227577.18"
"2025-03-14","2025-03-10","SF FuneralF1110330      250310","","63.25","","227640.43"
"2025-03-14","2025-03-10","SF FuneralF1113968      250310","","63.25","","227703.68"
"2025-03-14","2025-03-10","SF FuneralF1118370      250310","","63.25","","227766.93"
"2025-03-14","2025-03-10","SF FuneralF1132067      250310","","63.25","","227830.18"
"2025-03-14","2025-03-11","SF FuneralFDC00000008BSS250311","","63.25","","227893.43"
"2025-03-14","2025-03-11","SF FuneralFDC0000000FQV0250311","","63.25","","227956.68"
"2025-03-14","2025-03-11","SF FuneralF990777       250311","","63.25","","228019.93"
"2025-03-14","2025-03-11","SF FuneralF991428       250311","","63.25","","228083.18"
"2025-03-14","2025-03-11","SF FuneralF1054998      250311","","63.25","","228146.43"
"2025-03-14","2025-03-12","SF FuneralFDC00000007N5P250312","","126.5","","228272.93"
"2025-03-14","2025-03-12","SF FuneralF801104       250312","","126.5","","228399.43"
"2025-03-14","2025-03-12","SF FuneralF810891       250312","","126.5","","228525.93"
"2025-03-14","2025-03-12","SF FuneralF1126296      250312","","126.5","","228652.43"
"2025-03-14","2025-03-12","SF FuneralF1133526      250312","","126.5","","228778.93"
"2025-03-14","2025-03-07","SF FuneralFDC0000000H5YY250309","","31.63","","228810.56"
"2025-03-14","2025-03-07","SF FuneralF1079509      250307","","31.63","","228842.19"
"2025-03-14","2025-03-10","SF FuneralFDC00000004NQM250309","","31.63","","228873.82"
"2025-03-14","2025-03-10","SF FuneralFDC00000004NQP250309","","31.63","","228905.45"
"2025-03-14","2025-03-10","SF FuneralFDC00000005GH0250310","","31.63","","228937.08"
"2025-03-14","2025-03-10","SF FuneralFDC000000074Y5250310","","55","","228992.08"
"2025-03-14","2025-03-10","SF FuneralFDC00000007WVJ250310","","31.63","","229023.71"
"2025-03-14","2025-03-10","SF FuneralFDC000000086PW250309","","31.63","","229055.34"
"2025-03-14","2025-03-10","SF FuneralF815144       250310","","31.63","","229086.97"
"2025-03-14","2025-03-10","SF FuneralF822865       250310","","31.63","","229118.6"
"2025-03-14","2025-03-10","SF FuneralFDC0000000FVPD250310","","31.63","","229150.23"
"2025-03-14","2025-03-10","SF FuneralF986911       250310","","31.63","","229181.86"
"2025-03-14","2025-03-10","SF FuneralFDC0000000KYZ5250310","","31.63","","229213.49"
"2025-03-14","2025-03-10","SF FuneralF1104295      250310","","31.63","","229245.12"
"2025-03-14","2025-03-10","SF FuneralF1115957      250310","","31.63","","229276.75"
"2025-03-14","2025-03-10","SF FuneralF1118005      250310","","31.63","","229308.38"
"2025-03-14","2025-03-10","SF FuneralF1108848      250310","","31.63","","229340.01"
"2025-03-14","2025-03-10","SF FuneralF1128005      250310","","31.63","","229371.64"
"2025-03-14","2025-03-10","SF FuneralFDC0000000PYVQ250310","","31.63","","229403.27"
"2025-03-14","2025-03-10","SF FuneralF1129402      250310","","31.63","","229434.9"
"2025-03-14","2025-03-10","SF FuneralF1134076      250310","","31.63","","229466.53"
"2025-03-14","2025-03-11","SF FuneralFDC00000005P3L250311","","31.63","","229498.16"
"2025-03-14","2025-03-11","SF FuneralFDC000000088BV250311","","31.63","","229529.79"
"2025-03-14","2025-03-11","SF FuneralF814180       250311","","31.63","","229561.42"
"2025-03-14","2025-03-11","SF FuneralFDC0000000BMW2250311","","31.63","","229593.05"
"2025-03-14","2025-03-11","SF FuneralF830294       250311","","31.63","","229624.68"
"2025-03-14","2025-03-11","SF FuneralF1066227      250311","","31.63","","229656.31"
"2025-03-14","2025-03-11","SF FuneralF1110079      250311","","31.63","","229687.94"
"2025-03-14","2025-03-11","SF FuneralF1118352      250311","","31.63","","229719.57"
"2025-03-14","2025-03-11","SF FuneralF1130942      250311","","31.63","","229751.2"
"2025-03-14","2025-03-11","SF FuneralF1133043      250311","","31.63","","229782.83"
"2025-03-14","2025-03-12","SF FuneralFDC0000000MLNC250312","","31.63","","229814.46"
"2025-03-14","2025-03-12","SF FuneralF1124171      250312","","31.63","","229846.09"
"2025-03-14","2025-03-13","SF FuneralFDC00000005P8B250313","","31.63","","229877.72"
"2025-03-14","2025-03-10","SF FuneralF813361       250310","","31.63","","229909.35"
"2025-03-14","2025-03-10","SF FuneralF841850       250310","","31.63","","229940.98"
"2025-03-14","2025-03-10","SF FuneralF1132386      250310","","31.63","","229972.61"
"2025-03-14","2025-03-11","SF FuneralFDC00000005R1B250311","","31.63","","230004.24"
"2025-03-14","2025-03-11","SF FuneralF993770       250311","","31.63","","230035.87"
"2025-03-14","2025-03-11","SF FuneralFDC0000000K22X250311","","31.63","","230067.5"
"2025-03-14","2025-03-10","SF FuneralFDC00000006TRY250310","","63.25","","230130.75"
"2025-03-14","2025-03-08","SF FuneralF1072856      250309","","31.63","","230162.38"
"2025-03-14","2025-03-11","SF FuneralF797055       250311","","31.63","","230194.01"
"2025-03-14","2025-03-11","SF FuneralFDC0000000NN7N250311","","31.63","","230225.64"
"2025-03-14","2025-03-11","SF FuneralF1120129      250311","","31.63","","230257.27"
"2025-03-14","2025-03-11","SF FuneralF1123132      250311","","31.63","","230288.9"
"2025-03-14","2025-03-11","SF FuneralF1132354      250311","","31.63","","230320.53"
"2025-03-14","2025-03-12","SF FuneralF1021175      250312","","126.5","","230447.03"
"2025-03-14","2025-03-12","SF FuneralF1059424      250312","","31.63","","230478.66"
"2025-03-14","2025-03-10","SF FuneralF1120655      250310","","31.63","","230510.29"
"2025-03-14","2025-03-10","SF FuneralF1125114      250310","","31.63","","230541.92"
"2025-03-14","2025-03-12","SF FuneralFDC00000005HWG250312","","126.5","","230668.42"
"2025-03-14","2025-03-12","SF FuneralFDC00000005HZD250312","","126.5","","230794.92"
"2025-03-14","2025-03-12","SF FuneralFDC00000005K24250312","","126.5","","230921.42"
"2025-03-14","2025-03-12","SF FuneralFDC00000005LJ6250312","","126.5","","231047.92"
"2025-03-14","2025-03-12","SF FuneralFDC00000006314250312","","126.5","","231174.42"
"2025-03-14","2025-03-12","SF FuneralFDC00000006LX7250312","","126.5","","231300.92"
"2025-03-14","2025-03-12","SF FuneralFDC00000006RZV250312","","126.5","","231427.42"
"2025-03-14","2025-03-12","SF FuneralFDC00000006SL4250312","","126.5","","231553.92"
"2025-03-14","2025-03-12","SF FuneralFDC00000006Y42250312","","126.5","","231680.42"
"2025-03-14","2025-03-12","SF FuneralFDC00000007DP5250312","","126.5","","231806.92"
"2025-03-14","2025-03-12","SF FuneralF794542       250312","","126.5","","231933.42"
"2025-03-14","2025-03-12","SF FuneralF796013       250312","","126.5","","232059.92"
"2025-03-14","2025-03-12","SF FuneralFDC00000007Y1F250312","","126.5","","232186.42"
"2025-03-14","2025-03-12","SF FuneralFDC00000008BVN250312","","126.5","","232312.92"
"2025-03-14","2025-03-12","SF FuneralF805929       250312","","126.5","","232439.42"
"2025-03-14","2025-03-12","SF FuneralFDC000000095B4250312","","126.5","","232565.92"
"2025-03-14","2025-03-12","SF FuneralF810689       250312","","126.5","","232692.42"
"2025-03-14","2025-03-12","SF FuneralF811172       250312","","126.5","","232818.92"
"2025-03-14","2025-03-12","SF FuneralF813364       250312","","126.5","","232945.42"
"2025-03-14","2025-03-12","SF FuneralFDC0000000B1VV250312","","126.5","","233071.92"
"2025-03-14","2025-03-12","SF FuneralF828835       250312","","126.5","","233198.42"
"2025-03-14","2025-03-12","SF FuneralF831904       250312","","126.5","","233324.92"
"2025-03-14","2025-03-12","SF FuneralF843979       250312","","126.5","","233451.42"
"2025-03-14","2025-03-12","SF FuneralF844667       250312","","126.5","","233577.92"
"2025-03-14","2025-03-12","SF FuneralFDC0000000HQB8250312","","126.5","","233704.42"
"2025-03-14","2025-03-12","SF FuneralF993528       250312","","126.5","","233830.92"
"2025-03-14","2025-03-12","SF FuneralF1017070      250312","","126.5","","233957.42"
"2025-03-14","2025-03-12","SF FuneralF1021345      250312","","126.5","","234083.92"
"2025-03-14","2025-03-12","SF FuneralF1054626      250312","","126.5","","234210.42"
"2025-03-14","2025-03-12","SF FuneralF1060602      250312","","126.5","","234336.92"
"2025-03-14","2025-03-12","SF FuneralF1060646      250312","","126.5","","234463.42"
"2025-03-14","2025-03-12","SF FuneralF1079283      250312","","126.5","","234589.92"
"2025-03-14","2025-03-12","SF FuneralF1103933      250312","","126.5","","234716.42"
"2025-03-14","2025-03-12","SF FuneralF1115044      250312","","126.5","","234842.92"
"2025-03-14","2025-03-12","SF FuneralF1120815      250312","","31.63","","234874.55"
"2025-03-14","2025-03-12","SF FuneralF1127392      250312","","126.5","","235001.05"
"2025-03-14","2025-03-12","SF FuneralF1132847      250312","","126.5","","235127.55"
"2025-03-14","2025-03-11","SF FuneralFDC00000007NHV250311","","63.25","","235190.8"
"2025-03-14","2025-03-11","SF FuneralF811733       250311","","31.63","","235222.43"
"2025-03-14","2025-03-11","SF FuneralF828867       250311","","31.63","","235254.06"
"2025-03-14","2025-03-11","SF FuneralF844728       250311","","31.63","","235285.69"
"2025-03-14","2025-03-11","SF FuneralF1059394      250311","","63.25","","235348.94"
"2025-03-14","2025-03-11","SF FuneralF1111540      250311","","63.25","","235412.19"
"2025-03-14","2025-03-11","SF FuneralF1111588      250311","","31.63","","235443.82"
"2025-03-14","2025-03-11","SF FuneralF1118308      250311","","31.63","","235475.45"
"2025-03-14","2025-03-11","SF FuneralF1119889      250311","","31.63","","235507.08"
"2025-03-14","2025-03-11","SF FuneralF1124111      250311","","63.25","","235570.33"
"2025-03-14","2025-03-11","SF FuneralF1127611      250311","","31.63","","235601.96"
"2025-03-14","2025-03-11","SF FuneralF1129444      250311","","126.5","","235728.46"
"2025-03-14","2025-03-10","SF FuneralF1113793      250310","","126.5","","235854.96"
"2025-03-14","2025-03-14","SF FuneralFDC0000000L8NN250314","","31.63","","235886.59"
"2025-03-14","2025-03-12","SF FuneralFDC0000000349Q250312","","220","","236106.59"
"2025-03-14","2025-03-12","SF FuneralF840696       250312","","126.5","","236233.09"
"2025-03-14","2025-03-12","SF FuneralF1033584      250312","","126.5","","236359.59"
"2025-03-14","2025-03-12","SF FuneralF1079367      250312","","126.5","","236486.09"
"2025-03-14","2025-03-12","SF FuneralF1114796      250312","","126.5","","236612.59"
"2025-03-14","2025-03-12","SF FuneralF1133171      250312","","126.5","","236739.09"
"2025-03-14","2025-03-08","SF FuneralF1050764      250309","","126.5","","236865.59"
"2025-03-14","2025-03-08","SF FuneralFDC0000000K1KY250309","","126.5","","236992.09"
"2025-03-14","2025-03-08","SF FuneralF1117998      250309","","31.63","","237023.72"
"2025-03-14","2025-03-14","SF FuneralF803505       250314","","31.63","","237055.35"
"2025-03-14","2025-03-14","SF FuneralF1131921      250314","","31.63","","237086.98"
"2025-03-14","2025-03-14","SF FuneralF819674       250316","","31.63","","237118.61"
"2025-03-14","2025-03-14","SF FuneralF1079664      250314","","31.63","","237150.24"
"2025-03-14","2025-03-14","SF FuneralF1130338      250314","","31.63","","237181.87"
"2025-03-14","2025-03-13","SF FuneralF1016768      250313","","31.63","","237213.5"
"2025-03-14","2025-03-14","SF FuneralFDC00000007Q48250314","","31.63","","237245.13"
"2025-03-14","2025-03-11","SF FuneralFDC000000051KX250311","","31.63","","237276.76"
"2025-03-14","2025-03-11","SF FuneralFDC00000007FBC250311","","31.63","","237308.39"
"2025-03-14","2025-03-11","SF FuneralFDC00000007WH2250311","","47.88","","237356.27"
"2025-03-14","2025-03-11","SF FuneralF819196       250311","","31.63","","237387.9"
"2025-03-14","2025-03-11","SF FuneralF989177       250311","","31.63","","237419.53"
"2025-03-14","2025-03-11","SF FuneralF1110117      250311","","31.63","","237451.16"
"2025-03-14","2025-03-11","SF FuneralF1131622      250311","","31.63","","237482.79"
"2025-03-14","2025-03-12","SF FuneralF1110314      250312","","31.63","","237514.42"
"2025-03-14","2025-03-14","SF FuneralF814303       250314","","31.63","","237546.05"
"2025-03-14","2025-03-11","SF FuneralF834784       250311","","31.63","","237577.68"
"2025-03-14","2025-03-11","SF FuneralF981838       250311","","31.63","","237609.31"
"2025-03-14","2025-03-11","SF FuneralF1021467      250311","","31.63","","237640.94"
"2025-03-14","2025-03-11","SF FuneralF1074647      250311","","31.63","","237672.57"
"2025-03-14","2025-03-11","SF FuneralF1083692      250311","","31.63","","237704.2"
"2025-03-14","2025-03-11","SF FuneralF1126086      250311","","31.63","","237735.83"
"2025-03-14","2025-03-11","SF FuneralF1131484      250311","","31.63","","237767.46"
"2025-03-14","2025-03-11","SF FuneralF1131495      250311","","31.63","","237799.09"
"2025-03-14","2025-03-11","SF FuneralF1132209      250311","","31.63","","237830.72"
"2025-03-14","2025-03-14","SF FuneralF840580       250314","","31.63","","237862.35"
"2025-03-14","2025-03-14","SF FuneralF1079509      250314","","31.63","","237893.98"
"2025-03-14","2025-03-14","SF FuneralFDC0000000PK3S250314","","31.63","","237925.61"
"2025-03-14","2025-03-11","SF FuneralF811275       250311","","31.63","","237957.24"
"2025-03-14","2025-03-11","SF FuneralF843037       250311","","31.63","","237988.87"
"2025-03-14","2025-03-11","SF FuneralF1120226      250311","","31.63","","238020.5"
"2025-03-14","2025-03-11","SF FuneralF1124052      250311","","31.63","","238052.13"
"2025-03-14","2025-03-11","SF FuneralF1132366      250311","","31.63","","238083.76"
"2025-03-14","2025-03-11","SF FuneralF1134525      250311","","31.63","","238115.39"
"2025-03-14","2025-03-14","SF FuneralF843757       250314","","31.63","","238147.02"
"2025-03-14","2025-03-11","SF FuneralFDC00000006SSB250311","","31.63","","238178.65"
"2025-03-14","2025-03-11","SF FuneralFDC00000006ST9250311","","31.63","","238210.28"
"2025-03-14","2025-03-11","SF FuneralFDC00000006STJ250311","","31.63","","238241.91"
"2025-03-14","2025-03-11","SF FuneralF802169       250311","","31.63","","238273.54"
"2025-03-14","2025-03-11","SF FuneralF822125       250311","","31.63","","238305.17"
"2025-03-14","2025-03-11","SF FuneralF827812       250311","","31.63","","238336.8"
"2025-03-14","2025-03-11","SF FuneralF1073828      250311","","31.63","","238368.43"
"2025-03-14","2025-03-11","SF FuneralF1127528      250311","","31.63","","238400.06"
"2025-03-14","2025-03-11","SF FuneralF1127863      250311","","31.63","","238431.69"
"2025-03-14","2025-03-11","SF FuneralF1132381      250311","","31.63","","238463.32"
"2025-03-14","2025-03-11","SF FuneralF1132895      250311","","31.63","","238494.95"
"2025-03-14","2025-03-11","SF FuneralF1133704      250311","","31.63","","238526.58"
"2025-03-14","2025-03-14","SF FuneralF1080183      250314","","31.63","","238558.21"
"2025-03-14","2025-03-14","SF FuneralFDC0000000B37Y250314","","31.63","","238589.84"
"2025-03-14","2025-03-10","SF FuneralF1118416      250310","","31.63","","238621.47"
"2025-03-14","2025-03-12","SF FuneralF1122926      250312","","31.63","","238653.1"
"2025-03-14","2025-03-14","SF FuneralF817655       250314","","31.63","","238684.73"
"2025-03-14","2025-03-08","SF FuneralF1103935      250309","","31.63","","238716.36"
"2025-03-14","2025-03-10","SF FuneralFDC00000008MKX250310","","31.63","","238747.99"
"2025-03-14","2025-03-10","SF FuneralF1123277      250310","","31.63","","238779.62"
"2025-03-14","2025-03-11","SF FuneralFDC00000002QF4250311","","55","","238834.62"
"2025-03-14","2025-03-11","SF FuneralF797213       250311","","31.63","","238866.25"
"2025-03-14","2025-03-11","SF FuneralFDC00000009383250311","","31.63","","238897.88"
"2025-03-14","2025-03-11","SF FuneralF1061069      250311","","31.63","","238929.51"
"2025-03-14","2025-03-11","SF FuneralF1078209      250311","","31.63","","238961.14"
"2025-03-14","2025-03-11","SF FuneralF1113963      250311","","31.63","","238992.77"
"2025-03-14","2025-03-11","SF FuneralF1118892      250311","","31.63","","239024.4"
"2025-03-14","2025-03-11","SF FuneralF1127985      250311","","63.25","","239087.65"
"2025-03-14","2025-03-11","SF FuneralF1131657      250311","","31.63","","239119.28"
"2025-03-14","2025-03-12","SF FuneralFDC00000005HT6250312","","126.5","","239245.78"
"2025-03-14","2025-03-12","SF FuneralFDC00000005HTM250312","","126.5","","239372.28"
"2025-03-14","2025-03-12","SF FuneralFDC00000005KYY250312","","126.5","","239498.78"
"2025-03-14","2025-03-12","SF FuneralFDC00000005LBB250312","","126.5","","239625.28"
"2025-03-14","2025-03-12","SF FuneralFDC00000005LR0250312","","126.5","","239751.78"
"2025-03-14","2025-03-12","SF FuneralFDC00000005MZF250312","","126.5","","239878.28"
"2025-03-14","2025-03-12","SF FuneralFDC00000005N3T250312","","126.5","","240004.78"
"2025-03-14","2025-03-12","SF FuneralFDC00000005NF1250312","","126.5","","240131.28"
"2025-03-14","2025-03-12","SF FuneralFDC00000005P8H250312","","126.5","","240257.78"
"2025-03-14","2025-03-12","SF FuneralFDC00000005XR4250312","","126.5","","240384.28"
"2025-03-14","2025-03-12","SF FuneralFDC000000061PQ250312","","126.5","","240510.78"
"2025-03-14","2025-03-12","SF FuneralFDC000000061Q0250312","","126.5","","240637.28"
"2025-03-14","2025-03-12","SF FuneralFDC00000006F20250312","","126.5","","240763.78"
"2025-03-14","2025-03-12","SF FuneralFDC00000006GLM250312","","126.5","","240890.28"
"2025-03-14","2025-03-12","SF FuneralFDC00000006J8D250312","","126.5","","241016.78"
"2025-03-14","2025-03-12","SF FuneralFDC00000006J8J250312","","126.5","","241143.28"
"2025-03-14","2025-03-12","SF FuneralFDC00000006MTT250312","","126.5","","241269.78"
"2025-03-14","2025-03-12","SF FuneralFDC00000006RJW250312","","126.5","","241396.28"
"2025-03-14","2025-03-12","SF FuneralFDC00000006TH7250312","","126.5","","241522.78"
"2025-03-14","2025-03-12","SF FuneralFDC00000006V7G250312","","126.5","","241649.28"
"2025-03-14","2025-03-12","SF FuneralFDC00000007619250312","","126.5","","241775.78"
"2025-03-14","2025-03-12","SF FuneralFDC00000007G4Y250312","","126.5","","241902.28"
"2025-03-14","2025-03-12","SF FuneralFDC00000007H6L250312","","126.5","","242028.78"
"2025-03-14","2025-03-12","SF FuneralFDC000000080KX250312","","126.5","","242155.28"
"2025-03-14","2025-03-12","SF FuneralF800305       250312","","126.5","","242281.78"
"2025-03-14","2025-03-12","SF FuneralF802120       250312","","126.5","","242408.28"
"2025-03-14","2025-03-12","SF FuneralFDC00000008K4Q250312","","126.5","","242534.78"
"2025-03-14","2025-03-12","SF FuneralF805178       250312","","126.5","","242661.28"
"2025-03-14","2025-03-12","SF FuneralF807947       250312","","126.5","","242787.78"
"2025-03-14","2025-03-12","SF FuneralF808813       250312","","126.5","","242914.28"
"2025-03-14","2025-03-12","SF FuneralF779197       250312","","126.5","","243040.78"
"2025-03-14","2025-03-12","SF FuneralF816313       250312","","126.5","","243167.28"
"2025-03-14","2025-03-12","SF FuneralF819633       250312","","126.5","","243293.78"
"2025-03-14","2025-03-12","SF FuneralF822019       250312","","126.5","","243420.28"
"2025-03-14","2025-03-12","SF FuneralF822999       250312","","126.5","","243546.78"
"2025-03-14","2025-03-12","SF FuneralF830295       250312","","126.5","","243673.28"
"2025-03-14","2025-03-12","SF FuneralF830596       250312","","126.5","","243799.78"
"2025-03-14","2025-03-12","SF FuneralF830974       250312","","126.5","","243926.28"
"2025-03-14","2025-03-12","SF FuneralF831339       250312","","126.5","","244052.78"
"2025-03-14","2025-03-12","SF FuneralFDC0000000CWP5250312","","126.5","","244179.28"
"2025-03-14","2025-03-12","SF FuneralF834198       250312","","126.5","","244305.78"
"2025-03-14","2025-03-12","SF FuneralF834453       250312","","126.5","","244432.28"
"2025-03-14","2025-03-12","SF FuneralFDC0000000D2LH250312","","126.5","","244558.78"
"2025-03-14","2025-03-12","SF FuneralF843652       250312","","126.5","","244685.28"
"2025-03-14","2025-03-12","SF FuneralF986676       250312","","126.5","","244811.78"
"2025-03-14","2025-03-12","SF FuneralFDC0000000HM0V250312","","126.5","","244938.28"
"2025-03-14","2025-03-12","SF FuneralF988381       250312","","126.5","","245064.78"
"2025-03-14","2025-03-12","SF FuneralF1052140      250312","","126.5","","245191.28"
"2025-03-14","2025-03-12","SF FuneralF775909       250312","","191.5","","245382.78"
"2025-03-14","2025-03-12","SF FuneralFDC0000000LKQM250312","","126.5","","245509.28"
"2025-03-14","2025-03-12","SF FuneralFDC0000000MZNV250312","","126.5","","245635.78"
"2025-03-14","2025-03-12","SF FuneralF1123596      250312","","126.5","","245762.28"
"2025-03-14","2025-03-12","SF FuneralF1124035      250312","","126.5","","245888.78"
"2025-03-14","2025-03-12","SF FuneralFDC0000000PBZ3250312","","126.5","","246015.28"
"2025-03-14","2025-03-12","SF FuneralFDC0000000Q166250312","","126.5","","246141.78"
"2025-03-14","2025-03-12","SF FuneralFDC0000000Q168250312","","126.5","","246268.28"
"2025-03-14","2025-03-12","SF FuneralFDC0000000Q16C250312","","126.5","","246394.78"
"2025-03-14","2025-03-10","SF FuneralF1060944      250310","","31.63","","246426.41"
"2025-03-14","2025-03-10","SF FuneralF1123291      250310","","31.63","","246458.04"
"2025-03-14","2025-03-11","SF FuneralF1127480      250311","","31.63","","246489.67"
"2025-03-14","2025-03-14","SF FuneralF990787       250315","","31.63","","246521.3"
"2025-03-14","2025-03-14","SF FuneralF1131198      250314","","31.63","","246552.93"
"2025-03-14","2025-03-11","SF FuneralFDC000000086B2250311","","31.63","","246584.56"
"2025-03-14","2025-03-11","SF FuneralF801219       250311","","31.63","","246616.19"
"2025-03-14","2025-03-11","SF FuneralF986709       250311","","31.63","","246647.82"
"2025-03-14","2025-03-11","SF FuneralF1066647      250311","","31.63","","246679.45"
"2025-03-14","2025-03-11","SF FuneralF1128998      250311","","31.63","","246711.08"
"2025-03-14","2025-03-11","SF FuneralF1132785      250311","","31.63","","246742.71"
"2025-03-14","2025-03-10","SF FuneralF1079348      250310","","31.63","","246774.34"
"2025-03-14","2025-03-11","SF FuneralF799673       250311","","31.63","","246805.97"
"2025-03-14","2025-03-11","SF FuneralF833515       250311","","31.63","","246837.6"
"2025-03-14","2025-03-11","SF FuneralF833824       250311","","31.63","","246869.23"
"2025-03-14","2025-03-11","SF FuneralF1073297      250311","","31.63","","246900.86"
"2025-03-14","2025-03-11","SF FuneralF1084860      250311","","31.63","","246932.49"
"2025-03-14","2025-03-11","SF FuneralF1111731      250311","","31.63","","246964.12"
"2025-03-14","2025-03-11","SF FuneralF1112349      250311","","31.63","","246995.75"
"2025-03-14","2025-03-11","SF FuneralF1131696      250311","","31.63","","247027.38"
"2025-03-14","2025-03-13","SF FuneralF1109029      250313","","31.63","","247059.01"
"2025-03-14","2025-03-14","SF FuneralFDC0000000HVXH250315","","31.63","","247090.64"
"2025-03-14","2025-03-14","SF FuneralF1119753      250314","","31.63","","247122.27"
"2025-03-14","2025-03-07","SF FuneralF1110676      250307","","126.5","","247248.77"
"2025-03-14","2025-03-11","SF FuneralF992479       250311","","63.25","","247312.02"
"2025-03-14","2025-03-12","SF FuneralFDC00000005HWT250312","","126.5","","247438.52"
"2025-03-14","2025-03-11","SF FuneralF822823       250311","","63.25","","247501.77"
"2025-03-14","2025-03-12","SF FuneralFDC000000043BV250312","","220","","247721.77"
"2025-03-14","2025-03-12","SF FuneralFDC00000006YNY250312","","126.5","","247848.27"
"2025-03-14","2025-03-12","SF FuneralFDC000000070WX250312","","126.5","","247974.77"
"2025-03-14","2025-03-12","SF FuneralFDC0000000710G250312","","126.5","","248101.27"
"2025-03-14","2025-03-12","SF FuneralFDC00000008KSM250312","","126.5","","248227.77"
"2025-03-14","2025-03-12","SF FuneralF804578       250312","","126.5","","248354.27"
"2025-03-14","2025-03-12","SF FuneralF800589       250312","","126.5","","248480.77"
"2025-03-14","2025-03-12","SF FuneralF810985       250312","","126.5","","248607.27"
"2025-03-14","2025-03-12","SF FuneralF814106       250312","","126.5","","248733.77"
"2025-03-14","2025-03-12","SF FuneralFDC00000009KTH250312","","126.5","","248860.27"
"2025-03-14","2025-03-12","SF FuneralF1021083      250312","","126.5","","248986.77"
"2025-03-14","2025-03-12","SF FuneralF1050716      250312","","126.5","","249113.27"
"2025-03-14","2025-03-12","SF FuneralF1111777      250312","","126.5","","249239.77"
"2025-03-14","2025-03-11","SF FuneralF830076       250311","","63.25","","249303.02"
"2025-03-14","2025-03-12","SF FuneralFDC00000005Q9D250312","","126.5","","249429.52"
"2025-03-14","2025-03-12","SF FuneralF796728       250312","","126.5","","249556.02"
"2025-03-14","2025-03-12","SF FuneralFDC00000008B89250312","","126.5","","249682.52"
"2025-03-14","2025-03-12","SF FuneralF816324       250312","","126.5","","249809.02"
"2025-03-14","2025-03-12","SF FuneralF817919       250312","","126.5","","249935.52"
"2025-03-14","2025-03-12","SF FuneralFDC0000000BSLC250312","","126.5","","250062.02"
"2025-03-14","2025-03-11","SF FuneralF993898       250311","","63.25","","250125.27"
"2025-03-14","2025-03-11","SF FuneralF1016763      250311","","126.5","","250251.77"
"2025-03-14","2025-03-12","SF FuneralFDC0000000953Q250312","","126.5","","250378.27"
"2025-03-14","2025-03-10","SF FuneralFDC00000007F71250310","","63.25","","250441.52"
"2025-03-14","2025-03-12","SF FuneralF804219       250312","","126.5","","250568.02"
"2025-03-14","2025-03-12","SF FuneralF991384       250312","","126.5","","250694.52"
"2025-03-14","2025-03-12","SF FuneralF1132420      250312","","126.5","","250821.02"
"2025-03-14","2025-03-12","SF FuneralFDC00000005JSW250312","","126.5","","250947.52"
"2025-03-14","2025-03-12","SF FuneralFDC00000005K1B250312","","126.5","","251074.02"
"2025-03-14","2025-03-12","SF FuneralFDC00000005N90250312","","126.5","","251200.52"
"2025-03-14","2025-03-12","SF FuneralFDC00000006B6K250312","","126.5","","251327.02"
"2025-03-14","2025-03-12","SF FuneralFDC00000006W3P250312","","126.5","","251453.52"
"2025-03-14","2025-03-12","SF FuneralFDC00000006WDQ250312","","126.5","","251580.02"
"2025-03-14","2025-03-12","SF FuneralFDC00000006WY6250312","","126.5","","251706.52"
"2025-03-14","2025-03-12","SF FuneralFDC00000008BPL250312","","126.5","","251833.02"
"2025-03-14","2025-03-12","SF FuneralFDC0000000D71H250312","","126.5","","251959.52"
"2025-03-14","2025-03-12","SF FuneralFDC0000000DRNV250312","","126.5","","252086.02"
"2025-03-14","2025-03-12","SF FuneralFDC0000000FGXN250312","","126.5","","252212.52"
"2025-03-14","2025-03-12","SF FuneralF843697       250312","","126.5","","252339.02"
"2025-03-14","2025-03-12","SF FuneralF1061869      250312","","126.5","","252465.52"
"2025-03-14","2025-03-12","SF FuneralF1083626      250312","","126.5","","252592.02"
"2025-03-14","2025-03-12","SF FuneralF793566       250312","","126.5","","252718.52"
"2025-03-14","2025-03-12","SF FuneralF1130682      250312","","126.5","","252845.02"
"2025-03-14","2025-03-10","SF FuneralFDC00000005LNS250309","","126.5","","252971.52"
"2025-03-14","2025-03-10","SF FuneralF1118237      250310","","126.5","","253098.02"
"2025-03-14","2025-03-14","SF FuneralFDC0000000JMVM250314","","63.25","","253161.27"
"2025-03-14","2025-03-11","SF FuneralF830100       250311","","63.25","","253224.52"
"2025-03-14","2025-03-11","SF FuneralF1068200      250311","","63.25","","253287.77"
"2025-03-14","2025-03-11","SF FuneralF1078509      250311","","63.25","","253351.02"
"2025-03-14","2025-03-11","SF FuneralFDC0000000N2L7250311","","63.25","","253414.27"
"2025-03-14","2025-03-11","SF FuneralF1112459      250311","","63.25","","253477.52"
"2025-03-14","2025-03-11","SF FuneralF1080397      250311","","63.25","","253540.77"
"2025-03-14","2025-03-11","SF FuneralFDC0000000PYLY250311","","126.5","","253667.27"
"2025-03-14","2025-03-11","SF FuneralF1130060      250311","","63.25","","253730.52"
"2025-03-14","2025-03-12","SF FuneralFDC000000072GH250312","","126.5","","253857.02"
"2025-03-14","2025-03-12","SF FuneralFDC00000007CK1250312","","126.5","","253983.52"
"2025-03-14","2025-03-12","SF FuneralFDC00000007DLY250312","","126.5","","254110.02"
"2025-03-14","2025-03-12","SF FuneralFDC00000007DMG250312","","126.5","","254236.52"
"2025-03-14","2025-03-12","SF FuneralFDC00000007Y3K250312","","126.5","","254363.02"
"2025-03-14","2025-03-12","SF FuneralF802076       250312","","126.5","","254489.52"
"2025-03-14","2025-03-12","SF FuneralF810506       250312","","126.5","","254616.02"
"2025-03-14","2025-03-12","SF FuneralF830412       250312","","126.5","","254742.52"
"2025-03-14","2025-03-12","SF FuneralF989730       250312","","126.5","","254869.02"
"2025-03-14","2025-03-12","SF FuneralF1060695      250312","","126.5","","254995.52"
"2025-03-14","2025-03-12","SF FuneralFDC0000000KK01250312","","126.5","","255122.02"
"2025-03-14","2025-03-12","SF FuneralFDC0000000LDKT250312","","126.5","","255248.52"
"2025-03-14","2025-03-12","SF FuneralF1111667      250312","","126.5","","255375.02"
"2025-03-14","2025-03-12","SF FuneralFDC0000000NFB5250312","","126.5","","255501.52"
"2025-03-14","2025-03-12","SF FuneralF1118006      250312","","126.5","","255628.02"
"2025-03-14","2025-03-12","SF FuneralFDC0000000PZXJ250312","","126.5","","255754.52"
"2025-03-14","2025-03-10","SF FuneralFDC0000000659X250310","","63.25","","255817.77"
"2025-03-14","2025-03-11","SF FuneralF1052710      250311","","63.25","","255881.02"
"2025-03-14","2025-03-11","SF FuneralF1119681      250311","","63.25","","255944.27"
"2025-03-14","2025-03-12","SF FuneralFDC00000005GH3250312","","126.5","","256070.77"
"2025-03-14","2025-03-12","SF FuneralFDC00000005HQ9250312","","126.5","","256197.27"
"2025-03-14","2025-03-12","SF FuneralFDC00000005LNL250312","","126.5","","256323.77"
"2025-03-14","2025-03-12","SF FuneralFDC00000005LQK250312","","126.5","","256450.27"
"2025-03-14","2025-03-12","SF FuneralFDC00000005MBM250312","","126.5","","256576.77"
"2025-03-14","2025-03-12","SF FuneralFDC00000005MD5250312","","126.5","","256703.27"
"2025-03-14","2025-03-12","SF FuneralFDC00000005QPS250312","","126.5","","256829.77"
"2025-03-14","2025-03-12","SF FuneralF794742       250312","","126.5","","256956.27"
"2025-03-14","2025-03-12","SF FuneralF822846       250312","","126.5","","257082.77"
"2025-03-14","2025-03-12","SF FuneralF840538       250312","","126.5","","257209.27"
"2025-03-14","2025-03-12","SF FuneralF990043       250312","","126.5","","257335.77"
"2025-03-14","2025-03-12","SF FuneralFDC0000000P45S250312","","126.5","","257462.27"
"2025-03-14","2025-03-14","SF FuneralF980379       250314","","31.63","","257493.9"
"2025-03-14","2025-03-14","SF FuneralF1132255      250314","","31.63","","257525.53"
"2025-03-14","2025-03-12","SF FuneralF795840       250312","","126.5","","257652.03"
"2025-03-14","2025-03-12","SF FuneralFDC00000007X62250312","","126.5","","257778.53"
"2025-03-14","2025-03-12","SF FuneralFDC00000007XKK250312","","126.5","","257905.03"
"2025-03-14","2025-03-12","SF FuneralF796179       250312","","126.5","","258031.53"
"2025-03-14","2025-03-12","SF FuneralF796282       250312","","126.5","","258158.03"
"2025-03-14","2025-03-12","SF FuneralFDC00000008C7N250312","","126.5","","258284.53"
"2025-03-14","2025-03-12","SF FuneralF801016       250312","","126.5","","258411.03"
"2025-03-14","2025-03-12","SF FuneralF989253       250312","","126.5","","258537.53"
"2025-03-14","2025-03-12","SF FuneralF989556       250312","","126.5","","258664.03"
"2025-03-14","2025-03-12","SF FuneralF1110805      250312","","126.5","","258790.53"
"2025-03-14","2025-03-12","SF FuneralFDC0000000PL6F250312","","126.5","","258917.03"
"2025-03-14","2025-03-12","SF FuneralFDC0000000QCJY250312","","126.5","","259043.53"
"2025-03-14","2025-03-12","SF FuneralF1133295      250312","","126.5","","259170.03"
"2025-03-14","2025-03-14","SF FuneralFDC00000006ZGX250314","","126.5","","259296.53"
"2025-03-14","2025-03-11","SF FuneralF827697       250311","","126.5","","259423.03"
"2025-03-14","2025-03-11","SF FuneralF1114553      250311","","63.25","","259486.28"
"2025-03-14","2025-03-12","SF FuneralFDC000000043BX250312","","220","","259706.28"
"2025-03-14","2025-03-12","SF FuneralFDC00000005J20250312","","126.5","","259832.78"
"2025-03-14","2025-03-12","SF FuneralFDC00000005J58250312","","126.5","","259959.28"
"2025-03-14","2025-03-12","SF FuneralFDC00000005J99250312","","126.5","","260085.78"
"2025-03-14","2025-03-12","SF FuneralFDC00000005JCW250312","","126.5","","260212.28"
"2025-03-14","2025-03-12","SF FuneralFDC00000005L3N250312","","126.5","","260338.78"
"2025-03-14","2025-03-12","SF FuneralFDC00000005L52250312","","126.5","","260465.28"
"2025-03-14","2025-03-12","SF FuneralFDC00000005SZ7250312","","126.5","","260591.78"
"2025-03-14","2025-03-12","SF FuneralFDC00000005V13250312","","126.5","","260718.28"
"2025-03-14","2025-03-12","SF FuneralFDC00000005V62250312","","126.5","","260844.78"
"2025-03-14","2025-03-12","SF FuneralFDC00000005XGH250312","","126.5","","260971.28"
"2025-03-14","2025-03-12","SF FuneralFDC00000005ZC3250312","","126.5","","261097.78"
"2025-03-14","2025-03-12","SF FuneralFDC00000006CP2250312","","126.5","","261224.28"
"2025-03-14","2025-03-12","SF FuneralFDC00000006L8X250312","","126.5","","261350.78"
"2025-03-14","2025-03-12","SF FuneralFDC00000006X80250312","","126.5","","261477.28"
"2025-03-14","2025-03-12","SF FuneralFDC00000007N3L250312","","126.5","","261603.78"
"2025-03-14","2025-03-12","SF FuneralF804444       250312","","126.5","","261730.28"
"2025-03-14","2025-03-12","SF FuneralF787671       250312","","126.5","","261856.78"
"2025-03-14","2025-03-12","SF FuneralF814199       250312","","126.5","","261983.28"
"2025-03-14","2025-03-12","SF FuneralF822351       250312","","126.5","","262109.78"
"2025-03-14","2025-03-12","SF FuneralF822590       250312","","126.5","","262236.28"
"2025-03-14","2025-03-12","SF FuneralF831727       250312","","126.5","","262362.78"
"2025-03-14","2025-03-12","SF FuneralF833726       250312","","126.5","","262489.28"
"2025-03-14","2025-03-12","SF FuneralF833864       250312","","126.5","","262615.78"
"2025-03-14","2025-03-12","SF FuneralFDC0000000CWP7250312","","126.5","","262742.28"
"2025-03-14","2025-03-12","SF FuneralF833921       250312","","126.5","","262868.78"
"2025-03-14","2025-03-12","SF FuneralF833976       250312","","126.5","","262995.28"
"2025-03-14","2025-03-12","SF FuneralFDC0000000D000250312","","126.5","","263121.78"
"2025-03-14","2025-03-12","SF FuneralFDC0000000G606250312","","126.5","","263248.28"
"2025-03-14","2025-03-12","SF FuneralF986746       250312","","126.5","","263374.78"
"2025-03-14","2025-03-12","SF FuneralF986903       250312","","126.5","","263501.28"
"2025-03-14","2025-03-12","SF FuneralF986909       250312","","126.5","","263627.78"
"2025-03-14","2025-03-12","SF FuneralF990460       250312","","126.5","","263754.28"
"2025-03-14","2025-03-12","SF FuneralFDC0000000JG7T250312","","126.5","","263880.78"
"2025-03-14","2025-03-12","SF FuneralFDC0000000JGBQ250312","","126.5","","264007.28"
"2025-03-14","2025-03-12","SF FuneralF1017310      250312","","126.5","","264133.78"
"2025-03-14","2025-03-12","SF FuneralF1017413      250312","","126.5","","264260.28"
"2025-03-14","2025-03-12","SF FuneralFDC0000000JJX5250312","","126.5","","264386.78"
"2025-03-14","2025-03-12","SF FuneralFDC0000000L3TB250312","","126.5","","264513.28"
"2025-03-14","2025-03-12","SF FuneralF1079349      250312","","126.5","","264639.78"
"2025-03-14","2025-03-12","SF FuneralFDC0000000NJPY250312","","126.5","","264766.28"
"2025-03-14","2025-03-12","SF FuneralFDC0000000P5F4250312","","126.5","","264892.78"
"2025-03-14","2025-03-12","SF FuneralF1125185      250312","","126.5","","265019.28"
"2025-03-14","2025-03-12","SF FuneralF1127761      250312","","126.5","","265145.78"
"2025-03-14","2025-03-12","SF FuneralFDC0000000PVD2250312","","126.5","","265272.28"
"2025-03-14","2025-03-12","SF FuneralF1133347      250312","","126.5","","265398.78"
"2025-03-14","2025-03-11","SF FuneralF1060859      250311","","63.25","","265462.03"
"2025-03-14","2025-03-12","SF FuneralFDC00000002Q7T250312","","220","","265682.03"
"2025-03-14","2025-03-12","SF FuneralFDC00000003D4D250312","","220","","265902.03"
"2025-03-14","2025-03-12","SF FuneralFDC00000005N1Q250312","","126.5","","266028.53"
"2025-03-14","2025-03-12","SF FuneralFDC00000005N4G250312","","126.5","","266155.03"
"2025-03-14","2025-03-12","SF FuneralFDC00000005PMC250312","","126.5","","266281.53"
"2025-03-14","2025-03-12","SF FuneralFDC00000006Q2Z250312","","126.5","","266408.03"
"2025-03-14","2025-03-12","SF FuneralFDC00000006RKW250312","","126.5","","266534.53"
"2025-03-14","2025-03-12","SF FuneralFDC00000006V5J250312","","126.5","","266661.03"
"2025-03-14","2025-03-12","SF FuneralFDC00000006V75250312","","213.31","","266874.34"
"2025-03-14","2025-03-12","SF FuneralF804309       250312","","126.5","","267000.84"
"2025-03-14","2025-03-12","SF FuneralF980316       250312","","126.5","","267127.34"
"2025-03-14","2025-03-12","SF FuneralF980974       250312","","126.5","","267253.84"
"2025-03-14","2025-03-12","SF FuneralF981839       250312","","126.5","","267380.34"
"2025-03-14","2025-03-12","SF FuneralF1060763      250312","","126.5","","267506.84"
"2025-03-14","2025-03-12","SF FuneralF1083948      250312","","126.5","","267633.34"
"2025-03-14","2025-03-12","SF FuneralF1084280      250312","","126.5","","267759.84"
"2025-03-14","2025-03-12","SF FuneralF1103776      250312","","126.5","","267886.34"
"2025-03-14","2025-03-12","SF FuneralFDC0000000M8PV250312","","126.5","","268012.84"
"2025-03-14","2025-03-12","SF FuneralFDC0000000MRJY250312","","126.5","","268139.34"
"2025-03-14","2025-03-12","SF FuneralF796065       250312","","126.5","","268265.84"
"2025-03-14","2025-03-12","SF FuneralFDC0000000PL6G250312","","126.5","","268392.34"
"2025-03-14","2025-03-12","SF FuneralFDC0000000PL6M250312","","126.5","","268518.84"
"2025-03-14","2025-03-12","SF FuneralF1128701      250312","","126.5","","268645.34"
"2025-03-14","2025-03-12","SF FuneralF1132271      250312","","126.5","","268771.84"
"2025-03-14","2025-03-12","SF FuneralF1132305      250312","","126.5","","268898.34"
"2025-03-14","2025-03-14","SF FuneralF785787       250314","","63.25","","268961.59"
"2025-03-14","2025-03-14","SF FuneralF1060738      250314","","126.5","","269088.09"
"2025-03-14","2025-03-11","SF FuneralF822630       250311","","63.25","","269151.34"
"2025-03-14","2025-03-12","SF FuneralFDC00000006WVW250312","","126.5","","269277.84"
"2025-03-14","2025-03-12","SF FuneralFDC00000006YQ3250312","","126.5","","269404.34"
"2025-03-14","2025-03-12","SF FuneralFDC0000000757W250312","","126.5","","269530.84"
"2025-03-14","2025-03-12","SF FuneralF818309       250312","","126.5","","269657.34"
"2025-03-14","2025-03-12","SF FuneralF814384       250312","","126.5","","269783.84"
"2025-03-14","2025-03-12","SF FuneralF819113       250312","","126.5","","269910.34"
"2025-03-14","2025-03-12","SF FuneralF819726       250312","","126.5","","270036.84"
"2025-03-14","2025-03-12","SF FuneralF1061034      250312","","126.5","","270163.34"
"2025-03-14","2025-03-12","SF FuneralFDC0000000Q088250312","","126.5","","270289.84"
"2025-03-14","2025-03-12","SF FuneralF1130275      250312","","126.5","","270416.34"
"2025-03-14","2025-03-12","SF FuneralFDC0000000QC0Q250312","","126.5","","270542.84"
"2025-03-14","2025-03-10","SF FuneralF1125170      250310","","126.5","","270669.34"
"2025-03-14","2025-03-14","SF FuneralFDC000000089XM250314","","126.5","","270795.84"
"2025-03-14","2025-03-12","SF FuneralFDC00000005L5D250312","","126.5","","270922.34"
"2025-03-14","2025-03-12","SF FuneralFDC00000005LWL250312","","126.5","","271048.84"
"2025-03-14","2025-03-12","SF FuneralFDC0000000FLWY250312","","126.5","","271175.34"
"2025-03-14","2025-03-12","SF FuneralF1080305      250312","","126.5","","271301.84"
"2025-03-14","2025-03-11","SF FuneralF1131005      250311","","63.25","","271365.09"
"2025-03-14","2025-03-14","SF FuneralFDC00000007Y4Y250314","","126.5","","271491.59"
"2025-03-14","2025-03-12","SF FuneralF1079724      250312","","126.5","","271618.09"
"2025-03-14","2025-03-12","SF FuneralF1079728      250312","","126.5","","271744.59"
"2025-03-14","2025-03-12","SF FuneralFDC0000000N9DG250312","","126.5","","271871.09"
"2025-03-14","2025-03-12","SF FuneralF1122738      250312","","126.5","","271997.59"
"2025-03-14","2025-03-08","SF FuneralF1084288      250308","","31.63","","272029.22"
"2025-03-14","2025-03-10","SF FuneralFDC000000077L1250310","","63.25","","272092.47"
"2025-03-14","2025-03-10","SF FuneralFDC000000077LG250310","","110","","272202.47"
"2025-03-14","2025-03-10","SF FuneralFDC00000007R6J250310","","63.25","","272265.72"
"2025-03-14","2025-03-10","SF FuneralF1073862      250310","","31.63","","272297.35"
"2025-03-14","2025-03-10","SF FuneralF1080529      250310","","31.63","","272328.98"
"2025-03-14","2025-03-10","SF FuneralF1124114      250310","","31.63","","272360.61"
"2025-03-14","2025-03-10","SF FuneralF1133709      250310","","31.63","","272392.24"
"2025-03-14","2025-03-11","SF FuneralFDC00000006WKK250311","","31.63","","272423.87"
"2025-03-14","2025-03-11","SF FuneralFDC00000007CPB250311","","31.63","","272455.5"
"2025-03-14","2025-03-11","SF FuneralFDC00000008851250311","","31.63","","272487.13"
"2025-03-14","2025-03-11","SF FuneralF821545       250311","","47.88","","272535.01"
"2025-03-14","2025-03-11","SF FuneralF981653       250311","","63.25","","272598.26"
"2025-03-14","2025-03-11","SF FuneralF990255       250311","","31.63","","272629.89"
"2025-03-14","2025-03-11","SF FuneralF1065982      250311","","31.63","","272661.52"
"2025-03-14","2025-03-11","SF FuneralF1074649      250311","","31.63","","272693.15"
"2025-03-14","2025-03-11","SF FuneralF1080280      250311","","63.25","","272756.4"
"2025-03-14","2025-03-11","SF FuneralF1114485      250311","","63.25","","272819.65"
"2025-03-14","2025-03-11","SF FuneralF1122598      250311","","63.25","","272882.9"
"2025-03-14","2025-03-11","SF FuneralF1132378      250311","","31.63","","272914.53"
"2025-03-14","2025-03-12","SF FuneralFDC00000005HSY250312","","126.5","","273041.03"
"2025-03-14","2025-03-12","SF FuneralFDC00000005K6N250312","","126.5","","273167.53"
"2025-03-14","2025-03-12","SF FuneralFDC00000005M1V250312","","126.5","","273294.03"
"2025-03-14","2025-03-12","SF FuneralFDC00000005M5H250312","","220","","273514.03"
"2025-03-14","2025-03-12","SF FuneralFDC00000005MM8250312","","126.5","","273640.53"
"2025-03-14","2025-03-12","SF FuneralFDC00000005N3Y250312","","126.5","","273767.03"
"2025-03-14","2025-03-12","SF FuneralFDC00000005NZ7250312","","126.5","","273893.53"
"2025-03-14","2025-03-12","SF FuneralFDC00000005NZC250312","","126.5","","274020.03"
"2025-03-14","2025-03-12","SF FuneralFDC00000005P1G250312","","126.5","","274146.53"
"2025-03-14","2025-03-12","SF FuneralFDC00000005TKX250312","","126.5","","274273.03"
"2025-03-14","2025-03-12","SF FuneralFDC00000005XR7250312","","126.5","","274399.53"
"2025-03-14","2025-03-12","SF FuneralFDC0000000615G250312","","126.5","","274526.03"
"2025-03-14","2025-03-12","SF FuneralFDC00000006BQ5250312","","126.5","","274652.53"
"2025-03-14","2025-03-12","SF FuneralFDC00000006L2B250312","","278.31","","274930.84"
"2025-03-14","2025-03-12","SF FuneralFDC00000006RDP250312","","126.5","","275057.34"
"2025-03-14","2025-03-12","SF FuneralFDC00000006W87250312","","126.5","","275183.84"
"2025-03-14","2025-03-12","SF FuneralFDC00000006WZJ250312","","126.5","","275310.34"
"2025-03-14","2025-03-12","SF FuneralFDC00000006ZDR250312","","126.5","","275436.84"
"2025-03-14","2025-03-12","SF FuneralFDC00000007HJD250312","","126.5","","275563.34"
"2025-03-14","2025-03-12","SF FuneralFDC00000007RCC250312","","126.5","","275689.84"
"2025-03-14","2025-03-12","SF FuneralFDC00000007ZRC250312","","126.5","","275816.34"
"2025-03-14","2025-03-12","SF FuneralFDC000000080CD250312","","126.5","","275942.84"
"2025-03-14","2025-03-12","SF FuneralFDC00000008NF0250312","","126.5","","276069.34"
"2025-03-14","2025-03-12","SF FuneralF811281       250312","","126.5","","276195.84"
"2025-03-14","2025-03-12","SF FuneralF823270       250312","","126.5","","276322.34"
"2025-03-14","2025-03-12","SF FuneralF829988       250312","","126.5","","276448.84"
"2025-03-14","2025-03-12","SF FuneralF833884       250312","","126.5","","276575.34"
"2025-03-14","2025-03-12","SF FuneralF843692       250312","","126.5","","276701.84"
"2025-03-14","2025-03-12","SF FuneralF990482       250312","","126.5","","276828.34"
"2025-03-14","2025-03-12","SF FuneralF1016906      250312","","126.5","","276954.84"
"2025-03-14","2025-03-12","SF FuneralF1050816      250312","","126.5","","277081.34"
"2025-03-14","2025-03-12","SF FuneralF1050855      250312","","126.5","","277207.84"
"2025-03-14","2025-03-12","SF FuneralFDC0000000KGGJ250312","","126.5","","277334.34"
"2025-03-14","2025-03-12","SF FuneralF1080364      250312","","126.5","","277460.84"
"2025-03-14","2025-03-12","SF FuneralF1116720      250312","","126.5","","277587.34"
"2025-03-14","2025-03-12","SF FuneralFDC0000000NPJ2250312","","126.5","","277713.84"
"2025-03-14","2025-03-12","SF FuneralFDC0000000NPQ0250312","","126.5","","277840.34"
"2025-03-14","2025-03-14","SF FuneralFDC00000005M42250314","","220","","278060.34"
"2025-03-14","2025-03-14","SF FuneralFDC0000000628F250314","","31.63","","278091.97"
"2025-03-14","2025-03-14","SF FuneralFDC00000006P6D250314","","31.63","","278123.6"
"2025-03-14","2025-03-14","SF FuneralF993809       250314","","31.63","","278155.23"
"2025-03-14","2025-03-14","SF FuneralF993837       250314","","31.63","","278186.86"
"2025-03-14","2025-03-14","SF FuneralF1127827      250314","","126.5","","278313.36"
"2025-03-14","2025-03-12","SF FuneralF1118661      250312","","126.5","","278439.86"
"2025-03-14","2025-03-12","SF FuneralFDC0000000NPPS250312","","191.5","","278631.36"
"2025-03-14","2025-03-10","SF FuneralF1111946      250310","","126.5","","278757.86"
"2025-03-14","2025-03-12","SF FuneralFDC00000005KFX250312","","126.5","","278884.36"
"2025-03-14","2025-03-12","SF FuneralFDC00000005KSW250312","","126.5","","279010.86"
"2025-03-14","2025-03-12","SF FuneralF1074772      250312","","126.5","","279137.36"
"2025-03-14","2025-02-22","Rev SF FuneralFDC00000008JYC250222","","-126.5","","279010.86"
"2025-03-14","2025-03-13","Rev SF FuneralFDC00000005P8B250313","","-31.63","","278979.23"
"2025-03-14","2025-03-12","Rev SF FuneralFDC0000000P5F4250312","","-126.5","","278852.73"
"2025-03-14","2025-03-12","Rev SF FuneralFDC00000008KSM250312","","-126.5","","278726.23"
"2025-03-14","2025-03-12","Rev SF FuneralFDC00000008BPL250312","","-126.5","","278599.73"
"2025-03-14","2025-02-22","Rev SF FuneralFDC000000067N8250222","","-126.5","","278473.23"
"2025-03-14","2025-02-25","Rev SF FuneralFDC0000000Q8DY250225","","-126.5","","278346.73"
"2025-03-14","2025-03-11","Rev SF FuneralFDC00000003D2J250311","","-110","","278236.73"
"2025-03-14","2025-03-12","Rev SF FuneralFDC00000009KTH250312","","-126.5","","278110.23"
"2025-03-14","2025-03-12","Rev SF FuneralFDC0000000G985250312","","-126.5","","277983.73"
"2025-03-14","2025-02-28","Rev SF FuneralFDC0000000HTF1250228","","-126.5","","277857.23"
"2025-03-14","2025-03-01","Rev SF FuneralFDC00000009WGZ250301","","-126.5","","277730.73"
"2025-03-14","2025-03-10","SF FuneralFDC00000006Q80250310","","31.63","","277762.36"
"2025-03-14","2025-03-11","SF FuneralF794834       250311","","63.25","","277825.61"
"2025-03-14","2025-03-11","SF FuneralF822587       250311","","31.63","","277857.24"
"2025-03-14","2025-03-11","SF FuneralF990180       250311","","31.63","","277888.87"
"2025-03-14","2025-03-12","SF FuneralFDC0000000QD4Y250312","","126.5","","278015.37"
"2025-03-14","2025-03-12","SF FuneralF1133477      250312","","126.5","","278141.87"
"2025-03-14","2025-03-06","SF FuneralFDC000000063DX250306","","126.5","","278268.37"
"2025-03-14","2025-03-11","SF FuneralFDC00000006042250311","","63.25","","278331.62"
"2025-03-14","2025-03-11","SF FuneralFDC00000005NFK250311","","31.63","","278363.25"
"2025-03-14","2025-03-11","SF FuneralFDC00000007S9L250311","","31.63","","278394.88"
"2025-03-14","2025-03-11","SF FuneralF798846       250311","","31.63","","278426.51"
"2025-03-14","2025-03-11","SF FuneralF831226       250311","","31.63","","278458.14"
"2025-03-14","2025-03-11","SF FuneralF841781       250311","","31.63","","278489.77"
"2025-03-14","2025-03-11","SF FuneralF1050698      250311","","31.63","","278521.4"
"2025-03-14","2025-03-11","SF FuneralF1128951      250311","","31.63","","278553.03"
"2025-03-14","2025-03-12","SF FuneralF1124144      250312","","31.63","","278584.66"
"2025-03-14","2025-03-14","SF FuneralF811119       250314","","31.63","","278616.29"
"2025-03-14","2025-03-14","SF FuneralF841714       250314","","31.63","","278647.92"
"2025-03-14","2025-03-14","SF FuneralFDC0000000J2Y1250315","","31.63","","278679.55"
"2025-03-14","2025-03-11","SF FuneralFDC00000007333250311","","63.25","","278742.8"
"2025-03-14","2025-03-11","SF FuneralF990253       250311","","63.25","","278806.05"
"2025-03-14","2025-03-11","SF FuneralF1072954      250311","","126.5","","278932.55"
"2025-03-14","2025-03-11","SF FuneralF1122765      250311","","63.25","","278995.8"
"2025-03-14","2025-03-11","SF FuneralF1124156      250311","","63.25","","279059.05"
"2025-03-14","2025-03-12","SF FuneralFDC00000005K9B250312","","126.5","","279185.55"
"2025-03-14","2025-03-12","SF FuneralFDC00000005V08250312","","126.5","","279312.05"
"2025-03-14","2025-03-12","SF FuneralFDC00000006D5S250312","","126.5","","279438.55"
"2025-03-14","2025-03-12","SF FuneralFDC00000007FWD250312","","126.5","","279565.05"
"2025-03-14","2025-03-12","SF FuneralF814898       250312","","126.5","","279691.55"
"2025-03-14","2025-03-12","SF FuneralF989834       250312","","126.5","","279818.05"
"2025-03-14","2025-03-12","SF FuneralFDC0000000J2WH250312","","126.5","","279944.55"
"2025-03-14","2025-03-12","SF FuneralF1119711      250312","","126.5","","280071.05"
"2025-03-14","2025-03-11","SF FuneralFDC00000005P4K250311","","31.63","","280102.68"
"2025-03-14","2025-03-11","SF FuneralF800205       250311","","31.63","","280134.31"
"2025-03-14","2025-03-10","SF FuneralF1118033      250310","","31.63","","280165.94"
"2025-03-14","2025-03-11","SF FuneralFDC00000006WM3250311","","126.5","","280292.44"
"2025-03-14","2025-03-11","SF FuneralF811790       250311","","31.63","","280324.07"
"2025-03-14","2025-03-11","SF FuneralF819158       250311","","31.63","","280355.7"
"2025-03-14","2025-03-11","SF FuneralF989270       250311","","31.63","","280387.33"
"2025-03-14","2025-03-11","SF FuneralF1118335      250311","","31.63","","280418.96"
"2025-03-14","2025-03-11","SF FuneralF1118420      250311","","31.63","","280450.59"
"2025-03-14","2025-03-11","SF FuneralF1123396      250311","","63.25","","280513.84"
"2025-03-14","2025-03-11","SF FuneralF1129094      250311","","63.25","","280577.09"
"2025-03-14","2025-03-12","SF FuneralFDC00000005KF0250312","","126.5","","280703.59"
"2025-03-14","2025-03-12","SF FuneralFDC00000008BF0250312","","126.5","","280830.09"
"2025-03-14","2025-03-12","SF FuneralF814878       250312","","126.5","","280956.59"
"2025-03-14","2025-03-12","SF FuneralF1111534      250312","","126.5","","281083.09"
"2025-03-14","2025-03-12","SF FuneralF1114792      250312","","126.5","","281209.59"
"2025-03-14","2025-03-14","SF FuneralF847452       250314","","31.63","","281241.22"
"2025-03-14","2025-03-14","SF FuneralF988945       250316","","31.63","","281272.85"
"2025-03-14","2025-03-14","SF FuneralF1022106      250314","","31.63","","281304.48"
"2025-03-14","2025-03-14","SF FuneralF1033704      250314","","31.63","","281336.11"
"2025-03-14","2025-03-14","SF FuneralF1114116      250314","","31.63","","281367.74"
"2025-03-14","2025-03-11","SF FuneralFDC0000000HX1F250311","","63.25","","281430.99"
"2025-03-14","2025-03-11","SF FuneralF1074872      250311","","63.25","","281494.24"
"2025-03-14","2025-03-14","SF FuneralF1112474      250314","","63.25","","281557.49"
"2025-03-14","2025-03-06","SF FuneralFDC00000006TH1250306","","63.25","","281620.74"
"2025-03-14","2025-03-11","SF FuneralF1067978      250311","","31.63","","281652.37"
"2025-03-14","2025-03-12","SF FuneralF1110730      250312","","126.5","","281778.87"
"2025-03-14","2025-03-12","SF FuneralF1129649      250312","","126.5","","281905.37"
"2025-03-14","2025-03-11","SF FuneralFDC00000005GGL250311","","63.25","","281968.62"
"2025-03-14","2025-03-11","SF FuneralFDC00000008BNG250311","","126.5","","282095.12"
"2025-03-14","2025-03-11","SF FuneralF813480       250311","","63.25","","282158.37"
"2025-03-14","2025-03-11","SF FuneralF1020917      250311","","63.25","","282221.62"
"2025-03-14","2025-03-11","SF FuneralF1060636      250311","","63.25","","282284.87"
"2025-03-14","2025-03-11","SF FuneralF1073735      250311","","63.25","","282348.12"
"2025-03-14","2025-03-11","SF FuneralF1079157      250311","","63.25","","282411.37"
"2025-03-14","2025-03-12","SF FuneralFDC000000064R7250312","","126.5","","282537.87"
"2025-03-14","2025-03-12","SF FuneralFDC00000006N6F250312","","126.5","","282664.37"
"2025-03-14","2025-03-12","SF FuneralFDC00000006VYC250312","","126.5","","282790.87"
"2025-03-14","2025-03-12","SF FuneralFDC00000006VZG250312","","126.5","","282917.37"
"2025-03-14","2025-03-12","SF FuneralFDC00000007FWM250312","","126.5","","283043.87"
"2025-03-14","2025-03-12","SF FuneralF804364       250312","","126.5","","283170.37"
"2025-03-14","2025-03-12","SF FuneralF834372       250312","","126.5","","283296.87"
"2025-03-14","2025-03-12","SF FuneralFDC0000000HQH2250312","","126.5","","283423.37"
"2025-03-14","2025-03-11","SF FuneralFDC00000003V68250311","","55","","283478.37"
"2025-03-14","2025-03-11","SF FuneralF830023       250311","","31.63","","283510"
"2025-03-14","2025-03-11","SF FuneralF834645       250311","","31.63","","283541.63"
"2025-03-14","2025-03-11","SF FuneralF989148       250311","","31.63","","283573.26"
"2025-03-14","2025-03-11","SF FuneralF1066029      250311","","31.63","","283604.89"
"2025-03-14","2025-03-11","SF FuneralF1079178      250311","","31.63","","283636.52"
"2025-03-14","2025-03-11","SF FuneralF1103795      250311","","31.63","","283668.15"
"2025-03-14","2025-03-11","SF FuneralF1118962      250311","","31.63","","283699.78"
"2025-03-14","2025-03-14","SF FuneralFDC000000069RZ250314","","31.63","","283731.41"
"2025-03-14","2025-03-14","SF FuneralFDC0000000JXK7250314","","31.63","","283763.04"
"2025-03-14","2025-03-10","SF FuneralF830092       250310","","126.5","","283889.54"
"2025-03-14","2025-03-11","SF FuneralF989085       250311","","31.63","","283921.17"
"2025-03-14","2025-03-11","SF FuneralF1065831      250311","","63.25","","283984.42"
"2025-03-14","2025-03-11","SF FuneralF1130346      250311","","31.63","","284016.05"
"2025-03-14","2025-03-10","SF FuneralFDC00000005NWL250310","","31.63","","284047.68"
"2025-03-14","2025-03-11","SF FuneralFDC000000030DF250311","","55","","284102.68"
"2025-03-14","2025-03-11","SF FuneralFDC00000006X91250311","","31.63","","284134.31"
"2025-03-14","2025-03-11","SF FuneralF1052659      250311","","31.63","","284165.94"
"2025-03-14","2025-03-11","SF FuneralF1110073      250311","","63.25","","284229.19"
"2025-03-14","2025-03-12","SF FuneralF1115117      250312","","126.5","","284355.69"
"2025-03-14","2025-03-11","SF FuneralFDC0000000CY56250311","","31.63","","284387.32"
"2025-03-14","2025-03-12","SF FuneralFDC00000009LXN250312","","126.5","","284513.82"
"2025-03-14","2025-03-10","SF FuneralF1127535      250310","","63.25","","284577.07"
"2025-03-14","2025-03-07","SF FuneralF740157       250307","","220","","284797.07"
"2025-03-14","2025-03-10","SF FuneralFDC0000000831X250309","","63.25","","284860.32"
"2025-03-14","2025-03-10","SF FuneralFDC0000000832F250309","","63.25","","284923.57"
"2025-03-14","2025-03-10","SF FuneralF830266       250310","","31.63","","284955.2"
"2025-03-14","2025-03-10","SF FuneralF1113979      250310","","63.25","","285018.45"
"2025-03-14","2025-03-11","SF FuneralFDC00000005N64250311","","63.25","","285081.7"
"2025-03-14","2025-03-11","SF FuneralFDC000000073P4250311","","31.63","","285113.33"
"2025-03-14","2025-03-11","SF FuneralFDC000000078FZ250311","","31.63","","285144.96"
"2025-03-14","2025-03-11","SF FuneralFDC00000007YH4250311","","31.63","","285176.59"
"2025-03-14","2025-03-11","SF FuneralF798676       250311","","31.63","","285208.22"
"2025-03-14","2025-03-11","SF FuneralF811437       250311","","63.25","","285271.47"
"2025-03-14","2025-03-11","SF FuneralF812125       250311","","31.63","","285303.1"
"2025-03-14","2025-03-11","SF FuneralF813552       250311","","31.63","","285334.73"
"2025-03-14","2025-03-11","SF FuneralF823118       250311","","63.25","","285397.98"
"2025-03-14","2025-03-11","SF FuneralF830783       250311","","63.25","","285461.23"
"2025-03-14","2025-03-11","SF FuneralF991415       250311","","31.63","","285492.86"
"2025-03-14","2025-03-11","SF FuneralF992474       250311","","63.25","","285556.11"
"2025-03-14","2025-03-11","SF FuneralF1020608      250311","","31.63","","285587.74"
"2025-03-14","2025-03-11","SF FuneralF1033680      250311","","31.63","","285619.37"
"2025-03-14","2025-03-11","SF FuneralF1060316      250311","","31.63","","285651"
"2025-03-14","2025-03-11","SF FuneralF1061865      250311","","31.63","","285682.63"
"2025-03-14","2025-03-11","SF FuneralF1062646      250311","","31.63","","285714.26"
"2025-03-14","2025-03-11","SF FuneralF1067990      250311","","31.63","","285745.89"
"2025-03-14","2025-03-11","SF FuneralFDC0000000LVMD250311","","31.63","","285777.52"
"2025-03-14","2025-03-11","SF FuneralF1113987      250311","","31.63","","285809.15"
"2025-03-14","2025-03-11","SF FuneralF1116010      250311","","31.63","","285840.78"
"2025-03-14","2025-03-11","SF FuneralF1118471      250311","","31.63","","285872.41"
"2025-03-14","2025-03-11","SF FuneralF1120149      250311","","63.25","","285935.66"
"2025-03-14","2025-03-11","SF FuneralF1120220      250311","","63.25","","285998.91"
"2025-03-14","2025-03-11","SF FuneralF1124768      250311","","63.25","","286062.16"
"2025-03-14","2025-03-11","SF FuneralF1128820      250311","","31.63","","286093.79"
"2025-03-14","2025-03-11","SF FuneralF1129064      250311","","31.63","","286125.42"
"2025-03-14","2025-03-11","SF FuneralF1129417      250311","","31.63","","286157.05"
"2025-03-14","2025-03-11","SF FuneralF1132374      250311","","63.25","","286220.3"
"2025-03-14","2025-03-11","SF FuneralF1132892      250311","","63.25","","286283.55"
"2025-03-14","2025-03-11","SF FuneralF1132989      250311","","31.63","","286315.18"
"2025-03-14","2025-03-12","SF FuneralFDC000000082MV250312","","126.5","","286441.68"
"2025-03-14","2025-03-12","SF FuneralF829751       250312","","126.5","","286568.18"
"2025-03-14","2025-03-12","SF FuneralF1017477      250312","","126.5","","286694.68"
"2025-03-14","2025-03-12","SF FuneralF1060844      250312","","126.5","","286821.18"
"2025-03-14","2025-03-12","SF FuneralF1073356      250312","","126.5","","286947.68"
"2025-03-14","2025-03-14","SF FuneralFDC00000006B8B250314","","126.5","","287074.18"
"2025-03-14","2025-03-14","SF FuneralF831922       250314","","31.63","","287105.81"
"2025-03-14","2025-03-12","Rev SF FuneralFDC00000006Q2Z250312","","-126.5","","286979.31"
"2025-03-14","2025-03-12","Rev SF FuneralFDC0000000FLWY250312","","-126.5","","286852.81"
"2025-03-14","2025-03-12","Rev SF FuneralFDC0000000N9DG250312","","-126.5","","286726.31"
"2025-03-14","2025-03-12","Rev SF FuneralFDC0000000J2WH250312","","-126.5","","286599.81"
"2025-03-14","2025-03-10","Rev SF FuneralFDC0000000KYZ5250310","","-31.63","","286568.18"
"2025-03-14","2025-03-12","Rev SF FuneralFDC0000000D000250312","","-126.5","","286441.68"
"2025-03-14","2025-03-12","Rev SF FuneralFDC00000005K9B250312","","-126.5","","286315.18"
"2025-03-14","2025-03-12","Rev SF FuneralFDC000000043BV250312","","-220","","286095.18"
"2025-03-14","2025-03-12","Rev SF FuneralFDC00000005LNL250312","","-126.5","","285968.68"
"2025-03-14","2025-03-12","Rev SF FuneralFDC0000000HQH2250312","","-126.5","","285842.18"
"2025-03-14","2025-03-12","Rev SF FuneralFDC00000003D4D250312","","-220","","285622.18"
"2025-03-14","2025-03-12","Rev SF FuneralFDC00000005XGH250312","","-126.5","","285495.68"
"2025-03-14","2025-03-12","Rev SF FuneralFDC00000008BF0250312","","-126.5","","285369.18"
"2025-03-14","2025-03-12","Rev SF FuneralFDC0000000G606250312","","-126.5","","285242.68"
"2025-03-14","2025-03-12","Rev SF FuneralFDC0000000JGBQ250312","","-126.5","","285116.18"
"2025-03-14","2025-03-12","Rev SF FuneralFDC00000005L3N250312","","-126.5","","284989.68"
"2025-03-14","2025-03-12","Rev SF FuneralFDC00000005L52250312","","-126.5","","284863.18"
"2025-03-14","2025-03-12","Rev SF FuneralFDC0000000P45S250312","","-126.5","","284736.68"
"2025-03-14","2025-03-12","Rev SF FuneralFDC00000006VYC250312","","-126.5","","284610.18"
"2025-03-14","2025-03-12","Rev SF FuneralFDC00000006YNY250312","","-126.5","","284483.68"
"2025-03-14","2025-03-12","Rev SF FuneralFDC0000000MRJY250312","","-126.5","","284357.18"
"2025-03-14","2025-02-24","Rev SF FuneralFDC000000066F0250223","","-191.5","","284165.68"
"2025-03-14","2025-03-12","Rev SF FuneralFDC00000006D5S250312","","-126.5","","284039.18"
"2025-03-14","2025-03-12","Rev SF FuneralFDC00000006VZG250312","","-126.5","","283912.68"
"2025-03-14","2025-03-12","Rev SF FuneralFDC00000007FWD250312","","-126.5","","283786.18"
"2025-03-14","2025-03-12","Rev SF FuneralFDC0000000CWP7250312","","-126.5","","283659.68"
"2025-03-14","2025-03-11","Rev SF FuneralFDC0000000NRQK250311","","-31.63","","283628.05"
"2025-03-14","2025-02-18","Rev SF FuneralFDC00000007ZH7250218","","-31.63","","283596.42"
"2025-03-14","2025-02-25","Rev SF FuneralFDC00000007ZH7250225","","-31.63","","283564.79"
"2025-03-14","2025-03-11","SF FuneralF1122862      250311","","31.63","","283596.42"
"2025-03-14","2025-03-11","SF FuneralF1123027      250311","","31.63","","283628.05"
"2025-03-14","2025-03-13","SF FuneralF1117678      250313","","126.5","","283754.55"
"2025-03-14","2025-03-10","SF FuneralFDC0000000CSY7250310","","31.63","","283786.18"
"2025-03-14","2025-03-10","SF FuneralFDC00000007FPS250310","","31.63","","283817.81"
"2025-03-14","2025-03-10","SF FuneralFDC00000007M33250310","","126.5","","283944.31"
"2025-03-14","2025-03-11","SF FuneralFDC00000006CWD250311","","55","","283999.31"
"2025-03-14","2025-03-11","SF FuneralF796739       250311","","31.63","","284030.94"
"2025-03-14","2025-03-11","SF FuneralF1054618      250311","","31.63","","284062.57"
"2025-03-14","2025-03-11","SF FuneralF1068068      250311","","63.25","","284125.82"
"2025-03-14","2025-03-11","SF FuneralF1129047      250311","","63.25","","284189.07"
"2025-03-14","2025-03-12","SF FuneralFDC00000005P9M250312","","126.5","","284315.57"
"2025-03-14","2025-03-12","SF FuneralFDC00000009R3K250312","","126.5","","284442.07"
"2025-03-14","2025-03-12","SF FuneralFDC00000003WRN250312","","220","","284662.07"
"2025-03-14","2025-03-12","SF FuneralFDC0000000BF0Y250312","","126.5","","284788.57"
"2025-03-14","2025-03-12","SF FuneralF834047       250312","","126.5","","284915.07"
"2025-03-14","2025-03-12","SF FuneralFDC0000000FR7L250312","","126.5","","285041.57"
"2025-03-14","2025-03-12","SF FuneralF844787       250312","","126.5","","285168.07"
"2025-03-14","2025-03-12","SF FuneralF1020960      250312","","63.25","","285231.32"
"2025-03-14","2025-03-12","SF FuneralF1022075      250312","","126.5","","285357.82"
"2025-03-14","2025-03-12","SF FuneralF1072688      250312","","126.5","","285484.32"
"2025-03-14","2025-03-12","SF FuneralFDC0000000NC64250312","","126.5","","285610.82"
"2025-03-14","2025-03-12","SF FuneralFDC0000000NXBY250312","","126.5","","285737.32"
"2025-03-14","2025-03-12","SF FuneralF1127671      250312","","126.5","","285863.82"
"2025-03-14","2025-03-12","SF FuneralF1129256      250312","","126.5","","285990.32"
"2025-03-14","2025-03-12","SF FuneralF1132808      250312","","126.5","","286116.82"
"2025-03-14","2025-03-12","SF FuneralF1133052      250312","","126.5","","286243.32"
"2025-03-14","2025-03-12","SF FuneralF1133228      250312","","126.5","","286369.82"
"2025-03-14","2025-03-11","SF FuneralFDC000000061NF250311","","31.63","","286401.45"
"2025-03-14","2025-03-11","SF FuneralF806032       250311","","31.63","","286433.08"
"2025-03-14","2025-03-11","SF FuneralF809435       250311","","31.63","","286464.71"
"2025-03-14","2025-03-11","SF FuneralF987161       250311","","63.25","","286527.96"
"2025-03-14","2025-03-11","SF FuneralFDC0000000J23L250311","","31.63","","286559.59"
"2025-03-14","2025-03-11","SF FuneralF1022115      250311","","31.63","","286591.22"
"2025-03-14","2025-03-11","SF FuneralF1052200      250311","","31.63","","286622.85"
"2025-03-14","2025-03-11","SF FuneralF843649       250311","","31.63","","286654.48"
"2025-03-14","2025-03-11","SF FuneralF1068023      250311","","31.63","","286686.11"
"2025-03-14","2025-03-11","SF FuneralF1111329      250311","","31.63","","286717.74"
"2025-03-14","2025-03-11","SF FuneralF1111658      250311","","63.25","","286780.99"
"2025-03-14","2025-03-11","SF FuneralF1117702      250311","","31.63","","286812.62"
"2025-03-14","2025-03-11","SF FuneralF820999       250311","","31.63","","286844.25"
"2025-03-14","2025-03-11","SF FuneralF1125142      250311","","31.63","","286875.88"
"2025-03-14","2025-03-11","SF FuneralF990319       250311","","160.75","","287036.63"
"2025-03-14","2025-03-12","SF FuneralF1133268      250312","","126.5","","287163.13"
"2025-03-14","2025-02-22","Rev SF FuneralFDC0000000BB0P250222","","-126.5","","287036.63"
"2025-03-14","2025-03-14","EFT-4510255477089","","440","","287476.63"
"2025-03-15","2025-03-11","SF FuneralFDC00000006B9G250311","","31.63","","287508.26"
"2025-03-15","2025-03-11","SF FuneralF832776       250311","","63.25","","287571.51"
"2025-03-15","2025-03-11","SF FuneralF1016973      250311","","31.63","","287603.14"
"2025-03-15","2025-03-11","SF FuneralF1022184      250311","","31.63","","287634.77"
"2025-03-15","2025-03-14","SF FuneralF798583       250314","","31.63","","287666.4"
"2025-03-15","2025-03-10","SF FuneralF834709       250310","","63.25","","287729.65"
"2025-03-15","2025-03-12","SF FuneralFDC00000005L1J250312","","126.5","","287856.15"
"2025-03-15","2025-03-12","SF FuneralFDC00000005N7C250312","","126.5","","287982.65"
"2025-03-15","2025-03-12","SF FuneralFDC000000075Y5250312","","126.5","","288109.15"
"2025-03-15","2025-03-12","SF FuneralFDC00000007JJ1250312","","126.5","","288235.65"
"2025-03-15","2025-03-12","SF FuneralF810325       250312","","126.5","","288362.15"
"2025-03-15","2025-03-12","SF FuneralF1126239      250312","","126.5","","288488.65"
"2025-03-15","2025-03-12","SF FuneralF1129357      250312","","126.5","","288615.15"
"2025-03-15","2025-03-12","SF FuneralF1129408      250312","","126.5","","288741.65"
"2025-03-15","2025-03-12","SF FuneralF1129968      250312","","126.5","","288868.15"
"2025-03-15","2025-03-12","SF FuneralF1131000      250312","","126.5","","288994.65"
"2025-03-15","2025-03-08","SF FuneralF1129920      250309","","126.5","","289121.15"
"2025-03-15","2025-03-10","SF FuneralFDC000000034JS250310","","110","","289231.15"
"2025-03-15","2025-03-11","SF FuneralF1127919      250311","","63.25","","289294.4"
"2025-03-15","2025-03-12","SF FuneralFDC00000005MZZ250312","","126.5","","289420.9"
"2025-03-15","2025-03-12","SF FuneralF818481       250312","","126.5","","289547.4"
"2025-03-15","2025-03-12","SF FuneralF833875       250312","","126.5","","289673.9"
"2025-03-15","2025-03-12","SF FuneralFDC0000000J3WX250312","","126.5","","289800.4"
"2025-03-15","2025-03-14","SF FuneralFDC0000000Q90L250314","","126.5","","289926.9"
"2025-03-15","2025-03-10","SF FuneralF808988       250310","","31.63","","289958.53"
"2025-03-15","2025-03-10","SF FuneralF828566       250310","","31.63","","289990.16"
"2025-03-15","2025-03-10","SF FuneralF991465       250310","","31.63","","290021.79"
"2025-03-15","2025-03-11","SF FuneralFDC000000067FT250311","","63.25","","290085.04"
"2025-03-15","2025-03-11","SF FuneralFDC00000006QTN250311","","31.63","","290116.67"
"2025-03-15","2025-03-11","SF FuneralFDC00000006Y7S250311","","31.63","","290148.3"
"2025-03-15","2025-03-11","SF FuneralFDC00000009CP1250311","","95.75","","290244.05"
"2025-03-15","2025-03-11","SF FuneralF833123       250311","","31.63","","290275.68"
"2025-03-15","2025-03-11","SF FuneralFDC0000000CWJT250311","","63.25","","290338.93"
"2025-03-15","2025-03-11","SF FuneralF1017666      250311","","31.63","","290370.56"
"2025-03-15","2025-03-11","SF FuneralF1021955      250311","","63.25","","290433.81"
"2025-03-15","2025-03-11","SF FuneralF1068027      250311","","31.63","","290465.44"
"2025-03-15","2025-03-11","SF FuneralF1072850      250311","","63.25","","290528.69"
"2025-03-15","2025-03-11","SF FuneralFDC0000000L20G250311","","126.5","","290655.19"
"2025-03-15","2025-03-11","SF FuneralF1073209      250311","","126.5","","290781.69"
"2025-03-15","2025-03-11","SF FuneralF1073379      250311","","31.63","","290813.32"
"2025-03-15","2025-03-11","SF FuneralF1073746      250311","","31.63","","290844.95"
"2025-03-15","2025-03-11","SF FuneralF1074598      250311","","31.63","","290876.58"
"2025-03-15","2025-03-11","SF FuneralF1078528      250311","","63.25","","290939.83"
"2025-03-15","2025-03-11","SF FuneralF1080351      250311","","63.25","","291003.08"
"2025-03-15","2025-03-11","SF FuneralF1112035      250311","","31.63","","291034.71"
"2025-03-15","2025-03-11","SF FuneralF1118865      250311","","31.63","","291066.34"
"2025-03-15","2025-03-11","SF FuneralF1123497      250311","","31.63","","291097.97"
"2025-03-15","2025-03-11","SF FuneralF1127719      250311","","31.63","","291129.6"
"2025-03-15","2025-03-11","SF FuneralF739720       250311","","64.13","","291193.73"
"2025-03-15","2025-03-12","SF FuneralFDC00000005LS5250312","","126.5","","291320.23"
"2025-03-15","2025-03-12","SF FuneralFDC0000000718V250312","","126.5","","291446.73"
"2025-03-15","2025-03-12","SF FuneralFDC00000007G41250312","","126.5","","291573.23"
"2025-03-15","2025-03-12","SF FuneralFDC00000007H16250312","","126.5","","291699.73"
"2025-03-15","2025-03-12","SF FuneralFDC00000007KNK250312","","126.5","","291826.23"
"2025-03-15","2025-03-12","SF FuneralF814078       250312","","126.5","","291952.73"
"2025-03-15","2025-03-12","SF FuneralF822974       250312","","126.5","","292079.23"
"2025-03-15","2025-03-12","SF FuneralF1052331      250312","","126.5","","292205.73"
"2025-03-15","2025-03-12","SF FuneralF1052436      250312","","126.5","","292332.23"
"2025-03-15","2025-03-12","SF FuneralF1079669      250312","","126.5","","292458.73"
"2025-03-15","2025-03-12","SF FuneralF1119793      250312","","126.5","","292585.23"
"2025-03-15","2025-03-12","SF FuneralF1128325      250312","","126.5","","292711.73"
"2025-03-15","2025-03-12","SF FuneralF1131004      250312","","126.5","","292838.23"
"2025-03-15","2025-03-13","SF FuneralF830601       250313","","126.5","","292964.73"
"2025-03-15","2025-03-13","SF FuneralF987792       250313","","126.5","","293091.23"
"2025-03-15","2025-03-14","SF FuneralFDC000000032VH250314","","55","","293146.23"
"2025-03-15","2025-03-14","SF FuneralFDC0000000D307250314","","31.63","","293177.86"
"2025-03-15","2025-03-14","SF FuneralF1134597      250314","","31.63","","293209.49"
"2025-03-15","2025-03-10","SF FuneralFDC000000037KM250310","","220","","293429.49"
"2025-03-15","2025-03-10","SF FuneralF1127593      250310","","63.25","","293492.74"
"2025-03-15","2025-03-11","SF FuneralF833557       250311","","63.25","","293555.99"
"2025-03-15","2025-03-11","SF FuneralF840821       250311","","63.25","","293619.24"
"2025-03-15","2025-03-11","SF FuneralF1127561      250311","","63.25","","293682.49"
"2025-03-15","2025-03-12","SF FuneralF800330       250312","","126.5","","293808.99"
"2025-03-15","2025-03-12","SF FuneralF844243       250312","","126.5","","293935.49"
"2025-03-15","2025-03-12","SF FuneralFDC0000000JGPN250312","","126.5","","294061.99"
"2025-03-15","2025-03-12","SF FuneralFDC0000000L1WJ250312","","126.5","","294188.49"
"2025-03-15","2025-03-12","SF FuneralF1114717      250312","","126.5","","294314.99"
"2025-03-15","2025-03-12","SF FuneralF1133159      250312","","126.5","","294441.49"
"2025-03-15","2025-03-13","SF FuneralFDC0000000J05W250313","","126.5","","294567.99"
"2025-03-15","2025-03-10","SF FuneralFDC000000069C5250310","","31.63","","294599.62"
"2025-03-15","2025-03-10","SF FuneralF810327       250310","","31.63","","294631.25"
"2025-03-15","2025-03-10","SF FuneralF1079340      250310","","31.63","","294662.88"
"2025-03-15","2025-03-10","SF FuneralFDC0000000Q9HH250310","","31.63","","294694.51"
"2025-03-15","2025-03-11","SF FuneralFDC00000005L57250311","","31.63","","294726.14"
"2025-03-15","2025-03-11","SF FuneralFDC00000005X2M250311","","31.63","","294757.77"
"2025-03-15","2025-03-11","SF FuneralFDC00000008G43250311","","31.63","","294789.4"
"2025-03-15","2025-03-11","SF FuneralF805200       250311","","31.63","","294821.03"
"2025-03-15","2025-03-11","SF FuneralF817682       250311","","31.63","","294852.66"
"2025-03-15","2025-03-11","SF FuneralF1020683      250311","","31.63","","294884.29"
"2025-03-15","2025-03-11","SF FuneralF1072724      250311","","31.63","","294915.92"
"2025-03-15","2025-03-11","SF FuneralFDC0000000L215250311","","31.63","","294947.55"
"2025-03-15","2025-03-11","SF FuneralF1085179      250311","","31.63","","294979.18"
"2025-03-15","2025-03-11","SF FuneralF1115225      250311","","31.63","","295010.81"
"2025-03-15","2025-03-11","SF FuneralFDC0000000NRVB250311","","31.63","","295042.44"
"2025-03-15","2025-03-11","SF FuneralF1123030      250311","","31.63","","295074.07"
"2025-03-15","2025-03-11","SF FuneralF1127417      250311","","31.63","","295105.7"
"2025-03-15","2025-03-11","SF FuneralF1130616      250311","","31.63","","295137.33"
"2025-03-15","2025-03-11","SF FuneralF1132382      250311","","31.63","","295168.96"
"2025-03-15","2025-03-07","SF FuneralFDC0000000Q00G250307","","126.5","","295295.46"
"2025-03-15","2025-03-08","SF FuneralFDC0000000752S250308","","63.25","","295358.71"
"2025-03-15","2025-03-11","SF FuneralF1083636      250311","","63.25","","295421.96"
"2025-03-15","2025-03-11","SF FuneralF1118010      250311","","63.25","","295485.21"
"2025-03-15","2025-03-12","SF FuneralFDC00000003MLH250312","","220","","295705.21"
"2025-03-15","2025-03-12","SF FuneralFDC00000005VF8250312","","126.5","","295831.71"
"2025-03-15","2025-03-12","SF FuneralFDC0000000B3G4250312","","126.5","","295958.21"
"2025-03-15","2025-03-12","SF FuneralF822156       250312","","126.5","","296084.71"
"2025-03-15","2025-03-12","SF FuneralF1104171      250312","","191.5","","296276.21"
"2025-03-15","2025-03-12","SF FuneralF1124339      250312","","126.5","","296402.71"
"2025-03-15","2025-03-12","SF FuneralF1126155      250312","","126.5","","296529.21"
"2025-03-15","2025-03-12","SF FuneralF1129410      250312","","126.5","","296655.71"
"2025-03-15","2025-03-12","SF FuneralF1130480      250312","","126.5","","296782.21"
"2025-03-15","2025-03-11","SF FuneralF993377       250311","","63.25","","296845.46"
"2025-03-15","2025-03-11","SF FuneralF1085191      250311","","63.25","","296908.71"
"2025-03-15","2025-03-12","SF FuneralFDC00000005PK5250312","","126.5","","297035.21"
"2025-03-15","2025-03-12","SF FuneralFDC00000005RQ7250312","","126.5","","297161.71"
"2025-03-15","2025-03-12","SF FuneralF1118580      250312","","126.5","","297288.21"
"2025-03-15","2025-03-12","SF FuneralFDC0000000PN9W250312","","126.5","","297414.71"
"2025-03-15","2025-03-12","SF FuneralFDC0000000PN9Y250312","","126.5","","297541.21"
"2025-03-15","2025-03-12","SF FuneralF1129504      250312","","126.5","","297667.71"
"2025-03-15","2025-03-12","SF FuneralF1132480      250312","","126.5","","297794.21"
"2025-03-15","2025-03-12","SF FuneralF1132779      250312","","126.5","","297920.71"
"2025-03-15","2025-03-12","SF FuneralF1132799      250312","","126.5","","298047.21"
"2025-03-15","2025-03-15","SF FuneralFDC00000005XNC250315","","31.63","","298078.84"
"2025-03-15","2025-03-15","SF FuneralF1017512      250316","","31.63","","298110.47"
"2025-03-15","2025-03-15","SF FuneralF1121892      250316","","31.63","","298142.1"
"2025-03-15","2025-03-11","SF FuneralF834882       250311","","31.63","","298173.73"
"2025-03-15","2025-03-11","SF FuneralFDC0000000JHBW250311","","31.63","","298205.36"
"2025-03-15","2025-03-11","SF FuneralF1104234      250311","","31.63","","298236.99"
"2025-03-15","2025-03-14","SF FuneralF1072884      250314","","31.63","","298268.62"
"2025-03-15","2025-03-14","SF FuneralF1115119      250314","","31.63","","298300.25"
"2025-03-15","2025-03-14","SF FuneralF1130684      250314","","31.63","","298331.88"
"2025-03-15","2025-03-15","SF FuneralFDC00000005N9V250315","","126.5","","298458.38"
"2025-03-15","2025-03-15","SF FuneralFDC00000006LTK250315","","63.25","","298521.63"
"2025-03-15","2025-03-15","SF FuneralFDC00000007HT4250315","","126.5","","298648.13"
"2025-03-15","2025-03-15","SF FuneralF830878       250315","","126.5","","298774.63"
"2025-03-15","2025-03-15","SF FuneralF1052175      250315","","126.5","","298901.13"
"2025-03-15","2025-03-15","SF FuneralF776812       250315","","386.5","","299287.63"
"2025-03-15","2025-03-15","SF FuneralFDC0000000NJMN250315","","126.5","","299414.13"
"2025-03-15","2025-03-15","SF FuneralF1127722      250315","","126.5","","299540.63"
"2025-03-15","2025-03-15","SF FuneralF1129339      250315","","126.5","","299667.13"
"2025-03-15","2025-03-15","SF FuneralF1132806      250316","","126.5","","299793.63"
"2025-03-15","2025-03-14","SF FuneralFDC00000009V7T250314","","126.5","","299920.13"
"2025-03-15","2025-03-12","SF FuneralFDC00000005N5C250312","","126.5","","300046.63"
"2025-03-15","2025-03-12","SF FuneralFDC00000008N3V250312","","126.5","","300173.13"
"2025-03-15","2025-03-12","SF FuneralF847342       250312","","126.5","","300299.63"
"2025-03-15","2025-03-12","SF FuneralF1073206      250312","","126.5","","300426.13"
"2025-03-15","2025-03-12","SF FuneralFDC0000000N9R0250312","","126.5","","300552.63"
"2025-03-15","2025-03-12","SF FuneralF1129247      250312","","126.5","","300679.13"
"2025-03-15","2025-03-08","SF FuneralF1127847      250309","","63.25","","300742.38"
"2025-03-15","2025-03-11","SF FuneralF822981       250311","","126.5","","300868.88"
"2025-03-15","2025-03-12","SF FuneralFDC00000007J4Y250312","","126.5","","300995.38"
"2025-03-15","2025-03-12","SF FuneralF810150       250312","","126.5","","301121.88"
"2025-03-15","2025-03-12","SF FuneralF819514       250312","","126.5","","301248.38"
"2025-03-15","2025-03-12","SF FuneralF834564       250312","","126.5","","301374.88"
"2025-03-15","2025-03-12","SF FuneralF981800       250312","","126.5","","301501.38"
"2025-03-15","2025-03-12","SF FuneralF1017041      250312","","126.5","","301627.88"
"2025-03-15","2025-03-12","SF FuneralF1073647      250312","","126.5","","301754.38"
"2025-03-15","2025-03-12","SF FuneralFDC0000000N6RG250312","","126.5","","301880.88"
"2025-03-15","2025-03-12","SF FuneralF1114926      250312","","126.5","","302007.38"
"2025-03-15","2025-03-12","SF FuneralFDC0000000NFGD250312","","126.5","","302133.88"
"2025-03-15","2025-03-12","SF FuneralFDC0000000NPJ0250312","","126.5","","302260.38"
"2025-03-15","2025-03-12","SF FuneralF1118624      250312","","126.5","","302386.88"
"2025-03-15","2025-03-12","SF FuneralF1118720      250312","","126.5","","302513.38"
"2025-03-15","2025-03-12","SF FuneralF1123465      250312","","126.5","","302639.88"
"2025-03-15","2025-03-12","SF FuneralFDC0000000PQNK250312","","63.25","","302703.13"
"2025-03-15","2025-03-12","SF FuneralF1131883      250312","","63.25","","302766.38"
"2025-03-15","2025-03-12","SF FuneralF1134330      250312","","63.25","","302829.63"
"2025-03-15","2025-03-15","SF FuneralFDC00000007GR6250315","","31.63","","302861.26"
"2025-03-15","2025-03-15","SF FuneralF832932       250315","","31.63","","302892.89"
"2025-03-15","2025-03-15","SF FuneralF1072684      250315","","31.63","","302924.52"
"2025-03-15","2025-03-15","SF FuneralFDC0000000LNR4250316","","31.63","","302956.15"
"2025-03-15","2025-03-15","SF FuneralF1020853      250316","","126.5","","303082.65"
"2025-03-15","2025-03-11","SF FuneralFDC0000000595N250311","","31.62","","303114.27"
"2025-03-15","2025-03-11","SF FuneralFDC00000007CQV250311","","31.63","","303145.9"
"2025-03-15","2025-03-11","SF FuneralF1118348      250311","","31.63","","303177.53"
"2025-03-15","2025-03-11","SF FuneralF1130344      250311","","31.63","","303209.16"
"2025-03-15","2025-03-11","SF FuneralF1130991      250311","","31.63","","303240.79"
"2025-03-15","2025-03-15","SF FuneralFDC0000000KDQ3250315","","126.5","","303367.29"
"2025-03-15","2025-03-15","SF FuneralF1104075      250315","","126.5","","303493.79"
"2025-03-15","2025-03-15","SF FuneralF1119754      250316","","126.5","","303620.29"
"2025-03-15","2025-03-11","SF FuneralF822239       250311","","31.63","","303651.92"
"2025-03-15","2025-03-11","SF FuneralF1122750      250311","","31.63","","303683.55"
"2025-03-15","2025-03-11","SF FuneralF1123455      250311","","126.5","","303810.05"
"2025-03-15","2025-03-11","SF FuneralF1132532      250311","","63.25","","303873.3"
"2025-03-15","2025-03-12","SF FuneralFDC00000005ZJ4250312","","126.5","","303999.8"
"2025-03-15","2025-03-12","SF FuneralF810622       250312","","126.5","","304126.3"
"2025-03-15","2025-03-12","SF FuneralF843690       250312","","126.5","","304252.8"
"2025-03-15","2025-03-12","SF FuneralF1073420      250312","","126.5","","304379.3"
"2025-03-15","2025-03-12","SF FuneralF1132392      250312","","63.25","","304442.55"
"2025-03-15","2025-03-15","SF FuneralFDC00000002RFQ250315","","220","","304662.55"
"2025-03-15","2025-03-12","SF FuneralF822682       250312","","126.5","","304789.05"
"2025-03-15","2025-03-12","SF FuneralF1073273      250312","","126.5","","304915.55"
"2025-03-15","2025-03-12","SF FuneralF1124445      250312","","126.5","","305042.05"
"2025-03-15","2025-03-12","SF FuneralF1130339      250312","","126.5","","305168.55"
"2025-03-15","2025-03-11","SF FuneralFDC000000079QY250311","","31.63","","305200.18"
"2025-03-15","2025-03-11","SF FuneralFDC00000007GVV250311","","63.25","","305263.43"
"2025-03-15","2025-03-12","SF FuneralF804321       250312","","126.5","","305389.93"
"2025-03-15","2025-03-12","SF FuneralF989808       250312","","126.5","","305516.43"
"2025-03-15","2025-03-15","SF FuneralF810290       250315","","126.5","","305642.93"
"2025-03-15","2025-03-15","SF FuneralF1125662      250315","","31.63","","305674.56"
"2025-03-15","2025-03-15","SF FuneralFDC0000000QGJL250316","","126.5","","305801.06"
"2025-03-15","2025-03-11","SF FuneralF802375       250311","","31.63","","305832.69"
"2025-03-15","2025-03-11","SF FuneralF1103565      250311","","63.25","","305895.94"
"2025-03-15","2025-03-11","SF FuneralF981451       250311","","31.63","","305927.57"
"2025-03-15","2025-03-12","SF FuneralFDC00000005JLK250312","","126.5","","306054.07"
"2025-03-15","2025-03-12","SF FuneralFDC00000008T6X250312","","126.5","","306180.57"
"2025-03-15","2025-03-12","SF FuneralF1021776      250312","","126.5","","306307.07"
"2025-03-15","2025-03-14","SF FuneralF843410       250314","","31.63","","306338.7"
"2025-03-15","2025-03-15","SF FuneralF1084288      250315","","31.63","","306370.33"
"2025-03-15","2025-03-15","SF FuneralFDC0000000Q80S250315","","126.5","","306496.83"
"2025-03-15","2025-03-15","SF FuneralFDC0000000QH3N250316","","126.5","","306623.33"
"2025-03-15","2025-03-14","Rev SF FuneralFDC000000032VH250314","","-55","","306568.33"
"2025-03-15","2025-03-14","Rev SF FuneralFDC000000069RZ250314","","-31.63","","306536.7"
"2025-03-15","2025-02-12","Rev SF FuneralFDC00000007FWD250212","","-126.5","","306410.2"
"2025-03-15","2025-03-11","Rev SF FuneralFDC00000005N64250311","","-63.25","","306346.95"
"2025-03-15","2025-03-11","Rev SF FuneralFDC00000009CP1250311","","-95.75","","306251.2"
"2025-03-15","2025-02-28","Rev SF FuneralFDC00000006KZ0250228","","-126.5","","306124.7"
"2025-03-15","2025-01-13","Rev SF FuneralFDC00000007FWD250112","","-126.5","","305998.2"
"2025-03-15","2025-03-08","Rev SF FuneralFDC0000000KH3D250309","","-31.63","","305966.57"
"2025-03-15","2025-03-11","Rev SF FuneralF1111658      250311","","-63.25","","305903.32"
"2025-03-15","2025-03-12","Rev SF FuneralFDC0000000BLKQ250312","","-126.5","","305776.82"
"2025-03-15","2025-03-08","SF FuneralFDC00000007B53250308","","63.25","","305840.07"
"2025-03-15","2025-03-10","SF FuneralF1129915      250310","","31.63","","305871.7"
"2025-03-15","2025-03-11","SF FuneralFDC00000005V84250311","","126.5","","305998.2"
"2025-03-15","2025-03-11","SF FuneralF816436       250311","","31.63","","306029.83"
"2025-03-15","2025-03-11","SF FuneralF833072       250311","","31.63","","306061.46"
"2025-03-15","2025-03-11","SF FuneralF1083711      250311","","63.25","","306124.71"
"2025-03-15","2025-03-11","SF FuneralF1131861      250311","","31.63","","306156.34"
"2025-03-15","2025-03-12","SF FuneralFDC00000005TL4250312","","126.5","","306282.84"
"2025-03-15","2025-03-12","SF FuneralFDC000000060ZD250312","","126.5","","306409.34"
"2025-03-15","2025-03-12","SF FuneralF822014       250312","","126.5","","306535.84"
"2025-03-15","2025-03-12","SF FuneralF842872       250312","","31.63","","306567.47"
"2025-03-15","2025-03-12","SF FuneralF1073027      250312","","126.5","","306693.97"
"2025-03-15","2025-03-12","SF FuneralF1073806      250312","","126.5","","306820.47"
"2025-03-15","2025-03-12","SF FuneralF1114667      250312","","126.5","","306946.97"
"2025-03-15","2025-03-13","SF FuneralF1110817      250313","","63.25","","307010.22"
"2025-03-15","2025-03-14","SF FuneralF1127614      250314","","31.63","","307041.85"
"2025-03-15","2025-03-14","SF FuneralF822267       250314","","31.63","","307073.48"
"2025-03-15","2025-03-12","Rev SF FuneralFDC0000000LG2D250312","","-31.63","","307041.85"
"2025-03-15","2025-03-11","Rev SF FuneralFDC0000000JHBW250311","","-31.63","","307010.22"
"2025-03-15","2025-03-14","Rev SF FuneralFDC0000000Q90L250314","","-126.5","","306883.72"
"2025-03-15","2025-01-11","Rev SF FuneralFDC0000000MZNV250112","","-126.5","","306757.22"
"2025-03-15","2025-02-12","Rev SF FuneralFDC0000000MZNV250212","","-126.5","","306630.72"
"2025-03-15","2025-03-12","Rev SF FuneralFDC0000000MZNV250312","","-126.5","","306504.22"
"2025-03-15","2025-03-12","Rev SF FuneralFDC00000007J4Y250312","","-126.5","","306377.72"
"2025-03-15","2025-03-12","Rev SF FuneralFDC0000000NFGD250312","","-126.5","","306251.22"
"2025-03-15","2025-03-12","Rev SF FuneralFDC0000000B3G4250312","","-126.5","","306124.72"
"2025-03-15","2024-12-11","Rev SF FuneralFDC000000032JC241228","","-220","","305904.72"
"2025-03-15","2025-03-10","SF FuneralF829866       250309","","126.5","","306031.22"
"2025-03-15","2025-03-12","SF FuneralFDC000000095NR250312","","126.5","","306157.72"
"2025-03-15","2025-03-12","SF FuneralF844044       250312","","31.63","","306189.35"
"2025-03-15","2025-03-14","SF FuneralF989273       250316","","31.63","","306220.98"
"2025-03-15","2025-03-15","SF FuneralFDC000000071GW250315","","126.5","","306347.48"
"2025-03-15","2025-03-15","SF FuneralFDC00000007VKH250315","","31.63","","306379.11"
"2025-03-15","2025-03-15","SF FuneralF775997       250315","","191.5","","306570.61"
"2025-03-15","2025-03-10","SF FuneralF1128062      250310","","31.63","","306602.24"
"2025-03-15","2025-03-12","SF FuneralF1127551      250312","","126.5","","306728.74"
"2025-03-15","2025-03-14","SF FuneralF779346       250314","","31.63","","306760.37"
"2025-03-15","2025-03-11","SF FuneralFDC0000000788B250311","","31.63","","306792"
"2025-03-15","2025-03-12","SF FuneralF990573       250312","","126.5","","306918.5"
"2025-03-15","2024-12-23","Rev SF FuneralFDC000000072PC241222","","-126.5","","306792"
"2025-03-15","2025-01-22","Rev SF FuneralFDC000000072PC250122","","-126.5","","306665.5"
"2025-03-15","2025-02-22","Rev SF FuneralFDC000000072PC250222","","-126.5","","306539"
